Node_ID,cp_level_x,cp_r_citing_zero_x,cp_r_citing_nonzero_x,tr_citing_x,cp_r_cited_zero_x,cp_r_cited_nonzero_x,tr_cited_x,Cluster_ID,cp_level_y,cp_r_citing_zero_y,cp_r_citing_nonzero_y,tr_citing_y,cp_r_cited_zero_y,cp_r_cited_nonzero_y,tr_cited_y,network_degree,network_indegree,network_outdegree,cluster_degree,cluster_indegree,cluster_outdegree
9907233,3,3,0,0,1,2,10,100,1.0,1.0,0.0,0.0,0.0,1.0,5.0,14,3,11,7.0,1.0,6.0
9409371,61,10,51,197,51,10,10,67,29.0,3.0,26.0,109.0,23.0,6.0,6.0,64,61,3,19.0,18.0,1.0
9303284,190,34,156,1451,90,100,100,34,76.0,7.0,69.0,854.0,20.0,56.0,56.0,191,190,1,55.0,54.0,1.0
11358,4,3,1,1,1,3,5,372,0.0,0.0,0.0,0.0,0.0,0.0,0.0,14,4,10,4.0,2.0,2.0
9809311,111,4,107,730,1,110,775,1,72.0,2.0,70.0,530.0,0.0,72.0,653.0,134,111,23,60.0,48.0,12.0
9308246,314,15,299,2372,102,212,286,6,128.0,5.0,123.0,1106.0,16.0,112.0,169.0,318,314,4,45.0,43.0,2.0
9408382,49,6,43,224,49,0,0,7,27.0,4.0,23.0,115.0,27.0,0.0,0.0,50,49,1,14.0,14.0,0.0
6280,12,4,8,18,0,12,98,7,7.0,2.0,5.0,11.0,0.0,7.0,50.0,52,12,40,13.0,4.0,9.0
9904379,9,5,4,7,2,7,22,32,1.0,1.0,0.0,0.0,0.0,1.0,4.0,30,9,21,6.0,2.0,4.0
9902334,52,5,47,310,0,52,451,34,44.0,5.0,39.0,267.0,0.0,44.0,396.0,78,52,26,46.0,30.0,16.0
108195,9,6,3,3,3,6,9,239,2.0,2.0,0.0,0.0,2.0,0.0,0.0,19,9,10,3.0,2.0,1.0
9206236,122,28,94,412,122,0,0,34,24.0,3.0,21.0,119.0,24.0,0.0,0.0,122,122,0,10.0,10.0,0.0
211224,2,2,0,0,0,2,10,4,0.0,0.0,0.0,0.0,0.0,0.0,0.0,45,2,43,5.0,0.0,5.0
9506461,57,14,43,242,14,43,146,48,30.0,6.0,24.0,140.0,12.0,18.0,49.0,71,57,14,23.0,22.0,1.0
9203216,56,32,24,54,56,0,0,35,6.0,3.0,3.0,6.0,6.0,0.0,0.0,56,56,0,4.0,4.0,0.0
102227,53,4,49,203,2,51,338,19,26.0,2.0,24.0,105.0,1.0,25.0,125.0,79,53,26,21.0,16.0,5.0
10354,34,4,30,169,7,27,71,165,31.0,2.0,29.0,164.0,12.0,19.0,19.0,52,34,18,28.0,27.0,1.0
9704312,28,7,21,62,6,22,50,33,17.0,2.0,15.0,49.0,4.0,13.0,24.0,35,28,7,14.0,12.0,2.0
9503213,21,9,12,28,6,15,42,43,7.0,2.0,5.0,12.0,4.0,3.0,3.0,28,21,7,4.0,3.0,1.0
9611363,96,16,80,367,12,84,281,25,38.0,3.0,35.0,146.0,2.0,36.0,143.0,108,96,12,31.0,24.0,7.0
9708357,25,8,17,45,3,22,46,33,8.0,3.0,5.0,14.0,0.0,8.0,13.0,38,25,13,8.0,6.0,2.0
9807558,4,2,2,2,0,4,10,403,1.0,1.0,0.0,0.0,0.0,1.0,3.0,7,4,3,1.0,0.0,1.0
9907462,11,3,8,18,0,11,142,33,8.0,1.0,7.0,14.0,0.0,8.0,73.0,96,11,85,18.0,3.0,15.0
9512355,33,9,24,69,33,0,0,4,8.0,2.0,6.0,14.0,8.0,0.0,0.0,33,33,0,9.0,9.0,0.0
106098,15,6,9,25,0,15,67,37,5.0,2.0,3.0,5.0,0.0,5.0,5.0,32,15,17,12.0,7.0,5.0
9406401,13,10,3,5,5,8,24,26,5.0,3.0,2.0,3.0,2.0,3.0,10.0,24,13,11,4.0,3.0,1.0
9709297,17,4,13,20,7,10,33,26,1.0,1.0,0.0,0.0,1.0,0.0,0.0,33,17,16,2.0,2.0,0.0
9905468,2,1,1,1,0,2,9,26,1.0,1.0,0.0,0.0,0.0,1.0,4.0,18,2,16,2.0,0.0,2.0
9212229,38,16,22,65,38,0,0,35,9.0,3.0,6.0,11.0,9.0,0.0,0.0,38,38,0,7.0,7.0,0.0
9304249,11,4,7,17,6,5,5,19,3.0,2.0,1.0,1.0,0.0,3.0,3.0,12,11,1,6.0,6.0,0.0
9409457,17,11,6,7,7,10,12,157,4.0,1.0,3.0,4.0,0.0,4.0,4.0,20,17,3,5.0,4.0,1.0
9903294,66,3,63,618,0,66,686,2,61.0,4.0,57.0,585.0,0.0,61.0,655.0,85,66,19,55.0,41.0,14.0
9407301,3,2,1,1,2,1,2,93,2.0,1.0,1.0,1.0,1.0,1.0,2.0,7,3,4,1.0,1.0,0.0
108059,13,3,10,18,0,13,151,4,5.0,4.0,1.0,1.0,0.0,5.0,57.0,49,13,36,24.0,4.0,20.0
9501339,51,15,36,126,18,33,105,93,16.0,6.0,10.0,22.0,1.0,15.0,60.0,62,51,11,15.0,7.0,8.0
9806219,81,17,64,174,9,72,255,20,15.0,3.0,12.0,28.0,0.0,15.0,61.0,94,81,13,16.0,14.0,2.0
9301289,21,5,16,54,21,0,0,63,14.0,4.0,10.0,26.0,14.0,0.0,0.0,21,21,0,11.0,11.0,0.0
9305234,2,1,1,1,2,0,0,149,2.0,1.0,1.0,1.0,2.0,0.0,0.0,2,2,0,2.0,2.0,0.0
9610457,5,4,1,1,2,3,12,23,0.0,0.0,0.0,0.0,0.0,0.0,0.0,40,5,35,2.0,0.0,2.0
9511388,94,6,88,704,14,80,273,23,48.0,2.0,46.0,328.0,4.0,44.0,157.0,113,94,19,43.0,37.0,6.0
9310358,58,5,53,223,31,27,30,25,18.0,2.0,16.0,57.0,4.0,14.0,14.0,60,58,2,17.0,16.0,1.0
9207279,197,51,146,775,197,0,0,10,27.0,11.0,16.0,88.0,27.0,0.0,0.0,197,197,0,21.0,21.0,0.0
9212245,18,6,12,46,18,0,0,10,8.0,2.0,6.0,17.0,8.0,0.0,0.0,18,18,0,8.0,8.0,0.0
9208205,41,8,33,95,16,25,25,69,21.0,4.0,17.0,37.0,5.0,16.0,16.0,42,41,1,13.0,12.0,1.0
9207218,75,16,59,233,75,0,0,87,25.0,2.0,23.0,115.0,25.0,0.0,0.0,75,75,0,22.0,22.0,0.0
3184,57,9,48,272,2,55,535,0,36.0,4.0,32.0,199.0,1.0,35.0,325.0,113,57,56,43.0,24.0,19.0
9803299,74,5,69,394,3,71,279,0,43.0,3.0,40.0,261.0,0.0,43.0,180.0,85,74,11,40.0,34.0,6.0
9812308,8,6,2,2,0,8,39,3,5.0,4.0,1.0,1.0,0.0,5.0,23.0,26,8,18,1.0,1.0,0.0
9805238,26,1,25,83,9,17,23,0,9.0,1.0,8.0,13.0,5.0,4.0,4.0,31,26,5,11.0,10.0,1.0
9911524,68,8,60,293,0,68,492,0,39.0,3.0,36.0,195.0,0.0,39.0,294.0,107,68,39,39.0,25.0,14.0
9604415,13,7,6,9,11,2,4,0,1.0,1.0,0.0,0.0,1.0,0.0,0.0,15,13,2,2.0,2.0,0.0
9811252,47,3,44,257,2,45,108,3,38.0,2.0,36.0,195.0,3.0,35.0,79.0,59,47,12,17.0,16.0,1.0
9907532,61,12,49,207,5,56,389,3,37.0,8.0,29.0,130.0,0.0,37.0,320.0,85,61,24,35.0,18.0,17.0
9703465,68,10,58,271,13,55,142,0,37.0,4.0,33.0,185.0,2.0,35.0,67.0,81,68,13,29.0,27.0,2.0
9209259,16,10,6,8,16,0,0,250,12.0,6.0,6.0,8.0,12.0,0.0,0.0,16,16,0,7.0,7.0,0.0
9803415,45,6,39,155,2,43,104,0,8.0,2.0,6.0,10.0,8.0,0.0,0.0,51,45,6,12.0,12.0,0.0
9511323,8,1,7,12,4,4,5,91,3.0,1.0,2.0,3.0,3.0,0.0,0.0,13,8,5,4.0,3.0,1.0
9807361,32,11,21,124,17,15,35,0,17.0,2.0,15.0,92.0,17.0,0.0,0.0,37,32,5,16.0,16.0,0.0
9704253,29,7,22,78,7,22,55,3,16.0,4.0,12.0,34.0,2.0,14.0,34.0,36,29,7,13.0,10.0,3.0
9505383,11,6,5,5,0,11,34,3,2.0,2.0,0.0,0.0,0.0,2.0,7.0,21,11,10,5.0,1.0,4.0
9711358,12,9,3,3,7,5,14,0,3.0,3.0,0.0,0.0,3.0,0.0,0.0,27,12,15,2.0,2.0,0.0
9506228,21,11,10,16,4,17,52,0,7.0,3.0,4.0,5.0,0.0,7.0,20.0,50,21,29,4.0,4.0,0.0
9338,5,3,2,3,1,4,21,81,3.0,1.0,2.0,3.0,0.0,3.0,19.0,21,5,16,9.0,3.0,6.0
9512429,12,4,8,23,11,1,1,10,6.0,1.0,5.0,10.0,6.0,0.0,0.0,13,12,1,7.0,7.0,0.0
9710406,11,4,7,22,6,5,9,187,7.0,1.0,6.0,20.0,2.0,5.0,8.0,16,11,5,9.0,7.0,2.0
9804261,12,2,10,26,0,12,70,46,8.0,2.0,6.0,12.0,0.0,8.0,49.0,21,12,9,10.0,4.0,6.0
9504323,3,2,1,1,1,2,9,10,0.0,0.0,0.0,0.0,0.0,0.0,0.0,15,3,12,1.0,0.0,1.0
9503248,13,3,10,21,0,13,53,63,7.0,2.0,5.0,9.0,1.0,6.0,24.0,20,13,7,13.0,8.0,5.0
9710273,4,4,0,0,2,2,3,42,0.0,0.0,0.0,0.0,0.0,0.0,0.0,15,4,11,2.0,0.0,2.0
9710401,114,18,96,614,11,103,904,15,57.0,3.0,54.0,439.0,0.0,57.0,710.0,167,114,53,65.0,30.0,35.0
9707430,44,8,36,215,11,33,78,4,30.0,4.0,26.0,151.0,10.0,20.0,24.0,54,44,10,25.0,24.0,1.0
9606345,155,65,90,248,102,53,112,16,10.0,6.0,4.0,13.0,0.0,10.0,17.0,163,155,8,12.0,9.0,3.0
9210240,58,22,36,116,54,4,4,10,16.0,7.0,9.0,23.0,16.0,0.0,0.0,59,58,1,8.0,8.0,0.0
9403350,41,5,36,182,11,30,44,12,24.0,1.0,23.0,93.0,6.0,18.0,24.0,46,41,5,16.0,14.0,2.0
9908451,11,6,5,12,0,11,94,12,4.0,1.0,3.0,4.0,0.0,4.0,48.0,56,11,45,7.0,3.0,4.0
9703276,140,6,134,1344,36,104,302,36,83.0,2.0,81.0,1045.0,14.0,69.0,143.0,162,140,22,62.0,61.0,1.0
9706398,16,3,13,27,12,4,4,48,8.0,2.0,6.0,10.0,8.0,0.0,0.0,17,16,1,3.0,3.0,0.0
1290,30,6,24,52,17,13,29,1,9.0,3.0,6.0,12.0,9.0,0.0,0.0,36,30,6,6.0,6.0,0.0
9903363,107,14,93,573,19,88,216,32,36.0,1.0,35.0,210.0,7.0,29.0,39.0,120,107,13,20.0,20.0,0.0
8143,23,6,17,58,0,23,194,2,15.0,4.0,11.0,42.0,0.0,15.0,120.0,50,23,27,22.0,12.0,10.0
9509287,26,4,22,65,0,26,114,1,22.0,4.0,18.0,51.0,0.0,22.0,100.0,34,26,8,21.0,15.0,6.0
9804393,15,7,8,12,1,14,58,1,5.0,3.0,2.0,2.0,0.0,5.0,26.0,31,15,16,6.0,5.0,1.0
9512396,127,7,120,1306,24,103,213,23,63.0,1.0,62.0,806.0,8.0,55.0,100.0,133,127,6,55.0,53.0,2.0
9612394,69,6,63,376,8,61,169,67,38.0,4.0,34.0,208.0,2.0,36.0,69.0,86,69,17,31.0,28.0,3.0
104034,79,20,59,161,12,67,418,7,25.0,4.0,21.0,61.0,1.0,24.0,249.0,118,79,39,40.0,17.0,23.0
9504324,81,21,60,185,22,59,281,10,12.0,3.0,9.0,29.0,12.0,0.0,0.0,157,81,76,11.0,10.0,1.0
9612426,48,7,41,220,5,43,223,5,35.0,5.0,30.0,178.0,0.0,35.0,187.0,62,48,14,18.0,17.0,1.0
9706540,58,9,49,189,11,47,190,5,18.0,5.0,13.0,38.0,0.0,18.0,109.0,69,58,11,10.0,8.0,2.0
9603379,13,4,9,27,8,5,11,87,9.0,2.0,7.0,21.0,9.0,0.0,0.0,18,13,5,8.0,8.0,0.0
9409396,10,3,7,14,0,10,39,93,10.0,3.0,7.0,14.0,0.0,10.0,39.0,16,10,6,16.0,10.0,6.0
9703435,10,7,3,5,5,5,7,48,1.0,1.0,0.0,0.0,0.0,1.0,1.0,17,10,7,3.0,3.0,0.0
9709301,27,14,13,27,3,24,192,1,9.0,2.0,7.0,17.0,0.0,9.0,61.0,212,27,185,16.0,2.0,14.0
105252,4,4,0,0,0,4,7,580,3.0,3.0,0.0,0.0,1.0,2.0,2.0,7,4,3,4.0,2.0,2.0
9706520,50,11,39,133,4,46,300,6,30.0,7.0,23.0,76.0,0.0,30.0,229.0,68,50,18,16.0,12.0,4.0
9912372,7,4,3,4,1,6,19,1,2.0,1.0,1.0,1.0,0.0,2.0,3.0,24,7,17,2.0,2.0,0.0
9604438,42,14,28,77,3,39,140,6,13.0,4.0,9.0,15.0,2.0,11.0,12.0,67,42,25,7.0,5.0,2.0
9610478,10,2,8,12,6,4,4,1,,,,,,,,11,10,1,2.0,2.0,0.0
9406286,25,6,19,49,6,19,95,7,8.0,2.0,6.0,13.0,1.0,7.0,12.0,42,25,17,13.0,5.0,8.0
7170,9,1,8,16,0,9,48,1,1.0,1.0,0.0,0.0,0.0,1.0,1.0,27,9,18,2.0,0.0,2.0
9403362,35,8,27,108,12,23,42,4,22.0,4.0,18.0,77.0,5.0,17.0,30.0,40,35,5,17.0,15.0,2.0
9904425,36,3,33,166,0,36,556,2,26.0,1.0,25.0,150.0,0.0,26.0,501.0,68,36,32,45.0,20.0,25.0
9510256,6,6,0,0,5,1,1,174,2.0,2.0,0.0,0.0,2.0,0.0,0.0,8,6,2,2.0,2.0,0.0
9702244,36,2,34,206,1,35,270,21,30.0,2.0,28.0,179.0,0.0,30.0,229.0,59,36,23,37.0,23.0,14.0
9307369,15,5,10,15,15,0,0,7,3.0,2.0,1.0,1.0,3.0,0.0,0.0,16,15,1,3.0,3.0,0.0
9406427,43,13,30,94,3,40,248,75,15.0,7.0,8.0,15.0,0.0,15.0,83.0,71,43,28,20.0,11.0,9.0
9401226,88,12,76,291,15,73,417,6,40.0,4.0,36.0,135.0,3.0,37.0,252.0,104,88,16,25.0,17.0,8.0
9605235,86,3,83,711,5,81,439,15,62.0,1.0,61.0,586.0,1.0,61.0,384.0,99,86,13,57.0,45.0,12.0
9209245,48,11,37,251,48,0,0,15,34.0,6.0,28.0,211.0,34.0,0.0,0.0,48,48,0,20.0,20.0,0.0
9503227,3,2,1,2,3,0,0,12,,,,,,,,5,3,2,1.0,1.0,0.0
9901382,6,4,2,2,1,5,18,76,1.0,1.0,0.0,0.0,0.0,1.0,2.0,15,6,9,3.0,1.0,2.0
9408207,25,4,21,76,25,0,0,76,21.0,2.0,19.0,72.0,21.0,0.0,0.0,25,25,0,17.0,17.0,0.0
9602334,21,5,16,39,7,14,30,62,10.0,4.0,6.0,17.0,0.0,10.0,25.0,26,21,5,10.0,6.0,4.0
9306240,71,12,59,316,18,53,71,19,19.0,2.0,17.0,54.0,6.0,13.0,13.0,73,71,2,16.0,15.0,1.0
9309246,17,6,11,31,4,13,23,62,8.0,5.0,3.0,6.0,1.0,7.0,15.0,20,17,3,6.0,4.0,2.0
9309234,51,12,39,139,42,9,9,30,16.0,2.0,14.0,50.0,16.0,0.0,0.0,52,51,1,8.0,7.0,1.0
9411220,10,6,4,6,10,0,0,126,6.0,3.0,3.0,5.0,6.0,0.0,0.0,10,10,0,4.0,4.0,0.0
9611225,25,1,24,102,17,8,10,127,23.0,1.0,22.0,96.0,23.0,0.0,0.0,28,25,3,18.0,18.0,0.0
9701303,62,7,55,315,0,62,317,16,38.0,2.0,36.0,227.0,2.0,36.0,127.0,87,62,25,28.0,23.0,5.0
9612415,17,6,11,25,0,17,61,57,10.0,2.0,8.0,17.0,3.0,7.0,17.0,28,17,11,12.0,8.0,4.0
9610215,1,1,0,0,0,1,3,11,1.0,1.0,0.0,0.0,0.0,1.0,3.0,4,1,3,,,
9304276,39,18,21,42,39,0,0,236,13.0,6.0,7.0,14.0,13.0,0.0,0.0,39,39,0,10.0,10.0,0.0
9211322,57,11,46,180,57,0,0,62,29.0,5.0,24.0,109.0,29.0,0.0,0.0,57,57,0,17.0,17.0,0.0
9904274,5,1,4,6,1,4,18,80,3.0,1.0,2.0,2.0,1.0,2.0,7.0,17,5,12,6.0,4.0,2.0
9602351,64,9,55,266,14,50,171,30,37.0,2.0,35.0,210.0,7.0,30.0,72.0,96,64,32,30.0,25.0,5.0
9703446,22,9,13,33,4,18,74,114,5.0,2.0,3.0,3.0,0.0,5.0,19.0,39,22,17,11.0,5.0,6.0
9505389,3,2,1,1,1,2,2,225,0.0,0.0,0.0,0.0,0.0,0.0,0.0,7,3,4,2.0,2.0,0.0
3146,13,4,9,14,0,13,103,6,8.0,4.0,4.0,7.0,1.0,7.0,27.0,36,13,23,18.0,7.0,11.0
9304274,8,5,3,4,8,0,0,208,3.0,3.0,0.0,0.0,3.0,0.0,0.0,8,8,0,1.0,1.0,0.0
9703404,32,1,31,166,6,26,64,24,24.0,1.0,23.0,140.0,6.0,18.0,31.0,39,32,7,24.0,23.0,1.0
9204206,14,10,4,4,14,0,0,29,4.0,2.0,2.0,2.0,4.0,0.0,0.0,14,14,0,3.0,3.0,0.0
9409453,35,9,26,93,11,24,59,6,26.0,5.0,21.0,77.0,6.0,20.0,46.0,39,35,4,19.0,16.0,3.0
9607400,29,7,22,57,17,12,32,4,3.0,2.0,1.0,1.0,1.0,2.0,9.0,38,29,9,1.0,0.0,1.0
9705464,8,4,4,4,1,7,14,103,4.0,1.0,3.0,3.0,0.0,4.0,8.0,13,8,5,4.0,1.0,3.0
9509312,63,19,44,209,8,55,152,8,19.0,2.0,17.0,81.0,0.0,19.0,53.0,80,63,17,19.0,16.0,3.0
9403346,10,7,3,6,10,0,0,93,4.0,2.0,2.0,2.0,4.0,0.0,0.0,10,10,0,5.0,5.0,0.0
9411409,65,14,51,291,65,0,0,45,37.0,4.0,33.0,209.0,37.0,0.0,0.0,65,65,0,26.0,26.0,0.0
9912274,23,6,17,31,4,19,78,20,4.0,2.0,2.0,2.0,4.0,0.0,0.0,34,23,11,10.0,7.0,3.0
9906369,1,1,0,0,0,1,8,45,1.0,1.0,0.0,0.0,0.0,1.0,8.0,9,1,8,,,
9306294,88,13,75,370,39,49,52,22,44.0,3.0,41.0,257.0,22.0,22.0,22.0,90,88,2,31.0,30.0,1.0
9401309,22,6,16,51,22,0,0,22,14.0,1.0,13.0,42.0,14.0,0.0,0.0,22,22,0,8.0,8.0,0.0
9810313,31,5,26,152,0,31,198,22,25.0,3.0,22.0,136.0,0.0,25.0,134.0,48,31,17,34.0,23.0,11.0
9405371,21,9,12,26,8,13,14,88,4.0,2.0,2.0,5.0,1.0,3.0,3.0,24,21,3,5.0,4.0,1.0
9704414,13,3,10,21,0,13,46,88,8.0,2.0,6.0,13.0,0.0,8.0,32.0,27,13,14,13.0,6.0,7.0
101251,6,4,2,2,1,5,22,22,3.0,2.0,1.0,1.0,0.0,3.0,9.0,21,6,15,3.0,1.0,2.0
9610400,75,3,72,518,2,73,211,21,55.0,2.0,53.0,438.0,0.0,55.0,174.0,83,75,8,42.0,37.0,5.0
9608341,5,4,1,2,0,5,38,21,2.0,1.0,1.0,1.0,0.0,2.0,21.0,19,5,14,4.0,0.0,4.0
3035,13,6,7,12,0,13,95,39,9.0,3.0,6.0,11.0,0.0,9.0,62.0,31,13,18,21.0,7.0,14.0
9710213,9,2,7,20,0,9,21,19,9.0,2.0,7.0,20.0,0.0,9.0,21.0,12,9,3,1.0,1.0,0.0
9812455,32,4,28,113,3,29,62,80,17.0,3.0,14.0,66.0,1.0,16.0,25.0,39,32,7,16.0,14.0,2.0
9909506,69,4,65,701,0,69,141,19,58.0,3.0,55.0,637.0,0.0,58.0,123.0,74,69,5,50.0,47.0,3.0
9612204,12,4,8,14,2,10,36,8,4.0,1.0,3.0,5.0,0.0,4.0,11.0,34,12,22,8.0,4.0,4.0
9505343,15,8,7,7,5,10,24,39,3.0,1.0,2.0,2.0,0.0,3.0,6.0,20,15,5,5.0,3.0,2.0
5094,18,1,17,57,2,16,88,20,15.0,1.0,14.0,52.0,0.0,15.0,86.0,26,18,8,2.0,2.0,0.0
9812445,69,3,66,483,1,68,226,20,50.0,1.0,49.0,441.0,1.0,49.0,150.0,79,69,10,43.0,40.0,3.0
9908212,28,3,25,105,1,27,192,20,27.0,2.0,25.0,105.0,0.0,27.0,192.0,43,28,15,30.0,20.0,10.0
9307222,50,9,41,152,50,0,0,49,18.0,4.0,14.0,25.0,18.0,0.0,0.0,50,50,0,11.0,11.0,0.0
9503376,19,4,15,32,5,14,40,7,5.0,1.0,4.0,6.0,3.0,2.0,2.0,26,19,7,7.0,6.0,1.0
9501304,29,7,22,78,8,21,37,136,24.0,4.0,20.0,76.0,4.0,20.0,36.0,31,29,2,22.0,20.0,2.0
9506309,12,8,4,6,5,7,10,220,6.0,3.0,3.0,4.0,6.0,0.0,0.0,15,12,3,5.0,4.0,1.0
9801282,29,8,21,67,12,17,47,13,14.0,3.0,11.0,45.0,3.0,11.0,29.0,36,29,7,12.0,12.0,0.0
211218,6,1,5,10,0,6,35,37,6.0,1.0,5.0,10.0,0.0,6.0,33.0,27,6,21,15.0,6.0,9.0
9906513,68,2,66,350,1,67,388,2,33.0,1.0,32.0,132.0,13.0,20.0,20.0,94,68,26,21.0,20.0,1.0
9203222,38,13,25,56,31,7,7,6,4.0,3.0,1.0,1.0,2.0,2.0,2.0,39,38,1,5.0,4.0,1.0
9702300,11,3,8,11,1,10,51,6,5.0,3.0,2.0,3.0,0.0,5.0,30.0,29,11,18,14.0,3.0,11.0
9610242,17,5,12,26,17,0,0,5,7.0,1.0,6.0,16.0,7.0,0.0,0.0,17,17,0,3.0,3.0,0.0
9505308,48,15,33,108,48,0,0,61,13.0,5.0,8.0,20.0,13.0,0.0,0.0,48,48,0,9.0,9.0,0.0
9603350,38,13,25,53,8,30,119,10,7.0,2.0,5.0,10.0,0.0,7.0,23.0,79,38,41,7.0,5.0,2.0
9210280,31,8,23,81,24,7,9,75,10.0,4.0,6.0,16.0,8.0,2.0,2.0,33,31,2,8.0,8.0,0.0
9707475,21,9,12,30,2,19,95,60,8.0,1.0,7.0,18.0,0.0,8.0,57.0,35,21,14,16.0,8.0,8.0
9511470,6,1,5,7,0,6,9,42,0.0,0.0,0.0,0.0,0.0,0.0,0.0,16,6,10,2.0,2.0,0.0
9804365,6,3,3,3,0,6,31,5,3.0,1.0,2.0,2.0,0.0,3.0,9.0,27,6,21,11.0,3.0,8.0
9607414,47,13,34,124,2,45,206,5,22.0,5.0,17.0,82.0,0.0,22.0,78.0,79,47,32,19.0,15.0,4.0
9610224,61,12,49,186,4,57,391,18,5.0,4.0,1.0,1.0,0.0,5.0,43.0,99,61,38,25.0,8.0,17.0
9603360,6,4,2,3,4,2,2,115,0.0,0.0,0.0,0.0,0.0,0.0,0.0,9,6,3,1.0,0.0,1.0
5151,7,4,3,3,5,2,4,4,1.0,1.0,0.0,0.0,1.0,0.0,0.0,16,7,9,7.0,0.0,7.0
9308336,111,6,105,1127,94,17,49,23,56.0,1.0,55.0,689.0,56.0,0.0,0.0,117,111,6,46.0,46.0,0.0
9702426,27,9,18,54,1,26,115,92,14.0,4.0,10.0,26.0,1.0,13.0,50.0,43,27,16,17.0,12.0,5.0
9911468,1,1,0,0,0,1,8,61,0.0,0.0,0.0,0.0,0.0,0.0,0.0,40,1,39,9.0,0.0,9.0
9809521,82,5,77,380,10,72,313,70,54.0,1.0,53.0,324.0,0.0,54.0,279.0,92,82,10,44.0,37.0,7.0
9902267,41,6,35,120,10,31,46,0,8.0,1.0,7.0,16.0,8.0,0.0,0.0,44,41,3,5.0,5.0,0.0
9904225,17,7,10,13,2,15,54,0,3.0,3.0,0.0,0.0,0.0,3.0,10.0,33,17,16,12.0,3.0,9.0
9809426,18,3,15,39,0,18,73,28,11.0,3.0,8.0,19.0,0.0,11.0,41.0,30,18,12,12.0,6.0,6.0
9604288,8,4,4,5,5,3,4,501,4.0,2.0,2.0,2.0,4.0,0.0,0.0,11,8,3,3.0,3.0,0.0
9310361,4,2,2,2,2,2,2,36,2.0,1.0,1.0,1.0,0.0,2.0,2.0,6,4,2,,,
9711293,3,3,0,0,3,0,0,238,3.0,3.0,0.0,0.0,3.0,0.0,0.0,3,3,0,3.0,3.0,0.0
9611310,31,12,19,38,19,12,21,84,6.0,3.0,3.0,4.0,1.0,5.0,9.0,37,31,6,6.0,4.0,2.0
9603291,10,5,5,11,3,7,12,49,0.0,0.0,0.0,0.0,0.0,0.0,0.0,22,10,12,3.0,3.0,0.0
9507261,15,5,10,19,0,15,73,10,6.0,1.0,5.0,7.0,0.0,6.0,35.0,35,15,20,9.0,5.0,4.0
9904449,2,2,0,0,0,2,11,6,0.0,0.0,0.0,0.0,0.0,0.0,0.0,23,2,21,3.0,0.0,3.0
9403329,5,4,1,1,5,0,0,67,2.0,2.0,0.0,0.0,2.0,0.0,0.0,5,5,0,1.0,1.0,0.0
9709242,6,3,3,3,0,6,44,1,0.0,0.0,0.0,0.0,0.0,0.0,0.0,31,6,25,6.0,0.0,6.0
9610367,9,5,4,6,2,7,20,29,6.0,3.0,3.0,5.0,0.0,6.0,15.0,16,9,7,2.0,2.0,0.0
9603233,30,8,22,67,3,27,146,32,8.0,2.0,6.0,7.0,0.0,8.0,41.0,50,30,20,4.0,3.0,1.0
9304223,34,5,29,91,34,0,0,182,22.0,1.0,21.0,79.0,22.0,0.0,0.0,34,34,0,20.0,20.0,0.0
9507432,8,3,5,8,2,6,35,75,2.0,1.0,1.0,1.0,0.0,2.0,13.0,23,8,15,11.0,2.0,9.0
7328,16,2,14,44,2,14,69,55,4.0,1.0,3.0,5.0,0.0,4.0,38.0,31,16,15,7.0,7.0,0.0
9205,29,5,24,42,1,28,104,3,6.0,2.0,4.0,5.0,6.0,0.0,0.0,43,29,14,11.0,8.0,3.0
9610527,14,1,13,22,0,14,39,31,10.0,1.0,9.0,16.0,0.0,10.0,31.0,20,14,6,11.0,6.0,5.0
9904223,18,8,10,13,4,14,52,31,6.0,1.0,5.0,6.0,1.0,5.0,15.0,28,18,10,8.0,5.0,3.0
104028,17,5,12,21,7,10,16,18,11.0,2.0,9.0,16.0,6.0,5.0,9.0,34,17,17,3.0,3.0,0.0
9607465,34,7,27,91,3,31,100,60,12.0,3.0,9.0,32.0,0.0,12.0,31.0,51,34,17,14.0,11.0,3.0
102238,30,7,23,176,0,30,240,23,24.0,2.0,22.0,168.0,0.0,24.0,222.0,55,30,25,24.0,18.0,6.0
1172,46,8,38,92,2,44,142,5,6.0,3.0,3.0,4.0,6.0,0.0,0.0,65,46,19,6.0,5.0,1.0
103076,10,5,5,6,1,9,36,0,0.0,0.0,0.0,0.0,0.0,0.0,0.0,53,10,43,13.0,0.0,13.0
112013,11,5,6,9,1,10,74,18,2.0,2.0,0.0,0.0,0.0,2.0,20.0,42,11,31,4.0,4.0,0.0
9801446,33,7,26,84,0,33,218,5,17.0,3.0,14.0,40.0,0.0,17.0,41.0,57,33,24,20.0,12.0,8.0
9904452,12,5,7,11,1,11,56,13,6.0,1.0,5.0,9.0,0.0,6.0,39.0,37,12,25,8.0,1.0,7.0
9408391,24,5,19,77,10,14,20,18,10.0,2.0,8.0,18.0,5.0,5.0,5.0,27,24,3,6.0,5.0,1.0
9701272,15,10,5,7,4,11,21,244,6.0,4.0,2.0,3.0,1.0,5.0,6.0,23,15,8,3.0,2.0,1.0
9612483,72,9,63,433,9,63,114,7,40.0,4.0,36.0,267.0,0.0,40.0,70.0,76,72,4,30.0,28.0,2.0
9904399,29,1,28,101,10,19,38,0,18.0,1.0,17.0,67.0,14.0,4.0,4.0,44,29,15,7.0,0.0,7.0
7065,17,10,7,9,11,6,12,0,5.0,3.0,2.0,2.0,3.0,2.0,4.0,25,17,8,3.0,3.0,0.0
9603353,22,4,18,28,9,13,28,41,11.0,4.0,7.0,10.0,1.0,10.0,19.0,26,22,4,11.0,7.0,4.0
105263,6,6,0,0,1,5,22,118,3.0,3.0,0.0,0.0,0.0,3.0,19.0,19,6,13,12.0,3.0,9.0
105268,18,4,14,54,0,18,195,11,16.0,3.0,13.0,52.0,0.0,16.0,191.0,40,18,22,26.0,13.0,13.0
101060,1,1,0,0,0,1,5,11,0.0,0.0,0.0,0.0,0.0,0.0,0.0,19,1,18,1.0,0.0,1.0
9609378,12,2,10,21,1,11,34,16,5.0,2.0,3.0,5.0,1.0,4.0,17.0,17,12,5,9.0,5.0,4.0
9807563,3,3,0,0,2,1,5,97,1.0,1.0,0.0,0.0,1.0,0.0,0.0,14,3,11,2.0,2.0,0.0
7190,6,2,4,4,0,6,33,8,2.0,2.0,0.0,0.0,0.0,2.0,12.0,21,6,15,5.0,1.0,4.0
9605348,19,7,12,23,11,8,24,201,8.0,1.0,7.0,17.0,8.0,0.0,0.0,31,19,12,9.0,7.0,2.0
5308,6,4,2,3,0,6,17,280,0.0,0.0,0.0,0.0,0.0,0.0,0.0,20,6,14,2.0,0.0,2.0
9412366,13,4,9,16,13,0,0,129,6.0,1.0,5.0,9.0,6.0,0.0,0.0,13,13,0,4.0,4.0,0.0
9412238,7,3,4,4,7,0,0,129,1.0,1.0,0.0,0.0,1.0,0.0,0.0,7,7,0,1.0,1.0,0.0
9608342,10,6,4,6,2,8,15,39,1.0,1.0,0.0,0.0,1.0,0.0,0.0,18,10,8,2.0,1.0,1.0
9605285,14,10,4,6,13,1,1,39,6.0,3.0,3.0,5.0,6.0,0.0,0.0,15,14,1,2.0,2.0,0.0
9811470,24,6,18,56,9,15,22,278,9.0,1.0,8.0,21.0,5.0,4.0,4.0,29,24,5,10.0,9.0,1.0
9609201,7,2,5,8,0,7,12,50,4.0,1.0,3.0,4.0,0.0,4.0,7.0,10,7,3,7.0,5.0,2.0
9903259,21,8,13,29,2,19,68,4,0.0,0.0,0.0,0.0,0.0,0.0,0.0,44,21,23,3.0,1.0,2.0
4044,58,8,50,375,4,54,562,11,52.0,4.0,48.0,373.0,0.0,52.0,529.0,83,58,25,60.0,46.0,14.0
9901281,125,9,116,1000,6,119,913,11,93.0,4.0,89.0,878.0,5.0,88.0,663.0,148,125,23,80.0,68.0,12.0
101304,43,3,40,206,0,43,573,19,33.0,2.0,31.0,182.0,0.0,33.0,477.0,79,43,36,52.0,30.0,22.0
202251,9,4,5,9,0,9,99,43,1.0,1.0,0.0,0.0,0.0,1.0,15.0,54,9,45,8.0,0.0,8.0
9802231,12,8,4,6,5,7,38,39,3.0,2.0,1.0,1.0,0.0,3.0,7.0,35,12,23,10.0,1.0,9.0
105149,4,1,3,3,0,4,4,135,3.0,1.0,2.0,2.0,3.0,0.0,0.0,7,4,3,4.0,3.0,1.0
9709424,31,11,20,41,18,13,17,16,8.0,5.0,3.0,3.0,8.0,0.0,0.0,37,31,6,7.0,7.0,0.0
9807241,15,9,6,12,2,13,37,8,2.0,2.0,0.0,0.0,0.0,2.0,6.0,32,15,17,11.0,6.0,5.0
107287,4,2,2,3,0,4,28,28,4.0,2.0,2.0,3.0,0.0,4.0,18.0,13,4,9,6.0,1.0,5.0
9808324,43,5,38,170,5,38,53,28,26.0,2.0,24.0,106.0,2.0,24.0,33.0,47,43,4,23.0,21.0,2.0
9804354,37,7,30,118,9,28,34,28,23.0,3.0,20.0,69.0,4.0,19.0,22.0,39,37,2,15.0,14.0,1.0
9608289,1,1,0,0,1,0,0,1442,,,,,,,,1,1,0,,,
9312204,10,5,5,8,10,0,0,91,4.0,1.0,3.0,5.0,4.0,0.0,0.0,11,10,1,4.0,4.0,0.0
3089,19,5,14,40,0,19,171,2,8.0,3.0,5.0,13.0,0.0,8.0,91.0,52,19,33,14.0,5.0,9.0
9908205,14,1,13,24,0,14,235,2,9.0,1.0,8.0,16.0,0.0,9.0,209.0,50,14,36,37.0,8.0,29.0
9501285,21,4,17,33,0,21,64,35,9.0,3.0,6.0,10.0,0.0,9.0,21.0,33,21,12,10.0,6.0,4.0
211180,0,0,0,0,0,0,0,10,0.0,0.0,0.0,0.0,0.0,0.0,0.0,32,0,32,2.0,0.0,2.0
9501395,33,3,30,109,5,28,70,10,13.0,2.0,11.0,27.0,3.0,10.0,15.0,45,33,12,7.0,6.0,1.0
9712376,12,5,7,9,9,3,3,61,1.0,1.0,0.0,0.0,1.0,0.0,0.0,15,12,3,2.0,1.0,1.0
7327,13,5,8,15,2,11,67,5,0.0,0.0,0.0,0.0,0.0,0.0,0.0,51,13,38,6.0,1.0,5.0
9208254,67,13,54,275,67,0,0,17,35.0,2.0,33.0,182.0,35.0,0.0,0.0,67,67,0,6.0,6.0,0.0
9901403,7,4,3,6,1,6,14,28,4.0,1.0,3.0,4.0,0.0,4.0,8.0,14,7,7,6.0,3.0,3.0
9608313,13,9,4,5,2,11,32,12,7.0,7.0,0.0,0.0,0.0,7.0,23.0,19,13,6,2.0,2.0,0.0
9408367,10,9,1,2,3,7,8,234,2.0,2.0,0.0,0.0,0.0,2.0,2.0,13,10,3,1.0,0.0,1.0
9708485,4,1,3,3,0,4,10,86,4.0,1.0,3.0,3.0,1.0,3.0,5.0,12,4,8,2.0,1.0,1.0
9711385,7,5,2,2,1,6,34,35,3.0,2.0,1.0,1.0,0.0,3.0,18.0,44,7,37,5.0,1.0,4.0
9606247,12,2,10,21,1,11,60,6,5.0,1.0,4.0,10.0,1.0,4.0,8.0,35,12,23,10.0,6.0,4.0
109197,21,12,9,26,2,19,264,1,7.0,1.0,6.0,14.0,0.0,7.0,82.0,139,21,118,16.0,2.0,14.0
9024,2,1,1,1,1,1,11,7,,,,,,,,14,2,12,2.0,0.0,2.0
205013,12,2,10,18,3,9,36,62,9.0,1.0,8.0,16.0,0.0,9.0,36.0,20,12,8,14.0,9.0,5.0
9905478,17,7,10,17,10,7,18,34,2.0,1.0,1.0,1.0,2.0,0.0,0.0,22,17,5,1.0,0.0,1.0
9408218,14,4,10,19,9,5,22,75,3.0,2.0,1.0,1.0,0.0,3.0,15.0,21,14,7,7.0,3.0,4.0
9906225,5,3,2,4,0,5,15,79,3.0,2.0,1.0,1.0,0.0,3.0,9.0,8,5,3,8.0,5.0,3.0
9511443,19,4,15,32,18,1,1,72,11.0,3.0,8.0,12.0,11.0,0.0,0.0,22,19,3,4.0,4.0,0.0
9706329,17,1,16,74,0,17,155,11,16.0,1.0,15.0,69.0,0.0,16.0,135.0,33,17,16,17.0,12.0,5.0
9807448,24,9,15,63,0,24,161,11,19.0,5.0,14.0,48.0,0.0,19.0,119.0,53,24,29,25.0,12.0,13.0
9610398,2,1,1,1,2,0,0,202,0.0,0.0,0.0,0.0,0.0,0.0,0.0,13,2,11,1.0,0.0,1.0
9705286,53,11,42,156,0,53,306,17,43.0,6.0,37.0,143.0,0.0,43.0,258.0,72,53,19,38.0,27.0,11.0
9210276,14,8,6,7,12,2,2,26,4.0,3.0,1.0,2.0,4.0,0.0,0.0,15,14,1,4.0,4.0,0.0
9611256,6,4,2,2,5,1,1,52,2.0,1.0,1.0,1.0,2.0,0.0,0.0,12,6,6,2.0,2.0,0.0
9703424,16,5,11,14,9,7,12,244,5.0,2.0,3.0,3.0,3.0,2.0,3.0,25,16,9,4.0,4.0,0.0
9611311,8,2,6,15,0,8,14,104,8.0,2.0,6.0,15.0,0.0,8.0,14.0,13,8,5,8.0,6.0,2.0
9706423,8,6,2,2,0,8,14,52,4.0,3.0,1.0,1.0,0.0,4.0,6.0,16,8,8,4.0,3.0,1.0
9510343,3,2,1,1,0,3,16,8,1.0,1.0,0.0,0.0,0.0,1.0,1.0,9,3,6,3.0,2.0,1.0
9303269,8,2,6,9,5,3,3,246,1.0,1.0,0.0,0.0,0.0,1.0,1.0,10,8,2,1.0,1.0,0.0
9909502,12,2,10,27,0,12,20,4,11.0,1.0,10.0,26.0,0.0,11.0,19.0,14,12,2,10.0,8.0,2.0
9711266,34,10,24,75,5,29,51,7,17.0,3.0,14.0,49.0,1.0,16.0,25.0,43,34,9,5.0,4.0,1.0
9710545,17,4,13,41,1,16,100,12,15.0,2.0,13.0,39.0,0.0,15.0,95.0,30,17,13,20.0,13.0,7.0
9605226,4,3,1,1,2,2,8,129,2.0,1.0,1.0,1.0,0.0,2.0,6.0,9,4,5,5.0,2.0,3.0
106123,6,2,4,6,0,6,20,28,5.0,1.0,4.0,6.0,0.0,5.0,19.0,12,6,6,10.0,5.0,5.0
9712386,4,2,2,2,1,3,5,192,2.0,1.0,1.0,1.0,0.0,2.0,3.0,16,4,12,9.0,2.0,7.0
9406212,53,22,31,83,20,33,53,14,18.0,6.0,12.0,39.0,1.0,17.0,32.0,57,53,4,8.0,8.0,0.0
9403251,9,7,2,4,8,1,1,368,1.0,1.0,0.0,0.0,1.0,0.0,0.0,10,9,1,2.0,2.0,0.0
9507403,27,5,22,118,1,26,28,68,18.0,1.0,17.0,87.0,2.0,16.0,16.0,30,27,3,15.0,14.0,1.0
101236,4,2,2,2,1,3,25,24,3.0,1.0,2.0,2.0,0.0,3.0,16.0,26,4,22,11.0,3.0,8.0
9905387,27,9,18,40,3,24,97,24,6.0,2.0,4.0,8.0,0.0,6.0,18.0,47,27,20,16.0,4.0,12.0
9711346,14,7,7,12,7,7,7,64,7.0,3.0,4.0,8.0,0.0,7.0,7.0,15,14,1,7.0,6.0,1.0
9701275,9,3,6,10,8,1,2,64,8.0,2.0,6.0,10.0,8.0,0.0,0.0,11,9,2,3.0,3.0,0.0
9711227,83,7,76,414,2,81,512,9,58.0,6.0,52.0,304.0,0.0,58.0,357.0,104,83,21,42.0,27.0,15.0
7068,26,5,21,45,0,26,163,14,13.0,2.0,11.0,19.0,0.0,13.0,82.0,55,26,29,22.0,7.0,15.0
9712410,19,9,10,21,0,19,108,27,3.0,3.0,0.0,0.0,0.0,3.0,13.0,47,19,28,11.0,2.0,9.0
9702277,24,9,15,34,1,23,54,9,8.0,4.0,4.0,8.0,2.0,6.0,6.0,32,24,8,2.0,2.0,0.0
9710224,23,8,15,30,3,20,74,27,5.0,2.0,3.0,3.0,0.0,5.0,15.0,30,23,7,13.0,8.0,5.0
9702239,32,5,27,84,3,29,64,27,13.0,3.0,10.0,20.0,1.0,12.0,18.0,40,32,8,12.0,9.0,3.0
9911506,2,2,0,0,0,2,14,14,2.0,2.0,0.0,0.0,0.0,2.0,10.0,11,2,9,4.0,1.0,3.0
9403232,6,4,2,3,6,0,0,337,6.0,4.0,2.0,3.0,6.0,0.0,0.0,6,6,0,4.0,4.0,0.0
9708370,22,15,7,7,10,12,18,9,3.0,3.0,0.0,0.0,1.0,2.0,2.0,38,22,16,3.0,1.0,2.0
9402321,17,4,13,41,5,12,12,77,15.0,3.0,12.0,37.0,4.0,11.0,11.0,18,17,1,10.0,9.0,1.0
9909434,7,5,2,2,4,3,10,38,0.0,0.0,0.0,0.0,0.0,0.0,0.0,32,7,25,2.0,1.0,1.0
8316,19,6,13,20,1,18,64,17,8.0,2.0,6.0,8.0,0.0,8.0,18.0,32,19,13,7.0,4.0,3.0
9401249,25,8,17,49,2,23,43,17,16.0,3.0,13.0,35.0,1.0,15.0,26.0,28,25,3,14.0,12.0,2.0
9607275,20,3,17,59,2,18,66,66,11.0,1.0,10.0,30.0,0.0,11.0,22.0,32,20,12,12.0,9.0,3.0
9701378,9,3,6,11,0,9,37,8,4.0,2.0,2.0,2.0,0.0,4.0,22.0,22,9,13,7.0,0.0,7.0
9605389,48,19,29,76,12,36,109,115,33.0,12.0,21.0,59.0,1.0,32.0,88.0,53,48,5,17.0,15.0,2.0
9706448,5,2,3,4,1,4,21,11,1.0,1.0,0.0,0.0,1.0,0.0,0.0,20,5,15,1.0,1.0,0.0
9711298,8,5,3,8,1,7,27,72,6.0,3.0,3.0,6.0,1.0,5.0,14.0,17,8,9,10.0,6.0,4.0
9710392,13,5,8,14,1,12,92,8,7.0,2.0,5.0,9.0,0.0,7.0,68.0,41,13,28,8.0,1.0,7.0
9602407,20,8,12,18,12,8,8,132,10.0,3.0,7.0,10.0,10.0,0.0,0.0,21,20,1,5.0,5.0,0.0
9504248,93,3,90,647,5,88,216,8,69.0,1.0,68.0,518.0,3.0,66.0,131.0,100,93,7,41.0,38.0,3.0
9307210,18,6,12,22,17,1,1,15,5.0,3.0,2.0,3.0,5.0,0.0,0.0,19,18,1,3.0,3.0,0.0
9405225,21,5,16,41,3,18,30,90,5.0,2.0,3.0,5.0,0.0,5.0,7.0,26,21,5,5.0,4.0,1.0
9508405,7,1,6,6,0,7,17,15,2.0,2.0,0.0,0.0,0.0,2.0,3.0,13,7,6,2.0,1.0,1.0
9402221,30,5,25,112,28,2,2,90,25.0,5.0,20.0,103.0,25.0,0.0,0.0,32,30,2,17.0,17.0,0.0
9609310,8,3,5,7,3,5,15,34,1.0,1.0,0.0,0.0,0.0,1.0,1.0,16,8,8,1.0,1.0,0.0
9303277,9,5,4,12,9,0,0,162,6.0,2.0,4.0,8.0,6.0,0.0,0.0,9,9,0,5.0,5.0,0.0
9901401,4,3,1,3,1,3,12,0,2.0,2.0,0.0,0.0,1.0,1.0,3.0,16,4,12,4.0,1.0,3.0
9612245,31,3,28,121,0,31,135,50,20.0,2.0,18.0,77.0,0.0,20.0,86.0,43,31,12,16.0,12.0,4.0
9809206,11,7,4,5,2,9,49,0,2.0,1.0,1.0,1.0,0.0,2.0,14.0,26,11,15,6.0,1.0,5.0
107061,6,2,4,9,0,6,29,10,6.0,2.0,4.0,9.0,0.0,6.0,29.0,17,6,11,11.0,3.0,8.0
9703270,7,4,3,4,4,3,10,52,3.0,2.0,1.0,1.0,2.0,1.0,1.0,23,7,16,6.0,2.0,4.0
9712389,18,10,8,15,2,16,99,5,8.0,4.0,4.0,9.0,0.0,8.0,48.0,42,18,24,10.0,3.0,7.0
9706305,2,2,0,0,1,1,4,22,1.0,1.0,0.0,0.0,1.0,0.0,0.0,8,2,6,1.0,1.0,0.0
9902328,8,6,2,3,4,4,35,15,3.0,2.0,1.0,1.0,0.0,3.0,33.0,28,8,20,2.0,0.0,2.0
203266,7,2,5,11,0,7,35,146,6.0,2.0,4.0,10.0,0.0,6.0,30.0,16,7,9,15.0,7.0,8.0
9710236,11,2,9,27,2,9,15,120,8.0,1.0,7.0,17.0,0.0,8.0,13.0,13,11,2,10.0,8.0,2.0
6174,8,4,4,7,1,7,16,121,3.0,3.0,0.0,0.0,2.0,1.0,1.0,36,8,28,3.0,1.0,2.0
9305291,18,7,11,21,3,15,34,40,13.0,3.0,10.0,18.0,1.0,12.0,28.0,22,18,4,8.0,7.0,1.0
9701309,41,7,34,106,0,41,390,8,26.0,2.0,24.0,88.0,0.0,26.0,304.0,68,41,27,31.0,20.0,11.0
9610298,3,1,2,3,0,3,10,10,2.0,1.0,1.0,1.0,0.0,2.0,4.0,11,3,8,5.0,2.0,3.0
104317,18,8,10,25,0,18,238,23,13.0,6.0,7.0,18.0,0.0,13.0,177.0,65,18,47,28.0,9.0,19.0
9287,20,7,13,38,3,17,149,3,11.0,4.0,7.0,15.0,0.0,11.0,93.0,62,20,42,6.0,2.0,4.0
9805502,1,1,0,0,0,1,1,123,1.0,1.0,0.0,0.0,0.0,1.0,1.0,2,1,1,,,
9811438,7,4,3,6,1,6,55,90,5.0,2.0,3.0,6.0,0.0,5.0,40.0,27,7,20,13.0,4.0,9.0
9902449,54,6,48,142,2,52,174,21,14.0,5.0,9.0,28.0,0.0,14.0,64.0,71,54,17,20.0,18.0,2.0
9310365,68,2,66,442,13,55,198,53,57.0,1.0,56.0,397.0,4.0,53.0,196.0,73,68,5,45.0,40.0,5.0
9405391,17,7,10,18,7,10,11,33,11.0,3.0,8.0,14.0,3.0,8.0,8.0,19,17,2,11.0,10.0,1.0
9711413,3,1,2,3,0,3,10,306,1.0,1.0,0.0,0.0,0.0,1.0,2.0,13,3,10,4.0,2.0,2.0
9904472,53,11,42,170,3,50,258,30,29.0,3.0,26.0,97.0,2.0,27.0,127.0,78,53,25,26.0,17.0,9.0
9803313,25,9,16,26,11,14,23,23,7.0,2.0,5.0,5.0,1.0,6.0,6.0,30,25,5,8.0,7.0,1.0
108117,32,17,15,35,2,30,142,95,8.0,5.0,3.0,5.0,0.0,8.0,29.0,68,32,36,18.0,4.0,14.0
9412397,4,4,0,0,0,4,6,60,1.0,1.0,0.0,0.0,0.0,1.0,2.0,12,4,8,1.0,0.0,1.0
9907425,23,6,17,79,1,22,98,32,15.0,3.0,12.0,64.0,0.0,15.0,53.0,33,23,10,11.0,5.0,6.0
9902469,9,5,4,7,0,9,71,5,1.0,1.0,0.0,0.0,0.0,1.0,5.0,43,9,34,3.0,1.0,2.0
105312,4,4,0,0,1,3,5,7,,,,,,,,8,4,4,,,
9901384,63,19,44,144,6,57,238,13,16.0,4.0,12.0,36.0,0.0,16.0,84.0,98,63,35,22.0,8.0,14.0
4269,11,2,9,22,2,9,56,131,8.0,2.0,6.0,18.0,1.0,7.0,50.0,22,11,11,18.0,8.0,10.0
9508277,18,8,10,21,4,14,42,14,6.0,3.0,3.0,5.0,5.0,1.0,1.0,26,18,8,5.0,4.0,1.0
9701321,6,3,3,4,0,6,17,8,3.0,1.0,2.0,3.0,0.0,3.0,8.0,11,6,5,3.0,1.0,2.0
207241,11,2,9,18,0,11,128,7,5.0,1.0,4.0,6.0,0.0,5.0,42.0,38,11,27,17.0,5.0,12.0
2259,15,5,10,19,3,12,34,36,10.0,2.0,8.0,16.0,4.0,6.0,6.0,29,15,14,7.0,6.0,1.0
2130,6,3,3,6,0,6,15,12,5.0,2.0,3.0,6.0,0.0,5.0,6.0,10,6,4,7.0,6.0,1.0
9608307,13,6,7,15,3,10,12,12,8.0,1.0,7.0,14.0,0.0,8.0,8.0,21,13,8,2.0,2.0,0.0
103122,1,1,0,0,0,1,9,0,1.0,1.0,0.0,0.0,0.0,1.0,1.0,18,1,17,5.0,1.0,4.0
9503396,15,9,6,6,8,7,13,25,3.0,1.0,2.0,2.0,0.0,3.0,3.0,31,15,16,4.0,4.0,0.0
9611307,13,3,10,21,3,10,30,89,7.0,1.0,6.0,12.0,2.0,5.0,9.0,19,13,6,2.0,2.0,0.0
9305332,22,5,17,33,22,0,0,13,10.0,3.0,7.0,11.0,10.0,0.0,0.0,22,22,0,3.0,3.0,0.0
9612298,3,1,2,2,0,3,21,6,1.0,1.0,0.0,0.0,0.0,1.0,1.0,16,3,13,4.0,1.0,3.0
101268,0,0,0,0,0,0,0,30,0.0,0.0,0.0,0.0,0.0,0.0,0.0,15,0,15,11.0,0.0,11.0
202031,12,5,7,8,0,12,49,21,2.0,1.0,1.0,1.0,0.0,2.0,14.0,33,12,21,11.0,3.0,8.0
9802258,10,6,4,4,3,7,15,204,3.0,3.0,0.0,0.0,0.0,3.0,8.0,19,10,9,6.0,2.0,4.0
9612279,25,10,15,22,7,18,34,204,13.0,2.0,11.0,15.0,4.0,9.0,18.0,29,25,4,11.0,8.0,3.0
9602289,1,1,0,0,0,1,4,15,0.0,0.0,0.0,0.0,0.0,0.0,0.0,32,1,31,6.0,0.0,6.0
9905366,21,7,14,30,5,16,70,1,1.0,1.0,0.0,0.0,0.0,1.0,14.0,71,21,50,12.0,0.0,12.0
9908252,24,6,18,58,1,23,65,34,6.0,3.0,3.0,3.0,3.0,3.0,6.0,40,24,16,18.0,13.0,5.0
9806203,3,1,2,3,0,3,19,34,3.0,1.0,2.0,3.0,0.0,3.0,19.0,10,3,7,2.0,0.0,2.0
9311250,7,3,4,6,1,6,11,253,3.0,1.0,2.0,3.0,0.0,3.0,6.0,11,7,4,6.0,3.0,3.0
12151,1,1,0,0,0,1,3,1840,,,,,,,,6,1,5,1.0,0.0,1.0
9612285,29,17,12,20,17,12,21,148,8.0,7.0,1.0,1.0,3.0,5.0,10.0,37,29,8,9.0,5.0,4.0
9810358,7,2,5,8,0,7,17,25,2.0,1.0,1.0,1.0,2.0,0.0,0.0,13,7,6,2.0,2.0,0.0
104260,13,3,10,29,2,11,33,165,12.0,2.0,10.0,29.0,1.0,11.0,33.0,18,13,5,15.0,11.0,4.0
109117,12,3,9,20,1,11,157,24,11.0,2.0,9.0,20.0,1.0,10.0,139.0,41,12,29,23.0,7.0,16.0
9806533,1,1,0,0,0,1,2,8,0.0,0.0,0.0,0.0,0.0,0.0,0.0,32,1,31,6.0,0.0,6.0
9510222,2,2,0,0,2,0,0,1410,1.0,1.0,0.0,0.0,1.0,0.0,0.0,2,2,0,1.0,1.0,0.0
9604221,3,3,0,0,1,2,2,1839,1.0,1.0,0.0,0.0,0.0,1.0,1.0,7,3,4,1.0,1.0,0.0
9903240,10,7,3,5,0,10,41,43,5.0,4.0,1.0,1.0,0.0,5.0,22.0,34,10,24,5.0,4.0,1.0
3207,4,2,2,2,0,4,25,2,2.0,2.0,0.0,0.0,0.0,2.0,8.0,24,4,20,9.0,2.0,7.0
9609337,2,1,1,1,0,2,21,39,2.0,1.0,1.0,1.0,0.0,2.0,10.0,29,2,27,3.0,1.0,2.0
4146,1,1,0,0,0,1,4,357,0.0,0.0,0.0,0.0,0.0,0.0,0.0,8,1,7,1.0,0.0,1.0
6354,7,3,4,9,0,7,107,21,5.0,1.0,4.0,8.0,0.0,5.0,87.0,64,7,57,32.0,5.0,27.0
106144,1,1,0,0,1,0,0,56,0.0,0.0,0.0,0.0,0.0,0.0,0.0,9,1,8,1.0,1.0,0.0
9605376,22,3,19,35,18,4,14,227,9.0,1.0,8.0,19.0,9.0,0.0,0.0,32,22,10,7.0,7.0,0.0
9411287,30,7,23,77,15,15,17,13,25.0,6.0,19.0,60.0,12.0,13.0,15.0,32,30,2,13.0,12.0,1.0
9704396,21,6,15,78,0,21,91,8,14.0,4.0,10.0,43.0,0.0,14.0,45.0,41,21,20,19.0,13.0,6.0
9905416,3,2,1,1,1,2,10,182,2.0,1.0,1.0,1.0,0.0,2.0,10.0,10,3,7,8.0,2.0,6.0
9507225,18,3,15,35,4,14,20,169,10.0,3.0,7.0,17.0,2.0,8.0,10.0,21,18,3,10.0,8.0,2.0
5158,10,6,4,6,1,9,37,18,5.0,3.0,2.0,3.0,0.0,5.0,15.0,34,10,24,5.0,3.0,2.0
9711424,5,1,4,9,1,4,4,1648,5.0,1.0,4.0,9.0,1.0,4.0,4.0,7,5,2,,,
108193,12,2,10,35,0,12,80,0,9.0,2.0,7.0,21.0,0.0,9.0,43.0,28,12,16,14.0,8.0,6.0
104187,6,3,3,4,0,6,66,3,1.0,1.0,0.0,0.0,0.0,1.0,11.0,56,6,50,6.0,4.0,2.0
209136,5,1,4,7,0,5,21,393,5.0,1.0,4.0,7.0,1.0,4.0,4.0,13,5,8,6.0,5.0,1.0
9502349,22,3,19,80,22,0,0,68,16.0,1.0,15.0,70.0,16.0,0.0,0.0,22,22,0,14.0,14.0,0.0
108071,47,7,40,240,0,47,476,37,40.0,4.0,36.0,223.0,0.0,40.0,413.0,73,47,26,53.0,35.0,18.0
9708431,12,9,3,7,1,11,27,31,8.0,5.0,3.0,7.0,0.0,8.0,21.0,19,12,7,6.0,5.0,1.0
8268,7,4,3,4,0,7,100,69,4.0,2.0,2.0,3.0,0.0,4.0,37.0,72,7,65,12.0,3.0,9.0
104174,13,4,9,21,0,13,166,23,9.0,2.0,7.0,16.0,0.0,9.0,108.0,46,13,33,21.0,7.0,14.0
9510386,21,7,14,28,4,17,67,134,9.0,4.0,5.0,9.0,2.0,7.0,37.0,32,21,11,13.0,6.0,7.0
9610304,22,6,16,78,10,12,18,68,16.0,2.0,14.0,75.0,16.0,0.0,0.0,30,22,8,15.0,15.0,0.0
9709245,10,6,4,5,2,8,28,56,7.0,3.0,4.0,5.0,0.0,7.0,26.0,27,10,17,8.0,0.0,8.0
9808421,13,3,10,32,0,13,61,13,12.0,3.0,9.0,29.0,0.0,12.0,56.0,27,13,14,22.0,10.0,12.0
9507413,16,3,13,49,0,16,60,94,15.0,2.0,13.0,47.0,0.0,15.0,53.0,25,16,9,18.0,14.0,4.0
9903413,16,8,8,11,1,15,65,92,6.0,4.0,2.0,2.0,0.0,6.0,35.0,33,16,17,16.0,7.0,9.0
4240,2,2,0,0,1,1,10,2,1.0,1.0,0.0,0.0,0.0,1.0,10.0,29,2,27,4.0,1.0,3.0
9606407,1,1,0,0,0,1,2,370,1.0,1.0,0.0,0.0,0.0,1.0,2.0,4,1,3,3.0,1.0,2.0
212127,27,9,18,55,9,18,76,0,7.0,1.0,6.0,15.0,1.0,6.0,33.0,48,27,21,20.0,5.0,15.0
9404329,1,1,0,0,0,1,1,581,1.0,1.0,0.0,0.0,0.0,1.0,1.0,8,1,7,4.0,0.0,4.0
9804441,5,2,3,3,2,3,25,15,1.0,1.0,0.0,0.0,0.0,1.0,4.0,24,5,19,4.0,1.0,3.0
9308278,6,3,3,7,0,6,18,176,6.0,3.0,3.0,7.0,0.0,6.0,18.0,9,6,3,9.0,6.0,3.0
108272,5,3,2,2,5,0,0,251,2.0,1.0,1.0,1.0,2.0,0.0,0.0,5,5,0,2.0,2.0,0.0
2120,23,6,17,39,0,23,111,27,18.0,5.0,13.0,32.0,0.0,18.0,99.0,36,23,13,13.0,8.0,5.0
9605439,42,2,40,162,16,26,29,130,32.0,2.0,30.0,123.0,10.0,22.0,24.0,44,42,2,18.0,17.0,1.0
105121,9,3,6,10,1,8,38,140,7.0,3.0,4.0,6.0,1.0,6.0,14.0,20,9,11,4.0,2.0,2.0
2242,17,6,11,30,2,15,68,3,4.0,2.0,2.0,2.0,0.0,4.0,12.0,41,17,24,9.0,4.0,5.0
105188,16,6,10,30,2,14,53,129,8.0,2.0,6.0,14.0,3.0,5.0,5.0,29,16,13,10.0,8.0,2.0
108261,3,2,1,1,0,3,10,12,0.0,0.0,0.0,0.0,0.0,0.0,0.0,18,3,15,,,
9807457,5,3,2,3,0,5,10,182,0.0,0.0,0.0,0.0,0.0,0.0,0.0,18,5,13,3.0,3.0,0.0
207326,9,3,6,9,0,9,86,0,8.0,3.0,5.0,7.0,0.0,8.0,68.0,29,9,20,7.0,1.0,6.0
9710248,4,3,1,1,3,1,1,437,2.0,2.0,0.0,0.0,1.0,1.0,1.0,5,4,1,2.0,1.0,1.0
9704243,29,15,14,17,17,12,26,33,9.0,3.0,6.0,8.0,9.0,0.0,0.0,46,29,17,5.0,4.0,1.0
106089,14,9,5,6,1,13,146,23,6.0,3.0,3.0,4.0,0.0,6.0,64.0,74,14,60,24.0,5.0,19.0
9806340,19,12,7,9,1,18,39,47,2.0,2.0,0.0,0.0,0.0,2.0,6.0,30,19,11,2.0,2.0,0.0
203192,2,2,0,0,0,2,7,37,0.0,0.0,0.0,0.0,0.0,0.0,0.0,26,2,24,1.0,0.0,1.0
103346,4,3,1,1,2,2,5,99,0.0,0.0,0.0,0.0,0.0,0.0,0.0,30,4,26,4.0,0.0,4.0
202158,14,7,7,11,1,13,43,0,5.0,1.0,4.0,5.0,0.0,5.0,21.0,26,14,12,11.0,5.0,6.0
9609392,5,5,0,0,1,4,9,4,0.0,0.0,0.0,0.0,0.0,0.0,0.0,20,5,15,2.0,0.0,2.0
9611361,9,1,8,18,9,0,0,65,9.0,1.0,8.0,18.0,9.0,0.0,0.0,9,9,0,2.0,2.0,0.0
103208,23,5,18,26,2,21,50,77,9.0,3.0,6.0,11.0,0.0,9.0,14.0,40,23,17,10.0,7.0,3.0
9802205,1,1,0,0,0,1,1,1,0.0,0.0,0.0,0.0,0.0,0.0,0.0,12,1,11,1.0,0.0,1.0
9707253,2,2,0,0,0,2,2,100,1.0,1.0,0.0,0.0,0.0,1.0,1.0,10,2,8,7.0,0.0,7.0
9503219,23,7,16,39,9,14,28,1,6.0,3.0,3.0,7.0,1.0,5.0,9.0,31,23,8,9.0,8.0,1.0
9709307,7,1,6,12,0,7,20,101,6.0,1.0,5.0,10.0,0.0,6.0,10.0,14,7,7,8.0,6.0,2.0
9706411,13,2,11,27,0,13,13,11,13.0,2.0,11.0,27.0,0.0,13.0,13.0,15,13,2,2.0,2.0,0.0
9904230,11,3,8,27,8,3,3,13,1.0,1.0,0.0,0.0,1.0,0.0,0.0,17,11,6,2.0,2.0,0.0
9809425,8,2,6,17,0,8,61,13,8.0,2.0,6.0,17.0,0.0,8.0,37.0,22,8,14,11.0,7.0,4.0
9308327,10,3,7,20,10,0,0,54,8.0,2.0,6.0,17.0,8.0,0.0,0.0,11,10,1,2.0,2.0,0.0
9511441,3,3,0,0,3,0,0,59,2.0,2.0,0.0,0.0,2.0,0.0,0.0,3,3,0,1.0,1.0,0.0
102317,13,6,7,11,3,10,75,4,8.0,3.0,5.0,8.0,0.0,8.0,63.0,26,13,13,5.0,3.0,2.0
9212214,2,2,0,0,2,0,0,1130,,,,,,,,2,2,0,1.0,1.0,0.0
2046,2,2,0,0,2,0,0,62,0.0,0.0,0.0,0.0,0.0,0.0,0.0,19,2,17,4.0,0.0,4.0
2070,0,0,0,0,0,0,0,12,0.0,0.0,0.0,0.0,0.0,0.0,0.0,10,0,10,2.0,0.0,2.0
9512358,8,4,4,9,1,7,9,35,4.0,1.0,3.0,4.0,2.0,2.0,2.0,10,8,2,5.0,4.0,1.0
9905442,10,6,4,5,2,8,14,25,5.0,3.0,2.0,3.0,0.0,5.0,8.0,15,10,5,2.0,2.0,0.0
9706524,4,3,1,1,1,3,10,1,0.0,0.0,0.0,0.0,0.0,0.0,0.0,21,4,17,1.0,0.0,1.0
9131,21,10,11,15,8,13,35,6,1.0,1.0,0.0,0.0,1.0,0.0,0.0,36,21,15,4.0,2.0,2.0
101100,2,2,0,0,0,2,3,23,0.0,0.0,0.0,0.0,0.0,0.0,0.0,7,2,5,3.0,0.0,3.0
9607359,13,8,5,5,2,11,20,346,5.0,2.0,3.0,3.0,0.0,5.0,5.0,21,13,8,5.0,2.0,3.0
302014,2,2,0,0,2,0,0,42,0.0,0.0,0.0,0.0,0.0,0.0,0.0,17,2,15,2.0,1.0,1.0
9801301,6,5,1,1,3,3,4,157,3.0,3.0,0.0,0.0,0.0,3.0,4.0,8,6,2,4.0,2.0,2.0
101213,4,3,1,1,0,4,37,109,3.0,2.0,1.0,1.0,0.0,3.0,35.0,24,4,20,18.0,3.0,15.0
9508365,13,7,6,7,1,12,39,69,5.0,4.0,1.0,1.0,0.0,5.0,11.0,26,13,13,4.0,3.0,1.0
9404285,4,4,0,0,4,0,0,89,1.0,1.0,0.0,0.0,1.0,0.0,0.0,4,4,0,1.0,1.0,0.0
9302276,1,1,0,0,1,0,0,770,0.0,0.0,0.0,0.0,0.0,0.0,0.0,3,1,2,1.0,0.0,1.0
9812534,1,1,0,0,0,1,1,1238,,,,,,,,3,1,2,,,
9406394,4,1,3,3,1,3,3,17,1.0,1.0,0.0,0.0,1.0,0.0,0.0,5,4,1,1.0,1.0,0.0
9911529,2,2,0,0,0,2,4,19,0.0,0.0,0.0,0.0,0.0,0.0,0.0,14,2,12,10.0,0.0,10.0
8097,1,1,0,0,1,0,0,36,0.0,0.0,0.0,0.0,0.0,0.0,0.0,10,1,9,2.0,0.0,2.0
102061,3,3,0,0,2,1,11,7,1.0,1.0,0.0,0.0,0.0,1.0,8.0,23,3,20,12.0,1.0,11.0
3159,10,4,6,10,2,8,45,4,5.0,2.0,3.0,4.0,0.0,5.0,28.0,22,10,12,12.0,4.0,8.0
9902303,15,4,11,22,4,11,34,4,14.0,3.0,11.0,22.0,4.0,10.0,30.0,22,15,7,14.0,10.0,4.0
9809289,2,1,1,1,2,0,0,90,,,,,,,,2,2,0,,,
9703292,5,2,3,5,1,4,12,278,4.0,1.0,3.0,5.0,0.0,4.0,4.0,12,5,7,6.0,4.0,2.0
9806364,3,3,0,0,2,1,2,68,1.0,1.0,0.0,0.0,1.0,0.0,0.0,9,3,6,1.0,1.0,0.0
9809251,6,3,3,4,0,6,29,90,4.0,2.0,2.0,3.0,0.0,4.0,17.0,26,6,20,7.0,3.0,4.0
9505272,8,3,5,11,2,6,13,74,5.0,1.0,4.0,8.0,1.0,4.0,10.0,15,8,7,7.0,5.0,2.0
9703281,4,4,0,0,1,3,36,114,3.0,3.0,0.0,0.0,0.0,3.0,22.0,23,4,19,12.0,2.0,10.0
102021,11,2,9,17,0,11,47,0,8.0,1.0,7.0,14.0,0.0,8.0,25.0,26,11,15,12.0,8.0,4.0
9810246,2,2,0,0,1,1,2,1822,1.0,1.0,0.0,0.0,0.0,1.0,2.0,4,2,2,,,
6023,10,3,7,24,0,10,18,177,10.0,3.0,7.0,24.0,0.0,10.0,18.0,12,10,2,12.0,10.0,2.0
9601322,4,2,2,2,4,0,0,97,3.0,1.0,2.0,2.0,3.0,0.0,0.0,5,4,1,1.0,1.0,0.0
9907286,6,3,3,4,0,6,7,51,3.0,3.0,0.0,0.0,1.0,2.0,2.0,12,6,6,4.0,3.0,1.0
9405272,41,6,35,186,4,37,179,53,27.0,2.0,25.0,155.0,1.0,26.0,150.0,50,41,9,33.0,26.0,7.0
103147,3,3,0,0,0,3,23,3,2.0,2.0,0.0,0.0,0.0,2.0,8.0,22,3,19,11.0,2.0,9.0
9711437,1,1,0,0,0,1,6,25,0.0,0.0,0.0,0.0,0.0,0.0,0.0,15,1,14,10.0,0.0,10.0
6031,3,1,2,2,0,3,17,102,2.0,1.0,1.0,1.0,0.0,2.0,8.0,10,3,7,7.0,2.0,5.0
9905505,15,6,9,17,7,8,16,14,6.0,2.0,4.0,5.0,1.0,5.0,12.0,28,15,13,7.0,7.0,0.0
9403221,4,3,1,1,4,0,0,295,2.0,1.0,1.0,1.0,2.0,0.0,0.0,5,4,1,2.0,2.0,0.0
109061,3,3,0,0,0,3,30,8,3.0,3.0,0.0,0.0,0.0,3.0,9.0,31,3,28,13.0,2.0,11.0
9812331,0,0,0,0,0,0,0,105,0.0,0.0,0.0,0.0,0.0,0.0,0.0,2,0,2,,,
9703263,2,2,0,0,0,2,6,41,2.0,2.0,0.0,0.0,0.0,2.0,4.0,7,2,5,,,
201104,0,0,0,0,0,0,0,648,0.0,0.0,0.0,0.0,0.0,0.0,0.0,1,0,1,1.0,0.0,1.0
9602392,13,9,4,4,10,3,8,138,6.0,6.0,0.0,0.0,3.0,3.0,5.0,19,13,6,5.0,3.0,2.0
9401282,8,1,7,17,1,7,7,167,7.0,1.0,6.0,12.0,0.0,7.0,7.0,9,8,1,8.0,7.0,1.0
9606266,7,4,3,6,4,3,12,50,3.0,2.0,1.0,1.0,1.0,2.0,8.0,11,7,4,6.0,2.0,4.0
9605331,2,2,0,0,0,2,2,139,0.0,0.0,0.0,0.0,0.0,0.0,0.0,5,2,3,1.0,0.0,1.0
9701209,7,4,3,3,1,6,28,115,5.0,3.0,2.0,2.0,0.0,5.0,22.0,17,7,10,9.0,5.0,4.0
9502305,13,5,8,9,3,10,15,31,7.0,4.0,3.0,4.0,7.0,0.0,0.0,15,13,2,5.0,5.0,0.0
9711290,3,1,2,3,0,3,29,17,2.0,1.0,1.0,1.0,0.0,2.0,21.0,25,3,22,18.0,1.0,17.0
9710494,2,1,1,1,2,0,0,1255,2.0,1.0,1.0,1.0,2.0,0.0,0.0,2,2,0,2.0,2.0,0.0
106214,1,1,0,0,0,1,2,14,,,,,,,,8,1,7,2.0,1.0,1.0
9508377,4,2,2,2,0,4,6,143,2.0,1.0,1.0,1.0,0.0,2.0,2.0,6,4,2,3.0,2.0,1.0
9501218,2,1,1,1,0,2,2,331,2.0,1.0,1.0,1.0,0.0,2.0,2.0,12,2,10,3.0,2.0,1.0
9711204,6,2,4,6,0,6,45,56,6.0,2.0,4.0,6.0,0.0,6.0,45.0,19,6,13,15.0,6.0,9.0
9802336,4,1,3,5,0,4,11,243,1.0,1.0,0.0,0.0,0.0,1.0,4.0,13,4,9,7.0,1.0,6.0
9704269,2,1,1,1,0,2,3,50,0.0,0.0,0.0,0.0,0.0,0.0,0.0,4,2,2,,,
204229,16,3,13,32,0,16,104,193,15.0,2.0,13.0,32.0,0.0,15.0,87.0,30,16,14,22.0,15.0,7.0
9909445,4,1,3,3,0,4,24,9,2.0,1.0,1.0,1.0,0.0,2.0,13.0,25,4,21,7.0,4.0,3.0
110369,12,7,5,9,0,12,56,38,9.0,6.0,3.0,6.0,1.0,8.0,43.0,26,12,14,16.0,8.0,8.0
9407282,17,2,15,47,14,3,3,172,10.0,1.0,9.0,32.0,9.0,1.0,1.0,18,17,1,10.0,10.0,0.0
9912413,1,1,0,0,1,0,0,2030,1.0,1.0,0.0,0.0,1.0,0.0,0.0,1,1,0,1.0,1.0,0.0
12304,5,4,1,2,0,5,49,22,5.0,4.0,1.0,2.0,1.0,4.0,46.0,31,5,26,24.0,3.0,21.0
203242,9,7,2,2,2,7,48,18,4.0,3.0,1.0,1.0,1.0,3.0,33.0,27,9,18,16.0,4.0,12.0
9404319,3,3,0,0,2,1,1,199,2.0,2.0,0.0,0.0,1.0,1.0,1.0,4,3,1,2.0,1.0,1.0
9806214,5,2,3,4,0,5,11,12,2.0,2.0,0.0,0.0,0.0,2.0,4.0,10,5,5,2.0,1.0,1.0
9303243,4,2,2,2,4,0,0,234,1.0,1.0,0.0,0.0,1.0,0.0,0.0,4,4,0,1.0,1.0,0.0
9039,6,3,3,3,0,6,36,31,6.0,3.0,3.0,3.0,0.0,6.0,25.0,15,6,9,6.0,4.0,2.0
9603321,3,2,1,1,1,2,2,35,0.0,0.0,0.0,0.0,0.0,0.0,0.0,9,3,6,2.0,0.0,2.0
9707382,7,6,1,2,2,5,8,273,5.0,4.0,1.0,2.0,1.0,4.0,4.0,11,7,4,4.0,3.0,1.0
9604426,2,1,1,1,0,2,4,14,0.0,0.0,0.0,0.0,0.0,0.0,0.0,11,2,9,,,
9403365,5,3,2,4,5,0,0,601,3.0,1.0,2.0,2.0,3.0,0.0,0.0,5,5,0,2.0,2.0,0.0
9602411,14,7,7,18,1,13,57,49,10.0,4.0,6.0,16.0,0.0,10.0,32.0,27,14,13,9.0,2.0,7.0
9905425,6,3,3,3,1,5,18,29,2.0,1.0,1.0,1.0,0.0,2.0,7.0,27,6,21,7.0,4.0,3.0
106159,17,5,12,31,0,17,102,1,13.0,3.0,10.0,27.0,0.0,13.0,59.0,42,17,25,15.0,10.0,5.0
204270,7,1,6,13,0,7,24,73,2.0,1.0,1.0,1.0,0.0,2.0,11.0,15,7,8,3.0,3.0,0.0
2076,5,3,2,4,0,5,27,21,2.0,1.0,1.0,1.0,0.0,2.0,8.0,21,5,16,1.0,0.0,1.0
206066,4,4,0,0,0,4,53,73,4.0,4.0,0.0,0.0,0.0,4.0,50.0,28,4,24,9.0,1.0,8.0
9912431,14,8,6,8,0,14,27,51,2.0,1.0,1.0,1.0,0.0,2.0,4.0,24,14,10,7.0,5.0,2.0
9903375,15,6,9,19,0,15,68,13,6.0,1.0,5.0,10.0,0.0,6.0,34.0,35,15,20,18.0,5.0,13.0
9908519,4,4,0,0,0,4,8,202,2.0,2.0,0.0,0.0,2.0,0.0,0.0,10,4,6,1.0,1.0,0.0
9711356,4,3,1,1,1,3,14,529,1.0,1.0,0.0,0.0,1.0,0.0,0.0,17,4,13,4.0,1.0,3.0
4032,5,3,2,2,1,4,47,50,1.0,1.0,0.0,0.0,0.0,1.0,18.0,37,5,32,19.0,1.0,18.0
201107,6,3,3,4,4,2,13,50,2.0,1.0,1.0,1.0,0.0,2.0,13.0,14,6,8,2.0,0.0,2.0
9912215,22,7,15,61,0,22,178,50,21.0,6.0,15.0,60.0,0.0,21.0,176.0,38,22,16,32.0,16.0,16.0
9701230,5,3,2,2,3,2,2,195,2.0,1.0,1.0,1.0,1.0,1.0,1.0,8,5,3,4.0,1.0,3.0
9908260,20,4,16,58,2,18,180,68,15.0,4.0,11.0,45.0,0.0,15.0,136.0,46,20,26,27.0,14.0,13.0
9301284,8,2,6,7,8,0,0,187,6.0,1.0,5.0,6.0,6.0,0.0,0.0,8,8,0,4.0,4.0,0.0
9710560,6,5,1,1,0,6,58,13,5.0,4.0,1.0,1.0,0.0,5.0,44.0,30,6,24,12.0,4.0,8.0
9704343,14,5,9,35,0,14,96,36,14.0,5.0,9.0,35.0,0.0,14.0,86.0,28,14,14,18.0,12.0,6.0
9809374,1,1,0,0,0,1,10,57,1.0,1.0,0.0,0.0,0.0,1.0,7.0,18,1,17,9.0,0.0,9.0
105158,1,1,0,0,0,1,1,1077,,,,,,,,3,1,2,1.0,0.0,1.0
9702213,1,1,0,0,1,0,0,85,0.0,0.0,0.0,0.0,0.0,0.0,0.0,8,1,7,4.0,0.0,4.0
9510315,1,1,0,0,1,0,0,270,0.0,0.0,0.0,0.0,0.0,0.0,0.0,2,1,1,1.0,0.0,1.0
102256,4,3,1,1,0,4,29,22,3.0,2.0,1.0,1.0,0.0,3.0,21.0,22,4,18,9.0,3.0,6.0
9706318,5,4,1,1,0,5,9,112,1.0,1.0,0.0,0.0,0.0,1.0,2.0,18,5,13,3.0,0.0,3.0
5255,6,3,3,4,5,1,1,77,2.0,1.0,1.0,1.0,2.0,0.0,0.0,7,6,1,4.0,4.0,0.0
101017,7,4,3,4,5,2,8,55,1.0,1.0,0.0,0.0,0.0,1.0,5.0,16,7,9,2.0,2.0,0.0
9610480,4,3,1,1,1,3,5,130,1.0,1.0,0.0,0.0,0.0,1.0,1.0,14,4,10,1.0,1.0,0.0
9909412,2,1,1,1,0,2,2,214,1.0,1.0,0.0,0.0,1.0,0.0,0.0,5,2,3,2.0,2.0,0.0
10322,8,1,7,9,3,5,8,122,7.0,1.0,6.0,7.0,3.0,4.0,6.0,11,8,3,9.0,7.0,2.0
9808317,14,7,7,10,5,9,29,4,8.0,2.0,6.0,9.0,1.0,7.0,18.0,30,14,16,6.0,4.0,2.0
9810239,2,1,1,1,0,2,22,70,2.0,1.0,1.0,1.0,0.0,2.0,22.0,15,2,13,13.0,2.0,11.0
1208,5,4,1,2,0,5,28,0,5.0,4.0,1.0,2.0,0.0,5.0,26.0,15,5,10,2.0,1.0,1.0
9812398,10,4,6,21,1,9,19,45,7.0,1.0,6.0,17.0,0.0,7.0,9.0,14,10,4,8.0,7.0,1.0
10096,11,5,6,8,0,11,41,201,4.0,3.0,1.0,1.0,0.0,4.0,15.0,23,11,12,8.0,6.0,2.0
102018,3,3,0,0,3,0,0,16,0.0,0.0,0.0,0.0,0.0,0.0,0.0,48,3,45,9.0,0.0,9.0
7323,24,8,16,42,6,18,41,51,16.0,4.0,12.0,37.0,6.0,10.0,11.0,34,24,10,13.0,12.0,1.0
208266,10,9,1,1,2,8,41,3,2.0,1.0,1.0,1.0,0.0,2.0,16.0,50,10,40,6.0,2.0,4.0
204236,6,5,1,1,1,5,24,0,0.0,0.0,0.0,0.0,0.0,0.0,0.0,33,6,27,5.0,0.0,5.0
9912540,9,4,5,11,1,8,11,410,5.0,1.0,4.0,10.0,5.0,0.0,0.0,12,9,3,5.0,5.0,0.0
10062,7,4,3,3,3,4,9,189,4.0,1.0,3.0,3.0,0.0,4.0,9.0,10,7,3,7.0,4.0,3.0
9311365,4,4,0,0,3,1,1,365,2.0,2.0,0.0,0.0,2.0,0.0,0.0,5,4,1,2.0,2.0,0.0
207181,1,1,0,0,1,0,0,319,0.0,0.0,0.0,0.0,0.0,0.0,0.0,10,1,9,1.0,1.0,0.0
9210212,5,2,3,6,5,0,0,19,2.0,2.0,0.0,0.0,2.0,0.0,0.0,5,5,0,,,
9908287,4,3,1,1,0,4,12,260,3.0,2.0,1.0,1.0,0.0,3.0,9.0,9,4,5,6.0,3.0,3.0
210112,2,2,0,0,0,2,17,48,0.0,0.0,0.0,0.0,0.0,0.0,0.0,52,2,50,7.0,0.0,7.0
208204,1,1,0,0,0,1,7,7,1.0,1.0,0.0,0.0,0.0,1.0,3.0,15,1,14,8.0,1.0,7.0
108031,2,1,1,1,0,2,2,1978,2.0,1.0,1.0,1.0,2.0,0.0,0.0,4,2,2,2.0,2.0,0.0
9606331,3,3,0,0,3,0,0,31,0.0,0.0,0.0,0.0,0.0,0.0,0.0,8,3,5,1.0,0.0,1.0
9809589,7,4,3,4,0,7,35,25,3.0,1.0,2.0,2.0,0.0,3.0,13.0,31,7,24,8.0,1.0,7.0
9709512,2,2,0,0,0,2,7,42,0.0,0.0,0.0,0.0,0.0,0.0,0.0,12,2,10,2.0,1.0,1.0
9609509,3,3,0,0,1,2,2,310,1.0,1.0,0.0,0.0,1.0,0.0,0.0,7,3,4,2.0,1.0,1.0
9901440,14,2,12,24,4,10,20,191,14.0,2.0,12.0,24.0,4.0,10.0,17.0,20,14,6,12.0,8.0,4.0
207185,1,1,0,0,0,1,4,100,1.0,1.0,0.0,0.0,0.0,1.0,3.0,13,1,12,9.0,1.0,8.0
9911433,9,7,2,2,0,9,41,57,8.0,6.0,2.0,2.0,0.0,8.0,29.0,24,9,15,8.0,4.0,4.0
9509393,30,3,27,114,2,28,60,113,25.0,2.0,23.0,95.0,1.0,24.0,48.0,36,30,6,23.0,20.0,3.0
9712304,6,2,4,6,1,5,6,288,2.0,1.0,1.0,1.0,0.0,2.0,3.0,8,6,2,2.0,1.0,1.0
9803202,1,1,0,0,0,1,3,194,1.0,1.0,0.0,0.0,0.0,1.0,3.0,6,1,5,5.0,1.0,4.0
9607474,1,1,0,0,0,1,2,115,0.0,0.0,0.0,0.0,0.0,0.0,0.0,14,1,13,5.0,0.0,5.0
9704419,5,2,3,4,4,1,1,241,4.0,2.0,2.0,2.0,4.0,0.0,0.0,9,5,4,3.0,2.0,1.0
5122,16,7,9,13,3,13,79,90,9.0,4.0,5.0,9.0,0.0,9.0,48.0,96,16,80,25.0,1.0,24.0
9604448,4,2,2,3,1,3,3,101,2.0,1.0,1.0,1.0,2.0,0.0,0.0,7,4,3,3.0,3.0,0.0
9801428,0,0,0,0,0,0,0,18,,,,,,,,7,0,7,,,
210345,0,0,0,0,0,0,0,372,0.0,0.0,0.0,0.0,0.0,0.0,0.0,2,0,2,2.0,0.0,2.0
112202,5,3,2,2,3,2,10,162,1.0,1.0,0.0,0.0,0.0,1.0,5.0,17,5,12,5.0,1.0,4.0
9611227,4,4,0,0,0,4,51,15,4.0,4.0,0.0,0.0,0.0,4.0,50.0,26,4,22,2.0,1.0,1.0
111125,2,2,0,0,0,2,15,168,2.0,2.0,0.0,0.0,0.0,2.0,5.0,17,2,15,4.0,1.0,3.0
9406356,2,1,1,1,2,0,0,1580,,,,,,,,2,2,0,,,
203251,5,2,3,3,0,5,70,23,3.0,1.0,2.0,2.0,0.0,3.0,43.0,44,5,39,27.0,3.0,24.0
111258,7,7,0,0,1,6,24,23,2.0,2.0,0.0,0.0,0.0,2.0,11.0,18,7,11,11.0,2.0,9.0
9911254,10,2,8,19,4,6,6,136,6.0,1.0,5.0,15.0,6.0,0.0,0.0,14,10,4,6.0,6.0,0.0
9702356,10,2,8,12,0,10,46,130,6.0,2.0,4.0,7.0,0.0,6.0,28.0,19,10,9,11.0,5.0,6.0
9302209,3,3,0,0,3,0,0,653,0.0,0.0,0.0,0.0,0.0,0.0,0.0,5,3,2,1.0,0.0,1.0
110164,1,1,0,0,0,1,7,37,1.0,1.0,0.0,0.0,0.0,1.0,7.0,16,1,15,5.0,0.0,5.0
9810391,2,1,1,1,0,2,3,181,2.0,1.0,1.0,1.0,0.0,2.0,3.0,5,2,3,5.0,2.0,3.0
9803420,4,4,0,0,1,3,3,190,3.0,3.0,0.0,0.0,3.0,0.0,0.0,6,4,2,3.0,2.0,1.0
102303,11,4,7,13,1,10,59,9,9.0,3.0,6.0,11.0,1.0,8.0,49.0,30,11,19,6.0,1.0,5.0
302076,1,1,0,0,0,1,3,62,1.0,1.0,0.0,0.0,0.0,1.0,2.0,10,1,9,2.0,0.0,2.0
9809412,9,2,7,12,4,5,7,51,8.0,2.0,6.0,11.0,8.0,0.0,0.0,11,9,2,4.0,3.0,1.0
204251,3,2,1,1,1,2,6,23,0.0,0.0,0.0,0.0,0.0,0.0,0.0,119,3,116,27.0,0.0,27.0
102194,3,3,0,0,1,2,2,259,2.0,2.0,0.0,0.0,0.0,2.0,2.0,4,3,1,3.0,2.0,1.0
9302283,8,3,5,12,8,0,0,122,7.0,2.0,5.0,10.0,7.0,0.0,0.0,8,8,0,5.0,5.0,0.0
101325,10,4,6,12,2,8,39,68,7.0,2.0,5.0,9.0,0.0,7.0,31.0,19,10,9,13.0,6.0,7.0
3076,6,4,2,4,0,6,33,54,3.0,3.0,0.0,0.0,0.0,3.0,13.0,23,6,17,13.0,2.0,11.0
9804222,8,4,4,5,0,8,27,1,4.0,2.0,2.0,2.0,1.0,3.0,3.0,22,8,14,2.0,1.0,1.0
9501409,6,4,2,2,6,0,0,311,3.0,3.0,0.0,0.0,3.0,0.0,0.0,6,6,0,3.0,3.0,0.0
110040,4,3,1,2,0,4,22,5,0.0,0.0,0.0,0.0,0.0,0.0,0.0,56,4,52,18.0,0.0,18.0
9804328,4,3,1,1,2,2,3,141,0.0,0.0,0.0,0.0,0.0,0.0,0.0,8,4,4,1.0,1.0,0.0
9904460,4,4,0,0,0,4,81,6,3.0,3.0,0.0,0.0,0.0,3.0,59.0,65,4,61,13.0,1.0,12.0
11082,5,3,2,3,0,5,32,18,2.0,2.0,0.0,0.0,0.0,2.0,19.0,32,5,27,2.0,0.0,2.0
12244,6,4,2,3,1,5,39,17,4.0,2.0,2.0,2.0,0.0,4.0,33.0,21,6,15,4.0,1.0,3.0
5202,3,3,0,0,1,2,3,13,0.0,0.0,0.0,0.0,0.0,0.0,0.0,11,3,8,2.0,0.0,2.0
9606236,2,2,0,0,1,1,1,281,1.0,1.0,0.0,0.0,0.0,1.0,1.0,14,2,12,3.0,1.0,2.0
9311242,3,3,0,0,3,0,0,196,2.0,2.0,0.0,0.0,2.0,0.0,0.0,5,3,2,2.0,2.0,0.0
9910540,16,11,5,7,6,10,20,31,8.0,3.0,5.0,6.0,3.0,5.0,5.0,23,16,7,6.0,5.0,1.0
9511320,5,4,1,1,2,3,9,13,2.0,1.0,1.0,1.0,0.0,2.0,6.0,13,5,8,1.0,0.0,1.0
9907426,13,3,10,26,4,9,20,71,3.0,1.0,2.0,3.0,0.0,3.0,6.0,24,13,11,3.0,3.0,0.0
9504276,8,4,4,5,3,5,7,49,5.0,2.0,3.0,3.0,2.0,3.0,3.0,10,8,2,3.0,3.0,0.0
9904368,6,5,1,1,0,6,36,16,4.0,3.0,1.0,1.0,0.0,4.0,28.0,21,6,15,17.0,2.0,15.0
9706434,1,1,0,0,0,1,2,35,0.0,0.0,0.0,0.0,0.0,0.0,0.0,19,1,18,5.0,0.0,5.0
9711333,12,3,9,26,4,8,14,105,10.0,3.0,7.0,23.0,2.0,8.0,14.0,14,12,2,11.0,9.0,2.0
9905262,3,3,0,0,0,3,12,31,1.0,1.0,0.0,0.0,0.0,1.0,1.0,15,3,12,1.0,0.0,1.0
9701250,5,4,1,1,0,5,22,17,2.0,2.0,0.0,0.0,0.0,2.0,17.0,18,5,13,3.0,2.0,1.0
9510282,1,1,0,0,0,1,2,84,1.0,1.0,0.0,0.0,0.0,1.0,2.0,4,1,3,3.0,1.0,2.0
302070,2,1,1,1,1,1,1,65,1.0,1.0,0.0,0.0,1.0,0.0,0.0,7,2,5,2.0,2.0,0.0
9312320,12,3,9,28,10,2,2,29,5.0,2.0,3.0,4.0,5.0,0.0,0.0,14,12,2,5.0,5.0,0.0
111142,0,0,0,0,0,0,0,20,0.0,0.0,0.0,0.0,0.0,0.0,0.0,10,0,10,2.0,0.0,2.0
9603300,2,1,1,1,1,1,1,485,1.0,1.0,0.0,0.0,1.0,0.0,0.0,5,2,3,3.0,1.0,2.0
9605335,9,4,5,12,2,7,11,82,6.0,2.0,4.0,11.0,0.0,6.0,10.0,12,9,3,7.0,5.0,2.0
9805455,2,1,1,1,1,1,1,656,2.0,1.0,1.0,1.0,2.0,0.0,0.0,3,2,1,2.0,2.0,0.0
9903312,1,1,0,0,0,1,2,273,1.0,1.0,0.0,0.0,0.0,1.0,2.0,5,1,4,2.0,0.0,2.0
9801226,11,6,5,13,2,9,22,145,7.0,2.0,5.0,11.0,5.0,2.0,2.0,19,11,8,6.0,6.0,0.0
9711313,8,6,2,4,1,7,17,103,5.0,3.0,2.0,3.0,0.0,5.0,13.0,12,8,4,8.0,6.0,2.0
9701314,2,1,1,1,2,0,0,305,0.0,0.0,0.0,0.0,0.0,0.0,0.0,4,2,2,3.0,2.0,1.0
9611276,1,1,0,0,0,1,2,326,1.0,1.0,0.0,0.0,0.0,1.0,2.0,11,1,10,4.0,1.0,3.0
9207274,3,1,2,2,3,0,0,260,1.0,1.0,0.0,0.0,1.0,0.0,0.0,3,3,0,1.0,1.0,0.0
102129,1,1,0,0,1,0,0,79,1.0,1.0,0.0,0.0,1.0,0.0,0.0,4,1,3,1.0,1.0,0.0
9901415,10,1,9,21,6,4,5,64,10.0,1.0,9.0,21.0,6.0,4.0,4.0,13,10,3,8.0,8.0,0.0
9906352,1,1,0,0,0,1,2,255,,,,,,,,3,1,2,1.0,1.0,0.0
107255,2,2,0,0,0,2,11,5,2.0,2.0,0.0,0.0,0.0,2.0,11.0,14,2,12,1.0,1.0,0.0
6036,8,2,6,17,0,8,43,158,6.0,1.0,5.0,13.0,0.0,6.0,30.0,21,8,13,16.0,6.0,10.0
10174,5,3,2,2,0,5,36,1,4.0,2.0,2.0,2.0,0.0,4.0,28.0,26,5,21,5.0,0.0,5.0
9511416,0,0,0,0,0,0,0,317,0.0,0.0,0.0,0.0,0.0,0.0,0.0,3,0,3,1.0,0.0,1.0
9702228,1,1,0,0,0,1,2,527,1.0,1.0,0.0,0.0,0.0,1.0,2.0,3,1,2,3.0,1.0,2.0
9710233,2,2,0,0,0,2,18,12,2.0,2.0,0.0,0.0,0.0,2.0,18.0,21,2,19,2.0,0.0,2.0
204274,1,1,0,0,1,0,0,11,0.0,0.0,0.0,0.0,0.0,0.0,0.0,26,1,25,9.0,0.0,9.0
9802285,3,2,1,1,2,1,2,21,,,,,,,,5,3,2,,,
9802270,6,3,3,6,0,6,35,18,5.0,2.0,3.0,6.0,0.0,5.0,19.0,19,6,13,11.0,5.0,6.0
11099,2,2,0,0,2,0,0,251,0.0,0.0,0.0,0.0,0.0,0.0,0.0,7,2,5,1.0,1.0,0.0
9812251,4,4,0,0,1,3,19,8,1.0,1.0,0.0,0.0,0.0,1.0,11.0,45,4,41,22.0,0.0,22.0
110399,2,2,0,0,0,2,6,216,2.0,2.0,0.0,0.0,0.0,2.0,6.0,5,2,3,4.0,1.0,3.0
9409386,11,3,8,14,10,1,2,96,9.0,1.0,8.0,14.0,9.0,0.0,0.0,14,11,3,9.0,9.0,0.0
9802259,1,1,0,0,0,1,2,26,0.0,0.0,0.0,0.0,0.0,0.0,0.0,9,1,8,1.0,0.0,1.0
9906379,2,2,0,0,2,0,0,1,1.0,1.0,0.0,0.0,1.0,0.0,0.0,11,2,9,,,
9904459,5,3,2,2,1,4,18,110,2.0,2.0,0.0,0.0,0.0,2.0,9.0,14,5,9,8.0,2.0,6.0
9807331,5,4,1,1,0,5,20,40,3.0,3.0,0.0,0.0,0.0,3.0,7.0,16,5,11,5.0,2.0,3.0
9210258,3,3,0,0,3,0,0,280,3.0,3.0,0.0,0.0,3.0,0.0,0.0,3,3,0,3.0,3.0,0.0
106251,4,2,2,2,0,4,15,36,4.0,2.0,2.0,2.0,0.0,4.0,9.0,19,4,15,5.0,0.0,5.0
201044,9,8,1,1,0,9,40,83,2.0,2.0,0.0,0.0,0.0,2.0,6.0,47,9,38,16.0,1.0,15.0
206027,2,1,1,1,0,2,7,178,2.0,1.0,1.0,1.0,0.0,2.0,6.0,15,2,13,7.0,2.0,5.0
9910476,10,3,7,19,0,10,14,91,9.0,2.0,7.0,19.0,0.0,9.0,9.0,18,10,8,10.0,9.0,1.0
105338,3,2,1,1,1,2,8,8,3.0,2.0,1.0,1.0,1.0,2.0,2.0,13,3,10,1.0,0.0,1.0
9707283,1,1,0,0,0,1,1,85,0.0,0.0,0.0,0.0,0.0,0.0,0.0,15,1,14,6.0,0.0,6.0
9503441,8,4,4,6,2,6,8,57,4.0,2.0,2.0,2.0,0.0,4.0,5.0,13,8,5,4.0,4.0,0.0
108179,8,5,3,4,3,5,26,27,6.0,3.0,3.0,4.0,1.0,5.0,26.0,18,8,10,5.0,1.0,4.0
2290,10,3,7,15,1,9,13,95,7.0,1.0,6.0,11.0,0.0,7.0,7.0,13,10,3,8.0,7.0,1.0
9905261,6,6,0,0,2,4,4,31,1.0,1.0,0.0,0.0,1.0,0.0,0.0,8,6,2,1.0,1.0,0.0
9307353,1,1,0,0,1,0,0,1987,,,,,,,,1,1,0,1.0,1.0,0.0
9609306,7,7,0,0,1,6,8,132,2.0,2.0,0.0,0.0,0.0,2.0,2.0,10,7,3,3.0,2.0,1.0
9408362,1,1,0,0,1,0,0,364,1.0,1.0,0.0,0.0,1.0,0.0,0.0,2,1,1,2.0,1.0,1.0
1136,8,6,2,5,0,8,17,31,6.0,5.0,1.0,2.0,3.0,3.0,6.0,17,8,9,6.0,2.0,4.0
212092,4,1,3,4,0,4,51,1,4.0,1.0,3.0,4.0,0.0,4.0,26.0,57,4,53,15.0,4.0,11.0
5163,2,1,1,1,0,2,14,79,2.0,1.0,1.0,1.0,0.0,2.0,13.0,18,2,16,9.0,2.0,7.0
9908308,6,5,1,1,0,6,25,56,3.0,3.0,0.0,0.0,0.0,3.0,10.0,29,6,23,6.0,1.0,5.0
7030,0,0,0,0,0,0,0,264,0.0,0.0,0.0,0.0,0.0,0.0,0.0,5,0,5,1.0,0.0,1.0
9903202,7,6,1,1,1,6,28,7,1.0,1.0,0.0,0.0,0.0,1.0,9.0,25,7,18,7.0,2.0,5.0
9155,3,2,1,1,0,3,26,34,2.0,1.0,1.0,1.0,0.0,2.0,24.0,26,3,23,4.0,0.0,4.0
205035,5,3,2,2,0,5,16,283,4.0,3.0,1.0,1.0,0.0,4.0,15.0,13,5,8,3.0,1.0,2.0
9705281,1,1,0,0,1,0,0,481,0.0,0.0,0.0,0.0,0.0,0.0,0.0,4,1,3,2.0,0.0,2.0
205090,5,4,1,1,0,5,6,37,0.0,0.0,0.0,0.0,0.0,0.0,0.0,19,5,14,3.0,1.0,2.0
9405267,4,2,2,3,2,2,2,195,1.0,1.0,0.0,0.0,0.0,1.0,1.0,5,4,1,2.0,2.0,0.0
9611289,2,1,1,1,0,2,4,26,,,,,,,,6,2,4,1.0,0.0,1.0
301242,0,0,0,0,0,0,0,191,0.0,0.0,0.0,0.0,0.0,0.0,0.0,3,0,3,1.0,0.0,1.0
9603255,3,1,2,3,3,0,0,390,3.0,1.0,2.0,3.0,3.0,0.0,0.0,3,3,0,3.0,3.0,0.0
9509349,10,5,5,7,10,0,0,120,5.0,1.0,4.0,6.0,5.0,0.0,0.0,10,10,0,5.0,5.0,0.0
101349,2,2,0,0,2,0,0,540,0.0,0.0,0.0,0.0,0.0,0.0,0.0,5,2,3,2.0,0.0,2.0
9510272,0,0,0,0,0,0,0,337,0.0,0.0,0.0,0.0,0.0,0.0,0.0,1,0,1,,,
111368,2,2,0,0,2,0,0,39,0.0,0.0,0.0,0.0,0.0,0.0,0.0,8,2,6,3.0,0.0,3.0
9910531,7,5,2,2,1,6,10,11,1.0,1.0,0.0,0.0,1.0,0.0,0.0,19,7,12,2.0,2.0,0.0
212099,2,2,0,0,0,2,25,108,1.0,1.0,0.0,0.0,0.0,1.0,17.0,26,2,24,12.0,1.0,11.0
102069,6,4,2,3,0,6,38,11,4.0,2.0,2.0,3.0,0.0,4.0,14.0,23,6,17,9.0,4.0,5.0
205269,5,3,2,2,0,5,39,146,4.0,3.0,1.0,1.0,0.0,4.0,36.0,18,5,13,17.0,5.0,12.0
9811425,6,5,1,1,4,2,2,216,4.0,4.0,0.0,0.0,4.0,0.0,0.0,7,6,1,3.0,3.0,0.0
9901380,7,5,2,2,7,0,0,31,0.0,0.0,0.0,0.0,0.0,0.0,0.0,17,7,10,5.0,0.0,5.0
6272,1,1,0,0,0,1,4,67,1.0,1.0,0.0,0.0,0.0,1.0,4.0,6,1,5,1.0,0.0,1.0
101022,7,2,5,7,2,5,9,47,6.0,2.0,4.0,6.0,1.0,5.0,9.0,16,7,9,2.0,0.0,2.0
9704209,4,3,1,2,1,3,5,163,1.0,1.0,0.0,0.0,1.0,0.0,0.0,7,4,3,3.0,2.0,1.0
211057,0,0,0,0,0,0,0,106,0.0,0.0,0.0,0.0,0.0,0.0,0.0,14,0,14,5.0,0.0,5.0
9412357,4,4,0,0,4,0,0,331,2.0,2.0,0.0,0.0,2.0,0.0,0.0,4,4,0,1.0,1.0,0.0
9903209,7,3,4,6,2,5,9,215,4.0,3.0,1.0,2.0,2.0,2.0,2.0,13,7,6,3.0,3.0,0.0
202043,2,2,0,0,0,2,10,55,2.0,2.0,0.0,0.0,0.0,2.0,8.0,9,2,7,4.0,1.0,3.0
10125,1,1,0,0,1,0,0,53,0.0,0.0,0.0,0.0,0.0,0.0,0.0,37,1,36,13.0,0.0,13.0
9707206,3,3,0,0,2,1,2,220,2.0,2.0,0.0,0.0,2.0,0.0,0.0,8,3,5,1.0,1.0,0.0
9510255,1,1,0,0,0,1,1,33,1.0,1.0,0.0,0.0,0.0,1.0,1.0,7,1,6,2.0,0.0,2.0
201030,11,1,10,33,0,11,88,9,11.0,1.0,10.0,33.0,0.0,11.0,88.0,24,11,13,9.0,7.0,2.0
9607457,4,3,1,1,0,4,7,161,2.0,1.0,1.0,1.0,0.0,2.0,2.0,9,4,5,5.0,3.0,2.0
1281,3,1,2,2,3,0,0,13,0.0,0.0,0.0,0.0,0.0,0.0,0.0,6,3,3,2.0,0.0,2.0
9509350,3,3,0,0,3,0,0,134,0.0,0.0,0.0,0.0,0.0,0.0,0.0,7,3,4,1.0,0.0,1.0
9507374,1,1,0,0,0,1,1,78,1.0,1.0,0.0,0.0,0.0,1.0,1.0,4,1,3,1.0,0.0,1.0
207005,4,3,1,1,0,4,40,24,4.0,3.0,1.0,1.0,0.0,4.0,39.0,41,4,37,18.0,2.0,16.0
9807478,1,1,0,0,0,1,2,29,,,,,,,,3,1,2,,,
9604403,12,6,6,10,5,7,10,119,6.0,3.0,3.0,4.0,6.0,0.0,0.0,16,12,4,3.0,3.0,0.0
9512216,4,1,3,4,1,3,11,74,3.0,1.0,2.0,3.0,0.0,3.0,8.0,10,4,6,6.0,3.0,3.0
9603354,1,1,0,0,1,0,0,104,0.0,0.0,0.0,0.0,0.0,0.0,0.0,6,1,5,4.0,0.0,4.0
111331,1,1,0,0,1,0,0,105,0.0,0.0,0.0,0.0,0.0,0.0,0.0,17,1,16,7.0,0.0,7.0
9710232,11,2,9,25,2,9,10,175,11.0,2.0,9.0,25.0,2.0,9.0,9.0,13,11,2,10.0,9.0,1.0
9602387,3,1,2,2,3,0,0,190,0.0,0.0,0.0,0.0,0.0,0.0,0.0,8,3,5,2.0,0.0,2.0
9812376,3,3,0,0,2,1,1,154,1.0,1.0,0.0,0.0,0.0,1.0,1.0,10,3,7,3.0,1.0,2.0
9412271,6,1,5,6,6,0,0,316,4.0,1.0,3.0,4.0,4.0,0.0,0.0,6,6,0,4.0,4.0,0.0
9509416,8,2,6,13,2,6,12,157,4.0,1.0,3.0,5.0,0.0,4.0,4.0,16,8,8,5.0,4.0,1.0
11127,2,2,0,0,0,2,6,16,2.0,2.0,0.0,0.0,0.0,2.0,5.0,6,2,4,1.0,0.0,1.0
104239,5,2,3,6,0,5,9,171,5.0,2.0,3.0,6.0,0.0,5.0,9.0,8,5,3,8.0,5.0,3.0
109188,4,2,2,2,1,3,12,29,2.0,2.0,0.0,0.0,0.0,2.0,4.0,17,4,13,7.0,1.0,6.0
6334,5,1,4,6,0,5,14,82,5.0,1.0,4.0,6.0,0.0,5.0,13.0,9,5,4,3.0,2.0,1.0
9506397,2,1,1,1,0,2,2,117,2.0,1.0,1.0,1.0,0.0,2.0,2.0,6,2,4,,,
107178,9,4,5,7,3,6,28,209,6.0,3.0,3.0,5.0,0.0,6.0,25.0,17,9,8,12.0,5.0,7.0
9501206,5,1,4,5,4,1,1,307,5.0,1.0,4.0,5.0,5.0,0.0,0.0,7,5,2,3.0,3.0,0.0
9709257,2,2,0,0,0,2,10,30,1.0,1.0,0.0,0.0,0.0,1.0,4.0,10,2,8,2.0,1.0,1.0
9412277,5,1,4,5,5,0,0,235,5.0,1.0,4.0,5.0,5.0,0.0,0.0,6,5,1,4.0,4.0,0.0
9910261,4,4,0,0,0,4,17,3,3.0,3.0,0.0,0.0,0.0,3.0,16.0,41,4,37,20.0,1.0,19.0
9610203,2,2,0,0,0,2,8,14,0.0,0.0,0.0,0.0,0.0,0.0,0.0,10,2,8,4.0,0.0,4.0
9402255,2,2,0,0,1,1,2,806,0.0,0.0,0.0,0.0,0.0,0.0,0.0,5,2,3,1.0,1.0,0.0
9809264,3,1,2,3,0,3,4,66,3.0,1.0,2.0,3.0,3.0,0.0,0.0,5,3,2,3.0,3.0,0.0
204226,3,2,1,1,0,3,5,40,1.0,1.0,0.0,0.0,0.0,1.0,2.0,15,3,12,5.0,0.0,5.0
101234,1,1,0,0,0,1,2,1925,,,,,,,,3,1,2,2.0,0.0,2.0
9212309,3,3,0,0,3,0,0,176,2.0,2.0,0.0,0.0,2.0,0.0,0.0,3,3,0,1.0,1.0,0.0
9503201,5,5,0,0,5,0,0,318,1.0,1.0,0.0,0.0,1.0,0.0,0.0,5,5,0,2.0,2.0,0.0
9911284,4,3,1,1,1,3,9,31,3.0,2.0,1.0,1.0,1.0,2.0,6.0,28,4,24,3.0,0.0,3.0
204161,0,0,0,0,0,0,0,1654,,,,,,,,5,0,5,1.0,0.0,1.0
9710319,1,1,0,0,1,0,0,105,,,,,,,,2,1,1,,,
205238,1,1,0,0,1,0,0,32,0.0,0.0,0.0,0.0,0.0,0.0,0.0,14,1,13,5.0,0.0,5.0
9710553,3,3,0,0,3,0,0,269,3.0,3.0,0.0,0.0,3.0,0.0,0.0,3,3,0,1.0,1.0,0.0
9307214,0,0,0,0,0,0,0,207,0.0,0.0,0.0,0.0,0.0,0.0,0.0,2,0,2,,,
7151,2,1,1,1,0,2,12,118,1.0,1.0,0.0,0.0,0.0,1.0,5.0,12,2,10,6.0,1.0,5.0
102082,1,1,0,0,0,1,5,7,1.0,1.0,0.0,0.0,0.0,1.0,4.0,13,1,12,1.0,1.0,0.0
107226,4,3,1,1,2,2,6,29,0.0,0.0,0.0,0.0,0.0,0.0,0.0,29,4,25,2.0,2.0,0.0
9603286,1,1,0,0,0,1,1,368,0.0,0.0,0.0,0.0,0.0,0.0,0.0,3,1,2,1.0,0.0,1.0
9809357,4,3,1,1,0,4,9,41,2.0,2.0,0.0,0.0,0.0,2.0,3.0,24,4,20,2.0,1.0,1.0
9708468,2,1,1,1,1,1,4,213,2.0,1.0,1.0,1.0,1.0,1.0,3.0,10,2,8,6.0,1.0,5.0
111357,9,2,7,15,0,9,115,11,9.0,2.0,7.0,15.0,0.0,9.0,113.0,35,9,26,26.0,8.0,18.0
9801424,0,0,0,0,0,0,0,27,0.0,0.0,0.0,0.0,0.0,0.0,0.0,11,0,11,1.0,0.0,1.0
3209,2,1,1,1,0,2,6,65,2.0,1.0,1.0,1.0,0.0,2.0,6.0,9,2,7,2.0,0.0,2.0
9502331,1,1,0,0,1,0,0,359,1.0,1.0,0.0,0.0,1.0,0.0,0.0,1,1,0,1.0,1.0,0.0
9611424,3,2,1,1,0,3,5,113,0.0,0.0,0.0,0.0,0.0,0.0,0.0,8,3,5,3.0,0.0,3.0
102261,4,3,1,1,3,1,2,174,1.0,1.0,0.0,0.0,1.0,0.0,0.0,14,4,10,8.0,0.0,8.0
9208224,1,1,0,0,1,0,0,385,1.0,1.0,0.0,0.0,1.0,0.0,0.0,1,1,0,1.0,1.0,0.0
207297,4,4,0,0,0,4,43,16,4.0,4.0,0.0,0.0,0.0,4.0,42.0,31,4,27,14.0,2.0,12.0
110017,3,1,2,2,0,3,28,7,2.0,1.0,1.0,1.0,0.0,2.0,12.0,18,3,15,7.0,2.0,5.0
9804326,2,1,1,1,0,2,2,347,2.0,1.0,1.0,1.0,0.0,2.0,2.0,4,2,2,3.0,2.0,1.0
9906371,6,5,1,1,3,3,11,240,3.0,3.0,0.0,0.0,1.0,2.0,9.0,20,6,14,8.0,2.0,6.0
10187,4,3,1,1,1,3,4,280,2.0,1.0,1.0,1.0,0.0,2.0,3.0,9,4,5,5.0,2.0,3.0
212292,1,1,0,0,0,1,14,165,1.0,1.0,0.0,0.0,0.0,1.0,9.0,16,1,15,10.0,1.0,9.0
10255,2,2,0,0,2,0,0,617,1.0,1.0,0.0,0.0,1.0,0.0,0.0,2,2,0,1.0,1.0,0.0
208055,1,1,0,0,0,1,5,1,0.0,0.0,0.0,0.0,0.0,0.0,0.0,24,1,23,3.0,0.0,3.0
9904323,4,1,3,4,1,3,6,455,3.0,1.0,2.0,2.0,1.0,2.0,2.0,13,4,9,5.0,4.0,1.0
9702338,5,5,0,0,4,1,4,240,3.0,3.0,0.0,0.0,3.0,0.0,0.0,12,5,7,1.0,0.0,1.0
6167,2,1,1,1,2,0,0,1170,,,,,,,,2,2,0,,,
9905563,1,1,0,0,1,0,0,27,0.0,0.0,0.0,0.0,0.0,0.0,0.0,12,1,11,2.0,0.0,2.0
9707522,0,0,0,0,0,0,0,6,0.0,0.0,0.0,0.0,0.0,0.0,0.0,18,0,18,2.0,0.0,2.0
9604358,2,2,0,0,0,2,4,173,2.0,2.0,0.0,0.0,0.0,2.0,2.0,5,2,3,2.0,1.0,1.0
8189,9,5,4,5,3,6,29,33,1.0,1.0,0.0,0.0,0.0,1.0,7.0,41,9,32,3.0,3.0,0.0
9808227,4,4,0,0,1,3,10,95,2.0,2.0,0.0,0.0,0.0,2.0,2.0,14,4,10,1.0,1.0,0.0
108029,1,1,0,0,0,1,14,2,1.0,1.0,0.0,0.0,0.0,1.0,2.0,15,1,14,3.0,1.0,2.0
201118,0,0,0,0,0,0,0,78,0.0,0.0,0.0,0.0,0.0,0.0,0.0,19,0,19,10.0,0.0,10.0
9806337,9,4,5,9,1,8,16,162,3.0,2.0,1.0,2.0,1.0,2.0,6.0,22,9,13,6.0,1.0,5.0
107087,3,2,1,1,0,3,10,129,3.0,2.0,1.0,1.0,1.0,2.0,4.0,8,3,5,3.0,2.0,1.0
5215,3,2,1,1,0,3,8,277,3.0,2.0,1.0,1.0,0.0,3.0,8.0,7,3,4,5.0,1.0,4.0
9410371,0,0,0,0,0,0,0,119,,,,,,,,1,0,1,,,
9512409,2,1,1,1,1,1,2,133,0.0,0.0,0.0,0.0,0.0,0.0,0.0,6,2,4,,,
204150,4,3,1,1,0,4,25,8,1.0,1.0,0.0,0.0,0.0,1.0,4.0,22,4,18,8.0,2.0,6.0
207293,0,0,0,0,0,0,0,5,0.0,0.0,0.0,0.0,0.0,0.0,0.0,13,0,13,,,
9603445,3,1,2,3,0,3,9,162,3.0,1.0,2.0,3.0,0.0,3.0,5.0,7,3,4,5.0,3.0,2.0
109091,2,2,0,0,0,2,7,7,0.0,0.0,0.0,0.0,0.0,0.0,0.0,27,2,25,7.0,1.0,6.0
9804408,3,2,1,1,0,3,8,421,3.0,2.0,1.0,1.0,0.0,3.0,3.0,8,3,5,4.0,3.0,1.0
209051,3,1,2,2,0,3,27,21,3.0,1.0,2.0,2.0,0.0,3.0,21.0,14,3,11,11.0,3.0,8.0
9907217,0,0,0,0,0,0,0,637,0.0,0.0,0.0,0.0,0.0,0.0,0.0,3,0,3,1.0,0.0,1.0
9503311,7,5,2,4,2,5,13,71,6.0,4.0,2.0,4.0,3.0,3.0,5.0,14,7,7,6.0,3.0,3.0
9407335,2,2,0,0,2,0,0,563,2.0,2.0,0.0,0.0,2.0,0.0,0.0,2,2,0,2.0,2.0,0.0
9706258,9,4,5,12,3,6,9,90,7.0,2.0,5.0,12.0,3.0,4.0,4.0,14,9,5,5.0,5.0,0.0
111296,3,2,1,1,0,3,10,144,2.0,1.0,1.0,1.0,0.0,2.0,4.0,15,3,12,5.0,2.0,3.0
3205,4,4,0,0,0,4,14,41,3.0,3.0,0.0,0.0,0.0,3.0,9.0,23,4,19,7.0,1.0,6.0
9808318,0,0,0,0,0,0,0,303,0.0,0.0,0.0,0.0,0.0,0.0,0.0,16,0,16,2.0,0.0,2.0
9909327,2,1,1,1,0,2,6,53,2.0,1.0,1.0,1.0,0.0,2.0,4.0,21,2,19,3.0,0.0,3.0
9703300,4,2,2,2,1,3,5,17,3.0,1.0,2.0,2.0,3.0,0.0,0.0,14,4,10,3.0,3.0,0.0
101057,5,5,0,0,0,5,20,27,5.0,5.0,0.0,0.0,0.0,5.0,18.0,34,5,29,8.0,0.0,8.0
9506224,1,1,0,0,1,0,0,443,1.0,1.0,0.0,0.0,1.0,0.0,0.0,3,1,2,2.0,1.0,1.0
9505415,1,1,0,0,1,0,0,15,0.0,0.0,0.0,0.0,0.0,0.0,0.0,10,1,9,1.0,0.0,1.0
202277,6,3,3,4,0,6,19,65,4.0,2.0,2.0,3.0,0.0,4.0,14.0,17,6,11,5.0,3.0,2.0
9303240,1,1,0,0,1,0,0,1664,0.0,0.0,0.0,0.0,0.0,0.0,0.0,3,1,2,,,
4165,2,2,0,0,0,2,3,136,2.0,2.0,0.0,0.0,0.0,2.0,3.0,12,2,10,3.0,0.0,3.0
9409257,2,2,0,0,2,0,0,354,1.0,1.0,0.0,0.0,1.0,0.0,0.0,2,2,0,1.0,1.0,0.0
9610332,2,2,0,0,0,2,11,115,2.0,2.0,0.0,0.0,0.0,2.0,8.0,10,2,8,1.0,0.0,1.0
205010,3,3,0,0,0,3,21,37,1.0,1.0,0.0,0.0,0.0,1.0,3.0,31,3,28,7.0,0.0,7.0
204257,1,1,0,0,0,1,1,70,,,,,,,,4,1,3,1.0,1.0,0.0
9905357,2,2,0,0,2,0,0,181,1.0,1.0,0.0,0.0,1.0,0.0,0.0,2,2,0,1.0,1.0,0.0
9311203,1,1,0,0,1,0,0,96,1.0,1.0,0.0,0.0,1.0,0.0,0.0,1,1,0,1.0,1.0,0.0
102031,0,0,0,0,0,0,0,442,0.0,0.0,0.0,0.0,0.0,0.0,0.0,2,0,2,2.0,0.0,2.0
9610486,2,1,1,1,0,2,2,76,0.0,0.0,0.0,0.0,0.0,0.0,0.0,6,2,4,3.0,2.0,1.0
106305,1,1,0,0,0,1,4,8,1.0,1.0,0.0,0.0,0.0,1.0,4.0,8,1,7,6.0,1.0,5.0
9602298,1,1,0,0,0,1,3,195,1.0,1.0,0.0,0.0,0.0,1.0,3.0,5,1,4,3.0,1.0,2.0
204075,1,1,0,0,1,0,0,121,0.0,0.0,0.0,0.0,0.0,0.0,0.0,14,1,13,3.0,0.0,3.0
212062,0,0,0,0,0,0,0,180,0.0,0.0,0.0,0.0,0.0,0.0,0.0,4,0,4,4.0,0.0,4.0
9705291,5,1,4,6,2,3,5,130,1.0,1.0,0.0,0.0,1.0,0.0,0.0,7,5,2,2.0,2.0,0.0
110330,0,0,0,0,0,0,0,5,0.0,0.0,0.0,0.0,0.0,0.0,0.0,6,0,6,,,
302146,0,0,0,0,0,0,0,106,0.0,0.0,0.0,0.0,0.0,0.0,0.0,9,0,9,5.0,0.0,5.0
206177,3,3,0,0,0,3,9,46,0.0,0.0,0.0,0.0,0.0,0.0,0.0,14,3,11,1.0,0.0,1.0
9705385,1,1,0,0,0,1,3,43,0.0,0.0,0.0,0.0,0.0,0.0,0.0,12,1,11,1.0,0.0,1.0
9911539,2,2,0,0,0,2,3,36,0.0,0.0,0.0,0.0,0.0,0.0,0.0,28,2,26,3.0,0.0,3.0
9710464,2,1,1,1,0,2,4,145,2.0,1.0,1.0,1.0,0.0,2.0,2.0,6,2,4,3.0,2.0,1.0
103056,3,2,1,2,0,3,28,44,1.0,1.0,0.0,0.0,0.0,1.0,5.0,18,3,15,13.0,3.0,10.0
9709207,3,1,2,3,0,3,15,30,3.0,1.0,2.0,3.0,0.0,3.0,11.0,14,3,11,7.0,3.0,4.0
9503371,0,0,0,0,0,0,0,152,0.0,0.0,0.0,0.0,0.0,0.0,0.0,2,0,2,1.0,0.0,1.0
212095,0,0,0,0,0,0,0,1,0.0,0.0,0.0,0.0,0.0,0.0,0.0,19,0,19,12.0,0.0,12.0
9212223,2,1,1,1,2,0,0,63,2.0,1.0,1.0,1.0,2.0,0.0,0.0,2,2,0,,,
9401230,1,1,0,0,1,0,0,89,1.0,1.0,0.0,0.0,1.0,0.0,0.0,2,1,1,1.0,1.0,0.0
9604268,2,1,1,1,0,2,2,72,2.0,1.0,1.0,1.0,0.0,2.0,2.0,4,2,2,2.0,1.0,1.0
9909492,2,2,0,0,0,2,7,29,1.0,1.0,0.0,0.0,0.0,1.0,2.0,8,2,6,2.0,0.0,2.0
9309229,1,1,0,0,1,0,0,728,1.0,1.0,0.0,0.0,1.0,0.0,0.0,2,1,1,1.0,1.0,0.0
8305,2,1,1,1,0,2,4,159,2.0,1.0,1.0,1.0,0.0,2.0,4.0,10,2,8,4.0,2.0,2.0
209173,4,3,1,1,0,4,43,37,3.0,2.0,1.0,1.0,0.0,3.0,22.0,35,4,31,10.0,0.0,10.0
205074,2,1,1,1,2,0,0,14,0.0,0.0,0.0,0.0,0.0,0.0,0.0,11,2,9,9.0,0.0,9.0
112046,2,2,0,0,2,0,0,121,,,,,,,,5,2,3,,,
102075,10,7,3,5,0,10,49,18,5.0,3.0,2.0,3.0,0.0,5.0,21.0,36,10,26,4.0,3.0,1.0
9611384,0,0,0,0,0,0,0,84,0.0,0.0,0.0,0.0,0.0,0.0,0.0,5,0,5,,,
9802213,2,2,0,0,1,1,3,204,1.0,1.0,0.0,0.0,0.0,1.0,3.0,18,2,16,5.0,1.0,4.0
207287,6,3,3,4,0,6,99,11,5.0,2.0,3.0,4.0,0.0,5.0,63.0,45,6,39,21.0,5.0,16.0
9802355,1,1,0,0,0,1,2,5,0.0,0.0,0.0,0.0,0.0,0.0,0.0,59,1,58,7.0,0.0,7.0
206221,5,1,4,9,0,5,85,66,5.0,1.0,4.0,9.0,0.0,5.0,50.0,35,5,30,17.0,5.0,12.0
9912309,0,0,0,0,0,0,0,116,0.0,0.0,0.0,0.0,0.0,0.0,0.0,16,0,16,7.0,0.0,7.0
9912487,2,1,1,1,2,0,0,258,0.0,0.0,0.0,0.0,0.0,0.0,0.0,7,2,5,4.0,0.0,4.0
2131,2,1,1,1,1,1,10,7,0.0,0.0,0.0,0.0,0.0,0.0,0.0,16,2,14,1.0,0.0,1.0
9409288,1,1,0,0,1,0,0,422,1.0,1.0,0.0,0.0,1.0,0.0,0.0,2,1,1,1.0,0.0,1.0
9908239,0,0,0,0,0,0,0,99,,,,,,,,2,0,2,,,
111031,1,1,0,0,0,1,6,14,0.0,0.0,0.0,0.0,0.0,0.0,0.0,21,1,20,6.0,0.0,6.0
2085,2,1,1,1,2,0,0,184,2.0,1.0,1.0,1.0,2.0,0.0,0.0,3,2,1,2.0,2.0,0.0
9405213,1,1,0,0,1,0,0,273,1.0,1.0,0.0,0.0,1.0,0.0,0.0,1,1,0,1.0,1.0,0.0
102079,3,3,0,0,0,3,12,3,0.0,0.0,0.0,0.0,0.0,0.0,0.0,47,3,44,8.0,1.0,7.0
9508392,2,2,0,0,0,2,2,1756,1.0,1.0,0.0,0.0,1.0,0.0,0.0,6,2,4,1.0,1.0,0.0
203231,2,2,0,0,1,1,1,251,0.0,0.0,0.0,0.0,0.0,0.0,0.0,10,2,8,1.0,1.0,0.0
112142,2,2,0,0,1,1,4,30,0.0,0.0,0.0,0.0,0.0,0.0,0.0,27,2,25,7.0,1.0,6.0
9711468,1,1,0,0,1,0,0,93,0.0,0.0,0.0,0.0,0.0,0.0,0.0,7,1,6,1.0,0.0,1.0
9409205,0,0,0,0,0,0,0,236,0.0,0.0,0.0,0.0,0.0,0.0,0.0,2,0,2,,,
9909370,3,3,0,0,0,3,5,152,1.0,1.0,0.0,0.0,0.0,1.0,1.0,5,3,2,2.0,1.0,1.0
9505316,1,1,0,0,1,0,0,1846,1.0,1.0,0.0,0.0,1.0,0.0,0.0,2,1,1,1.0,0.0,1.0
208003,2,2,0,0,1,1,12,46,1.0,1.0,0.0,0.0,0.0,1.0,8.0,27,2,25,2.0,0.0,2.0
210312,0,0,0,0,0,0,0,71,0.0,0.0,0.0,0.0,0.0,0.0,0.0,5,0,5,1.0,0.0,1.0
9603211,3,1,2,2,2,1,1,388,3.0,1.0,2.0,2.0,2.0,1.0,1.0,4,3,1,4.0,3.0,1.0
5244,1,1,0,0,0,1,3,0,0.0,0.0,0.0,0.0,0.0,0.0,0.0,24,1,23,7.0,0.0,7.0
7132,2,2,0,0,0,2,16,267,2.0,2.0,0.0,0.0,0.0,2.0,10.0,14,2,12,7.0,2.0,5.0
9804324,0,0,0,0,0,0,0,79,0.0,0.0,0.0,0.0,0.0,0.0,0.0,27,0,27,8.0,0.0,8.0
8149,0,0,0,0,0,0,0,77,0.0,0.0,0.0,0.0,0.0,0.0,0.0,4,0,4,,,
101247,2,2,0,0,2,0,0,31,0.0,0.0,0.0,0.0,0.0,0.0,0.0,10,2,8,2.0,0.0,2.0
110185,1,1,0,0,1,0,0,65,0.0,0.0,0.0,0.0,0.0,0.0,0.0,10,1,9,2.0,0.0,2.0
101074,1,1,0,0,0,1,5,119,1.0,1.0,0.0,0.0,0.0,1.0,1.0,21,1,20,1.0,0.0,1.0
9803283,5,2,3,6,0,5,33,115,5.0,2.0,3.0,6.0,0.0,5.0,27.0,30,5,25,12.0,5.0,7.0
7131,3,3,0,0,1,2,10,240,1.0,1.0,0.0,0.0,0.0,1.0,4.0,18,3,15,6.0,1.0,5.0
9402346,1,1,0,0,1,0,0,458,1.0,1.0,0.0,0.0,1.0,0.0,0.0,1,1,0,1.0,1.0,0.0
9809225,1,1,0,0,0,1,3,38,1.0,1.0,0.0,0.0,1.0,0.0,0.0,4,1,3,1.0,1.0,0.0
108184,0,0,0,0,0,0,0,12,0.0,0.0,0.0,0.0,0.0,0.0,0.0,12,0,12,10.0,0.0,10.0
9609208,0,0,0,0,0,0,0,370,0.0,0.0,0.0,0.0,0.0,0.0,0.0,9,0,9,3.0,0.0,3.0
207103,0,0,0,0,0,0,0,9,,,,,,,,7,0,7,1.0,0.0,1.0
9906201,1,1,0,0,1,0,0,54,0.0,0.0,0.0,0.0,0.0,0.0,0.0,4,1,3,2.0,0.0,2.0
209161,6,3,3,3,1,5,18,45,3.0,2.0,1.0,1.0,1.0,2.0,6.0,18,6,12,3.0,2.0,1.0
112180,3,1,2,2,0,3,22,45,3.0,1.0,2.0,2.0,0.0,3.0,18.0,15,3,12,6.0,3.0,3.0
205239,2,2,0,0,0,2,29,7,1.0,1.0,0.0,0.0,0.0,1.0,13.0,41,2,39,15.0,1.0,14.0
211138,2,2,0,0,0,2,2,55,,,,,,,,8,2,6,1.0,1.0,0.0
9805325,2,2,0,0,1,1,9,115,1.0,1.0,0.0,0.0,0.0,1.0,9.0,19,2,17,9.0,1.0,8.0
211050,1,1,0,0,0,1,1,27,0.0,0.0,0.0,0.0,0.0,0.0,0.0,15,1,14,10.0,0.0,10.0
101198,0,0,0,0,0,0,0,135,0.0,0.0,0.0,0.0,0.0,0.0,0.0,14,0,14,11.0,0.0,11.0
9704302,0,0,0,0,0,0,0,5,0.0,0.0,0.0,0.0,0.0,0.0,0.0,7,0,7,,,
9507308,1,1,0,0,0,1,1,153,1.0,1.0,0.0,0.0,0.0,1.0,1.0,3,1,2,1.0,1.0,0.0
212384,1,1,0,0,0,1,15,37,1.0,1.0,0.0,0.0,0.0,1.0,15.0,43,1,42,31.0,1.0,30.0
302188,0,0,0,0,0,0,0,37,0.0,0.0,0.0,0.0,0.0,0.0,0.0,25,0,25,11.0,0.0,11.0
9912392,1,1,0,0,1,0,0,160,0.0,0.0,0.0,0.0,0.0,0.0,0.0,4,1,3,3.0,0.0,3.0
9904467,2,2,0,0,0,2,3,70,0.0,0.0,0.0,0.0,0.0,0.0,0.0,15,2,13,12.0,0.0,12.0
9310251,0,0,0,0,0,0,0,816,,,,,,,,1,0,1,,,
9606341,0,0,0,0,0,0,0,231,0.0,0.0,0.0,0.0,0.0,0.0,0.0,4,0,4,1.0,0.0,1.0
202217,1,1,0,0,0,1,8,79,1.0,1.0,0.0,0.0,0.0,1.0,6.0,11,1,10,5.0,1.0,4.0
212390,0,0,0,0,0,0,0,35,0.0,0.0,0.0,0.0,0.0,0.0,0.0,6,0,6,1.0,0.0,1.0
302207,0,0,0,0,0,0,0,7,0.0,0.0,0.0,0.0,0.0,0.0,0.0,18,0,18,8.0,0.0,8.0
210326,0,0,0,0,0,0,0,55,0.0,0.0,0.0,0.0,0.0,0.0,0.0,27,0,27,9.0,0.0,9.0
9411223,0,0,0,0,0,0,0,93,0.0,0.0,0.0,0.0,0.0,0.0,0.0,7,0,7,6.0,0.0,6.0
9404320,0,0,0,0,0,0,0,199,0.0,0.0,0.0,0.0,0.0,0.0,0.0,1,0,1,,,
4011,1,1,0,0,0,1,2,83,0.0,0.0,0.0,0.0,0.0,0.0,0.0,15,1,14,3.0,0.0,3.0
9902333,0,0,0,0,0,0,0,30,0.0,0.0,0.0,0.0,0.0,0.0,0.0,11,0,11,11.0,0.0,11.0
211336,1,1,0,0,0,1,3,226,1.0,1.0,0.0,0.0,0.0,1.0,2.0,15,1,14,6.0,1.0,5.0
107108,4,1,3,6,0,4,24,66,4.0,1.0,3.0,6.0,0.0,4.0,13.0,16,4,12,7.0,4.0,3.0
9049,1,1,0,0,0,1,1,344,1.0,1.0,0.0,0.0,0.0,1.0,1.0,2,1,1,1.0,1.0,0.0
211386,1,1,0,0,0,1,8,9,0.0,0.0,0.0,0.0,0.0,0.0,0.0,24,1,23,5.0,0.0,5.0
6180,2,2,0,0,2,0,0,438,1.0,1.0,0.0,0.0,1.0,0.0,0.0,6,2,4,1.0,1.0,0.0
203125,0,0,0,0,0,0,0,25,0.0,0.0,0.0,0.0,0.0,0.0,0.0,15,0,15,8.0,0.0,8.0
209338,0,0,0,0,0,0,0,63,0.0,0.0,0.0,0.0,0.0,0.0,0.0,16,0,16,4.0,0.0,4.0
209054,1,1,0,0,0,1,6,27,1.0,1.0,0.0,0.0,0.0,1.0,6.0,14,1,13,8.0,1.0,7.0
108146,1,1,0,0,0,1,3,18,0.0,0.0,0.0,0.0,0.0,0.0,0.0,15,1,14,3.0,0.0,3.0
101125,3,1,2,3,0,3,3,375,3.0,1.0,2.0,3.0,0.0,3.0,3.0,4,3,1,4.0,3.0,1.0
9607209,3,2,1,1,3,0,0,266,3.0,2.0,1.0,1.0,3.0,0.0,0.0,6,3,3,2.0,0.0,2.0
1026,1,1,0,0,0,1,3,21,1.0,1.0,0.0,0.0,1.0,0.0,0.0,11,1,10,1.0,1.0,0.0
2219,0,0,0,0,0,0,0,534,0.0,0.0,0.0,0.0,0.0,0.0,0.0,5,0,5,4.0,0.0,4.0
208107,0,0,0,0,0,0,0,37,0.0,0.0,0.0,0.0,0.0,0.0,0.0,20,0,20,11.0,0.0,11.0
207030,2,2,0,0,0,2,17,48,1.0,1.0,0.0,0.0,0.0,1.0,7.0,31,2,29,9.0,1.0,8.0
106062,0,0,0,0,0,0,0,130,0.0,0.0,0.0,0.0,0.0,0.0,0.0,15,0,15,7.0,0.0,7.0
9811398,1,1,0,0,1,0,0,891,1.0,1.0,0.0,0.0,1.0,0.0,0.0,2,1,1,1.0,1.0,0.0
9612423,0,0,0,0,0,0,0,1115,,,,,,,,2,0,2,1.0,0.0,1.0
9501353,0,0,0,0,0,0,0,10,0.0,0.0,0.0,0.0,0.0,0.0,0.0,19,0,19,6.0,0.0,6.0
302160,0,0,0,0,0,0,0,415,0.0,0.0,0.0,0.0,0.0,0.0,0.0,4,0,4,1.0,0.0,1.0
9909274,1,1,0,0,0,1,2,8,0.0,0.0,0.0,0.0,0.0,0.0,0.0,10,1,9,3.0,0.0,3.0
9407316,0,0,0,0,0,0,0,15,0.0,0.0,0.0,0.0,0.0,0.0,0.0,8,0,8,1.0,0.0,1.0
9612368,0,0,0,0,0,0,0,117,,,,,,,,3,0,3,1.0,0.0,1.0
9709324,1,1,0,0,0,1,3,36,1.0,1.0,0.0,0.0,0.0,1.0,3.0,27,1,26,2.0,1.0,1.0
9711511,0,0,0,0,0,0,0,33,0.0,0.0,0.0,0.0,0.0,0.0,0.0,61,0,61,16.0,0.0,16.0
9310308,0,0,0,0,0,0,0,304,0.0,0.0,0.0,0.0,0.0,0.0,0.0,4,0,4,1.0,0.0,1.0
9805328,0,0,0,0,0,0,0,36,0.0,0.0,0.0,0.0,0.0,0.0,0.0,30,0,30,5.0,0.0,5.0
6163,3,3,0,0,0,3,6,156,1.0,1.0,0.0,0.0,0.0,1.0,2.0,6,3,3,2.0,2.0,0.0
9511346,0,0,0,0,0,0,0,217,0.0,0.0,0.0,0.0,0.0,0.0,0.0,3,0,3,1.0,0.0,1.0
9211295,1,1,0,0,1,0,0,796,1.0,1.0,0.0,0.0,1.0,0.0,0.0,1,1,0,1.0,1.0,0.0
207311,1,1,0,0,0,1,5,252,1.0,1.0,0.0,0.0,0.0,1.0,2.0,12,1,11,3.0,1.0,2.0
201060,0,0,0,0,0,0,0,357,0.0,0.0,0.0,0.0,0.0,0.0,0.0,10,0,10,6.0,0.0,6.0
9403228,2,2,0,0,0,2,2,78,2.0,2.0,0.0,0.0,0.0,2.0,2.0,5,2,3,1.0,1.0,0.0
205330,1,1,0,0,0,1,8,51,1.0,1.0,0.0,0.0,0.0,1.0,1.0,28,1,27,7.0,0.0,7.0
9901355,0,0,0,0,0,0,0,922,0.0,0.0,0.0,0.0,0.0,0.0,0.0,2,0,2,,,
9711230,1,1,0,0,1,0,0,274,0.0,0.0,0.0,0.0,0.0,0.0,0.0,3,1,2,1.0,0.0,1.0
9410291,0,0,0,0,0,0,0,466,0.0,0.0,0.0,0.0,0.0,0.0,0.0,2,0,2,1.0,0.0,1.0
302230,0,0,0,0,0,0,0,0,0.0,0.0,0.0,0.0,0.0,0.0,0.0,9,0,9,1.0,0.0,1.0
302172,0,0,0,0,0,0,0,573,0.0,0.0,0.0,0.0,0.0,0.0,0.0,2,0,2,2.0,0.0,2.0
104026,0,0,0,0,0,0,0,6,0.0,0.0,0.0,0.0,0.0,0.0,0.0,24,0,24,4.0,0.0,4.0
9705443,0,0,0,0,0,0,0,14,0.0,0.0,0.0,0.0,0.0,0.0,0.0,9,0,9,2.0,0.0,2.0
9912468,1,1,0,0,1,0,0,1940,1.0,1.0,0.0,0.0,1.0,0.0,0.0,1,1,0,,,
6236,1,1,0,0,0,1,1,64,,,,,,,,2,1,1,,,
301229,0,0,0,0,0,0,0,38,0.0,0.0,0.0,0.0,0.0,0.0,0.0,15,0,15,12.0,0.0,12.0
9908209,1,1,0,0,1,0,0,415,1.0,1.0,0.0,0.0,1.0,0.0,0.0,7,1,6,2.0,1.0,1.0
112268,3,3,0,0,0,3,21,9,3.0,3.0,0.0,0.0,0.0,3.0,6.0,25,3,22,7.0,2.0,5.0
105337,1,1,0,0,1,0,0,113,1.0,1.0,0.0,0.0,1.0,0.0,0.0,8,1,7,6.0,0.0,6.0
302186,0,0,0,0,0,0,0,12,0.0,0.0,0.0,0.0,0.0,0.0,0.0,16,0,16,1.0,0.0,1.0
206179,1,1,0,0,0,1,10,51,1.0,1.0,0.0,0.0,0.0,1.0,7.0,16,1,15,9.0,1.0,8.0
9806463,0,0,0,0,0,0,0,380,0.0,0.0,0.0,0.0,0.0,0.0,0.0,4,0,4,,,
9712412,1,1,0,0,1,0,0,92,1.0,1.0,0.0,0.0,1.0,0.0,0.0,4,1,3,,,
9704340,0,0,0,0,0,0,0,156,,,,,,,,1,0,1,,,
104234,0,0,0,0,0,0,0,1954,0.0,0.0,0.0,0.0,0.0,0.0,0.0,2,0,2,2.0,0.0,2.0
9811503,0,0,0,0,0,0,0,201,0.0,0.0,0.0,0.0,0.0,0.0,0.0,8,0,8,5.0,0.0,5.0
4231,0,0,0,0,0,0,0,324,0.0,0.0,0.0,0.0,0.0,0.0,0.0,2,0,2,2.0,0.0,2.0
9904212,0,0,0,0,0,0,0,327,0.0,0.0,0.0,0.0,0.0,0.0,0.0,2,0,2,1.0,0.0,1.0
211376,0,0,0,0,0,0,0,109,0.0,0.0,0.0,0.0,0.0,0.0,0.0,11,0,11,1.0,0.0,1.0
210068,0,0,0,0,0,0,0,9,0.0,0.0,0.0,0.0,0.0,0.0,0.0,15,0,15,4.0,0.0,4.0
9907242,0,0,0,0,0,0,0,163,0.0,0.0,0.0,0.0,0.0,0.0,0.0,2,0,2,,,
9410221,2,2,0,0,2,0,0,180,2.0,2.0,0.0,0.0,2.0,0.0,0.0,2,2,0,,,
11320,3,2,1,1,0,3,14,76,3.0,2.0,1.0,1.0,0.0,3.0,14.0,15,3,12,11.0,2.0,9.0
209242,1,1,0,0,0,1,8,127,1.0,1.0,0.0,0.0,0.0,1.0,7.0,19,1,18,14.0,1.0,13.0
4202,0,0,0,0,0,0,0,96,0.0,0.0,0.0,0.0,0.0,0.0,0.0,8,0,8,2.0,0.0,2.0
102148,0,0,0,0,0,0,0,76,0.0,0.0,0.0,0.0,0.0,0.0,0.0,6,0,6,2.0,0.0,2.0
211191,0,0,0,0,0,0,0,105,0.0,0.0,0.0,0.0,0.0,0.0,0.0,22,0,22,7.0,0.0,7.0
9812453,1,1,0,0,0,1,4,216,1.0,1.0,0.0,0.0,0.0,1.0,3.0,7,1,6,3.0,1.0,2.0
9910504,0,0,0,0,0,0,0,87,0.0,0.0,0.0,0.0,0.0,0.0,0.0,18,0,18,16.0,0.0,16.0
10226,0,0,0,0,0,0,0,149,0.0,0.0,0.0,0.0,0.0,0.0,0.0,5,0,5,3.0,0.0,3.0
201046,1,1,0,0,0,1,2,18,1.0,1.0,0.0,0.0,0.0,1.0,2.0,24,1,23,10.0,0.0,10.0
9903311,0,0,0,0,0,0,0,78,0.0,0.0,0.0,0.0,0.0,0.0,0.0,4,0,4,1.0,0.0,1.0
9910439,0,0,0,0,0,0,0,1,0.0,0.0,0.0,0.0,0.0,0.0,0.0,13,0,13,10.0,0.0,10.0
10084,0,0,0,0,0,0,0,113,0.0,0.0,0.0,0.0,0.0,0.0,0.0,1,0,1,,,
207115,0,0,0,0,0,0,0,205,0.0,0.0,0.0,0.0,0.0,0.0,0.0,7,0,7,3.0,0.0,3.0
9901248,3,2,1,1,2,1,1,142,1.0,1.0,0.0,0.0,0.0,1.0,1.0,9,3,6,3.0,3.0,0.0
109289,1,1,0,0,0,1,3,117,0.0,0.0,0.0,0.0,0.0,0.0,0.0,20,1,19,5.0,0.0,5.0
212299,1,1,0,0,0,1,10,67,0.0,0.0,0.0,0.0,0.0,0.0,0.0,22,1,21,7.0,1.0,6.0
9801302,1,1,0,0,0,1,2,57,0.0,0.0,0.0,0.0,0.0,0.0,0.0,11,1,10,2.0,0.0,2.0
9609508,0,0,0,0,0,0,0,61,,,,,,,,2,0,2,,,
211119,1,1,0,0,1,0,0,88,0.0,0.0,0.0,0.0,0.0,0.0,0.0,10,1,9,4.0,0.0,4.0
9198,1,1,0,0,0,1,3,144,1.0,1.0,0.0,0.0,0.0,1.0,3.0,4,1,3,3.0,1.0,2.0
211172,1,1,0,0,1,0,0,1505,,,,,,,,1,1,0,,,
108263,1,1,0,0,0,1,11,9,1.0,1.0,0.0,0.0,0.0,1.0,10.0,18,1,17,4.0,1.0,3.0
109011,1,1,0,0,0,1,1,463,1.0,1.0,0.0,0.0,0.0,1.0,1.0,4,1,3,2.0,1.0,1.0
9910266,0,0,0,0,0,0,0,9,0.0,0.0,0.0,0.0,0.0,0.0,0.0,12,0,12,6.0,0.0,6.0
206234,0,0,0,0,0,0,0,468,0.0,0.0,0.0,0.0,0.0,0.0,0.0,5,0,5,3.0,0.0,3.0
9305316,0,0,0,0,0,0,0,75,0.0,0.0,0.0,0.0,0.0,0.0,0.0,11,0,11,1.0,0.0,1.0
106338,3,3,0,0,2,1,9,21,1.0,1.0,0.0,0.0,0.0,1.0,8.0,33,3,30,8.0,0.0,8.0
9906464,0,0,0,0,0,0,0,127,0.0,0.0,0.0,0.0,0.0,0.0,0.0,8,0,8,6.0,0.0,6.0
9212269,0,0,0,0,0,0,0,1511,,,,,,,,1,0,1,,,
9906458,0,0,0,0,0,0,0,158,,,,,,,,1,0,1,,,
9501235,0,0,0,0,0,0,0,44,0.0,0.0,0.0,0.0,0.0,0.0,0.0,3,0,3,1.0,0.0,1.0
9511354,0,0,0,0,0,0,0,1512,0.0,0.0,0.0,0.0,0.0,0.0,0.0,1,0,1,1.0,0.0,1.0
103241,1,1,0,0,0,1,3,24,0.0,0.0,0.0,0.0,0.0,0.0,0.0,8,1,7,,,
4218,0,0,0,0,0,0,0,1814,,,,,,,,1,0,1,,,
109263,0,0,0,0,0,0,0,503,0.0,0.0,0.0,0.0,0.0,0.0,0.0,10,0,10,3.0,0.0,3.0
9604348,0,0,0,0,0,0,0,208,0.0,0.0,0.0,0.0,0.0,0.0,0.0,1,0,1,,,
112290,1,1,0,0,0,1,3,228,1.0,1.0,0.0,0.0,0.0,1.0,2.0,4,1,3,4.0,1.0,3.0
7324,0,0,0,0,0,0,0,434,0.0,0.0,0.0,0.0,0.0,0.0,0.0,1,0,1,1.0,0.0,1.0
102043,0,0,0,0,0,0,0,15,0.0,0.0,0.0,0.0,0.0,0.0,0.0,46,0,46,16.0,0.0,16.0
302259,0,0,0,0,0,0,0,102,0.0,0.0,0.0,0.0,0.0,0.0,0.0,25,0,25,8.0,0.0,8.0
3171,0,0,0,0,0,0,0,128,,,,,,,,6,0,6,1.0,0.0,1.0
9911335,1,1,0,0,0,1,2,80,1.0,1.0,0.0,0.0,0.0,1.0,2.0,5,1,4,1.0,1.0,0.0
9094,0,0,0,0,0,0,0,330,0.0,0.0,0.0,0.0,0.0,0.0,0.0,18,0,18,5.0,0.0,5.0
9812424,2,2,0,0,0,2,4,31,0.0,0.0,0.0,0.0,0.0,0.0,0.0,7,2,5,1.0,1.0,0.0
12375,2,1,1,1,0,2,8,21,2.0,1.0,1.0,1.0,0.0,2.0,8.0,14,2,12,3.0,2.0,1.0
110065,0,0,0,0,0,0,0,112,,,,,,,,2,0,2,2.0,0.0,2.0
9910511,0,0,0,0,0,0,0,14,0.0,0.0,0.0,0.0,0.0,0.0,0.0,6,0,6,4.0,0.0,4.0
208232,0,0,0,0,0,0,0,106,0.0,0.0,0.0,0.0,0.0,0.0,0.0,5,0,5,3.0,0.0,3.0
9901396,4,2,2,3,0,4,10,125,4.0,2.0,2.0,3.0,0.0,4.0,10.0,8,4,4,8.0,4.0,4.0
9912347,0,0,0,0,0,0,0,156,0.0,0.0,0.0,0.0,0.0,0.0,0.0,2,0,2,,,
201158,0,0,0,0,0,0,0,35,0.0,0.0,0.0,0.0,0.0,0.0,0.0,22,0,22,10.0,0.0,10.0
9708289,0,0,0,0,0,0,0,198,0.0,0.0,0.0,0.0,0.0,0.0,0.0,1,0,1,1.0,0.0,1.0
9701319,0,0,0,0,0,0,0,293,0.0,0.0,0.0,0.0,0.0,0.0,0.0,16,0,16,1.0,0.0,1.0
211398,0,0,0,0,0,0,0,19,,,,,,,,9,0,9,7.0,0.0,7.0
9610386,0,0,0,0,0,0,0,115,0.0,0.0,0.0,0.0,0.0,0.0,0.0,7,0,7,5.0,0.0,5.0
211429,0,0,0,0,0,0,0,247,0.0,0.0,0.0,0.0,0.0,0.0,0.0,7,0,7,1.0,0.0,1.0
6194,2,1,1,1,1,1,2,150,1.0,1.0,0.0,0.0,1.0,0.0,0.0,6,2,4,1.0,1.0,0.0
212268,0,0,0,0,0,0,0,22,0.0,0.0,0.0,0.0,0.0,0.0,0.0,14,0,14,9.0,0.0,9.0
301171,2,2,0,0,0,2,8,2,1.0,1.0,0.0,0.0,0.0,1.0,6.0,27,2,25,11.0,1.0,10.0
9808382,2,1,1,1,0,2,4,246,2.0,1.0,1.0,1.0,0.0,2.0,4.0,5,2,3,5.0,2.0,3.0
212159,0,0,0,0,0,0,0,66,0.0,0.0,0.0,0.0,0.0,0.0,0.0,28,0,28,11.0,0.0,11.0
107196,1,1,0,0,0,1,7,195,1.0,1.0,0.0,0.0,0.0,1.0,3.0,13,1,12,4.0,1.0,3.0
9609489,0,0,0,0,0,0,0,105,0.0,0.0,0.0,0.0,0.0,0.0,0.0,5,0,5,,,
109266,0,0,0,0,0,0,0,135,0.0,0.0,0.0,0.0,0.0,0.0,0.0,4,0,4,1.0,0.0,1.0
203039,0,0,0,0,0,0,0,50,0.0,0.0,0.0,0.0,0.0,0.0,0.0,14,0,14,2.0,0.0,2.0
9906306,0,0,0,0,0,0,0,17,0.0,0.0,0.0,0.0,0.0,0.0,0.0,31,0,31,2.0,0.0,2.0
9603332,0,0,0,0,0,0,0,53,0.0,0.0,0.0,0.0,0.0,0.0,0.0,7,0,7,2.0,0.0,2.0
9211218,0,0,0,0,0,0,0,1507,,,,,,,,1,0,1,,,
10023,1,1,0,0,0,1,3,408,1.0,1.0,0.0,0.0,0.0,1.0,2.0,4,1,3,3.0,1.0,2.0
104156,0,0,0,0,0,0,0,32,0.0,0.0,0.0,0.0,0.0,0.0,0.0,24,0,24,4.0,0.0,4.0
301147,0,0,0,0,0,0,0,101,0.0,0.0,0.0,0.0,0.0,0.0,0.0,11,0,11,1.0,0.0,1.0
1094,0,0,0,0,0,0,0,68,0.0,0.0,0.0,0.0,0.0,0.0,0.0,12,0,12,8.0,0.0,8.0
9406336,0,0,0,0,0,0,0,102,,,,,,,,2,0,2,,,
9908285,0,0,0,0,0,0,0,196,,,,,,,,3,0,3,,,
9708322,0,0,0,0,0,0,0,15,0.0,0.0,0.0,0.0,0.0,0.0,0.0,23,0,23,4.0,0.0,4.0
104298,2,2,0,0,2,0,0,361,2.0,2.0,0.0,0.0,2.0,0.0,0.0,2,2,0,1.0,1.0,0.0
9902474,0,0,0,0,0,0,0,7,0.0,0.0,0.0,0.0,0.0,0.0,0.0,28,0,28,5.0,0.0,5.0
201218,0,0,0,0,0,0,0,34,0.0,0.0,0.0,0.0,0.0,0.0,0.0,44,0,44,33.0,0.0,33.0
9806370,0,0,0,0,0,0,0,154,0.0,0.0,0.0,0.0,0.0,0.0,0.0,10,0,10,6.0,0.0,6.0
210229,0,0,0,0,0,0,0,9,0.0,0.0,0.0,0.0,0.0,0.0,0.0,13,0,13,9.0,0.0,9.0
10022,0,0,0,0,0,0,0,1190,,,,,,,,3,0,3,,,
9708360,0,0,0,0,0,0,0,1311,,,,,,,,1,0,1,1.0,0.0,1.0
106036,0,0,0,0,0,0,0,211,0.0,0.0,0.0,0.0,0.0,0.0,0.0,2,0,2,1.0,0.0,1.0
9712472,0,0,0,0,0,0,0,54,0.0,0.0,0.0,0.0,0.0,0.0,0.0,19,0,19,3.0,0.0,3.0
9609363,0,0,0,0,0,0,0,1909,,,,,,,,1,0,1,,,
9902376,1,1,0,0,0,1,6,38,1.0,1.0,0.0,0.0,0.0,1.0,3.0,8,1,7,5.0,1.0,4.0
302100,0,0,0,0,0,0,0,729,0.0,0.0,0.0,0.0,0.0,0.0,0.0,1,0,1,1.0,0.0,1.0
9812414,0,0,0,0,0,0,0,65,0.0,0.0,0.0,0.0,0.0,0.0,0.0,4,0,4,1.0,0.0,1.0
4054,0,0,0,0,0,0,0,113,0.0,0.0,0.0,0.0,0.0,0.0,0.0,22,0,22,9.0,0.0,9.0
9709308,0,0,0,0,0,0,0,1406,,,,,,,,1,0,1,,,
211070,0,0,0,0,0,0,0,20,0.0,0.0,0.0,0.0,0.0,0.0,0.0,9,0,9,,,
212018,0,0,0,0,0,0,0,416,0.0,0.0,0.0,0.0,0.0,0.0,0.0,4,0,4,4.0,0.0,4.0
105201,0,0,0,0,0,0,0,64,0.0,0.0,0.0,0.0,0.0,0.0,0.0,11,0,11,7.0,0.0,7.0
211265,0,0,0,0,0,0,0,1379,,,,,,,,2,0,2,2.0,0.0,2.0
9207,0,0,0,0,0,0,0,13,0.0,0.0,0.0,0.0,0.0,0.0,0.0,11,0,11,6.0,0.0,6.0
9608410,1,1,0,0,0,1,5,22,0.0,0.0,0.0,0.0,0.0,0.0,0.0,10,1,9,1.0,1.0,0.0
12124,0,0,0,0,0,0,0,102,0.0,0.0,0.0,0.0,0.0,0.0,0.0,6,0,6,3.0,0.0,3.0
7308,0,0,0,0,0,0,0,72,0.0,0.0,0.0,0.0,0.0,0.0,0.0,10,0,10,5.0,0.0,5.0
210234,0,0,0,0,0,0,0,72,0.0,0.0,0.0,0.0,0.0,0.0,0.0,9,0,9,3.0,0.0,3.0
9603407,0,0,0,0,0,0,0,533,0.0,0.0,0.0,0.0,0.0,0.0,0.0,1,0,1,1.0,0.0,1.0
2111,0,0,0,0,0,0,0,986,0.0,0.0,0.0,0.0,0.0,0.0,0.0,1,0,1,1.0,0.0,1.0
9611295,2,1,1,1,2,0,0,88,2.0,1.0,1.0,1.0,2.0,0.0,0.0,2,2,0,2.0,2.0,0.0
302050,0,0,0,0,0,0,0,51,0.0,0.0,0.0,0.0,0.0,0.0,0.0,17,0,17,10.0,0.0,10.0
207240,0,0,0,0,0,0,0,56,0.0,0.0,0.0,0.0,0.0,0.0,0.0,7,0,7,3.0,0.0,3.0
107333,0,0,0,0,0,0,0,1763,0.0,0.0,0.0,0.0,0.0,0.0,0.0,12,0,12,1.0,0.0,1.0
209234,0,0,0,0,0,0,0,19,0.0,0.0,0.0,0.0,0.0,0.0,0.0,36,0,36,21.0,0.0,21.0
201259,0,0,0,0,0,0,0,586,0.0,0.0,0.0,0.0,0.0,0.0,0.0,3,0,3,2.0,0.0,2.0
203037,0,0,0,0,0,0,0,856,,,,,,,,1,0,1,,,
11390,0,0,0,0,0,0,0,27,0.0,0.0,0.0,0.0,0.0,0.0,0.0,11,0,11,9.0,0.0,9.0
206161,0,0,0,0,0,0,0,84,0.0,0.0,0.0,0.0,0.0,0.0,0.0,9,0,9,3.0,0.0,3.0
212237,0,0,0,0,0,0,0,4,0.0,0.0,0.0,0.0,0.0,0.0,0.0,162,0,162,19.0,0.0,19.0
9604307,0,0,0,0,0,0,0,74,0.0,0.0,0.0,0.0,0.0,0.0,0.0,4,0,4,,,
9612295,0,0,0,0,0,0,0,30,0.0,0.0,0.0,0.0,0.0,0.0,0.0,8,0,8,1.0,0.0,1.0
9806300,0,0,0,0,0,0,0,84,0.0,0.0,0.0,0.0,0.0,0.0,0.0,3,0,3,2.0,0.0,2.0
106058,0,0,0,0,0,0,0,9,0.0,0.0,0.0,0.0,0.0,0.0,0.0,5,0,5,,,
9507313,0,0,0,0,0,0,0,374,0.0,0.0,0.0,0.0,0.0,0.0,0.0,6,0,6,2.0,0.0,2.0
302175,0,0,0,0,0,0,0,50,0.0,0.0,0.0,0.0,0.0,0.0,0.0,23,0,23,3.0,0.0,3.0
9809578,0,0,0,0,0,0,0,200,,,,,,,,1,0,1,,,
107210,0,0,0,0,0,0,0,380,0.0,0.0,0.0,0.0,0.0,0.0,0.0,9,0,9,4.0,0.0,4.0
9408335,0,0,0,0,0,0,0,304,0.0,0.0,0.0,0.0,0.0,0.0,0.0,5,0,5,1.0,0.0,1.0
106032,0,0,0,0,0,0,0,344,0.0,0.0,0.0,0.0,0.0,0.0,0.0,1,0,1,1.0,0.0,1.0
302140,0,0,0,0,0,0,0,122,0.0,0.0,0.0,0.0,0.0,0.0,0.0,44,0,44,10.0,0.0,10.0
105198,0,0,0,0,0,0,0,345,0.0,0.0,0.0,0.0,0.0,0.0,0.0,3,0,3,1.0,0.0,1.0
212327,1,1,0,0,1,0,0,738,1.0,1.0,0.0,0.0,1.0,0.0,0.0,1,1,0,1.0,1.0,0.0
9325,0,0,0,0,0,0,0,41,0.0,0.0,0.0,0.0,0.0,0.0,0.0,5,0,5,2.0,0.0,2.0
210344,0,0,0,0,0,0,0,148,0.0,0.0,0.0,0.0,0.0,0.0,0.0,2,0,2,2.0,0.0,2.0
11113,0,0,0,0,0,0,0,1613,,,,,,,,4,0,4,,,
9706264,0,0,0,0,0,0,0,202,0.0,0.0,0.0,0.0,0.0,0.0,0.0,9,0,9,1.0,0.0,1.0
9710527,0,0,0,0,0,0,0,17,0.0,0.0,0.0,0.0,0.0,0.0,0.0,13,0,13,1.0,0.0,1.0
9405255,0,0,0,0,0,0,0,1359,,,,,,,,1,0,1,,,
9406309,0,0,0,0,0,0,0,2008,,,,,,,,1,0,1,,,
205300,0,0,0,0,0,0,0,0,0.0,0.0,0.0,0.0,0.0,0.0,0.0,7,0,7,,,
109070,0,0,0,0,0,0,0,1074,0.0,0.0,0.0,0.0,0.0,0.0,0.0,1,0,1,1.0,0.0,1.0
9905414,0,0,0,0,0,0,0,166,,,,,,,,2,0,2,,,
211135,0,0,0,0,0,0,0,35,0.0,0.0,0.0,0.0,0.0,0.0,0.0,15,0,15,4.0,0.0,4.0
107289,0,0,0,0,0,0,0,60,,,,,,,,7,0,7,3.0,0.0,3.0
9811297,0,0,0,0,0,0,0,234,0.0,0.0,0.0,0.0,0.0,0.0,0.0,6,0,6,3.0,0.0,3.0
9505228,0,0,0,0,0,0,0,75,0.0,0.0,0.0,0.0,0.0,0.0,0.0,15,0,15,1.0,0.0,1.0
9911519,0,0,0,0,0,0,0,11,0.0,0.0,0.0,0.0,0.0,0.0,0.0,6,0,6,,,
211373,0,0,0,0,0,0,0,4,0.0,0.0,0.0,0.0,0.0,0.0,0.0,15,0,15,6.0,0.0,6.0
9301253,59,11,48,210,59,0,0,31,26.0,2.0,24.0,103.0,26.0,0.0,0.0,59,59,0,13.0,13.0,0.0
9411285,101,19,82,343,84,17,17,67,37.0,2.0,35.0,172.0,37.0,0.0,0.0,102,101,1,25.0,25.0,0.0
9304257,271,31,240,2032,191,80,80,34,82.0,4.0,78.0,919.0,39.0,43.0,43.0,272,271,1,57.0,56.0,1.0
12152,28,7,21,81,1,27,167,1,22.0,4.0,18.0,73.0,0.0,22.0,115.0,43,28,15,16.0,8.0,8.0
9809384,23,2,21,54,1,22,167,1,18.0,2.0,16.0,40.0,1.0,17.0,145.0,52,23,29,25.0,12.0,13.0
9308262,119,19,100,533,4,115,236,6,65.0,9.0,56.0,314.0,0.0,65.0,147.0,124,119,5,31.0,28.0,3.0
9408390,44,4,40,157,16,28,32,58,16.0,2.0,14.0,40.0,4.0,12.0,12.0,46,44,2,14.0,13.0,1.0
7085,34,1,33,180,2,32,216,1,18.0,1.0,17.0,57.0,1.0,17.0,37.0,63,34,29,24.0,19.0,5.0
9904480,13,6,7,15,0,13,65,1,3.0,3.0,0.0,0.0,1.0,2.0,3.0,28,13,15,6.0,3.0,3.0
9903230,43,4,39,202,4,39,336,34,21.0,3.0,18.0,96.0,0.0,21.0,158.0,72,43,29,31.0,16.0,15.0
110253,18,8,10,16,2,16,57,6,6.0,4.0,2.0,3.0,0.0,6.0,22.0,41,18,23,7.0,3.0,4.0
9302246,23,9,14,24,23,0,0,58,2.0,1.0,1.0,1.0,2.0,0.0,0.0,23,23,0,2.0,2.0,0.0
211308,4,3,1,1,0,4,25,4,1.0,1.0,0.0,0.0,0.0,1.0,2.0,38,4,34,7.0,0.0,7.0
9508338,28,3,25,65,1,27,94,61,14.0,1.0,13.0,31.0,0.0,14.0,55.0,41,28,13,15.0,9.0,6.0
9211272,30,11,19,53,30,0,0,33,12.0,3.0,9.0,31.0,12.0,0.0,0.0,30,30,0,3.0,3.0,0.0
102241,47,12,35,140,1,46,221,19,25.0,7.0,18.0,81.0,0.0,25.0,106.0,65,47,18,22.0,16.0,6.0
11311,90,12,78,425,13,77,353,37,30.0,3.0,27.0,171.0,23.0,7.0,7.0,119,90,29,23.0,3.0,20.0
9706304,39,21,18,40,6,33,108,33,11.0,5.0,6.0,10.0,1.0,10.0,40.0,48,39,9,12.0,7.0,5.0
9503433,118,13,105,592,5,113,263,26,67.0,1.0,66.0,436.0,0.0,67.0,187.0,123,118,5,24.0,21.0,3.0
9611367,29,4,25,110,3,26,84,33,23.0,3.0,20.0,93.0,1.0,22.0,64.0,38,29,9,18.0,14.0,4.0
9708358,20,8,12,34,2,18,87,48,13.0,7.0,6.0,14.0,0.0,13.0,68.0,34,20,14,10.0,2.0,8.0
9807570,32,12,20,53,4,28,55,80,9.0,5.0,4.0,8.0,5.0,4.0,4.0,39,32,7,6.0,5.0,1.0
9907509,46,5,41,111,6,40,306,24,21.0,3.0,18.0,54.0,0.0,21.0,164.0,73,46,27,17.0,9.0,8.0
9602224,7,4,3,4,7,0,0,4,2.0,1.0,1.0,1.0,2.0,0.0,0.0,7,7,0,,,
107117,2,2,0,0,0,2,17,26,1.0,1.0,0.0,0.0,0.0,1.0,5.0,15,2,13,8.0,1.0,7.0
9409215,88,12,76,270,63,25,38,6,17.0,4.0,13.0,29.0,17.0,0.0,0.0,102,88,14,9.0,9.0,0.0
9712319,89,9,80,402,21,68,213,26,43.0,3.0,40.0,195.0,7.0,36.0,141.0,104,89,15,30.0,23.0,7.0
9906234,126,9,117,677,2,124,1529,2,67.0,6.0,61.0,360.0,0.0,67.0,1140.0,184,126,58,45.0,26.0,19.0
9212268,26,5,21,56,26,0,0,35,10.0,2.0,8.0,20.0,10.0,0.0,0.0,26,26,0,9.0,9.0,0.0
9304293,8,3,5,6,7,1,1,35,4.0,3.0,1.0,1.0,4.0,0.0,0.0,9,8,1,2.0,2.0,0.0
9409458,131,24,107,353,112,19,28,4,38.0,5.0,33.0,106.0,22.0,16.0,24.0,134,131,3,16.0,14.0,2.0
9903382,13,6,7,16,1,12,59,4,8.0,3.0,5.0,12.0,0.0,8.0,44.0,27,13,14,5.0,2.0,3.0
9407326,20,5,15,42,9,11,14,114,12.0,2.0,10.0,29.0,5.0,7.0,9.0,23,20,3,10.0,9.0,1.0
109097,15,5,10,14,2,13,45,121,3.0,1.0,2.0,3.0,0.0,3.0,6.0,40,15,25,4.0,0.0,4.0
9503214,103,29,74,155,34,69,157,10,16.0,3.0,13.0,23.0,0.0,16.0,52.0,117,103,14,3.0,3.0,0.0
9810383,6,2,4,5,5,1,2,456,5.0,2.0,3.0,3.0,5.0,0.0,0.0,8,6,2,5.0,5.0,0.0
9301290,42,6,36,150,20,22,22,63,21.0,3.0,18.0,68.0,4.0,17.0,17.0,43,42,1,20.0,19.0,1.0
9311239,2,1,1,1,2,0,0,149,2.0,1.0,1.0,1.0,2.0,0.0,0.0,3,2,1,2.0,2.0,0.0
9611334,8,4,4,5,3,5,9,204,0.0,0.0,0.0,0.0,0.0,0.0,0.0,20,8,12,1.0,1.0,0.0
9512369,93,12,81,461,7,86,289,23,41.0,6.0,35.0,150.0,0.0,41.0,141.0,103,93,10,28.0,23.0,5.0
9406404,13,2,11,32,1,12,23,25,8.0,1.0,7.0,15.0,0.0,8.0,15.0,17,13,4,9.0,7.0,2.0
9302223,70,15,55,264,70,0,0,46,31.0,3.0,28.0,154.0,31.0,0.0,0.0,70,70,0,6.0,6.0,0.0
9305274,94,22,72,480,94,0,0,15,41.0,5.0,36.0,358.0,41.0,0.0,0.0,94,94,0,30.0,30.0,0.0
9309335,47,15,32,84,42,5,5,5,8.0,5.0,3.0,9.0,8.0,0.0,0.0,48,47,1,5.0,5.0,0.0
9211310,38,12,26,57,38,0,0,10,14.0,4.0,10.0,26.0,14.0,0.0,0.0,38,38,0,7.0,7.0,0.0
9207257,69,13,56,165,69,0,0,0,20.0,2.0,18.0,60.0,20.0,0.0,0.0,69,69,0,5.0,5.0,0.0
9805293,33,5,28,72,7,26,57,0,4.0,1.0,3.0,4.0,1.0,3.0,4.0,41,33,8,9.0,8.0,1.0
9812360,188,49,139,485,37,151,879,0,36.0,5.0,31.0,145.0,1.0,35.0,181.0,322,188,134,30.0,19.0,11.0
9807525,49,11,38,99,7,42,63,0,10.0,4.0,6.0,8.0,2.0,8.0,8.0,52,49,3,10.0,9.0,1.0
9912358,105,26,79,258,20,85,477,3,25.0,3.0,22.0,78.0,3.0,22.0,77.0,217,105,112,23.0,19.0,4.0
1306,14,7,7,17,0,14,237,3,10.0,4.0,6.0,16.0,0.0,10.0,196.0,100,14,86,42.0,4.0,38.0
9811265,37,6,31,117,1,36,158,3,24.0,4.0,20.0,86.0,0.0,24.0,86.0,52,37,15,7.0,7.0,0.0
9908262,3,1,2,2,1,2,6,318,0.0,0.0,0.0,0.0,0.0,0.0,0.0,12,3,9,2.0,0.0,2.0
9705391,44,12,32,91,14,30,109,41,10.0,2.0,8.0,16.0,0.0,10.0,42.0,65,44,21,17.0,13.0,4.0
9402241,56,3,53,363,46,10,10,50,30.0,1.0,29.0,189.0,30.0,0.0,0.0,57,56,1,16.0,15.0,1.0
9804400,48,9,39,183,8,40,113,0,8.0,3.0,5.0,10.0,2.0,6.0,24.0,61,48,13,8.0,4.0,4.0
9702229,6,2,4,6,5,1,3,0,3.0,1.0,2.0,2.0,3.0,0.0,0.0,22,6,16,4.0,4.0,0.0
9405296,58,14,44,189,58,0,0,28,29.0,3.0,26.0,116.0,29.0,0.0,0.0,58,58,0,22.0,22.0,0.0
9706535,2,1,1,1,0,2,5,3,1.0,1.0,0.0,0.0,0.0,1.0,3.0,11,2,9,4.0,1.0,3.0
9601303,36,3,33,88,5,31,87,10,10.0,1.0,9.0,15.0,2.0,8.0,12.0,47,36,11,9.0,8.0,1.0
9711363,24,3,21,81,4,20,73,82,19.0,2.0,17.0,65.0,1.0,18.0,66.0,29,24,5,21.0,16.0,5.0
9612259,5,5,0,0,4,1,2,0,1.0,1.0,0.0,0.0,1.0,0.0,0.0,11,5,6,2.0,0.0,2.0
102306,16,9,7,12,7,9,16,81,6.0,1.0,5.0,10.0,6.0,0.0,0.0,25,16,9,3.0,2.0,1.0
9601332,12,3,9,23,0,12,31,81,10.0,3.0,7.0,17.0,0.0,10.0,20.0,38,12,26,6.0,0.0,6.0
9405414,73,15,58,187,73,0,0,51,31.0,5.0,26.0,92.0,31.0,0.0,0.0,73,73,0,13.0,13.0,0.0
9805427,28,4,24,104,0,28,177,46,23.0,4.0,19.0,79.0,0.0,23.0,142.0,40,28,12,14.0,8.0,6.0
9704231,53,4,49,311,4,49,217,46,45.0,2.0,43.0,288.0,2.0,43.0,179.0,70,53,17,32.0,29.0,3.0
9503456,12,4,8,13,2,10,52,63,3.0,2.0,1.0,2.0,0.0,3.0,22.0,21,12,9,13.0,5.0,8.0
9207268,24,7,17,34,24,0,0,120,12.0,1.0,11.0,19.0,12.0,0.0,0.0,24,24,0,4.0,4.0,0.0
9710426,20,8,12,28,1,19,161,71,14.0,4.0,10.0,25.0,0.0,14.0,119.0,44,20,24,24.0,9.0,15.0
9810257,20,7,13,20,0,20,153,0,5.0,3.0,2.0,3.0,0.0,5.0,53.0,59,20,39,21.0,2.0,19.0
9610231,141,29,112,443,123,18,18,66,22.0,3.0,19.0,64.0,22.0,0.0,0.0,142,141,1,12.0,12.0,0.0
9402266,44,27,17,38,8,36,129,10,14.0,8.0,6.0,20.0,1.0,13.0,30.0,63,44,19,6.0,6.0,0.0
9502385,76,8,68,307,38,38,65,12,15.0,1.0,14.0,53.0,7.0,8.0,8.0,83,76,7,10.0,10.0,0.0
9405253,41,8,33,149,6,35,60,12,14.0,3.0,11.0,44.0,1.0,13.0,13.0,45,41,4,5.0,4.0,1.0
9703279,95,2,93,1012,5,90,269,36,68.0,2.0,66.0,828.0,5.0,63.0,156.0,116,95,21,59.0,58.0,1.0
9706510,13,6,7,9,5,8,17,12,3.0,2.0,1.0,1.0,0.0,3.0,10.0,19,13,6,1.0,1.0,0.0
7319,17,5,12,26,0,17,225,34,14.0,3.0,11.0,24.0,0.0,14.0,205.0,49,17,32,37.0,12.0,25.0
9908404,33,11,22,53,0,33,222,32,13.0,5.0,8.0,12.0,1.0,12.0,84.0,52,33,19,12.0,5.0,7.0
10008,16,4,12,29,2,14,230,34,12.0,3.0,9.0,19.0,0.0,12.0,210.0,79,16,63,40.0,10.0,30.0
9510363,51,6,45,169,6,45,299,1,42.0,3.0,39.0,152.0,1.0,41.0,290.0,65,51,14,27.0,15.0,12.0
9809204,13,6,7,11,0,13,140,1,12.0,5.0,7.0,11.0,0.0,12.0,121.0,35,13,22,25.0,8.0,17.0
9601360,118,4,114,647,24,94,257,7,33.0,3.0,30.0,135.0,3.0,30.0,53.0,134,118,16,14.0,14.0,0.0
9704249,62,14,48,247,6,56,212,67,33.0,8.0,25.0,132.0,1.0,32.0,147.0,74,62,12,31.0,25.0,6.0
106005,2,2,0,0,0,2,2,62,1.0,1.0,0.0,0.0,0.0,1.0,1.0,6,2,4,,,
9507378,438,25,413,3828,30,408,976,5,141.0,6.0,135.0,1774.0,2.0,139.0,282.0,456,438,18,64.0,62.0,2.0
9612464,69,13,56,179,3,66,432,5,28.0,4.0,24.0,81.0,0.0,28.0,266.0,100,69,31,33.0,16.0,17.0
9706554,28,6,22,67,0,28,192,5,21.0,5.0,16.0,55.0,0.0,21.0,159.0,39,28,11,20.0,14.0,6.0
9608450,20,2,18,61,11,9,13,87,11.0,1.0,10.0,29.0,4.0,7.0,7.0,27,20,7,10.0,9.0,1.0
9410357,38,5,33,170,4,34,77,33,30.0,4.0,26.0,146.0,3.0,27.0,62.0,43,38,5,26.0,22.0,4.0
9704355,24,8,16,25,9,15,20,384,5.0,2.0,3.0,3.0,1.0,4.0,4.0,31,24,7,4.0,3.0,1.0
9802315,29,2,27,73,4,25,50,1,17.0,1.0,16.0,36.0,2.0,15.0,28.0,38,29,9,10.0,9.0,1.0
106040,10,5,5,10,1,9,26,6,3.0,2.0,1.0,1.0,3.0,0.0,0.0,20,10,10,2.0,2.0,0.0
9710550,44,4,40,139,11,33,133,7,8.0,2.0,6.0,9.0,0.0,8.0,27.0,68,44,24,3.0,2.0,1.0
3258,50,12,38,135,4,46,251,13,26.0,3.0,23.0,80.0,0.0,26.0,168.0,89,50,39,24.0,8.0,16.0
9704272,42,10,32,92,8,34,96,7,12.0,2.0,10.0,29.0,3.0,9.0,20.0,55,42,13,13.0,10.0,3.0
9611433,231,19,212,1570,35,196,584,9,117.0,2.0,115.0,1081.0,12.0,105.0,289.0,242,231,11,56.0,51.0,5.0
9602281,121,5,116,799,6,115,493,7,70.0,3.0,67.0,503.0,0.0,70.0,283.0,134,121,13,44.0,39.0,5.0
12219,19,5,14,41,0,19,166,1,11.0,4.0,7.0,27.0,0.0,11.0,87.0,54,19,35,8.0,3.0,5.0
9406337,18,10,8,21,14,4,7,4,5.0,3.0,2.0,3.0,5.0,0.0,0.0,21,18,3,5.0,5.0,0.0
9905328,4,4,0,0,2,2,13,71,1.0,1.0,0.0,0.0,0.0,1.0,11.0,27,4,23,14.0,1.0,13.0
9512206,23,7,16,65,23,0,0,59,16.0,2.0,14.0,62.0,16.0,0.0,0.0,23,23,0,14.0,14.0,0.0
9703327,58,3,55,211,1,57,323,21,29.0,3.0,26.0,104.0,0.0,29.0,156.0,77,58,19,27.0,16.0,11.0
9505352,47,8,39,153,7,40,87,7,29.0,3.0,26.0,99.0,2.0,27.0,27.0,59,47,12,24.0,22.0,2.0
9408370,56,16,40,151,42,14,18,7,9.0,2.0,7.0,19.0,9.0,0.0,0.0,59,56,3,8.0,8.0,0.0
9403376,38,9,29,56,18,20,101,6,5.0,5.0,0.0,0.0,0.0,5.0,47.0,58,38,20,5.0,4.0,1.0
9606445,19,9,10,16,0,19,39,12,2.0,1.0,1.0,1.0,2.0,0.0,0.0,28,19,9,2.0,1.0,1.0
9212235,159,33,126,982,61,98,167,15,58.0,4.0,54.0,511.0,20.0,38.0,75.0,163,159,4,41.0,38.0,3.0
9902476,6,3,3,5,0,6,20,69,4.0,2.0,2.0,2.0,0.0,4.0,10.0,15,6,9,8.0,4.0,4.0
9904389,25,13,12,20,9,16,61,76,3.0,1.0,2.0,3.0,0.0,3.0,14.0,62,25,37,9.0,3.0,6.0
9411244,4,4,0,0,3,1,2,371,1.0,1.0,0.0,0.0,1.0,0.0,0.0,6,4,2,3.0,2.0,1.0
9604399,4,2,2,3,4,0,0,235,0.0,0.0,0.0,0.0,0.0,0.0,0.0,6,4,2,3.0,3.0,0.0
9405386,57,10,47,339,5,52,70,19,39.0,5.0,34.0,264.0,1.0,38.0,54.0,59,57,2,12.0,10.0,2.0
9312276,28,3,25,125,9,19,25,19,9.0,6.0,3.0,3.0,9.0,0.0,0.0,32,28,4,16.0,14.0,2.0
9403244,46,17,29,67,46,0,0,30,10.0,1.0,9.0,15.0,10.0,0.0,0.0,46,46,0,8.0,8.0,0.0
9707337,28,9,19,44,13,15,32,24,10.0,3.0,7.0,14.0,10.0,0.0,0.0,33,28,5,9.0,9.0,0.0
9702373,30,6,24,71,4,26,86,11,12.0,3.0,9.0,16.0,0.0,12.0,27.0,37,30,7,12.0,10.0,2.0
9704267,33,6,27,89,1,32,72,16,18.0,3.0,15.0,54.0,0.0,18.0,37.0,39,33,6,2.0,2.0,0.0
9701252,10,2,8,10,0,10,42,57,9.0,2.0,7.0,9.0,0.0,9.0,21.0,17,10,7,11.0,7.0,4.0
9209230,7,7,0,0,7,0,0,401,2.0,2.0,0.0,0.0,2.0,0.0,0.0,7,7,0,2.0,2.0,0.0
9410250,14,9,5,10,9,5,7,14,4.0,1.0,3.0,6.0,4.0,0.0,0.0,19,14,5,4.0,4.0,0.0
9401297,10,6,4,7,7,3,5,363,2.0,1.0,1.0,1.0,0.0,2.0,3.0,17,10,7,4.0,3.0,1.0
9906316,21,5,16,62,7,14,45,80,15.0,4.0,11.0,51.0,4.0,11.0,36.0,25,21,4,16.0,12.0,4.0
9911216,1,1,0,0,0,1,1,422,0.0,0.0,0.0,0.0,0.0,0.0,0.0,8,1,7,1.0,0.0,1.0
9812378,16,2,14,34,2,14,22,86,9.0,2.0,7.0,22.0,3.0,6.0,6.0,22,16,6,10.0,9.0,1.0
9506430,27,7,20,52,15,12,14,33,8.0,2.0,6.0,17.0,8.0,0.0,0.0,29,27,2,2.0,2.0,0.0
6346,15,6,9,19,0,15,86,6,7.0,2.0,5.0,11.0,0.0,7.0,37.0,36,15,21,6.0,4.0,2.0
9411323,23,8,15,35,4,19,99,6,6.0,3.0,3.0,3.0,0.0,6.0,41.0,38,23,15,9.0,5.0,4.0
9705254,50,9,41,143,4,46,168,25,24.0,3.0,21.0,63.0,0.0,24.0,103.0,69,50,19,25.0,16.0,9.0
9209263,7,4,3,5,7,0,0,85,3.0,1.0,2.0,2.0,3.0,0.0,0.0,7,7,0,2.0,2.0,0.0
9411211,134,8,126,1151,81,53,87,8,79.0,2.0,77.0,809.0,79.0,0.0,0.0,142,134,8,49.0,49.0,0.0
9702415,8,3,5,8,0,8,44,87,7.0,2.0,5.0,8.0,0.0,7.0,38.0,15,8,7,11.0,5.0,6.0
9808380,0,0,0,0,0,0,0,287,0.0,0.0,0.0,0.0,0.0,0.0,0.0,12,0,12,4.0,0.0,4.0
9601280,49,21,28,57,14,35,120,14,9.0,2.0,7.0,17.0,1.0,8.0,33.0,90,49,41,9.0,1.0,8.0
9411235,4,3,1,1,3,1,2,93,1.0,1.0,0.0,0.0,0.0,1.0,2.0,7,4,3,2.0,1.0,1.0
9210262,32,9,23,69,32,0,0,45,14.0,2.0,12.0,38.0,14.0,0.0,0.0,32,32,0,5.0,5.0,0.0
9405343,19,1,18,84,14,5,5,38,17.0,1.0,16.0,73.0,17.0,0.0,0.0,21,19,2,12.0,12.0,0.0
9906373,5,2,3,4,2,3,22,45,4.0,1.0,3.0,4.0,1.0,3.0,20.0,15,5,10,10.0,3.0,7.0
9306298,29,10,19,69,18,11,16,22,13.0,4.0,9.0,28.0,5.0,8.0,12.0,32,29,3,4.0,4.0,0.0
9401317,26,8,18,62,26,0,0,22,14.0,1.0,13.0,51.0,14.0,0.0,0.0,26,26,0,3.0,3.0,0.0
9812504,19,1,18,40,0,19,104,22,5.0,1.0,4.0,6.0,0.0,5.0,19.0,44,19,25,15.0,5.0,10.0
9406210,24,8,16,46,3,21,60,104,10.0,4.0,6.0,9.0,0.0,10.0,29.0,30,24,6,14.0,10.0,4.0
9708294,10,6,4,7,1,9,43,51,8.0,4.0,4.0,6.0,0.0,8.0,32.0,23,10,13,10.0,3.0,7.0
3134,6,3,3,3,0,6,25,40,5.0,2.0,3.0,3.0,0.0,5.0,23.0,23,6,17,5.0,3.0,2.0
9701423,46,2,44,214,1,45,222,21,30.0,2.0,28.0,122.0,0.0,30.0,155.0,55,46,9,26.0,18.0,8.0
9611376,2,1,1,1,0,2,6,21,0.0,0.0,0.0,0.0,0.0,0.0,0.0,7,2,5,1.0,0.0,1.0
4194,2,2,0,0,0,2,3,435,1.0,1.0,0.0,0.0,0.0,1.0,1.0,4,2,2,2.0,1.0,1.0
9710255,50,2,48,465,6,44,246,19,43.0,2.0,41.0,421.0,4.0,39.0,169.0,71,50,21,31.0,30.0,1.0
9901201,24,2,22,163,0,24,141,19,24.0,2.0,22.0,163.0,0.0,24.0,136.0,37,24,13,23.0,20.0,3.0
9910252,22,4,18,29,2,20,93,43,8.0,1.0,7.0,11.0,0.0,8.0,50.0,35,22,13,11.0,7.0,4.0
9811351,25,6,19,40,16,9,17,66,8.0,2.0,6.0,9.0,8.0,0.0,0.0,34,25,9,3.0,2.0,1.0
9507465,35,4,31,100,19,16,22,101,25.0,2.0,23.0,84.0,18.0,7.0,7.0,39,35,4,11.0,11.0,0.0
5225,31,5,26,86,4,27,137,20,24.0,2.0,22.0,82.0,0.0,24.0,130.0,42,31,11,13.0,11.0,2.0
9812510,67,1,66,670,1,66,272,20,63.0,1.0,62.0,650.0,0.0,63.0,261.0,75,67,8,54.0,48.0,6.0
9908248,64,2,62,404,0,64,382,20,60.0,2.0,58.0,392.0,0.0,60.0,367.0,71,64,7,49.0,42.0,7.0
9307330,27,9,18,54,8,19,47,29,12.0,3.0,9.0,28.0,1.0,11.0,34.0,32,27,5,11.0,8.0,3.0
9503491,11,2,9,13,1,10,23,49,6.0,1.0,5.0,7.0,1.0,5.0,6.0,16,11,5,5.0,5.0,0.0
9507314,12,1,11,28,0,12,28,136,12.0,1.0,11.0,28.0,0.0,12.0,28.0,15,12,3,13.0,10.0,3.0
9705438,5,5,0,0,3,2,3,220,2.0,2.0,0.0,0.0,0.0,2.0,2.0,8,5,3,4.0,2.0,2.0
9807286,14,7,7,13,2,12,26,13,9.0,3.0,6.0,11.0,1.0,8.0,13.0,22,14,8,8.0,6.0,2.0
202089,18,2,16,81,0,18,24,37,15.0,1.0,14.0,71.0,0.0,15.0,18.0,23,18,5,17.0,16.0,1.0
9906523,67,7,60,269,0,67,278,2,31.0,4.0,27.0,100.0,1.0,30.0,48.0,75,67,8,21.0,19.0,2.0
9204237,18,6,12,30,18,0,0,6,2.0,2.0,0.0,0.0,2.0,0.0,0.0,18,18,0,1.0,1.0,0.0
9305349,9,5,4,8,9,0,0,78,5.0,2.0,3.0,5.0,5.0,0.0,0.0,9,9,0,4.0,4.0,0.0
9611217,30,13,17,46,4,26,152,10,7.0,3.0,4.0,7.0,0.0,7.0,17.0,70,30,40,6.0,5.0,1.0
9508258,98,11,87,338,10,88,167,60,21.0,5.0,16.0,72.0,0.0,21.0,64.0,104,98,6,16.0,13.0,3.0
9611254,4,2,2,3,3,1,1,61,0.0,0.0,0.0,0.0,0.0,0.0,0.0,23,4,19,4.0,0.0,4.0
9402226,5,3,2,2,1,4,12,75,1.0,1.0,0.0,0.0,0.0,1.0,4.0,19,5,14,2.0,1.0,1.0
9708393,72,8,64,431,13,59,269,15,47.0,3.0,44.0,338.0,3.0,44.0,217.0,88,72,16,29.0,24.0,5.0
9512241,4,3,1,1,0,4,8,248,1.0,1.0,0.0,0.0,0.0,1.0,2.0,9,4,5,5.0,1.0,4.0
9806281,5,1,4,5,0,5,25,42,3.0,1.0,2.0,2.0,0.0,3.0,15.0,12,5,7,2.0,1.0,1.0
9611454,21,16,5,8,13,8,12,35,6.0,2.0,4.0,7.0,6.0,0.0,0.0,38,21,17,4.0,0.0,4.0
9506251,25,5,20,55,1,24,25,61,11.0,5.0,6.0,13.0,0.0,11.0,11.0,29,25,4,7.0,7.0,0.0
9606325,37,12,25,65,4,33,185,5,9.0,2.0,7.0,8.0,2.0,7.0,41.0,72,37,35,20.0,6.0,14.0
9201,7,4,3,4,0,7,37,4,5.0,3.0,2.0,2.0,0.0,5.0,15.0,19,7,12,9.0,5.0,4.0
9311316,39,5,34,168,30,9,11,23,27.0,3.0,24.0,112.0,27.0,0.0,0.0,41,39,2,16.0,16.0,0.0
9703275,11,2,9,22,5,6,8,4,7.0,2.0,5.0,12.0,7.0,0.0,0.0,14,11,3,4.0,4.0,0.0
9912463,47,5,42,126,0,47,324,4,25.0,2.0,23.0,82.0,0.0,25.0,193.0,88,47,41,14.0,5.0,9.0
9809572,56,14,42,262,1,55,398,70,50.0,11.0,39.0,258.0,0.0,50.0,386.0,66,56,10,45.0,36.0,9.0
9904248,60,19,41,111,9,51,255,119,13.0,10.0,3.0,6.0,0.0,13.0,93.0,86,60,26,28.0,12.0,16.0
9812239,15,5,10,15,6,9,23,3,5.0,3.0,2.0,2.0,0.0,5.0,14.0,19,15,4,2.0,2.0,0.0
9809547,33,5,28,65,0,33,168,21,8.0,4.0,4.0,5.0,0.0,8.0,46.0,50,33,17,14.0,7.0,7.0
9607237,20,5,15,28,2,18,57,18,7.0,1.0,6.0,11.0,1.0,6.0,16.0,30,20,10,9.0,5.0,4.0
9507420,22,10,12,24,20,2,2,308,10.0,3.0,7.0,16.0,10.0,0.0,0.0,25,22,3,6.0,6.0,0.0
9711330,5,3,2,2,5,0,0,238,5.0,3.0,2.0,2.0,5.0,0.0,0.0,5,5,0,3.0,3.0,0.0
9611375,19,7,12,24,3,16,38,84,16.0,4.0,12.0,23.0,2.0,14.0,33.0,25,19,6,11.0,8.0,3.0
9401348,8,4,4,8,8,0,0,49,4.0,1.0,3.0,5.0,4.0,0.0,0.0,8,8,0,2.0,2.0,0.0
9511469,38,28,10,13,11,27,83,10,2.0,1.0,1.0,1.0,1.0,1.0,1.0,81,38,43,4.0,4.0,0.0
9907468,9,2,7,15,0,9,28,251,8.0,2.0,6.0,14.0,0.0,8.0,16.0,19,9,10,11.0,8.0,3.0
9403385,20,9,11,22,20,0,0,23,5.0,3.0,2.0,2.0,5.0,0.0,0.0,22,20,2,3.0,2.0,1.0
9601383,14,6,8,15,11,3,6,61,2.0,2.0,0.0,0.0,2.0,0.0,0.0,17,14,3,1.0,0.0,1.0
9611364,23,7,16,45,2,21,119,7,14.0,3.0,11.0,28.0,0.0,14.0,88.0,41,23,18,22.0,11.0,11.0
9606269,13,4,9,19,2,11,17,1,2.0,2.0,0.0,0.0,2.0,0.0,0.0,16,13,3,1.0,1.0,0.0
9405313,38,17,21,64,16,22,33,10,9.0,5.0,4.0,10.0,9.0,0.0,0.0,43,38,5,9.0,9.0,0.0
9709510,11,1,10,34,0,11,18,55,7.0,1.0,6.0,13.0,1.0,6.0,6.0,22,11,11,2.0,2.0,0.0
9502252,32,10,22,56,0,32,211,75,8.0,4.0,4.0,5.0,0.0,8.0,54.0,65,32,33,23.0,11.0,12.0
9808396,18,9,9,10,7,11,20,173,4.0,2.0,2.0,3.0,0.0,4.0,5.0,27,18,9,5.0,4.0,1.0
9212275,4,3,1,1,4,0,0,633,1.0,1.0,0.0,0.0,1.0,0.0,0.0,4,4,0,2.0,2.0,0.0
9907516,22,9,13,24,3,19,172,31,14.0,6.0,8.0,17.0,0.0,14.0,122.0,52,22,30,26.0,7.0,19.0
107329,20,8,12,16,0,20,238,32,4.0,3.0,1.0,1.0,0.0,4.0,55.0,107,20,87,23.0,2.0,21.0
9609212,15,10,5,7,1,14,69,5,5.0,4.0,1.0,1.0,0.0,5.0,30.0,31,15,16,2.0,0.0,2.0
102242,21,1,20,126,0,21,198,23,21.0,1.0,20.0,126.0,0.0,21.0,186.0,40,21,19,22.0,16.0,6.0
3081,38,6,32,157,0,38,277,5,24.0,4.0,20.0,104.0,0.0,24.0,176.0,63,38,25,33.0,21.0,12.0
103079,3,2,1,1,1,2,6,18,0.0,0.0,0.0,0.0,0.0,0.0,0.0,9,3,6,1.0,1.0,0.0
9708416,15,12,3,5,8,7,10,4,1.0,1.0,0.0,0.0,0.0,1.0,3.0,22,15,7,5.0,4.0,1.0
9809223,36,10,26,43,5,31,100,5,11.0,7.0,4.0,6.0,0.0,11.0,47.0,52,36,16,11.0,2.0,9.0
9908283,39,11,28,93,6,33,108,34,13.0,4.0,9.0,22.0,1.0,12.0,26.0,51,39,12,18.0,14.0,4.0
9408392,13,3,10,34,3,10,24,18,3.0,1.0,2.0,3.0,1.0,2.0,2.0,18,13,5,1.0,0.0,1.0
9905249,18,5,13,45,2,16,111,25,10.0,3.0,7.0,16.0,0.0,10.0,69.0,50,18,32,28.0,7.0,21.0
9907427,10,2,8,19,0,10,38,7,10.0,2.0,8.0,19.0,0.0,10.0,38.0,15,10,5,15.0,10.0,5.0
9910286,38,4,34,115,6,32,97,0,19.0,1.0,18.0,65.0,1.0,18.0,30.0,50,38,12,10.0,4.0,6.0
7154,4,2,2,2,1,3,17,0,2.0,1.0,1.0,1.0,0.0,2.0,13.0,20,4,16,14.0,2.0,12.0
9612294,14,3,11,26,0,14,67,69,9.0,3.0,6.0,15.0,0.0,9.0,46.0,22,14,8,16.0,9.0,7.0
7201,10,2,8,11,3,7,7,118,7.0,1.0,6.0,9.0,1.0,6.0,6.0,12,10,2,8.0,7.0,1.0
9502289,76,4,72,520,7,69,182,11,58.0,4.0,54.0,448.0,0.0,58.0,161.0,79,76,3,21.0,21.0,0.0
104010,14,8,6,6,0,14,53,11,5.0,1.0,4.0,4.0,1.0,4.0,8.0,23,14,9,10.0,6.0,4.0
9610413,5,5,0,0,2,3,14,43,1.0,1.0,0.0,0.0,0.0,1.0,6.0,18,5,13,2.0,1.0,1.0
9808340,37,9,28,90,0,37,167,16,26.0,6.0,20.0,73.0,0.0,26.0,118.0,46,37,9,23.0,16.0,7.0
9905339,18,6,12,24,5,13,115,8,13.0,5.0,8.0,19.0,0.0,13.0,113.0,39,18,21,27.0,10.0,17.0
9806522,8,3,5,5,1,7,22,19,4.0,2.0,2.0,2.0,0.0,4.0,8.0,24,8,16,8.0,4.0,4.0
6162,9,7,2,4,3,6,31,62,0.0,0.0,0.0,0.0,0.0,0.0,0.0,102,9,93,8.0,0.0,8.0
9512432,16,6,10,22,8,8,8,129,10.0,3.0,7.0,17.0,5.0,5.0,5.0,17,16,1,6.0,5.0,1.0
9406267,23,7,16,25,23,0,0,79,8.0,3.0,5.0,9.0,8.0,0.0,0.0,26,23,3,6.0,6.0,0.0
9610211,3,2,1,1,0,3,11,39,0.0,0.0,0.0,0.0,0.0,0.0,0.0,13,3,10,5.0,0.0,5.0
9608379,3,2,1,1,0,3,5,39,,,,,,,,5,3,2,1.0,1.0,0.0
9901337,10,7,3,7,1,9,41,46,5.0,4.0,1.0,4.0,0.0,5.0,21.0,21,10,11,10.0,2.0,8.0
9804364,10,4,6,13,10,0,0,50,6.0,3.0,3.0,7.0,6.0,0.0,0.0,10,10,0,6.0,6.0,0.0
205194,0,0,0,0,0,0,0,138,0.0,0.0,0.0,0.0,0.0,0.0,0.0,5,0,5,1.0,0.0,1.0
6233,23,10,13,32,1,22,227,11,14.0,7.0,7.0,23.0,0.0,14.0,137.0,56,23,33,14.0,5.0,9.0
9903246,42,4,38,167,4,38,341,11,36.0,5.0,31.0,143.0,2.0,34.0,289.0,63,42,21,38.0,26.0,12.0
102201,41,10,31,181,0,41,676,19,33.0,5.0,28.0,171.0,0.0,33.0,558.0,86,41,45,57.0,32.0,25.0
202266,9,2,7,13,0,9,137,19,9.0,2.0,7.0,13.0,0.0,9.0,137.0,28,9,19,27.0,9.0,18.0
9806316,6,3,3,5,0,6,21,140,5.0,3.0,2.0,4.0,0.0,5.0,12.0,11,6,5,9.0,5.0,4.0
106052,9,8,1,1,2,7,27,19,1.0,1.0,0.0,0.0,0.0,1.0,1.0,26,9,17,3.0,0.0,3.0
9807572,5,3,2,3,2,3,9,354,2.0,2.0,0.0,0.0,0.0,2.0,3.0,12,5,7,4.0,2.0,2.0
9910224,12,6,6,8,1,11,39,25,1.0,1.0,0.0,0.0,0.0,1.0,6.0,24,12,12,2.0,2.0,0.0
109004,8,3,5,8,0,8,49,2,1.0,1.0,0.0,0.0,0.0,1.0,14.0,28,8,20,2.0,2.0,0.0
9904510,28,5,23,133,0,28,508,2,24.0,2.0,22.0,127.0,0.0,24.0,484.0,63,28,35,46.0,20.0,26.0
109247,5,1,4,5,0,5,27,28,4.0,1.0,3.0,4.0,0.0,4.0,4.0,18,5,13,1.0,0.0,1.0
9501249,8,7,1,1,6,2,2,26,3.0,3.0,0.0,0.0,1.0,2.0,2.0,10,8,2,1.0,0.0,1.0
9312226,18,7,11,18,18,0,0,198,5.0,1.0,4.0,7.0,5.0,0.0,0.0,18,18,0,5.0,5.0,0.0
4200,36,8,28,71,0,36,177,2,11.0,4.0,7.0,18.0,0.0,11.0,14.0,73,36,37,13.0,9.0,4.0
9909248,43,6,37,148,21,22,59,37,17.0,2.0,15.0,77.0,17.0,0.0,0.0,56,43,13,3.0,3.0,0.0
9505266,33,11,22,47,1,32,87,35,13.0,2.0,11.0,25.0,0.0,13.0,39.0,46,33,13,16.0,11.0,5.0
11147,3,1,2,2,0,3,16,2,3.0,1.0,2.0,2.0,3.0,0.0,0.0,30,3,27,4.0,3.0,1.0
9606212,33,8,25,119,3,30,132,60,14.0,3.0,11.0,53.0,0.0,14.0,74.0,48,33,15,23.0,15.0,8.0
9812513,19,5,14,38,2,17,60,10,9.0,4.0,5.0,8.0,0.0,9.0,38.0,27,19,8,13.0,7.0,6.0
102096,4,1,3,4,0,4,17,10,1.0,1.0,0.0,0.0,0.0,1.0,6.0,32,4,28,3.0,3.0,0.0
6092,5,4,1,2,0,5,7,28,3.0,3.0,0.0,0.0,0.0,3.0,3.0,15,5,10,1.0,1.0,0.0
9901450,3,1,2,2,0,3,14,28,3.0,1.0,2.0,2.0,0.0,3.0,10.0,13,3,10,8.0,3.0,5.0
9302292,41,15,26,76,41,0,0,50,10.0,4.0,6.0,19.0,10.0,0.0,0.0,41,41,0,9.0,9.0,0.0
9512285,5,5,0,0,5,0,0,855,2.0,2.0,0.0,0.0,2.0,0.0,0.0,5,5,0,2.0,2.0,0.0
9902244,7,4,3,3,2,5,28,8,1.0,1.0,0.0,0.0,0.0,1.0,8.0,34,7,27,4.0,2.0,2.0
9804306,30,2,28,102,5,25,46,95,23.0,1.0,22.0,88.0,4.0,19.0,33.0,38,30,8,15.0,14.0,1.0
9606327,7,4,3,6,2,5,15,6,4.0,1.0,3.0,6.0,0.0,4.0,8.0,15,7,8,6.0,3.0,3.0
109238,26,3,23,77,0,26,195,1,13.0,2.0,11.0,32.0,0.0,13.0,143.0,67,26,41,32.0,8.0,24.0
9033,10,4,6,9,3,7,61,7,5.0,1.0,4.0,6.0,2.0,3.0,35.0,28,10,18,18.0,2.0,16.0
9405288,9,3,6,11,2,7,12,35,1.0,1.0,0.0,0.0,0.0,1.0,1.0,13,9,4,3.0,2.0,1.0
9909236,7,2,5,6,2,5,24,34,2.0,1.0,1.0,1.0,0.0,2.0,12.0,24,7,17,1.0,0.0,1.0
9410284,6,3,3,4,0,6,29,75,1.0,1.0,0.0,0.0,0.0,1.0,9.0,29,6,23,7.0,2.0,5.0
9303264,18,7,11,20,18,0,0,79,7.0,1.0,6.0,13.0,7.0,0.0,0.0,18,18,0,5.0,5.0,0.0
9512318,2,1,1,1,1,1,2,72,1.0,1.0,0.0,0.0,0.0,1.0,1.0,4,2,2,2.0,1.0,1.0
9808332,16,3,13,43,1,15,189,11,14.0,2.0,12.0,41.0,0.0,14.0,171.0,43,16,27,18.0,11.0,7.0
9601242,22,4,18,48,22,0,0,77,9.0,1.0,8.0,24.0,9.0,0.0,0.0,22,22,0,8.0,8.0,0.0
9612301,15,7,8,17,1,14,70,17,9.0,4.0,5.0,10.0,0.0,9.0,55.0,30,15,15,4.0,4.0,0.0
9706369,11,3,8,18,0,11,125,17,10.0,2.0,8.0,18.0,0.0,10.0,114.0,41,11,30,23.0,6.0,17.0
9212208,9,4,5,7,9,0,0,211,5.0,3.0,2.0,3.0,5.0,0.0,0.0,9,9,0,4.0,4.0,0.0
9412206,28,14,14,28,1,27,99,26,18.0,12.0,6.0,13.0,0.0,18.0,82.0,36,28,8,19.0,12.0,7.0
9708423,7,2,5,10,1,6,12,25,3.0,2.0,1.0,1.0,1.0,2.0,2.0,14,7,7,3.0,2.0,1.0
9902458,7,3,4,9,0,7,26,104,6.0,2.0,4.0,9.0,0.0,6.0,17.0,12,7,5,8.0,5.0,3.0
9302211,13,6,7,14,13,0,0,67,2.0,1.0,1.0,1.0,2.0,0.0,0.0,13,13,0,2.0,2.0,0.0
9510366,14,3,11,19,6,8,18,6,6.0,2.0,4.0,7.0,5.0,1.0,1.0,22,14,8,3.0,2.0,1.0
9505220,10,1,9,11,1,9,22,21,,,,,,,,13,10,3,1.0,1.0,0.0
2134,23,6,17,49,2,21,122,4,16.0,3.0,13.0,41.0,0.0,16.0,84.0,46,23,23,10.0,7.0,3.0
9610333,8,5,3,4,0,8,85,7,1.0,1.0,0.0,0.0,0.0,1.0,11.0,35,8,27,1.0,1.0,0.0
9711307,32,7,25,68,19,13,37,95,14.0,3.0,11.0,26.0,9.0,5.0,22.0,40,32,8,9.0,4.0,5.0
9403261,10,6,4,5,5,5,5,79,4.0,2.0,2.0,3.0,4.0,0.0,0.0,11,10,1,3.0,3.0,0.0
9603392,8,4,4,5,8,0,0,327,3.0,2.0,1.0,1.0,3.0,0.0,0.0,8,8,0,3.0,3.0,0.0
9811208,13,7,6,14,5,8,15,192,3.0,2.0,1.0,2.0,0.0,3.0,6.0,17,13,4,5.0,3.0,2.0
9408292,3,3,0,0,2,1,2,413,1.0,1.0,0.0,0.0,0.0,1.0,2.0,5,3,2,3.0,1.0,2.0
9405323,8,5,3,4,1,7,9,414,3.0,3.0,0.0,0.0,3.0,0.0,0.0,10,8,2,5.0,4.0,1.0
9501213,81,20,61,252,47,34,67,54,29.0,3.0,26.0,153.0,18.0,11.0,14.0,97,81,16,24.0,23.0,1.0
105008,23,5,18,43,3,20,272,24,12.0,3.0,9.0,16.0,0.0,12.0,170.0,84,23,61,19.0,6.0,13.0
9906324,12,7,5,8,3,9,26,8,4.0,2.0,2.0,3.0,0.0,4.0,7.0,29,12,17,5.0,3.0,2.0
9711349,26,8,18,58,26,0,0,64,16.0,5.0,11.0,43.0,16.0,0.0,0.0,26,26,0,12.0,12.0,0.0
9511361,9,4,5,6,0,9,39,21,1.0,1.0,0.0,0.0,0.0,1.0,3.0,23,9,14,1.0,0.0,1.0
9711371,51,7,44,166,1,50,258,9,24.0,3.0,21.0,102.0,0.0,24.0,124.0,62,51,11,24.0,15.0,9.0
7218,53,22,31,64,1,52,464,14,12.0,5.0,7.0,16.0,0.0,12.0,61.0,174,53,121,18.0,4.0,14.0
1046,57,10,47,126,4,53,307,14,20.0,3.0,17.0,45.0,0.0,20.0,174.0,86,57,29,34.0,17.0,17.0
9707276,3,2,1,1,0,3,21,14,3.0,2.0,1.0,1.0,0.0,3.0,16.0,23,3,20,1.0,0.0,1.0
9311255,47,5,42,137,24,23,23,14,21.0,2.0,19.0,62.0,6.0,15.0,15.0,48,47,1,7.0,6.0,1.0
9703343,18,6,12,40,2,16,62,27,10.0,4.0,6.0,12.0,2.0,8.0,18.0,30,18,12,17.0,11.0,6.0
9912529,4,2,2,2,4,0,0,169,1.0,1.0,0.0,0.0,1.0,0.0,0.0,16,4,12,3.0,0.0,3.0
9412261,4,3,1,1,2,2,2,337,4.0,3.0,1.0,1.0,2.0,2.0,2.0,5,4,1,4.0,3.0,1.0
9507339,3,1,2,3,3,0,0,44,3.0,1.0,2.0,3.0,3.0,0.0,0.0,6,3,3,3.0,3.0,0.0
9403265,19,6,13,24,19,0,0,45,3.0,1.0,2.0,3.0,3.0,0.0,0.0,19,19,0,3.0,3.0,0.0
9910219,4,1,3,4,0,4,19,118,3.0,1.0,2.0,3.0,0.0,3.0,8.0,14,4,10,6.0,3.0,3.0
8091,14,6,8,15,0,14,65,17,7.0,3.0,4.0,6.0,0.0,7.0,41.0,40,14,26,5.0,2.0,3.0
9403396,9,5,4,5,1,8,25,17,3.0,2.0,1.0,1.0,3.0,0.0,0.0,15,9,6,3.0,3.0,0.0
9609203,4,2,2,2,2,2,3,1974,1.0,1.0,0.0,0.0,1.0,0.0,0.0,7,4,3,,,
9704295,12,7,5,5,6,6,10,14,4.0,4.0,0.0,0.0,0.0,4.0,5.0,17,12,5,2.0,2.0,0.0
9606204,1,1,0,0,1,0,0,232,0.0,0.0,0.0,0.0,0.0,0.0,0.0,3,1,2,2.0,0.0,2.0
9706459,2,2,0,0,0,2,11,16,1.0,1.0,0.0,0.0,0.0,1.0,3.0,11,2,9,5.0,0.0,5.0
9711403,28,9,19,53,26,2,3,16,13.0,2.0,11.0,33.0,13.0,0.0,0.0,30,28,2,7.0,7.0,0.0
9711406,12,1,11,36,0,12,90,8,8.0,1.0,7.0,21.0,0.0,8.0,55.0,28,12,16,19.0,8.0,11.0
9603294,5,2,3,4,0,5,5,111,2.0,1.0,1.0,1.0,2.0,0.0,0.0,7,5,2,3.0,2.0,1.0
9505391,55,3,52,330,1,54,198,8,44.0,2.0,42.0,270.0,0.0,44.0,150.0,67,55,12,34.0,29.0,5.0
9311367,30,9,21,123,15,15,24,15,20.0,4.0,16.0,95.0,7.0,13.0,20.0,33,30,3,8.0,7.0,1.0
9405365,9,1,8,20,1,8,13,15,1.0,1.0,0.0,0.0,1.0,0.0,0.0,11,9,2,7.0,6.0,1.0
9509338,4,3,1,1,2,2,6,15,1.0,1.0,0.0,0.0,1.0,0.0,0.0,7,4,3,2.0,2.0,0.0
9305222,13,7,6,11,0,13,26,15,7.0,4.0,3.0,4.0,0.0,7.0,8.0,19,13,6,6.0,5.0,1.0
9610223,44,16,28,55,33,11,11,67,16.0,4.0,12.0,24.0,9.0,7.0,7.0,45,44,1,8.0,7.0,1.0
9811308,32,8,24,89,5,27,56,4,15.0,1.0,14.0,51.0,2.0,13.0,28.0,40,32,8,2.0,2.0,0.0
9907372,19,2,17,65,5,14,52,0,16.0,1.0,15.0,57.0,8.0,8.0,19.0,34,19,15,10.0,6.0,4.0
9903353,4,4,0,0,2,2,6,292,0.0,0.0,0.0,0.0,0.0,0.0,0.0,15,4,11,1.0,1.0,0.0
9809234,12,8,4,4,2,10,90,0,3.0,2.0,1.0,1.0,0.0,3.0,27.0,100,12,88,17.0,1.0,16.0
9609325,16,3,13,29,8,8,16,10,9.0,2.0,7.0,15.0,2.0,7.0,15.0,23,16,7,8.0,5.0,3.0
9704326,10,6,4,5,7,3,13,52,2.0,2.0,0.0,0.0,0.0,2.0,5.0,17,10,7,3.0,3.0,0.0
9801376,8,5,3,3,0,8,60,5,2.0,2.0,0.0,0.0,0.0,2.0,17.0,46,8,38,9.0,0.0,9.0
9801204,10,2,8,13,1,9,69,15,7.0,2.0,5.0,9.0,1.0,6.0,35.0,28,10,18,3.0,1.0,2.0
9510364,1,1,0,0,1,0,0,1741,,,,,,,,1,1,0,,,
8205,6,4,2,3,6,0,0,128,1.0,1.0,0.0,0.0,1.0,0.0,0.0,13,6,7,2.0,0.0,2.0
9711240,14,4,10,27,6,8,15,120,11.0,1.0,10.0,27.0,4.0,7.0,14.0,18,14,4,12.0,10.0,2.0
6274,4,3,1,1,2,2,2,50,1.0,1.0,0.0,0.0,0.0,1.0,1.0,7,4,3,1.0,1.0,0.0
9307297,19,7,12,25,13,6,6,40,14.0,3.0,11.0,24.0,9.0,5.0,5.0,20,19,1,5.0,4.0,1.0
9704297,30,8,22,50,1,29,248,8,22.0,5.0,17.0,44.0,1.0,21.0,198.0,60,30,30,23.0,14.0,9.0
9701308,28,9,19,59,17,11,19,25,14.0,6.0,8.0,26.0,13.0,1.0,2.0,37,28,9,11.0,11.0,0.0
9712300,18,3,15,31,0,18,76,69,12.0,2.0,10.0,21.0,0.0,12.0,58.0,34,18,16,15.0,6.0,9.0
9412325,5,4,1,1,5,0,0,618,2.0,2.0,0.0,0.0,2.0,0.0,0.0,6,5,1,2.0,2.0,0.0
9810301,11,4,7,10,0,11,45,21,3.0,3.0,0.0,0.0,0.0,3.0,11.0,27,11,16,10.0,4.0,6.0
9910348,8,5,3,6,0,8,47,22,7.0,4.0,3.0,6.0,0.0,7.0,45.0,20,8,12,16.0,5.0,11.0
7176,78,26,52,188,12,66,419,46,36.0,6.0,30.0,113.0,1.0,35.0,249.0,141,78,63,37.0,21.0,16.0
9311327,5,5,0,0,4,1,1,78,1.0,1.0,0.0,0.0,1.0,0.0,0.0,6,5,1,1.0,1.0,0.0
9407409,9,7,2,3,2,7,7,281,3.0,1.0,2.0,3.0,0.0,3.0,3.0,11,9,2,2.0,2.0,0.0
9711512,5,4,1,1,1,4,27,14,0.0,0.0,0.0,0.0,0.0,0.0,0.0,42,5,37,4.0,0.0,4.0
9912261,31,3,28,95,0,31,150,30,24.0,5.0,19.0,72.0,0.0,24.0,136.0,41,31,10,24.0,16.0,8.0
9805327,12,1,11,19,4,8,45,30,11.0,1.0,10.0,18.0,3.0,8.0,45.0,19,12,7,14.0,8.0,6.0
9610513,7,2,5,7,1,6,16,41,3.0,1.0,2.0,3.0,0.0,3.0,6.0,15,7,8,9.0,4.0,5.0
9511284,12,3,9,19,0,12,25,60,7.0,3.0,4.0,7.0,0.0,7.0,16.0,16,12,4,8.0,4.0,4.0
9907474,23,6,17,42,0,23,179,32,12.0,5.0,7.0,14.0,0.0,12.0,116.0,60,23,37,13.0,9.0,4.0
3198,26,9,17,39,4,22,111,32,14.0,6.0,8.0,19.0,0.0,14.0,69.0,37,26,11,6.0,5.0,1.0
1188,10,2,8,10,1,9,21,13,5.0,1.0,4.0,6.0,0.0,5.0,14.0,24,10,14,2.0,0.0,2.0
9907333,33,11,22,60,2,31,151,13,26.0,5.0,21.0,56.0,0.0,26.0,142.0,47,33,14,27.0,14.0,13.0
11105,5,2,3,4,0,5,5,131,4.0,1.0,3.0,4.0,0.0,4.0,4.0,6,5,1,5.0,4.0,1.0
9509222,6,3,3,3,1,5,13,14,2.0,2.0,0.0,0.0,2.0,0.0,0.0,12,6,6,2.0,2.0,0.0
9706326,10,2,8,17,4,6,13,8,5.0,1.0,4.0,6.0,2.0,3.0,3.0,18,10,8,6.0,5.0,1.0
210145,10,7,3,3,0,10,75,7,2.0,2.0,0.0,0.0,0.0,2.0,9.0,56,10,46,18.0,2.0,16.0
101347,14,8,6,9,2,12,100,12,8.0,3.0,5.0,8.0,0.0,8.0,41.0,42,14,28,18.0,8.0,10.0
3012,17,5,12,27,1,16,111,12,8.0,2.0,6.0,10.0,0.0,8.0,46.0,45,17,28,14.0,7.0,7.0
9711234,15,5,10,17,1,14,38,61,0.0,0.0,0.0,0.0,0.0,0.0,0.0,37,15,22,6.0,1.0,5.0
105155,40,22,18,29,3,37,222,14,2.0,2.0,0.0,0.0,0.0,2.0,16.0,166,40,126,10.0,4.0,6.0
9506244,2,1,1,1,2,0,0,94,0.0,0.0,0.0,0.0,0.0,0.0,0.0,13,2,11,2.0,0.0,2.0
9701389,22,5,17,36,2,20,65,89,12.0,1.0,11.0,24.0,2.0,10.0,18.0,33,22,11,4.0,3.0,1.0
5208,23,10,13,30,2,21,69,31,15.0,5.0,10.0,18.0,3.0,12.0,31.0,37,23,14,4.0,4.0,0.0
9612349,4,2,2,2,1,3,92,6,3.0,1.0,2.0,2.0,0.0,3.0,84.0,58,4,54,31.0,2.0,29.0
7012,23,6,17,47,0,23,127,30,17.0,4.0,13.0,43.0,0.0,17.0,95.0,41,23,18,13.0,7.0,6.0
208228,5,4,1,1,0,5,47,21,1.0,1.0,0.0,0.0,0.0,1.0,14.0,39,5,34,14.0,4.0,10.0
9803480,6,6,0,0,1,5,7,204,0.0,0.0,0.0,0.0,0.0,0.0,0.0,44,6,38,9.0,1.0,8.0
9711232,4,4,0,0,0,4,12,5,0.0,0.0,0.0,0.0,0.0,0.0,0.0,81,4,77,12.0,0.0,12.0
9901306,17,4,13,59,2,15,165,21,15.0,3.0,12.0,56.0,0.0,15.0,165.0,41,17,24,33.0,12.0,21.0
9801270,17,11,6,7,7,10,53,7,5.0,3.0,2.0,3.0,0.0,5.0,28.0,38,17,21,2.0,2.0,0.0
9608281,11,1,10,38,0,11,40,34,10.0,1.0,9.0,33.0,0.0,10.0,38.0,16,11,5,2.0,2.0,0.0
9907514,14,3,11,29,2,12,75,34,11.0,1.0,10.0,27.0,0.0,11.0,60.0,39,14,25,11.0,0.0,11.0
9412334,28,10,18,41,15,13,18,68,10.0,3.0,7.0,15.0,10.0,0.0,0.0,31,28,3,9.0,9.0,0.0
1173,1,1,0,0,1,0,0,73,0.0,0.0,0.0,0.0,0.0,0.0,0.0,23,1,22,19.0,0.0,19.0
9808294,10,2,8,11,0,10,36,143,9.0,2.0,7.0,10.0,0.0,9.0,31.0,17,10,7,12.0,7.0,5.0
9905277,10,5,5,6,1,9,29,7,3.0,1.0,2.0,2.0,0.0,3.0,7.0,30,10,20,7.0,3.0,4.0
9602341,11,4,7,7,4,7,21,4,3.0,3.0,0.0,0.0,2.0,1.0,2.0,22,11,11,3.0,1.0,2.0
110028,5,4,1,1,0,5,18,339,2.0,2.0,0.0,0.0,0.0,2.0,4.0,16,5,11,5.0,2.0,3.0
9905392,32,8,24,57,8,24,65,129,10.0,1.0,9.0,18.0,3.0,7.0,18.0,47,32,15,9.0,5.0,4.0
9606471,6,6,0,0,2,4,7,222,2.0,2.0,0.0,0.0,0.0,2.0,4.0,14,6,8,4.0,2.0,2.0
9311207,12,9,3,7,2,10,25,75,7.0,5.0,2.0,5.0,0.0,7.0,21.0,16,12,4,6.0,5.0,1.0
9912488,19,3,16,76,1,18,91,8,16.0,1.0,15.0,74.0,0.0,16.0,70.0,32,19,13,19.0,10.0,9.0
9909496,9,5,4,7,0,9,37,2,6.0,5.0,1.0,3.0,1.0,5.0,11.0,19,9,10,7.0,4.0,3.0
9711263,4,2,2,2,0,4,25,15,2.0,1.0,1.0,1.0,0.0,2.0,6.0,19,4,15,7.0,1.0,6.0
6129,21,4,17,40,6,15,22,172,11.0,1.0,10.0,29.0,3.0,8.0,14.0,24,21,3,12.0,10.0,2.0
9910214,9,3,6,13,0,9,137,21,8.0,3.0,5.0,12.0,0.0,8.0,135.0,50,9,41,41.0,6.0,35.0
106210,4,3,1,1,1,3,3,0,,,,,,,,5,4,1,1.0,1.0,0.0
9611350,8,8,0,0,3,5,13,200,8.0,8.0,0.0,0.0,3.0,5.0,13.0,17,8,9,10.0,3.0,7.0
9512234,18,4,14,30,3,15,20,13,14.0,3.0,11.0,24.0,2.0,12.0,17.0,21,18,3,6.0,6.0,0.0
9402315,7,4,3,4,6,1,2,355,5.0,3.0,2.0,3.0,5.0,0.0,0.0,9,7,2,4.0,4.0,0.0
2177,20,6,14,41,0,20,169,3,17.0,6.0,11.0,35.0,0.0,17.0,146.0,54,20,34,11.0,7.0,4.0
9610533,12,4,8,13,1,11,44,169,4.0,1.0,3.0,4.0,0.0,4.0,7.0,32,12,20,7.0,4.0,3.0
6198,3,2,1,1,0,3,21,69,3.0,2.0,1.0,1.0,0.0,3.0,15.0,24,3,21,1.0,0.0,1.0
8044,31,3,28,128,0,31,155,0,13.0,1.0,12.0,56.0,0.0,13.0,83.0,66,31,35,23.0,15.0,8.0
111224,9,1,8,20,0,9,91,0,6.0,1.0,5.0,12.0,0.0,6.0,51.0,30,9,21,19.0,7.0,12.0
104200,24,6,18,60,2,22,217,3,11.0,1.0,10.0,38.0,1.0,10.0,47.0,63,24,39,18.0,12.0,6.0
209258,3,0,3,3,0,3,8,393,3.0,0.0,3.0,3.0,0.0,3.0,5.0,6,3,3,5.0,3.0,2.0
9508297,18,2,16,72,0,18,28,68,14.0,1.0,13.0,64.0,0.0,14.0,14.0,22,18,4,13.0,12.0,1.0
108102,22,4,18,82,0,22,142,37,17.0,4.0,13.0,58.0,0.0,17.0,114.0,40,22,18,23.0,13.0,10.0
9708454,8,4,4,6,8,0,0,67,4.0,3.0,1.0,1.0,4.0,0.0,0.0,8,8,0,2.0,2.0,0.0
9809475,12,5,7,13,0,12,57,69,8.0,4.0,4.0,10.0,0.0,8.0,32.0,22,12,10,12.0,5.0,7.0
104225,9,4,5,8,0,9,195,23,7.0,3.0,4.0,7.0,0.0,7.0,170.0,53,9,44,21.0,3.0,18.0
9511439,3,3,0,0,3,0,0,589,1.0,1.0,0.0,0.0,1.0,0.0,0.0,4,3,1,1.0,1.0,0.0
9702370,8,5,3,6,0,8,17,183,5.0,2.0,3.0,6.0,0.0,5.0,9.0,19,8,11,7.0,4.0,3.0
9811313,17,16,1,1,4,13,69,25,1.0,1.0,0.0,0.0,0.0,1.0,9.0,138,17,121,11.0,1.0,10.0
9901381,15,5,10,22,15,0,0,13,14.0,4.0,10.0,22.0,14.0,0.0,0.0,16,15,1,1.0,1.0,0.0
9604333,11,4,7,29,1,10,36,94,9.0,2.0,7.0,29.0,0.0,9.0,31.0,21,11,10,13.0,9.0,4.0
9904417,6,4,2,2,0,6,21,92,4.0,3.0,1.0,1.0,0.0,4.0,8.0,14,6,8,4.0,2.0,2.0
5170,1,1,0,0,1,0,0,32,0.0,0.0,0.0,0.0,0.0,0.0,0.0,13,1,12,5.0,0.0,5.0
9603389,16,8,8,16,7,9,17,53,9.0,4.0,5.0,7.0,5.0,4.0,4.0,20,16,4,5.0,5.0,0.0
212129,24,10,14,41,7,17,73,0,6.0,1.0,5.0,9.0,1.0,5.0,28.0,44,24,20,14.0,4.0,10.0
11059,5,1,4,7,0,5,55,15,5.0,1.0,4.0,7.0,0.0,5.0,55.0,20,5,15,13.0,5.0,8.0
210380,1,1,0,0,0,1,4,4,1.0,1.0,0.0,0.0,0.0,1.0,4.0,13,1,12,5.0,1.0,4.0
9309231,5,2,3,4,0,5,21,176,5.0,2.0,3.0,4.0,0.0,5.0,21.0,10,5,5,10.0,5.0,5.0
1072,33,5,28,90,0,33,69,2,13.0,2.0,11.0,22.0,11.0,2.0,2.0,42,33,9,15.0,14.0,1.0
2268,24,9,15,33,1,23,134,27,14.0,5.0,9.0,17.0,0.0,14.0,86.0,45,24,21,13.0,8.0,5.0
9609207,25,7,18,60,1,24,75,130,20.0,6.0,14.0,44.0,0.0,20.0,57.0,30,25,5,18.0,14.0,4.0
107262,4,3,1,1,0,4,29,43,2.0,2.0,0.0,0.0,0.0,2.0,9.0,29,4,25,8.0,0.0,8.0
105175,28,4,24,109,2,26,156,46,21.0,2.0,19.0,91.0,2.0,19.0,108.0,63,28,35,29.0,18.0,11.0
107011,6,3,3,6,1,5,13,44,4.0,2.0,2.0,4.0,0.0,4.0,4.0,16,6,10,7.0,1.0,6.0
109018,12,3,9,26,0,12,156,3,9.0,2.0,7.0,20.0,0.0,9.0,57.0,50,12,38,18.0,10.0,8.0
9807549,10,5,5,10,0,10,43,3,2.0,2.0,0.0,0.0,0.0,2.0,8.0,35,10,25,9.0,3.0,6.0
208026,24,7,17,36,4,20,119,0,10.0,3.0,7.0,12.0,0.0,10.0,73.0,59,24,35,21.0,7.0,14.0
9907548,30,6,24,94,1,29,165,50,24.0,3.0,21.0,90.0,1.0,23.0,140.0,41,30,11,26.0,17.0,9.0
9711304,3,3,0,0,1,2,2,241,2.0,2.0,0.0,0.0,1.0,1.0,1.0,7,3,4,2.0,1.0,1.0
107249,4,3,1,2,0,4,14,95,2.0,2.0,0.0,0.0,0.0,2.0,3.0,13,4,9,1.0,0.0,1.0
9810340,8,1,7,13,0,8,128,9,7.0,1.0,6.0,12.0,0.0,7.0,49.0,33,8,25,14.0,7.0,7.0
204021,5,3,2,2,0,5,16,3,3.0,2.0,1.0,1.0,0.0,3.0,8.0,20,5,15,5.0,0.0,5.0
108247,9,2,7,16,0,9,96,37,8.0,2.0,6.0,14.0,0.0,8.0,76.0,45,9,36,20.0,6.0,14.0
5249,9,4,5,6,1,8,41,3,0.0,0.0,0.0,0.0,0.0,0.0,0.0,48,9,39,15.0,0.0,15.0
9710277,20,6,14,26,5,15,55,62,3.0,3.0,0.0,0.0,0.0,3.0,15.0,51,20,31,13.0,1.0,12.0
9701260,28,12,16,44,3,25,57,166,16.0,5.0,11.0,33.0,2.0,14.0,14.0,37,28,9,10.0,9.0,1.0
111223,3,3,0,0,0,3,9,11,1.0,1.0,0.0,0.0,1.0,0.0,0.0,22,3,19,8.0,0.0,8.0
9807497,21,2,19,53,0,21,127,9,17.0,2.0,15.0,45.0,0.0,17.0,107.0,36,21,15,25.0,12.0,13.0
9603251,10,8,2,2,5,5,16,100,2.0,1.0,1.0,1.0,0.0,2.0,8.0,37,10,27,9.0,2.0,7.0
9705465,4,1,3,3,0,4,18,1,3.0,1.0,2.0,2.0,0.0,3.0,13.0,14,4,10,9.0,4.0,5.0
9810425,15,1,14,23,0,15,29,54,8.0,1.0,7.0,7.0,6.0,2.0,3.0,26,15,11,9.0,8.0,1.0
9806434,6,2,4,9,0,6,32,11,4.0,1.0,3.0,6.0,0.0,4.0,22.0,21,6,15,1.0,0.0,1.0
9905309,38,3,35,107,4,34,162,13,26.0,2.0,24.0,82.0,3.0,23.0,87.0,51,38,13,22.0,16.0,6.0
9905539,11,1,10,25,0,11,43,13,9.0,1.0,8.0,22.0,0.0,9.0,34.0,16,11,5,13.0,9.0,4.0
9312219,4,2,2,2,1,3,6,291,1.0,1.0,0.0,0.0,0.0,1.0,1.0,9,4,5,2.0,1.0,1.0
9908481,6,6,0,0,0,6,26,83,3.0,3.0,0.0,0.0,0.0,3.0,11.0,17,6,11,9.0,2.0,7.0
102318,2,2,0,0,0,2,19,4,2.0,2.0,0.0,0.0,0.0,2.0,18.0,12,2,10,4.0,1.0,3.0
9909508,11,8,3,3,1,10,18,21,1.0,1.0,0.0,0.0,1.0,0.0,0.0,26,11,15,4.0,1.0,3.0
9210267,2,1,1,1,2,0,0,751,1.0,1.0,0.0,0.0,1.0,0.0,0.0,2,2,0,1.0,1.0,0.0
9704411,2,2,0,0,1,1,1,97,0.0,0.0,0.0,0.0,0.0,0.0,0.0,13,2,11,1.0,0.0,1.0
9602248,6,2,4,4,1,5,13,235,3.0,1.0,2.0,2.0,0.0,3.0,4.0,15,6,9,5.0,3.0,2.0
9602340,8,3,5,8,3,5,9,173,5.0,1.0,4.0,7.0,4.0,1.0,2.0,14,8,6,6.0,5.0,1.0
9611258,7,5,2,3,0,7,35,17,5.0,3.0,2.0,3.0,0.0,5.0,13.0,23,7,16,8.0,4.0,4.0
10133,4,3,1,1,2,2,34,24,2.0,1.0,1.0,1.0,0.0,2.0,20.0,21,4,17,4.0,2.0,2.0
9806436,9,1,8,11,4,5,9,13,6.0,1.0,5.0,7.0,6.0,0.0,0.0,11,9,2,2.0,2.0,0.0
9607461,10,6,4,9,8,2,3,255,5.0,3.0,2.0,4.0,5.0,0.0,0.0,14,10,4,6.0,6.0,0.0
9811375,27,8,19,48,8,19,20,128,18.0,2.0,16.0,42.0,4.0,14.0,14.0,30,27,3,14.0,13.0,1.0
9807333,1,1,0,0,1,0,0,85,0.0,0.0,0.0,0.0,0.0,0.0,0.0,9,1,8,3.0,0.0,3.0
101353,6,2,4,8,5,1,4,95,5.0,1.0,4.0,8.0,5.0,0.0,0.0,26,6,20,5.0,1.0,4.0
9508376,1,1,0,0,0,1,1,26,0.0,0.0,0.0,0.0,0.0,0.0,0.0,11,1,10,10.0,0.0,10.0
9302286,5,5,0,0,5,0,0,487,3.0,3.0,0.0,0.0,3.0,0.0,0.0,5,5,0,2.0,2.0,0.0
9604380,6,3,3,3,3,3,4,93,3.0,1.0,2.0,2.0,3.0,0.0,0.0,9,6,3,2.0,2.0,0.0
9901428,1,1,0,0,0,1,18,21,1.0,1.0,0.0,0.0,0.0,1.0,5.0,20,1,19,9.0,1.0,8.0
9211251,8,7,1,3,8,0,0,155,6.0,5.0,1.0,2.0,6.0,0.0,0.0,8,8,0,3.0,3.0,0.0
9709209,5,4,1,1,2,3,3,210,2.0,2.0,0.0,0.0,0.0,2.0,2.0,6,5,1,3.0,2.0,1.0
9610464,8,5,3,5,1,7,45,36,6.0,3.0,3.0,5.0,0.0,6.0,39.0,20,8,12,16.0,5.0,11.0
112015,4,3,1,1,1,3,6,52,4.0,3.0,1.0,1.0,4.0,0.0,0.0,11,4,7,4.0,3.0,1.0
7298,24,14,10,16,0,24,191,33,13.0,8.0,5.0,10.0,0.0,13.0,116.0,99,24,75,25.0,5.0,20.0
9412307,1,1,0,0,0,1,8,75,0.0,0.0,0.0,0.0,0.0,0.0,0.0,9,1,8,,,
9705312,5,4,1,1,2,3,22,22,3.0,2.0,1.0,1.0,0.0,3.0,19.0,20,5,15,3.0,2.0,1.0
9703393,1,1,0,0,1,0,0,7,0.0,0.0,0.0,0.0,0.0,0.0,0.0,9,1,8,,,
9204208,5,4,1,1,5,0,0,105,1.0,1.0,0.0,0.0,1.0,0.0,0.0,5,5,0,1.0,1.0,0.0
9912474,3,2,1,1,0,3,12,90,2.0,1.0,1.0,1.0,0.0,2.0,8.0,20,3,17,6.0,1.0,5.0
9703458,1,1,0,0,0,1,1,303,0.0,0.0,0.0,0.0,0.0,0.0,0.0,9,1,8,3.0,0.0,3.0
9605241,2,2,0,0,2,0,0,114,,,,,,,,3,2,1,,,
9294,16,3,13,31,1,15,77,0,10.0,1.0,9.0,21.0,0.0,10.0,30.0,37,16,21,15.0,9.0,6.0
9907228,20,5,15,45,8,12,17,8,11.0,3.0,8.0,21.0,2.0,9.0,14.0,24,20,4,13.0,10.0,3.0
9327,4,1,3,5,0,4,15,177,4.0,1.0,3.0,5.0,0.0,4.0,13.0,9,4,5,8.0,4.0,4.0
9608360,3,1,2,2,0,3,6,97,3.0,1.0,2.0,2.0,0.0,3.0,6.0,5,3,2,2.0,2.0,0.0
9502299,1,1,0,0,1,0,0,1084,1.0,1.0,0.0,0.0,1.0,0.0,0.0,1,1,0,,,
9406227,39,3,36,234,4,35,191,53,33.0,1.0,32.0,216.0,2.0,31.0,184.0,48,39,9,37.0,29.0,8.0
9909207,10,1,9,20,0,10,53,3,7.0,1.0,6.0,11.0,0.0,7.0,18.0,40,10,30,12.0,8.0,4.0
9802429,8,3,5,9,0,8,24,25,5.0,3.0,2.0,3.0,0.0,5.0,19.0,14,8,6,8.0,5.0,3.0
9180,2,2,0,0,0,2,16,102,1.0,1.0,0.0,0.0,0.0,1.0,4.0,14,2,12,5.0,1.0,4.0
9808462,7,5,2,4,1,6,12,14,1.0,1.0,0.0,0.0,1.0,0.0,0.0,10,7,3,1.0,0.0,1.0
9503329,7,2,5,8,5,2,7,88,2.0,1.0,1.0,1.0,0.0,2.0,6.0,13,7,6,7.0,2.0,5.0
9812498,18,3,15,33,0,18,76,8,13.0,2.0,11.0,23.0,2.0,11.0,28.0,28,18,10,16.0,10.0,6.0
9508387,10,4,6,11,6,4,6,14,3.0,1.0,2.0,2.0,1.0,2.0,2.0,14,10,4,1.0,1.0,0.0
9704291,5,4,1,1,0,5,23,41,3.0,2.0,1.0,1.0,0.0,3.0,13.0,41,5,36,12.0,2.0,10.0
9602365,1,1,0,0,1,0,0,648,1.0,1.0,0.0,0.0,1.0,0.0,0.0,4,1,3,2.0,1.0,1.0
9610249,4,2,2,2,0,4,7,138,1.0,1.0,0.0,0.0,0.0,1.0,3.0,10,4,6,2.0,2.0,0.0
9510375,2,1,1,1,0,2,4,167,2.0,1.0,1.0,1.0,0.0,2.0,4.0,4,2,2,4.0,2.0,2.0
9908224,9,3,6,15,2,7,9,294,6.0,1.0,5.0,14.0,0.0,6.0,8.0,11,9,2,8.0,6.0,2.0
9606294,8,6,2,2,5,3,5,101,3.0,3.0,0.0,0.0,3.0,0.0,0.0,16,8,8,5.0,3.0,2.0
9605298,34,12,22,58,1,33,92,115,22.0,9.0,13.0,31.0,0.0,22.0,74.0,38,34,4,19.0,16.0,3.0
9610326,16,4,12,16,0,16,31,31,15.0,4.0,11.0,15.0,0.0,15.0,25.0,20,16,4,4.0,4.0,0.0
9807560,4,4,0,0,1,3,14,27,3.0,3.0,0.0,0.0,1.0,2.0,8.0,13,4,9,1.0,1.0,0.0
102071,18,8,10,19,1,17,67,27,17.0,8.0,9.0,18.0,0.0,17.0,66.0,38,18,20,10.0,8.0,2.0
9812383,4,1,3,5,0,4,27,14,4.0,1.0,3.0,5.0,0.0,4.0,22.0,71,4,67,14.0,0.0,14.0
9909500,11,6,5,8,7,4,11,198,5.0,3.0,2.0,2.0,1.0,4.0,11.0,21,11,10,10.0,3.0,7.0
9510233,2,2,0,0,1,1,1,331,0.0,0.0,0.0,0.0,0.0,0.0,0.0,6,2,4,2.0,1.0,1.0
9711455,9,3,6,8,1,8,23,56,7.0,2.0,5.0,7.0,0.0,7.0,22.0,14,9,5,2.0,2.0,0.0
9803245,7,2,5,8,0,7,24,56,6.0,2.0,4.0,6.0,0.0,6.0,23.0,18,7,11,4.0,4.0,0.0
210436,2,2,0,0,0,2,14,37,2.0,2.0,0.0,0.0,0.0,2.0,14.0,24,2,22,7.0,0.0,7.0
206152,20,10,10,26,0,20,130,193,15.0,6.0,9.0,24.0,0.0,15.0,66.0,41,20,21,21.0,14.0,7.0
9712399,3,2,1,1,0,3,7,29,1.0,1.0,0.0,0.0,0.0,1.0,4.0,7,3,4,1.0,1.0,0.0
111341,1,1,0,0,0,1,13,38,1.0,1.0,0.0,0.0,0.0,1.0,11.0,35,1,34,18.0,1.0,17.0
4116,7,3,4,5,0,7,58,11,6.0,3.0,3.0,4.0,0.0,6.0,53.0,28,7,21,9.0,2.0,7.0
9704202,6,3,3,3,0,6,36,63,4.0,1.0,3.0,3.0,0.0,4.0,25.0,25,6,19,11.0,4.0,7.0
9501223,16,1,15,47,8,8,15,22,13.0,1.0,12.0,36.0,6.0,7.0,12.0,19,16,3,14.0,12.0,2.0
6183,9,3,6,8,0,9,24,18,5.0,1.0,4.0,5.0,0.0,5.0,14.0,16,9,7,2.0,1.0,1.0
9308236,11,9,2,4,11,0,0,199,7.0,6.0,1.0,1.0,7.0,0.0,0.0,11,11,0,4.0,4.0,0.0
204243,1,1,0,0,0,1,6,2,1.0,1.0,0.0,0.0,0.0,1.0,5.0,52,1,51,25.0,0.0,25.0
9310288,5,5,0,0,5,0,0,250,3.0,3.0,0.0,0.0,3.0,0.0,0.0,5,5,0,2.0,2.0,0.0
5090,2,1,1,1,0,2,12,31,2.0,1.0,1.0,1.0,0.0,2.0,10.0,8,2,6,3.0,2.0,1.0
9706550,5,5,0,0,2,3,4,30,0.0,0.0,0.0,0.0,0.0,0.0,0.0,9,5,4,1.0,0.0,1.0
9709255,1,1,0,0,0,1,15,16,1.0,1.0,0.0,0.0,0.0,1.0,7.0,22,1,21,7.0,1.0,6.0
111436,1,1,0,0,0,1,1,28,1.0,1.0,0.0,0.0,0.0,1.0,1.0,10,1,9,4.0,0.0,4.0
9506381,8,3,5,11,1,7,17,16,6.0,2.0,4.0,6.0,2.0,4.0,4.0,13,8,5,5.0,4.0,1.0
9612207,14,5,9,14,4,10,12,168,5.0,1.0,4.0,5.0,5.0,0.0,0.0,18,14,4,7.0,6.0,1.0
9809479,2,2,0,0,0,2,5,1,0.0,0.0,0.0,0.0,0.0,0.0,0.0,28,2,26,4.0,0.0,4.0
107165,36,7,29,111,1,35,382,1,28.0,2.0,26.0,106.0,0.0,28.0,310.0,77,36,41,38.0,21.0,17.0
206272,6,2,4,6,0,6,49,73,2.0,2.0,0.0,0.0,0.0,2.0,17.0,29,6,23,3.0,2.0,1.0
3045,7,5,2,3,0,7,56,21,1.0,1.0,0.0,0.0,0.0,1.0,3.0,32,7,25,10.0,1.0,9.0
208241,5,1,4,4,0,5,21,219,4.0,2.0,2.0,2.0,0.0,4.0,18.0,12,5,7,10.0,4.0,6.0
9502386,10,5,5,7,10,0,0,292,5.0,2.0,3.0,5.0,5.0,0.0,0.0,10,10,0,5.0,5.0,0.0
9908247,22,11,11,15,3,19,44,13,9.0,7.0,2.0,4.0,1.0,8.0,22.0,31,22,9,3.0,3.0,0.0
9411379,13,7,6,6,7,6,6,194,7.0,3.0,4.0,4.0,2.0,5.0,5.0,14,13,1,7.0,6.0,1.0
9403297,9,3,6,17,1,8,21,61,4.0,1.0,3.0,6.0,0.0,4.0,12.0,16,9,7,10.0,7.0,3.0
6103,9,6,3,5,2,7,31,50,6.0,3.0,3.0,4.0,0.0,6.0,30.0,18,9,9,11.0,4.0,7.0
9302261,5,4,1,1,5,0,0,234,1.0,1.0,0.0,0.0,1.0,0.0,0.0,5,5,0,2.0,2.0,0.0
9308289,6,4,2,2,1,5,6,329,4.0,3.0,1.0,1.0,2.0,2.0,2.0,9,6,3,4.0,3.0,1.0
9503461,11,5,6,14,4,7,28,24,5.0,2.0,3.0,5.0,0.0,5.0,13.0,27,11,16,8.0,5.0,3.0
9908275,1,1,0,0,0,1,2,287,0.0,0.0,0.0,0.0,0.0,0.0,0.0,3,1,2,1.0,0.0,1.0
9402256,10,3,7,13,7,3,3,187,7.0,2.0,5.0,10.0,7.0,0.0,0.0,11,10,1,4.0,4.0,0.0
9711205,4,4,0,0,4,0,0,67,1.0,1.0,0.0,0.0,1.0,0.0,0.0,10,4,6,1.0,0.0,1.0
2128,6,4,2,3,0,6,20,41,1.0,1.0,0.0,0.0,0.0,1.0,7.0,24,6,18,3.0,2.0,1.0
9809454,10,6,4,6,7,3,3,106,2.0,1.0,1.0,1.0,1.0,1.0,1.0,14,10,4,1.0,1.0,0.0
9605384,1,1,0,0,0,1,2,111,1.0,1.0,0.0,0.0,0.0,1.0,1.0,3,1,2,2.0,1.0,1.0
9410219,5,1,4,6,5,0,0,72,5.0,1.0,4.0,6.0,5.0,0.0,0.0,5,5,0,3.0,3.0,0.0
302055,0,0,0,0,0,0,0,22,0.0,0.0,0.0,0.0,0.0,0.0,0.0,19,0,19,9.0,0.0,9.0
106292,4,2,2,3,0,4,9,22,2.0,1.0,1.0,1.0,0.0,2.0,7.0,14,4,10,6.0,2.0,4.0
9706530,27,10,17,33,4,23,126,40,20.0,5.0,15.0,27.0,0.0,20.0,110.0,45,27,18,27.0,17.0,10.0
10092,4,4,0,0,1,3,12,120,2.0,2.0,0.0,0.0,0.0,2.0,5.0,14,4,10,1.0,1.0,0.0
103081,4,2,2,3,0,4,27,26,0.0,0.0,0.0,0.0,0.0,0.0,0.0,25,4,21,13.0,1.0,12.0
9406260,8,7,1,1,8,0,0,9,7.0,6.0,1.0,1.0,7.0,0.0,0.0,9,8,1,6.0,6.0,0.0
9704408,10,6,4,6,9,1,1,72,2.0,2.0,0.0,0.0,2.0,0.0,0.0,14,10,4,5.0,5.0,0.0
10323,3,2,1,1,0,3,6,122,2.0,1.0,1.0,1.0,0.0,2.0,4.0,5,3,2,4.0,2.0,2.0
9901221,24,3,21,91,5,19,25,4,19.0,2.0,17.0,71.0,11.0,8.0,10.0,33,24,9,10.0,10.0,0.0
9909542,26,3,23,116,0,26,340,70,26.0,3.0,23.0,116.0,0.0,26.0,340.0,41,26,15,38.0,24.0,14.0
3299,7,3,4,6,0,7,13,0,6.0,2.0,4.0,6.0,0.0,6.0,11.0,12,7,5,4.0,3.0,1.0
107060,9,4,5,7,0,9,68,67,5.0,2.0,3.0,3.0,0.0,5.0,39.0,32,9,23,18.0,3.0,15.0
9903532,10,6,4,4,3,7,21,65,3.0,2.0,1.0,1.0,0.0,3.0,10.0,17,10,7,6.0,2.0,4.0
9907397,3,2,1,1,0,3,15,3,1.0,1.0,0.0,0.0,1.0,0.0,0.0,14,3,11,1.0,1.0,0.0
9090,7,6,1,1,4,3,6,51,2.0,2.0,0.0,0.0,0.0,2.0,3.0,13,7,6,3.0,3.0,0.0
209017,1,1,0,0,0,1,3,0,1.0,1.0,0.0,0.0,0.0,1.0,3.0,15,1,14,8.0,1.0,7.0
109161,3,2,1,1,0,3,13,55,3.0,2.0,1.0,1.0,0.0,3.0,13.0,13,3,10,,,
7346,8,6,2,2,3,5,27,3,4.0,3.0,1.0,1.0,0.0,4.0,19.0,71,8,63,23.0,1.0,22.0
9703399,1,1,0,0,0,1,2,279,1.0,1.0,0.0,0.0,1.0,0.0,0.0,4,1,3,1.0,1.0,0.0
9405335,3,1,2,3,0,3,6,108,3.0,1.0,2.0,3.0,0.0,3.0,6.0,6,3,3,1.0,0.0,1.0
9910519,6,4,2,2,6,0,0,319,1.0,1.0,0.0,0.0,1.0,0.0,0.0,8,6,2,2.0,2.0,0.0
9210214,5,2,3,6,5,0,0,19,2.0,2.0,0.0,0.0,2.0,0.0,0.0,5,5,0,,,
9407236,3,2,1,1,3,0,0,525,3.0,2.0,1.0,1.0,3.0,0.0,0.0,4,3,1,2.0,2.0,0.0
210291,9,8,1,1,1,8,79,1,2.0,2.0,0.0,0.0,0.0,2.0,20.0,119,9,110,15.0,0.0,15.0
201142,3,2,1,1,1,2,2,64,1.0,1.0,0.0,0.0,1.0,0.0,0.0,6,3,3,2.0,2.0,0.0
111313,2,2,0,0,0,2,3,1,0.0,0.0,0.0,0.0,0.0,0.0,0.0,32,2,30,4.0,1.0,3.0
9609324,8,6,2,2,0,8,89,34,0.0,0.0,0.0,0.0,0.0,0.0,0.0,68,8,60,5.0,0.0,5.0
9409204,8,2,6,17,0,8,11,14,8.0,2.0,6.0,17.0,0.0,8.0,10.0,11,8,3,3.0,3.0,0.0
9905466,15,10,5,6,2,13,81,5,1.0,1.0,0.0,0.0,0.0,1.0,9.0,132,15,117,29.0,0.0,29.0
8169,1,1,0,0,1,0,0,873,1.0,1.0,0.0,0.0,1.0,0.0,0.0,1,1,0,,,
4153,10,3,7,8,8,2,2,191,4.0,2.0,2.0,2.0,4.0,0.0,0.0,12,10,2,5.0,5.0,0.0
9803431,7,2,5,8,0,7,23,100,7.0,2.0,5.0,8.0,0.0,7.0,23.0,15,7,8,13.0,7.0,6.0
9309285,7,3,4,5,4,3,3,279,2.0,1.0,1.0,1.0,2.0,0.0,0.0,8,7,1,2.0,2.0,0.0
9512319,24,5,19,58,4,20,51,113,19.0,4.0,15.0,44.0,4.0,15.0,40.0,33,24,9,17.0,14.0,3.0
9503342,2,2,0,0,1,1,5,223,0.0,0.0,0.0,0.0,0.0,0.0,0.0,11,2,9,3.0,0.0,3.0
9901352,6,5,1,1,0,6,16,43,1.0,1.0,0.0,0.0,0.0,1.0,5.0,32,6,26,1.0,0.0,1.0
9507469,7,2,5,5,7,0,0,68,5.0,2.0,3.0,3.0,5.0,0.0,0.0,7,7,0,6.0,6.0,0.0
9803327,4,3,1,2,4,0,0,49,0.0,0.0,0.0,0.0,0.0,0.0,0.0,14,4,10,3.0,3.0,0.0
9412347,3,3,0,0,1,2,2,418,1.0,1.0,0.0,0.0,0.0,1.0,1.0,6,3,3,2.0,1.0,1.0
9801283,8,4,4,7,3,5,10,101,5.0,2.0,3.0,6.0,4.0,1.0,1.0,14,8,6,4.0,4.0,0.0
9510274,2,2,0,0,2,0,0,1702,,,,,,,,3,2,1,,,
9710515,3,3,0,0,1,2,12,372,2.0,2.0,0.0,0.0,0.0,2.0,10.0,11,3,8,2.0,2.0,0.0
112356,1,1,0,0,0,1,5,4,1.0,1.0,0.0,0.0,0.0,1.0,5.0,38,1,37,15.0,0.0,15.0
9606377,8,2,6,13,0,8,25,142,8.0,2.0,6.0,13.0,0.0,8.0,25.0,12,8,4,7.0,3.0,4.0
10069,6,3,3,6,0,6,15,168,4.0,1.0,3.0,6.0,4.0,0.0,0.0,13,6,7,4.0,4.0,0.0
9407207,2,1,1,1,0,2,3,15,0.0,0.0,0.0,0.0,0.0,0.0,0.0,6,2,4,1.0,0.0,1.0
204122,4,4,0,0,0,4,20,5,2.0,2.0,0.0,0.0,0.0,2.0,9.0,17,4,13,1.0,0.0,1.0
202203,1,1,0,0,0,1,8,23,1.0,1.0,0.0,0.0,0.0,1.0,6.0,19,1,18,1.0,0.0,1.0
9603406,5,4,1,1,1,4,4,153,2.0,1.0,1.0,1.0,2.0,0.0,0.0,8,5,3,3.0,1.0,2.0
9907504,17,6,11,27,0,17,58,27,14.0,5.0,9.0,22.0,0.0,14.0,44.0,32,17,15,2.0,0.0,2.0
9702336,0,0,0,0,0,0,0,325,0.0,0.0,0.0,0.0,0.0,0.0,0.0,7,0,7,4.0,0.0,4.0
112094,7,4,3,3,0,7,74,37,6.0,3.0,3.0,3.0,0.0,6.0,63.0,31,7,24,20.0,5.0,15.0
9908471,1,1,0,0,0,1,3,181,1.0,1.0,0.0,0.0,0.0,1.0,2.0,11,1,10,5.0,1.0,4.0
9912527,21,5,16,59,2,19,75,4,18.0,5.0,13.0,45.0,2.0,16.0,48.0,39,21,18,8.0,7.0,1.0
103343,17,5,12,39,0,17,127,9,16.0,5.0,11.0,37.0,0.0,16.0,122.0,36,17,19,14.0,2.0,12.0
105147,14,4,10,31,1,13,38,62,12.0,3.0,9.0,29.0,0.0,12.0,31.0,25,14,11,15.0,11.0,4.0
9810486,2,2,0,0,0,2,2,51,0.0,0.0,0.0,0.0,0.0,0.0,0.0,13,2,11,2.0,0.0,2.0
8190,7,5,2,2,3,4,11,32,0.0,0.0,0.0,0.0,0.0,0.0,0.0,66,7,59,4.0,0.0,4.0
9404348,11,10,1,1,11,0,0,259,5.0,5.0,0.0,0.0,5.0,0.0,0.0,11,11,0,4.0,4.0,0.0
9712279,2,1,1,1,0,2,8,74,2.0,1.0,1.0,1.0,0.0,2.0,6.0,7,2,5,5.0,2.0,3.0
102119,6,3,3,3,0,6,35,68,3.0,2.0,1.0,1.0,0.0,3.0,28.0,24,6,18,13.0,3.0,10.0
11334,7,3,4,8,0,7,44,68,6.0,3.0,3.0,7.0,0.0,6.0,27.0,19,7,12,12.0,5.0,7.0
9803425,9,1,8,11,2,7,23,102,7.0,1.0,6.0,9.0,2.0,5.0,8.0,13,9,4,7.0,7.0,0.0
302128,0,0,0,0,0,0,0,247,0.0,0.0,0.0,0.0,0.0,0.0,0.0,2,0,2,2.0,0.0,2.0
12103,19,8,11,23,0,19,170,5,13.0,5.0,8.0,18.0,0.0,13.0,95.0,48,19,29,22.0,11.0,11.0
9804348,15,6,9,20,8,7,28,139,8.0,3.0,5.0,9.0,3.0,5.0,21.0,25,15,10,12.0,8.0,4.0
9906420,4,2,2,2,0,4,35,6,3.0,1.0,2.0,2.0,0.0,3.0,9.0,20,4,16,7.0,3.0,4.0
108212,0,0,0,0,0,0,0,64,0.0,0.0,0.0,0.0,0.0,0.0,0.0,5,0,5,1.0,0.0,1.0
9409286,7,6,1,1,0,7,7,17,4.0,3.0,1.0,1.0,4.0,0.0,0.0,8,7,1,2.0,2.0,0.0
10043,3,2,1,1,1,2,8,13,2.0,1.0,1.0,1.0,0.0,2.0,4.0,14,3,11,7.0,2.0,5.0
9503453,1,1,0,0,1,0,0,323,0.0,0.0,0.0,0.0,0.0,0.0,0.0,4,1,3,3.0,0.0,3.0
9606318,8,2,6,9,2,6,8,173,4.0,1.0,3.0,5.0,0.0,4.0,5.0,11,8,3,4.0,4.0,0.0
9512258,11,4,7,15,0,11,39,10,7.0,3.0,4.0,5.0,0.0,7.0,7.0,23,11,12,9.0,7.0,2.0
9604294,22,5,17,35,2,20,27,113,7.0,2.0,5.0,11.0,0.0,7.0,14.0,24,22,2,9.0,8.0,1.0
9311308,2,1,1,1,0,2,11,6,1.0,1.0,0.0,0.0,1.0,0.0,0.0,8,2,6,1.0,1.0,0.0
9505215,1,1,0,0,0,1,1,433,0.0,0.0,0.0,0.0,0.0,0.0,0.0,4,1,3,2.0,0.0,2.0
9806384,5,3,2,3,3,2,5,328,4.0,2.0,2.0,3.0,3.0,1.0,1.0,10,5,5,5.0,3.0,2.0
9908488,3,2,1,1,1,2,6,26,0.0,0.0,0.0,0.0,0.0,0.0,0.0,26,3,23,3.0,0.0,3.0
9901258,4,2,2,3,0,4,19,105,4.0,2.0,2.0,3.0,0.0,4.0,18.0,11,4,7,9.0,4.0,5.0
9912512,8,2,6,15,0,8,50,89,7.0,2.0,5.0,14.0,3.0,4.0,16.0,26,8,18,5.0,5.0,0.0
9608457,1,1,0,0,0,1,4,17,,,,,,,,10,1,9,1.0,1.0,0.0
9611340,8,5,3,4,6,2,2,85,2.0,2.0,0.0,0.0,1.0,1.0,1.0,9,8,1,2.0,1.0,1.0
201217,7,4,3,5,1,6,19,49,5.0,3.0,2.0,4.0,0.0,5.0,15.0,26,7,19,7.0,3.0,4.0
9907339,1,1,0,0,1,0,0,242,,,,,,,,3,1,2,,,
110104,5,5,0,0,0,5,27,22,2.0,2.0,0.0,0.0,0.0,2.0,12.0,63,5,58,30.0,0.0,30.0
9607357,1,1,0,0,0,1,1,485,0.0,0.0,0.0,0.0,0.0,0.0,0.0,2,1,1,1.0,0.0,1.0
9605399,3,1,2,2,1,2,2,82,3.0,1.0,2.0,2.0,1.0,2.0,2.0,4,3,1,,,
3254,3,3,0,0,1,2,12,9,1.0,1.0,0.0,0.0,0.0,1.0,4.0,31,3,28,12.0,2.0,10.0
111315,16,5,11,21,1,15,103,11,13.0,3.0,10.0,19.0,0.0,13.0,95.0,43,16,27,7.0,1.0,6.0
9807470,2,1,1,1,1,1,1,145,0.0,0.0,0.0,0.0,0.0,0.0,0.0,8,2,6,1.0,0.0,1.0
9609416,1,1,0,0,0,1,12,17,0.0,0.0,0.0,0.0,0.0,0.0,0.0,35,1,34,24.0,0.0,24.0
9804318,5,2,3,3,1,4,6,91,1.0,1.0,0.0,0.0,0.0,1.0,1.0,8,5,3,2.0,1.0,1.0
9702302,3,3,0,0,0,3,9,326,2.0,2.0,0.0,0.0,0.0,2.0,5.0,12,3,9,4.0,1.0,3.0
301143,2,1,1,1,0,2,19,20,1.0,1.0,0.0,0.0,0.0,1.0,11.0,26,2,24,10.0,1.0,9.0
112127,4,3,1,1,1,3,30,1,2.0,1.0,1.0,1.0,0.0,2.0,22.0,24,4,20,11.0,2.0,9.0
6085,7,3,4,4,5,2,6,64,3.0,1.0,2.0,2.0,1.0,2.0,4.0,25,7,18,3.0,3.0,0.0
9707358,1,1,0,0,1,0,0,255,1.0,1.0,0.0,0.0,1.0,0.0,0.0,6,1,5,2.0,1.0,1.0
108246,5,2,3,3,0,5,45,5,2.0,1.0,1.0,1.0,0.0,2.0,16.0,30,5,25,12.0,2.0,10.0
7325,8,2,6,14,0,8,44,158,6.0,1.0,5.0,10.0,0.0,6.0,32.0,22,8,14,14.0,6.0,8.0
207131,5,4,1,1,2,3,5,7,0.0,0.0,0.0,0.0,0.0,0.0,0.0,59,5,54,28.0,0.0,28.0
9203202,3,3,0,0,3,0,0,317,2.0,2.0,0.0,0.0,2.0,0.0,0.0,3,3,0,2.0,2.0,0.0
9603320,3,1,2,3,3,0,0,527,3.0,1.0,2.0,3.0,3.0,0.0,0.0,7,3,4,3.0,3.0,0.0
9903214,9,5,4,10,1,8,26,92,1.0,1.0,0.0,0.0,0.0,1.0,6.0,22,9,13,8.0,1.0,7.0
204353,4,2,2,2,0,4,8,20,1.0,1.0,0.0,0.0,1.0,0.0,0.0,7,4,3,5.0,3.0,2.0
9709310,0,0,0,0,0,0,0,67,0.0,0.0,0.0,0.0,0.0,0.0,0.0,4,0,4,1.0,0.0,1.0
9702290,5,4,1,1,0,5,7,18,2.0,2.0,0.0,0.0,2.0,0.0,0.0,11,5,6,2.0,1.0,1.0
110263,4,1,3,4,0,4,37,78,4.0,1.0,3.0,4.0,0.0,4.0,21.0,22,4,18,8.0,3.0,5.0
9606274,6,1,5,8,0,6,87,71,6.0,1.0,5.0,8.0,0.0,6.0,80.0,26,6,20,23.0,6.0,17.0
9909531,9,1,8,22,6,3,5,216,9.0,1.0,8.0,22.0,9.0,0.0,0.0,14,9,5,8.0,8.0,0.0
9508395,9,3,6,12,5,4,7,96,8.0,2.0,6.0,12.0,8.0,0.0,0.0,13,9,4,8.0,8.0,0.0
9610219,17,6,11,22,13,4,4,148,13.0,5.0,8.0,16.0,10.0,3.0,3.0,20,17,3,9.0,8.0,1.0
9407242,2,2,0,0,1,1,2,6,1.0,1.0,0.0,0.0,1.0,0.0,0.0,9,2,7,1.0,0.0,1.0
12278,15,10,5,9,2,13,97,31,10.0,6.0,4.0,6.0,0.0,10.0,70.0,53,15,38,26.0,4.0,22.0
9707245,4,3,1,1,0,4,23,40,2.0,2.0,0.0,0.0,0.0,2.0,16.0,21,4,17,16.0,2.0,14.0
9406290,1,1,0,0,0,1,1,280,1.0,1.0,0.0,0.0,0.0,1.0,1.0,6,1,5,3.0,1.0,2.0
107159,4,4,0,0,0,4,24,36,4.0,4.0,0.0,0.0,1.0,3.0,12.0,19,4,15,8.0,3.0,5.0
212280,0,0,0,0,0,0,0,58,0.0,0.0,0.0,0.0,0.0,0.0,0.0,32,0,32,9.0,0.0,9.0
102067,12,6,6,13,6,6,7,178,6.0,1.0,5.0,11.0,0.0,6.0,7.0,14,12,2,8.0,6.0,2.0
103015,3,1,2,3,0,3,6,91,3.0,1.0,2.0,3.0,0.0,3.0,6.0,5,3,2,5.0,3.0,2.0
208109,0,0,0,0,0,0,0,55,0.0,0.0,0.0,0.0,0.0,0.0,0.0,11,0,11,1.0,0.0,1.0
9609280,2,2,0,0,1,1,6,48,1.0,1.0,0.0,0.0,0.0,1.0,6.0,8,2,6,6.0,1.0,5.0
9607430,1,1,0,0,0,1,8,43,1.0,1.0,0.0,0.0,0.0,1.0,6.0,20,1,19,1.0,1.0,0.0
9811348,1,1,0,0,0,1,1,9,0.0,0.0,0.0,0.0,0.0,0.0,0.0,27,1,26,5.0,0.0,5.0
105100,10,3,7,12,0,10,35,95,8.0,2.0,6.0,9.0,2.0,6.0,14.0,28,10,18,11.0,8.0,3.0
7207,13,3,10,23,2,11,32,31,8.0,1.0,7.0,15.0,0.0,8.0,14.0,22,13,9,6.0,5.0,1.0
9710206,17,5,12,43,2,15,59,52,13.0,2.0,11.0,42.0,2.0,11.0,49.0,32,17,15,18.0,11.0,7.0
9607307,0,0,0,0,0,0,0,10,0.0,0.0,0.0,0.0,0.0,0.0,0.0,11,0,11,4.0,0.0,4.0
9509247,4,1,3,4,4,0,0,229,4.0,1.0,3.0,4.0,4.0,0.0,0.0,15,4,11,4.0,4.0,0.0
9908217,9,4,5,6,1,8,43,83,7.0,3.0,4.0,4.0,0.0,7.0,31.0,27,9,18,13.0,4.0,9.0
301269,1,1,0,0,0,1,8,7,1.0,1.0,0.0,0.0,0.0,1.0,8.0,41,1,40,14.0,1.0,13.0
9907226,7,7,0,0,0,7,20,83,5.0,5.0,0.0,0.0,5.0,0.0,0.0,20,7,13,7.0,1.0,6.0
9708378,3,3,0,0,1,2,4,14,0.0,0.0,0.0,0.0,0.0,0.0,0.0,26,3,23,5.0,0.0,5.0
6069,7,7,0,0,4,3,3,264,4.0,4.0,0.0,0.0,1.0,3.0,3.0,11,7,4,4.0,2.0,2.0
110088,9,8,1,1,1,8,41,76,4.0,3.0,1.0,1.0,1.0,3.0,13.0,38,9,29,8.0,2.0,6.0
9607312,3,3,0,0,2,1,5,34,1.0,1.0,0.0,0.0,0.0,1.0,5.0,14,3,11,1.0,0.0,1.0
205220,5,5,0,0,1,4,10,283,3.0,3.0,0.0,0.0,1.0,2.0,6.0,17,5,12,5.0,1.0,4.0
9809452,1,1,0,0,0,1,3,38,1.0,1.0,0.0,0.0,0.0,1.0,3.0,4,1,3,4.0,1.0,3.0
201086,6,4,2,2,5,1,5,37,5.0,4.0,1.0,1.0,5.0,0.0,0.0,15,6,9,2.0,1.0,1.0
9406383,14,3,11,24,14,0,0,175,7.0,1.0,6.0,11.0,7.0,0.0,0.0,14,14,0,5.0,5.0,0.0
4055,3,2,1,1,2,1,1,6,2.0,1.0,1.0,1.0,2.0,0.0,0.0,12,3,9,,,
203124,2,2,0,0,0,2,4,191,2.0,2.0,0.0,0.0,0.0,2.0,4.0,7,2,5,3.0,1.0,2.0
9909471,5,2,3,3,1,4,8,72,5.0,2.0,3.0,3.0,5.0,0.0,0.0,9,5,4,6.0,4.0,2.0
9606249,5,2,3,3,5,0,0,290,2.0,1.0,1.0,1.0,2.0,0.0,0.0,5,5,0,2.0,2.0,0.0
107328,2,1,1,1,0,2,2,126,0.0,0.0,0.0,0.0,0.0,0.0,0.0,5,2,3,2.0,2.0,0.0
9705331,0,0,0,0,0,0,0,947,,,,,,,,2,0,2,,,
112259,8,6,2,2,1,7,106,17,6.0,4.0,2.0,2.0,0.0,6.0,87.0,40,8,32,9.0,4.0,5.0
106152,0,0,0,0,0,0,0,15,0.0,0.0,0.0,0.0,0.0,0.0,0.0,32,0,32,23.0,0.0,23.0
9136,4,2,2,2,0,4,15,104,2.0,1.0,1.0,1.0,0.0,2.0,10.0,13,4,9,7.0,2.0,5.0
9610420,10,8,2,2,6,4,6,51,3.0,3.0,0.0,0.0,2.0,1.0,1.0,22,10,12,3.0,3.0,0.0
209134,2,2,0,0,0,2,8,146,1.0,1.0,0.0,0.0,0.0,1.0,4.0,23,2,21,14.0,2.0,12.0
9909504,9,5,4,4,1,8,63,11,1.0,1.0,0.0,0.0,0.0,1.0,5.0,56,9,47,16.0,2.0,14.0
9904493,1,1,0,0,1,0,0,1411,,,,,,,,1,1,0,,,
9709405,2,2,0,0,0,2,12,67,2.0,2.0,0.0,0.0,0.0,2.0,11.0,13,2,11,4.0,0.0,4.0
201301,2,2,0,0,0,2,21,47,2.0,2.0,0.0,0.0,0.0,2.0,21.0,21,2,19,13.0,2.0,11.0
5062,0,0,0,0,0,0,0,77,,,,,,,,4,0,4,2.0,0.0,2.0
9011,6,2,4,10,0,6,23,16,5.0,1.0,4.0,9.0,4.0,1.0,1.0,23,6,17,7.0,6.0,1.0
9603236,2,2,0,0,2,0,0,1686,1.0,1.0,0.0,0.0,1.0,0.0,0.0,3,2,1,1.0,1.0,0.0
9706505,5,3,2,2,5,0,0,1790,2.0,1.0,1.0,1.0,2.0,0.0,0.0,5,5,0,2.0,2.0,0.0
112077,3,3,0,0,0,3,9,3,0.0,0.0,0.0,0.0,0.0,0.0,0.0,38,3,35,2.0,1.0,1.0
9611315,5,2,3,4,5,0,0,233,5.0,2.0,3.0,4.0,5.0,0.0,0.0,6,5,1,5.0,5.0,0.0
9610287,0,0,0,0,0,0,0,135,0.0,0.0,0.0,0.0,0.0,0.0,0.0,5,0,5,1.0,0.0,1.0
9911399,3,3,0,0,2,1,1,48,0.0,0.0,0.0,0.0,0.0,0.0,0.0,19,3,16,11.0,0.0,11.0
205315,7,3,4,5,0,7,78,9,3.0,1.0,2.0,3.0,0.0,3.0,49.0,39,7,32,9.0,3.0,6.0
9604276,2,2,0,0,2,0,0,484,2.0,2.0,0.0,0.0,2.0,0.0,0.0,8,2,6,1.0,1.0,0.0
2180,3,1,2,2,3,0,0,35,0.0,0.0,0.0,0.0,0.0,0.0,0.0,15,3,12,4.0,0.0,4.0
1106,5,4,1,1,0,5,24,48,0.0,0.0,0.0,0.0,0.0,0.0,0.0,25,5,20,3.0,0.0,3.0
7330,3,2,1,1,0,3,21,78,2.0,1.0,1.0,1.0,0.0,2.0,14.0,22,3,19,9.0,0.0,9.0
109093,6,3,3,7,0,6,16,24,5.0,2.0,3.0,7.0,0.0,5.0,13.0,16,6,10,1.0,1.0,0.0
9603426,3,1,2,2,0,3,6,29,3.0,1.0,2.0,2.0,0.0,3.0,5.0,7,3,4,1.0,1.0,0.0
9308231,0,0,0,0,0,0,0,526,0.0,0.0,0.0,0.0,0.0,0.0,0.0,1,0,1,1.0,0.0,1.0
9701225,4,3,1,1,2,2,8,74,0.0,0.0,0.0,0.0,0.0,0.0,0.0,49,4,45,4.0,2.0,2.0
103193,0,0,0,0,0,0,0,559,0.0,0.0,0.0,0.0,0.0,0.0,0.0,1,0,1,1.0,0.0,1.0
9273,5,1,4,6,1,4,6,105,5.0,1.0,4.0,6.0,1.0,4.0,6.0,7,5,2,5.0,4.0,1.0
9509421,2,1,1,1,2,0,0,199,1.0,1.0,0.0,0.0,1.0,0.0,0.0,2,2,0,,,
9607353,7,2,5,12,0,7,18,30,6.0,1.0,5.0,9.0,0.0,6.0,15.0,15,7,8,9.0,6.0,3.0
7092,5,5,0,0,2,3,19,13,2.0,2.0,0.0,0.0,0.0,2.0,18.0,75,5,70,23.0,1.0,22.0
9606286,3,2,1,1,1,2,2,211,2.0,1.0,1.0,1.0,1.0,1.0,1.0,11,3,8,3.0,2.0,1.0
9610452,1,1,0,0,0,1,1,33,0.0,0.0,0.0,0.0,0.0,0.0,0.0,6,1,5,4.0,0.0,4.0
106118,1,1,0,0,0,1,1,11,0.0,0.0,0.0,0.0,0.0,0.0,0.0,17,1,16,7.0,0.0,7.0
109204,4,2,2,2,0,4,11,171,4.0,2.0,2.0,2.0,0.0,4.0,11.0,9,4,5,7.0,3.0,4.0
5026,7,3,4,8,0,7,21,29,6.0,2.0,4.0,8.0,3.0,3.0,3.0,14,7,7,5.0,4.0,1.0
7262,6,2,4,5,0,6,18,82,6.0,2.0,4.0,5.0,0.0,6.0,18.0,10,6,4,2.0,1.0,1.0
9510236,3,2,1,1,0,3,4,117,3.0,2.0,1.0,1.0,0.0,3.0,3.0,5,3,2,1.0,1.0,0.0
6153,8,2,6,18,2,6,15,209,7.0,1.0,6.0,18.0,1.0,6.0,11.0,13,8,5,10.0,7.0,3.0
9507400,3,3,0,0,2,1,2,41,0.0,0.0,0.0,0.0,0.0,0.0,0.0,7,3,4,2.0,1.0,1.0
9709413,3,3,0,0,1,2,4,30,1.0,1.0,0.0,0.0,0.0,1.0,3.0,11,3,8,5.0,1.0,4.0
9505364,3,2,1,1,0,3,3,235,3.0,2.0,1.0,1.0,0.0,3.0,3.0,5,3,2,3.0,2.0,1.0
9803203,0,0,0,0,0,0,0,845,0.0,0.0,0.0,0.0,0.0,0.0,0.0,2,0,2,,,
9810236,0,0,0,0,0,0,0,24,0.0,0.0,0.0,0.0,0.0,0.0,0.0,8,0,8,2.0,0.0,2.0
9810255,0,0,0,0,0,0,0,222,0.0,0.0,0.0,0.0,0.0,0.0,0.0,9,0,9,1.0,0.0,1.0
9901360,8,5,3,7,4,4,12,8,4.0,2.0,2.0,5.0,2.0,2.0,2.0,25,8,17,5.0,4.0,1.0
301067,0,0,0,0,0,0,0,177,0.0,0.0,0.0,0.0,0.0,0.0,0.0,12,0,12,9.0,0.0,9.0
9807337,1,1,0,0,1,0,0,13,0.0,0.0,0.0,0.0,0.0,0.0,0.0,22,1,21,5.0,0.0,5.0
9309332,3,2,1,1,3,0,0,108,,,,,,,,3,3,0,2.0,2.0,0.0
9509372,2,2,0,0,2,0,0,58,2.0,2.0,0.0,0.0,2.0,0.0,0.0,4,2,2,2.0,2.0,0.0
9906524,5,3,2,2,0,5,13,101,3.0,1.0,2.0,2.0,0.0,3.0,9.0,14,5,9,5.0,1.0,4.0
9701203,0,0,0,0,0,0,0,187,0.0,0.0,0.0,0.0,0.0,0.0,0.0,5,0,5,1.0,0.0,1.0
9808309,7,1,6,13,1,6,10,105,7.0,1.0,6.0,13.0,1.0,6.0,10.0,11,7,4,7.0,6.0,1.0
207213,2,2,0,0,0,2,44,32,1.0,1.0,0.0,0.0,0.0,1.0,40.0,87,2,85,45.0,1.0,44.0
9805365,4,3,1,1,2,2,3,269,4.0,3.0,1.0,1.0,2.0,2.0,2.0,7,4,3,3.0,2.0,1.0
6203,2,2,0,0,1,1,6,17,1.0,1.0,0.0,0.0,0.0,1.0,6.0,17,2,15,1.0,0.0,1.0
5212,6,4,2,3,2,4,10,98,1.0,1.0,0.0,0.0,0.0,1.0,1.0,11,6,5,2.0,1.0,1.0
202103,3,2,1,1,1,2,9,7,2.0,2.0,0.0,0.0,0.0,2.0,5.0,12,3,9,6.0,2.0,4.0
9402352,2,2,0,0,2,0,0,546,0.0,0.0,0.0,0.0,0.0,0.0,0.0,3,2,1,2.0,1.0,1.0
9604422,1,1,0,0,1,0,0,414,0.0,0.0,0.0,0.0,0.0,0.0,0.0,4,1,3,2.0,0.0,2.0
9703231,2,2,0,0,1,1,1,4,0.0,0.0,0.0,0.0,0.0,0.0,0.0,23,2,21,4.0,0.0,4.0
9608300,1,1,0,0,1,0,0,213,1.0,1.0,0.0,0.0,1.0,0.0,0.0,1,1,0,,,
111362,6,5,1,1,0,6,141,11,5.0,4.0,1.0,1.0,0.0,5.0,131.0,80,6,74,48.0,5.0,43.0
11072,2,1,1,1,0,2,2,195,2.0,1.0,1.0,1.0,2.0,0.0,0.0,7,2,5,1.0,0.0,1.0
10114,10,4,6,10,1,9,22,65,6.0,2.0,4.0,7.0,0.0,6.0,15.0,18,10,8,6.0,5.0,1.0
9710359,3,2,1,1,0,3,4,112,,,,,,,,6,3,3,,,
104306,8,1,7,16,0,8,18,8,5.0,1.0,4.0,7.0,0.0,5.0,11.0,16,8,8,7.0,5.0,2.0
104296,2,2,0,0,1,1,1,174,1.0,1.0,0.0,0.0,1.0,0.0,0.0,3,2,1,1.0,1.0,0.0
9510348,1,1,0,0,1,0,0,385,0.0,0.0,0.0,0.0,0.0,0.0,0.0,4,1,3,2.0,0.0,2.0
208130,5,4,1,1,0,5,18,16,3.0,3.0,0.0,0.0,0.0,3.0,15.0,17,5,12,6.0,0.0,6.0
9902223,10,5,5,7,1,9,54,7,4.0,3.0,1.0,2.0,0.0,4.0,24.0,28,10,18,8.0,3.0,5.0
9910512,2,1,1,1,0,2,4,347,2.0,1.0,1.0,1.0,0.0,2.0,3.0,6,2,4,4.0,2.0,2.0
9904226,5,3,2,3,0,5,18,240,5.0,3.0,2.0,3.0,0.0,5.0,15.0,12,5,7,9.0,5.0,4.0
9511467,1,1,0,0,1,0,0,280,0.0,0.0,0.0,0.0,0.0,0.0,0.0,2,1,1,1.0,0.0,1.0
205214,3,2,1,1,2,1,5,89,1.0,1.0,0.0,0.0,0.0,1.0,4.0,16,3,13,5.0,1.0,4.0
9402247,2,1,1,1,2,0,0,369,0.0,0.0,0.0,0.0,0.0,0.0,0.0,3,2,1,3.0,2.0,1.0
208114,5,4,1,1,3,2,32,6,1.0,1.0,0.0,0.0,0.0,1.0,23.0,120,5,115,16.0,0.0,16.0
9904325,4,2,2,2,0,4,8,455,2.0,1.0,1.0,1.0,0.0,2.0,2.0,16,4,12,4.0,3.0,1.0
9711491,0,0,0,0,0,0,0,181,0.0,0.0,0.0,0.0,0.0,0.0,0.0,3,0,3,,,
9909519,2,2,0,0,0,2,3,17,2.0,2.0,0.0,0.0,0.0,2.0,3.0,14,2,12,1.0,0.0,1.0
204039,1,1,0,0,0,1,3,25,1.0,1.0,0.0,0.0,0.0,1.0,2.0,9,1,8,3.0,0.0,3.0
9502369,3,3,0,0,3,0,0,203,2.0,2.0,0.0,0.0,2.0,0.0,0.0,3,3,0,2.0,2.0,0.0
9711219,0,0,0,0,0,0,0,954,0.0,0.0,0.0,0.0,0.0,0.0,0.0,3,0,3,2.0,0.0,2.0
204102,1,1,0,0,1,0,0,241,1.0,1.0,0.0,0.0,1.0,0.0,0.0,2,1,1,1.0,0.0,1.0
9610226,1,1,0,0,0,1,2,90,,,,,,,,5,1,4,1.0,1.0,0.0
110030,2,2,0,0,1,1,1,405,0.0,0.0,0.0,0.0,0.0,0.0,0.0,4,2,2,2.0,0.0,2.0
4264,4,3,1,1,0,4,15,251,2.0,2.0,0.0,0.0,0.0,2.0,9.0,18,4,14,9.0,2.0,7.0
211243,2,2,0,0,0,2,7,21,2.0,2.0,0.0,0.0,1.0,1.0,2.0,24,2,22,14.0,1.0,13.0
9612481,0,0,0,0,0,0,0,26,0.0,0.0,0.0,0.0,0.0,0.0,0.0,3,0,3,3.0,0.0,3.0
110052,1,1,0,0,0,1,29,69,1.0,1.0,0.0,0.0,0.0,1.0,13.0,42,1,41,16.0,1.0,15.0
1097,0,0,0,0,0,0,0,975,,,,,,,,1,0,1,,,
9409390,1,1,0,0,0,1,1,133,0.0,0.0,0.0,0.0,0.0,0.0,0.0,2,1,1,,,
206098,1,1,0,0,0,1,3,8,1.0,1.0,0.0,0.0,0.0,1.0,3.0,5,1,4,5.0,1.0,4.0
9701335,1,1,0,0,1,0,0,430,0.0,0.0,0.0,0.0,0.0,0.0,0.0,3,1,2,2.0,0.0,2.0
9607320,3,1,2,2,2,1,1,162,1.0,1.0,0.0,0.0,1.0,0.0,0.0,6,3,3,1.0,0.0,1.0
205176,2,1,1,1,0,2,13,12,0.0,0.0,0.0,0.0,0.0,0.0,0.0,18,2,16,5.0,2.0,3.0
9703453,5,2,3,4,2,3,3,421,5.0,2.0,3.0,4.0,5.0,0.0,0.0,6,5,1,5.0,5.0,0.0
9410247,1,1,0,0,0,1,2,274,1.0,1.0,0.0,0.0,0.0,1.0,1.0,4,1,3,1.0,1.0,0.0
9509280,1,1,0,0,1,0,0,637,,,,,,,,1,1,0,1.0,1.0,0.0
211227,0,0,0,0,0,0,0,8,0.0,0.0,0.0,0.0,0.0,0.0,0.0,7,0,7,1.0,0.0,1.0
9501337,0,0,0,0,0,0,0,163,,,,,,,,1,0,1,,,
9905564,1,1,0,0,1,0,0,138,1.0,1.0,0.0,0.0,1.0,0.0,0.0,5,1,4,3.0,0.0,3.0
205149,2,2,0,0,1,1,4,144,1.0,1.0,0.0,0.0,0.0,1.0,3.0,10,2,8,4.0,1.0,3.0
9604257,9,4,5,11,1,8,18,41,2.0,1.0,1.0,1.0,2.0,0.0,0.0,21,9,12,3.0,3.0,0.0
211351,0,0,0,0,0,0,0,339,0.0,0.0,0.0,0.0,0.0,0.0,0.0,7,0,7,2.0,0.0,2.0
9711296,2,2,0,0,0,2,13,53,1.0,1.0,0.0,0.0,0.0,1.0,8.0,19,2,17,4.0,1.0,3.0
9809460,1,1,0,0,0,1,7,24,1.0,1.0,0.0,0.0,0.0,1.0,4.0,15,1,14,9.0,1.0,8.0
301230,0,0,0,0,0,0,0,444,0.0,0.0,0.0,0.0,0.0,0.0,0.0,1,0,1,1.0,0.0,1.0
9706393,2,2,0,0,0,2,8,62,2.0,2.0,0.0,0.0,0.0,2.0,7.0,21,2,19,8.0,1.0,7.0
9506239,3,3,0,0,1,2,5,35,1.0,1.0,0.0,0.0,0.0,1.0,1.0,11,3,8,1.0,1.0,0.0
104019,6,5,1,2,0,6,22,49,5.0,4.0,1.0,2.0,0.0,5.0,12.0,20,6,14,5.0,4.0,1.0
9405293,1,1,0,0,0,1,2,242,0.0,0.0,0.0,0.0,0.0,0.0,0.0,7,1,6,1.0,0.0,1.0
9905272,3,2,1,1,0,3,5,136,3.0,2.0,1.0,1.0,0.0,3.0,5.0,10,3,7,8.0,2.0,6.0
112052,0,0,0,0,0,0,0,1812,,,,,,,,1,0,1,,,
103321,2,2,0,0,0,2,13,1,1.0,1.0,0.0,0.0,0.0,1.0,1.0,19,2,17,1.0,1.0,0.0
107290,4,2,2,2,0,4,27,37,2.0,1.0,1.0,1.0,0.0,2.0,8.0,26,4,22,6.0,1.0,5.0
302142,0,0,0,0,0,0,0,20,0.0,0.0,0.0,0.0,0.0,0.0,0.0,28,0,28,4.0,0.0,4.0
9710485,0,0,0,0,0,0,0,1365,,,,,,,,3,0,3,,,
9404273,3,2,1,1,1,2,11,96,2.0,2.0,0.0,0.0,0.0,2.0,9.0,10,3,7,7.0,2.0,5.0
9906344,3,2,1,1,0,3,7,131,3.0,2.0,1.0,1.0,0.0,3.0,7.0,7,3,4,5.0,3.0,2.0
9403374,7,6,1,1,6,1,1,199,5.0,4.0,1.0,1.0,5.0,0.0,0.0,8,7,1,3.0,3.0,0.0
9703243,0,0,0,0,0,0,0,1549,0.0,0.0,0.0,0.0,0.0,0.0,0.0,2,0,2,1.0,0.0,1.0
9411265,2,2,0,0,2,0,0,195,1.0,1.0,0.0,0.0,1.0,0.0,0.0,2,2,0,1.0,1.0,0.0
9507447,1,1,0,0,1,0,0,167,,,,,,,,1,1,0,1.0,1.0,0.0
204325,1,1,0,0,0,1,3,180,1.0,1.0,0.0,0.0,0.0,1.0,3.0,7,1,6,5.0,1.0,4.0
9512391,0,0,0,0,0,0,0,268,0.0,0.0,0.0,0.0,0.0,0.0,0.0,2,0,2,1.0,0.0,1.0
202193,0,0,0,0,0,0,0,2,0.0,0.0,0.0,0.0,0.0,0.0,0.0,11,0,11,2.0,0.0,2.0
111046,4,1,3,5,0,4,7,106,4.0,1.0,3.0,5.0,0.0,4.0,7.0,7,4,3,6.0,4.0,2.0
201264,1,1,0,0,1,0,0,219,0.0,0.0,0.0,0.0,0.0,0.0,0.0,6,1,5,1.0,0.0,1.0
9812428,3,3,0,0,0,3,6,117,3.0,3.0,0.0,0.0,0.0,3.0,6.0,10,3,7,2.0,2.0,0.0
102078,4,3,1,1,0,4,8,28,1.0,1.0,0.0,0.0,1.0,0.0,0.0,13,4,9,2.0,2.0,0.0
9809447,2,1,1,1,0,2,6,145,2.0,1.0,1.0,1.0,0.0,2.0,4.0,8,2,6,4.0,2.0,2.0
9507229,0,0,0,0,0,0,0,190,0.0,0.0,0.0,0.0,0.0,0.0,0.0,8,0,8,1.0,0.0,1.0
9504358,3,3,0,0,0,3,7,30,3.0,3.0,0.0,0.0,0.0,3.0,7.0,8,3,5,4.0,3.0,1.0
3047,2,2,0,0,0,2,7,177,1.0,1.0,0.0,0.0,0.0,1.0,4.0,16,2,14,5.0,1.0,4.0
211272,1,1,0,0,0,1,11,1,1.0,1.0,0.0,0.0,0.0,1.0,11.0,29,1,28,16.0,1.0,15.0
9511268,2,1,1,1,1,1,1,93,2.0,1.0,1.0,1.0,1.0,1.0,1.0,4,2,2,3.0,2.0,1.0
105275,0,0,0,0,0,0,0,2,0.0,0.0,0.0,0.0,0.0,0.0,0.0,25,0,25,14.0,0.0,14.0
209120,0,0,0,0,0,0,0,63,0.0,0.0,0.0,0.0,0.0,0.0,0.0,23,0,23,2.0,0.0,2.0
9802229,0,0,0,0,0,0,0,112,0.0,0.0,0.0,0.0,0.0,0.0,0.0,14,0,14,7.0,0.0,7.0
207329,1,1,0,0,0,1,1,720,1.0,1.0,0.0,0.0,0.0,1.0,1.0,2,1,1,2.0,1.0,1.0
6028,3,2,1,1,0,3,18,0,1.0,1.0,0.0,0.0,0.0,1.0,8.0,28,3,25,6.0,1.0,5.0
211059,2,2,0,0,0,2,24,37,2.0,2.0,0.0,0.0,0.0,2.0,12.0,25,2,23,1.0,0.0,1.0
206169,5,4,1,1,3,2,5,44,0.0,0.0,0.0,0.0,0.0,0.0,0.0,226,5,221,19.0,0.0,19.0
112165,3,3,0,0,2,1,2,4,1.0,1.0,0.0,0.0,1.0,0.0,0.0,16,3,13,1.0,1.0,0.0
9403211,0,0,0,0,0,0,0,155,0.0,0.0,0.0,0.0,0.0,0.0,0.0,2,0,2,1.0,0.0,1.0
5184,0,0,0,0,0,0,0,100,0.0,0.0,0.0,0.0,0.0,0.0,0.0,9,0,9,1.0,0.0,1.0
301089,0,0,0,0,0,0,0,423,0.0,0.0,0.0,0.0,0.0,0.0,0.0,3,0,3,1.0,0.0,1.0
205343,5,1,4,8,0,5,26,11,5.0,1.0,4.0,8.0,0.0,5.0,20.0,11,5,6,9.0,5.0,4.0
9803468,2,2,0,0,2,0,0,26,1.0,1.0,0.0,0.0,1.0,0.0,0.0,7,2,5,1.0,1.0,0.0
207222,4,1,3,5,0,4,71,66,4.0,1.0,3.0,5.0,0.0,4.0,41.0,39,4,35,18.0,4.0,14.0
9909552,0,0,0,0,0,0,0,15,0.0,0.0,0.0,0.0,0.0,0.0,0.0,14,0,14,2.0,0.0,2.0
112100,0,0,0,0,0,0,0,177,0.0,0.0,0.0,0.0,0.0,0.0,0.0,4,0,4,2.0,0.0,2.0
111389,1,1,0,0,0,1,18,7,1.0,1.0,0.0,0.0,0.0,1.0,15.0,21,1,20,16.0,1.0,15.0
9602361,1,1,0,0,0,1,1,49,0.0,0.0,0.0,0.0,0.0,0.0,0.0,18,1,17,2.0,0.0,2.0
9810229,0,0,0,0,0,0,0,194,,,,,,,,2,0,2,,,
107032,1,1,0,0,0,1,3,14,1.0,1.0,0.0,0.0,0.0,1.0,3.0,9,1,8,5.0,1.0,4.0
9706361,1,1,0,0,1,0,0,110,0.0,0.0,0.0,0.0,0.0,0.0,0.0,3,1,2,,,
9910222,1,1,0,0,0,1,5,47,0.0,0.0,0.0,0.0,0.0,0.0,0.0,32,1,31,7.0,0.0,7.0
9905432,1,1,0,0,0,1,2,3,0.0,0.0,0.0,0.0,0.0,0.0,0.0,8,1,7,,,
9503298,0,0,0,0,0,0,0,114,0.0,0.0,0.0,0.0,0.0,0.0,0.0,5,0,5,3.0,0.0,3.0
207359,3,3,0,0,1,2,10,43,1.0,1.0,0.0,0.0,0.0,1.0,1.0,18,3,15,3.0,1.0,2.0
9511226,0,0,0,0,0,0,0,132,0.0,0.0,0.0,0.0,0.0,0.0,0.0,1,0,1,1.0,0.0,1.0
103204,1,1,0,0,0,1,7,104,1.0,1.0,0.0,0.0,0.0,1.0,6.0,11,1,10,7.0,1.0,6.0
9608475,3,1,2,2,0,3,9,31,3.0,1.0,2.0,2.0,0.0,3.0,6.0,6,3,3,5.0,3.0,2.0
12373,0,0,0,0,0,0,0,1022,0.0,0.0,0.0,0.0,0.0,0.0,0.0,5,0,5,,,
111050,1,1,0,0,0,1,1,110,1.0,1.0,0.0,0.0,1.0,0.0,0.0,4,1,3,2.0,1.0,1.0
9401275,0,0,0,0,0,0,0,1914,,,,,,,,1,0,1,,,
302010,0,0,0,0,0,0,0,11,0.0,0.0,0.0,0.0,0.0,0.0,0.0,46,0,46,24.0,0.0,24.0
9609244,2,2,0,0,0,2,2,388,2.0,2.0,0.0,0.0,0.0,2.0,2.0,4,2,2,4.0,2.0,2.0
9812390,1,1,0,0,1,0,0,288,1.0,1.0,0.0,0.0,1.0,0.0,0.0,6,1,5,,,
9805257,0,0,0,0,0,0,0,132,0.0,0.0,0.0,0.0,0.0,0.0,0.0,4,0,4,1.0,0.0,1.0
9712258,2,2,0,0,0,2,8,79,2.0,2.0,0.0,0.0,0.0,2.0,6.0,8,2,6,5.0,2.0,3.0
104314,0,0,0,0,0,0,0,98,0.0,0.0,0.0,0.0,0.0,0.0,0.0,10,0,10,6.0,0.0,6.0
3229,0,0,0,0,0,0,0,107,0.0,0.0,0.0,0.0,0.0,0.0,0.0,4,0,4,1.0,0.0,1.0
110418,1,1,0,0,1,0,0,197,0.0,0.0,0.0,0.0,0.0,0.0,0.0,17,1,16,2.0,0.0,2.0
101116,1,1,0,0,0,1,4,119,0.0,0.0,0.0,0.0,0.0,0.0,0.0,6,1,5,4.0,1.0,3.0
9603437,0,0,0,0,0,0,0,173,,,,,,,,1,0,1,,,
9307331,0,0,0,0,0,0,0,169,0.0,0.0,0.0,0.0,0.0,0.0,0.0,2,0,2,,,
9609264,1,1,0,0,1,0,0,458,1.0,1.0,0.0,0.0,1.0,0.0,0.0,1,1,0,1.0,1.0,0.0
9801258,0,0,0,0,0,0,0,239,0.0,0.0,0.0,0.0,0.0,0.0,0.0,2,0,2,1.0,0.0,1.0
302038,0,0,0,0,0,0,0,37,0.0,0.0,0.0,0.0,0.0,0.0,0.0,20,0,20,14.0,0.0,14.0
9605458,0,0,0,0,0,0,0,69,0.0,0.0,0.0,0.0,0.0,0.0,0.0,6,0,6,,,
9408279,0,0,0,0,0,0,0,10,,,,,,,,8,0,8,,,
9911354,0,0,0,0,0,0,0,98,0.0,0.0,0.0,0.0,0.0,0.0,0.0,2,0,2,2.0,0.0,2.0
212109,2,2,0,0,0,2,10,45,1.0,1.0,0.0,0.0,0.0,1.0,5.0,20,2,18,5.0,1.0,4.0
203144,2,2,0,0,0,2,14,45,2.0,2.0,0.0,0.0,0.0,2.0,11.0,20,2,18,7.0,2.0,5.0
206037,1,1,0,0,1,0,0,296,0.0,0.0,0.0,0.0,0.0,0.0,0.0,4,1,3,1.0,0.0,1.0
102080,2,2,0,0,1,1,7,21,0.0,0.0,0.0,0.0,0.0,0.0,0.0,14,2,12,2.0,0.0,2.0
9805492,1,1,0,0,1,0,0,108,0.0,0.0,0.0,0.0,0.0,0.0,0.0,7,1,6,1.0,0.0,1.0
211155,2,2,0,0,0,2,7,27,1.0,1.0,0.0,0.0,0.0,1.0,5.0,21,2,19,10.0,1.0,9.0
207098,0,0,0,0,0,0,0,99,0.0,0.0,0.0,0.0,0.0,0.0,0.0,10,0,10,3.0,0.0,3.0
1193,3,3,0,0,0,3,9,65,2.0,2.0,0.0,0.0,2.0,0.0,0.0,10,3,7,2.0,1.0,1.0
9906496,0,0,0,0,0,0,0,21,,,,,,,,8,0,8,,,
302073,1,1,0,0,0,1,8,37,1.0,1.0,0.0,0.0,0.0,1.0,8.0,50,1,49,15.0,1.0,14.0
112023,4,3,1,1,0,4,37,94,1.0,1.0,0.0,0.0,0.0,1.0,22.0,79,4,75,22.0,1.0,21.0
9711267,0,0,0,0,0,0,0,5,0.0,0.0,0.0,0.0,0.0,0.0,0.0,13,0,13,1.0,0.0,1.0
9812512,1,1,0,0,0,1,1,137,1.0,1.0,0.0,0.0,0.0,1.0,1.0,2,1,1,1.0,1.0,0.0
204032,1,1,0,0,0,1,1,64,0.0,0.0,0.0,0.0,0.0,0.0,0.0,8,1,7,1.0,0.0,1.0
210153,2,2,0,0,1,1,1,121,0.0,0.0,0.0,0.0,0.0,0.0,0.0,9,2,7,1.0,0.0,1.0
204235,0,0,0,0,0,0,0,161,0.0,0.0,0.0,0.0,0.0,0.0,0.0,1,0,1,1.0,0.0,1.0
211229,2,2,0,0,0,2,2,35,0.0,0.0,0.0,0.0,0.0,0.0,0.0,37,2,35,5.0,0.0,5.0
9903216,3,2,1,1,0,3,3,267,2.0,1.0,1.0,1.0,0.0,2.0,2.0,7,3,4,2.0,2.0,0.0
9503416,3,2,1,1,3,0,0,506,3.0,2.0,1.0,1.0,3.0,0.0,0.0,3,3,0,3.0,3.0,0.0
9709377,0,0,0,0,0,0,0,8,0.0,0.0,0.0,0.0,0.0,0.0,0.0,6,0,6,4.0,0.0,4.0
9910472,0,0,0,0,0,0,0,0,0.0,0.0,0.0,0.0,0.0,0.0,0.0,37,0,37,2.0,0.0,2.0
9604450,2,2,0,0,0,2,3,195,1.0,1.0,0.0,0.0,0.0,1.0,2.0,4,2,2,2.0,1.0,1.0
110233,0,0,0,0,0,0,0,267,0.0,0.0,0.0,0.0,0.0,0.0,0.0,15,0,15,6.0,0.0,6.0
301028,1,1,0,0,0,1,5,226,1.0,1.0,0.0,0.0,0.0,1.0,3.0,14,1,13,4.0,1.0,3.0
9910421,4,1,3,6,0,4,8,66,4.0,1.0,3.0,6.0,0.0,4.0,4.0,6,4,2,5.0,4.0,1.0
9604241,0,0,0,0,0,0,0,228,0.0,0.0,0.0,0.0,0.0,0.0,0.0,4,0,4,3.0,0.0,3.0
206159,1,1,0,0,0,1,17,9,1.0,1.0,0.0,0.0,0.0,1.0,4.0,26,1,25,6.0,1.0,5.0
9702232,0,0,0,0,0,0,0,285,0.0,0.0,0.0,0.0,0.0,0.0,0.0,2,0,2,1.0,0.0,1.0
203048,1,1,0,0,0,1,2,133,0.0,0.0,0.0,0.0,0.0,0.0,0.0,10,1,9,2.0,0.0,2.0
104123,3,2,1,1,1,2,3,63,2.0,1.0,1.0,1.0,0.0,2.0,2.0,23,3,20,6.0,0.0,6.0
102341,1,1,0,0,0,1,4,92,1.0,1.0,0.0,0.0,0.0,1.0,3.0,5,1,4,1.0,1.0,0.0
109276,1,1,0,0,1,0,0,99,,,,,,,,3,1,2,,,
212053,0,0,0,0,0,0,0,80,0.0,0.0,0.0,0.0,0.0,0.0,0.0,7,0,7,,,
9412388,1,1,0,0,1,0,0,266,1.0,1.0,0.0,0.0,1.0,0.0,0.0,1,1,0,1.0,1.0,0.0
9901390,2,2,0,0,1,1,1,125,1.0,1.0,0.0,0.0,1.0,0.0,0.0,11,2,9,3.0,2.0,1.0
211244,0,0,0,0,0,0,0,140,,,,,,,,3,0,3,,,
206289,1,1,0,0,0,1,1,136,0.0,0.0,0.0,0.0,0.0,0.0,0.0,9,1,8,3.0,1.0,2.0
9712361,0,0,0,0,0,0,0,107,0.0,0.0,0.0,0.0,0.0,0.0,0.0,2,0,2,,,
209034,0,0,0,0,0,0,0,108,0.0,0.0,0.0,0.0,0.0,0.0,0.0,6,0,6,3.0,0.0,3.0
9812285,4,3,1,1,4,0,0,212,1.0,1.0,0.0,0.0,1.0,0.0,0.0,4,4,0,2.0,2.0,0.0
111454,1,1,0,0,0,1,1,2060,,,,,,,,4,1,3,1.0,0.0,1.0
212131,1,1,0,0,0,1,5,45,1.0,1.0,0.0,0.0,0.0,1.0,5.0,10,1,9,,,
210418,0,0,0,0,0,0,0,189,0.0,0.0,0.0,0.0,0.0,0.0,0.0,4,0,4,3.0,0.0,3.0
9808285,2,2,0,0,1,1,3,8,1.0,1.0,0.0,0.0,0.0,1.0,2.0,7,2,5,3.0,1.0,2.0
210308,0,0,0,0,0,0,0,1899,,,,,,,,1,0,1,,,
9702425,1,1,0,0,1,0,0,197,1.0,1.0,0.0,0.0,1.0,0.0,0.0,3,1,2,1.0,1.0,0.0
7163,3,2,1,1,0,3,44,131,3.0,2.0,1.0,1.0,0.0,3.0,34.0,24,3,21,14.0,3.0,11.0
9604374,0,0,0,0,0,0,0,1642,0.0,0.0,0.0,0.0,0.0,0.0,0.0,1,0,1,1.0,0.0,1.0
112020,0,0,0,0,0,0,0,15,0.0,0.0,0.0,0.0,0.0,0.0,0.0,21,0,21,3.0,0.0,3.0
9410373,2,2,0,0,2,0,0,163,,,,,,,,2,2,0,,,
9907565,0,0,0,0,0,0,0,70,0.0,0.0,0.0,0.0,0.0,0.0,0.0,9,0,9,,,
302263,0,0,0,0,0,0,0,2,0.0,0.0,0.0,0.0,0.0,0.0,0.0,18,0,18,4.0,0.0,4.0
9706241,0,0,0,0,0,0,0,17,0.0,0.0,0.0,0.0,0.0,0.0,0.0,26,0,26,24.0,0.0,24.0
211020,0,0,0,0,0,0,0,469,0.0,0.0,0.0,0.0,0.0,0.0,0.0,2,0,2,2.0,0.0,2.0
9911398,2,2,0,0,0,2,5,357,2.0,2.0,0.0,0.0,0.0,2.0,5.0,7,2,5,6.0,2.0,4.0
302179,0,0,0,0,0,0,0,11,0.0,0.0,0.0,0.0,0.0,0.0,0.0,94,0,94,22.0,0.0,22.0
9602312,2,2,0,0,2,0,0,53,0.0,0.0,0.0,0.0,0.0,0.0,0.0,19,2,17,2.0,0.0,2.0
9308314,0,0,0,0,0,0,0,367,0.0,0.0,0.0,0.0,0.0,0.0,0.0,1,0,1,1.0,0.0,1.0
9703398,3,3,0,0,3,0,0,274,3.0,3.0,0.0,0.0,3.0,0.0,0.0,5,3,2,1.0,1.0,0.0
9905274,0,0,0,0,0,0,0,154,0.0,0.0,0.0,0.0,0.0,0.0,0.0,3,0,3,3.0,0.0,3.0
201098,1,1,0,0,0,1,2,35,1.0,1.0,0.0,0.0,0.0,1.0,1.0,30,1,29,5.0,0.0,5.0
204310,1,1,0,0,1,0,0,573,1.0,1.0,0.0,0.0,1.0,0.0,0.0,2,1,1,2.0,1.0,1.0
9407369,0,0,0,0,0,0,0,15,0.0,0.0,0.0,0.0,0.0,0.0,0.0,14,0,14,1.0,0.0,1.0
9207259,2,2,0,0,2,0,0,1490,1.0,1.0,0.0,0.0,1.0,0.0,0.0,2,2,0,1.0,1.0,0.0
210408,2,2,0,0,1,1,11,47,1.0,1.0,0.0,0.0,0.0,1.0,10.0,27,2,25,12.0,1.0,11.0
9812425,0,0,0,0,0,0,0,148,0.0,0.0,0.0,0.0,0.0,0.0,0.0,9,0,9,5.0,0.0,5.0
202248,4,1,3,4,0,4,60,20,2.0,1.0,1.0,1.0,0.0,2.0,30.0,39,4,35,11.0,2.0,9.0
11030,0,0,0,0,0,0,0,18,0.0,0.0,0.0,0.0,0.0,0.0,0.0,14,0,14,3.0,0.0,3.0
11341,1,1,0,0,0,1,6,200,1.0,1.0,0.0,0.0,0.0,1.0,3.0,10,1,9,3.0,1.0,2.0
9608217,1,1,0,0,1,0,0,236,0.0,0.0,0.0,0.0,0.0,0.0,0.0,5,1,4,1.0,0.0,1.0
302221,0,0,0,0,0,0,0,56,,,,,,,,4,0,4,1.0,0.0,1.0
9511248,0,0,0,0,0,0,0,48,,,,,,,,2,0,2,,,
3080,0,0,0,0,0,0,0,844,,,,,,,,2,0,2,,,
9909309,0,0,0,0,0,0,0,154,,,,,,,,1,0,1,1.0,0.0,1.0
301110,0,0,0,0,0,0,0,32,0.0,0.0,0.0,0.0,0.0,0.0,0.0,69,0,69,36.0,0.0,36.0
212122,0,0,0,0,0,0,0,473,0.0,0.0,0.0,0.0,0.0,0.0,0.0,2,0,2,1.0,0.0,1.0
206239,2,1,1,1,0,2,2,381,1.0,1.0,0.0,0.0,0.0,1.0,1.0,17,2,15,6.0,1.0,5.0
207246,0,0,0,0,0,0,0,96,0.0,0.0,0.0,0.0,0.0,0.0,0.0,20,0,20,3.0,0.0,3.0
1078,0,0,0,0,0,0,0,54,0.0,0.0,0.0,0.0,0.0,0.0,0.0,16,0,16,3.0,0.0,3.0
9507446,0,0,0,0,0,0,0,1498,,,,,,,,1,0,1,,,
9809350,0,0,0,0,0,0,0,34,0.0,0.0,0.0,0.0,0.0,0.0,0.0,9,0,9,4.0,0.0,4.0
9605380,0,0,0,0,0,0,0,97,,,,,,,,1,0,1,,,
9411275,1,1,0,0,1,0,0,29,0.0,0.0,0.0,0.0,0.0,0.0,0.0,15,1,14,6.0,0.0,6.0
3027,0,0,0,0,0,0,0,153,0.0,0.0,0.0,0.0,0.0,0.0,0.0,7,0,7,2.0,0.0,2.0
207345,3,2,1,1,0,3,18,127,3.0,2.0,1.0,1.0,0.0,3.0,15.0,20,3,17,10.0,3.0,7.0
9608383,0,0,0,0,0,0,0,403,0.0,0.0,0.0,0.0,0.0,0.0,0.0,3,0,3,1.0,0.0,1.0
11384,0,0,0,0,0,0,0,19,0.0,0.0,0.0,0.0,0.0,0.0,0.0,9,0,9,,,
210358,0,0,0,0,0,0,0,24,0.0,0.0,0.0,0.0,0.0,0.0,0.0,14,0,14,2.0,0.0,2.0
9511222,0,0,0,0,0,0,0,156,,,,,,,,1,0,1,,,
9612228,0,0,0,0,0,0,0,326,0.0,0.0,0.0,0.0,0.0,0.0,0.0,5,0,5,2.0,0.0,2.0
9609372,4,1,3,5,1,3,3,68,4.0,1.0,3.0,5.0,4.0,0.0,0.0,8,4,4,4.0,4.0,0.0
9901328,0,0,0,0,0,0,0,9,0.0,0.0,0.0,0.0,0.0,0.0,0.0,29,0,29,5.0,0.0,5.0
9608234,0,0,0,0,0,0,0,61,0.0,0.0,0.0,0.0,0.0,0.0,0.0,9,0,9,1.0,0.0,1.0
2040,0,0,0,0,0,0,0,349,0.0,0.0,0.0,0.0,0.0,0.0,0.0,2,0,2,2.0,0.0,2.0
204046,2,2,0,0,0,2,7,45,0.0,0.0,0.0,0.0,0.0,0.0,0.0,17,2,15,4.0,1.0,3.0
205087,0,0,0,0,0,0,0,76,0.0,0.0,0.0,0.0,0.0,0.0,0.0,20,0,20,7.0,0.0,7.0
9908478,2,1,1,1,2,0,0,142,2.0,1.0,1.0,1.0,2.0,0.0,0.0,2,2,0,2.0,2.0,0.0
112146,1,1,0,0,0,1,2,193,,,,,,,,13,1,12,1.0,0.0,1.0
3057,1,1,0,0,0,1,3,25,0.0,0.0,0.0,0.0,0.0,0.0,0.0,10,1,9,,,
9803423,1,1,0,0,0,1,7,57,1.0,1.0,0.0,0.0,0.0,1.0,5.0,18,1,17,8.0,1.0,7.0
206007,0,0,0,0,0,0,0,83,0.0,0.0,0.0,0.0,0.0,0.0,0.0,25,0,25,9.0,0.0,9.0
112002,0,0,0,0,0,0,0,0,0.0,0.0,0.0,0.0,0.0,0.0,0.0,11,0,11,3.0,0.0,3.0
203043,1,1,0,0,0,1,1,70,1.0,1.0,0.0,0.0,0.0,1.0,1.0,12,1,11,4.0,0.0,4.0
211276,1,1,0,0,0,1,4,12,1.0,1.0,0.0,0.0,0.0,1.0,4.0,12,1,11,,,
9706255,1,1,0,0,1,0,0,765,1.0,1.0,0.0,0.0,1.0,0.0,0.0,4,1,3,1.0,1.0,0.0
208033,1,1,0,0,0,1,2,121,1.0,1.0,0.0,0.0,0.0,1.0,1.0,9,1,8,6.0,0.0,6.0
9903505,0,0,0,0,0,0,0,3,0.0,0.0,0.0,0.0,0.0,0.0,0.0,14,0,14,,,
8219,1,1,0,0,1,0,0,468,1.0,1.0,0.0,0.0,1.0,0.0,0.0,1,1,0,1.0,1.0,0.0
9506368,0,0,0,0,0,0,0,77,0.0,0.0,0.0,0.0,0.0,0.0,0.0,4,0,4,4.0,0.0,4.0
9512314,1,1,0,0,1,0,0,1707,,,,,,,,2,1,1,,,
105169,0,0,0,0,0,0,0,59,0.0,0.0,0.0,0.0,0.0,0.0,0.0,3,0,3,1.0,0.0,1.0
302171,0,0,0,0,0,0,0,16,0.0,0.0,0.0,0.0,0.0,0.0,0.0,24,0,24,8.0,0.0,8.0
9406405,0,0,0,0,0,0,0,4,0.0,0.0,0.0,0.0,0.0,0.0,0.0,10,0,10,1.0,0.0,1.0
9705403,0,0,0,0,0,0,0,92,0.0,0.0,0.0,0.0,0.0,0.0,0.0,4,0,4,3.0,0.0,3.0
206069,0,0,0,0,0,0,0,51,0.0,0.0,0.0,0.0,0.0,0.0,0.0,4,0,4,1.0,0.0,1.0
9705326,0,0,0,0,0,0,0,118,,,,,,,,1,0,1,,,
209053,1,1,0,0,0,1,2,91,1.0,1.0,0.0,0.0,0.0,1.0,2.0,4,1,3,3.0,0.0,3.0
111132,0,0,0,0,0,0,0,51,0.0,0.0,0.0,0.0,0.0,0.0,0.0,8,0,8,2.0,0.0,2.0
301197,0,0,0,0,0,0,0,185,0.0,0.0,0.0,0.0,0.0,0.0,0.0,1,0,1,1.0,0.0,1.0
9510445,0,0,0,0,0,0,0,97,0.0,0.0,0.0,0.0,0.0,0.0,0.0,3,0,3,2.0,0.0,2.0
9907413,0,0,0,0,0,0,0,276,0.0,0.0,0.0,0.0,0.0,0.0,0.0,9,0,9,4.0,0.0,4.0
9089,2,2,0,0,1,1,1,73,0.0,0.0,0.0,0.0,0.0,0.0,0.0,33,2,31,25.0,0.0,25.0
9068,1,1,0,0,0,1,3,102,0.0,0.0,0.0,0.0,0.0,0.0,0.0,58,1,57,22.0,0.0,22.0
9904224,0,0,0,0,0,0,0,1397,,,,,,,,1,0,1,,,
109251,0,0,0,0,0,0,0,1855,,,,,,,,11,0,11,1.0,0.0,1.0
7039,1,1,0,0,0,1,15,330,1.0,1.0,0.0,0.0,0.0,1.0,7.0,22,1,21,5.0,1.0,4.0
9702317,0,0,0,0,0,0,0,520,0.0,0.0,0.0,0.0,0.0,0.0,0.0,1,0,1,1.0,0.0,1.0
110244,2,1,1,1,0,2,12,21,2.0,1.0,1.0,1.0,0.0,2.0,12.0,18,2,16,3.0,2.0,1.0
9908375,0,0,0,0,0,0,0,1764,0.0,0.0,0.0,0.0,0.0,0.0,0.0,6,0,6,2.0,0.0,2.0
9805236,0,0,0,0,0,0,0,51,0.0,0.0,0.0,0.0,0.0,0.0,0.0,7,0,7,6.0,0.0,6.0
9409292,0,0,0,0,0,0,0,394,0.0,0.0,0.0,0.0,0.0,0.0,0.0,2,0,2,2.0,0.0,2.0
9803374,4,2,2,3,0,4,7,125,4.0,2.0,2.0,3.0,0.0,4.0,7.0,7,4,3,7.0,4.0,3.0
203086,0,0,0,0,0,0,0,26,0.0,0.0,0.0,0.0,0.0,0.0,0.0,15,0,15,1.0,0.0,1.0
302158,0,0,0,0,0,0,0,68,0.0,0.0,0.0,0.0,0.0,0.0,0.0,18,0,18,12.0,0.0,12.0
9808491,0,0,0,0,0,0,0,110,0.0,0.0,0.0,0.0,0.0,0.0,0.0,10,0,10,6.0,0.0,6.0
9710412,0,0,0,0,0,0,0,1970,,,,,,,,1,0,1,,,
9602401,0,0,0,0,0,0,0,326,0.0,0.0,0.0,0.0,0.0,0.0,0.0,5,0,5,1.0,0.0,1.0
9804424,0,0,0,0,0,0,0,38,0.0,0.0,0.0,0.0,0.0,0.0,0.0,4,0,4,3.0,0.0,3.0
9912382,0,0,0,0,0,0,0,1733,,,,,,,,2,0,2,,,
9701239,0,0,0,0,0,0,0,471,0.0,0.0,0.0,0.0,0.0,0.0,0.0,1,0,1,1.0,0.0,1.0
110298,0,0,0,0,0,0,0,254,0.0,0.0,0.0,0.0,0.0,0.0,0.0,2,0,2,2.0,0.0,2.0
9608248,1,1,0,0,1,0,0,272,1.0,1.0,0.0,0.0,1.0,0.0,0.0,2,1,1,2.0,1.0,1.0
9808383,1,1,0,0,0,1,2,246,1.0,1.0,0.0,0.0,0.0,1.0,2.0,7,1,6,5.0,1.0,4.0
9908383,0,0,0,0,0,0,0,151,0.0,0.0,0.0,0.0,0.0,0.0,0.0,10,0,10,3.0,0.0,3.0
9504301,0,0,0,0,0,0,0,1931,,,,,,,,1,0,1,,,
212041,0,0,0,0,0,0,0,23,0.0,0.0,0.0,0.0,0.0,0.0,0.0,23,0,23,2.0,0.0,2.0
112192,0,0,0,0,0,0,0,9,0.0,0.0,0.0,0.0,0.0,0.0,0.0,20,0,20,6.0,0.0,6.0
9702271,0,0,0,0,0,0,0,441,0.0,0.0,0.0,0.0,0.0,0.0,0.0,5,0,5,2.0,0.0,2.0
11052,1,1,0,0,1,0,0,175,1.0,1.0,0.0,0.0,1.0,0.0,0.0,2,1,1,1.0,0.0,1.0
9908282,0,0,0,0,0,0,0,103,0.0,0.0,0.0,0.0,0.0,0.0,0.0,3,0,3,1.0,0.0,1.0
9808208,1,1,0,0,0,1,4,65,1.0,1.0,0.0,0.0,0.0,1.0,2.0,5,1,4,4.0,1.0,3.0
9912454,2,1,1,1,2,0,0,408,2.0,1.0,1.0,1.0,2.0,0.0,0.0,2,2,0,2.0,2.0,0.0
104195,0,0,0,0,0,0,0,2,0.0,0.0,0.0,0.0,0.0,0.0,0.0,8,0,8,1.0,0.0,1.0
9506441,0,0,0,0,0,0,0,1102,,,,,,,,2,0,2,,,
112224,0,0,0,0,0,0,0,2,0.0,0.0,0.0,0.0,0.0,0.0,0.0,14,0,14,3.0,0.0,3.0
5008,0,0,0,0,0,0,0,0,0.0,0.0,0.0,0.0,0.0,0.0,0.0,7,0,7,1.0,0.0,1.0
9808435,0,0,0,0,0,0,0,610,0.0,0.0,0.0,0.0,0.0,0.0,0.0,2,0,2,1.0,0.0,1.0
9609464,0,0,0,0,0,0,0,50,0.0,0.0,0.0,0.0,0.0,0.0,0.0,13,0,13,3.0,0.0,3.0
9608202,0,0,0,0,0,0,0,58,0.0,0.0,0.0,0.0,0.0,0.0,0.0,8,0,8,3.0,0.0,3.0
1278,0,0,0,0,0,0,0,139,0.0,0.0,0.0,0.0,0.0,0.0,0.0,2,0,2,1.0,0.0,1.0
12139,0,0,0,0,0,0,0,120,0.0,0.0,0.0,0.0,0.0,0.0,0.0,1,0,1,,,
302270,0,0,0,0,0,0,0,41,0.0,0.0,0.0,0.0,0.0,0.0,0.0,14,0,14,4.0,0.0,4.0
209331,1,1,0,0,0,1,21,1,1.0,1.0,0.0,0.0,0.0,1.0,16.0,60,1,59,24.0,0.0,24.0
9408341,0,0,0,0,0,0,0,822,,,,,,,,2,0,2,1.0,0.0,1.0
9606242,0,0,0,0,0,0,0,34,0.0,0.0,0.0,0.0,0.0,0.0,0.0,4,0,4,1.0,0.0,1.0
9905433,0,0,0,0,0,0,0,320,0.0,0.0,0.0,0.0,0.0,0.0,0.0,11,0,11,3.0,0.0,3.0
9701383,0,0,0,0,0,0,0,507,0.0,0.0,0.0,0.0,0.0,0.0,0.0,1,0,1,1.0,0.0,1.0
110251,0,0,0,0,0,0,0,1,0.0,0.0,0.0,0.0,0.0,0.0,0.0,23,0,23,1.0,0.0,1.0
9801247,0,0,0,0,0,0,0,17,0.0,0.0,0.0,0.0,0.0,0.0,0.0,21,0,21,4.0,0.0,4.0
208137,1,1,0,0,1,0,0,729,1.0,1.0,0.0,0.0,1.0,0.0,0.0,1,1,0,1.0,1.0,0.0
203245,0,0,0,0,0,0,0,128,0.0,0.0,0.0,0.0,0.0,0.0,0.0,4,0,4,3.0,0.0,3.0
9810521,0,0,0,0,0,0,0,271,0.0,0.0,0.0,0.0,0.0,0.0,0.0,1,0,1,,,
9308252,0,0,0,0,0,0,0,581,0.0,0.0,0.0,0.0,0.0,0.0,0.0,3,0,3,3.0,0.0,3.0
209310,0,0,0,0,0,0,0,107,0.0,0.0,0.0,0.0,0.0,0.0,0.0,49,0,49,16.0,0.0,16.0
9609294,0,0,0,0,0,0,0,264,0.0,0.0,0.0,0.0,0.0,0.0,0.0,3,0,3,,,
9512249,0,0,0,0,0,0,0,1479,0.0,0.0,0.0,0.0,0.0,0.0,0.0,6,0,6,1.0,0.0,1.0
9701414,0,0,0,0,0,0,0,266,0.0,0.0,0.0,0.0,0.0,0.0,0.0,9,0,9,3.0,0.0,3.0
301136,0,0,0,0,0,0,0,252,0.0,0.0,0.0,0.0,0.0,0.0,0.0,4,0,4,1.0,0.0,1.0
3117,0,0,0,0,0,0,0,76,0.0,0.0,0.0,0.0,0.0,0.0,0.0,3,0,3,,,
105339,0,0,0,0,0,0,0,1,0.0,0.0,0.0,0.0,0.0,0.0,0.0,11,0,11,2.0,0.0,2.0
206256,0,0,0,0,0,0,0,47,0.0,0.0,0.0,0.0,0.0,0.0,0.0,6,0,6,4.0,0.0,4.0
9701280,0,0,0,0,0,0,0,13,0.0,0.0,0.0,0.0,0.0,0.0,0.0,18,0,18,10.0,0.0,10.0
5247,0,0,0,0,0,0,0,2,,,,,,,,8,0,8,,,
9906479,0,0,0,0,0,0,0,195,0.0,0.0,0.0,0.0,0.0,0.0,0.0,5,0,5,1.0,0.0,1.0
9306213,0,0,0,0,0,0,0,1057,,,,,,,,2,0,2,,,
9306312,0,0,0,0,0,0,0,41,0.0,0.0,0.0,0.0,0.0,0.0,0.0,3,0,3,2.0,0.0,2.0
9812343,0,0,0,0,0,0,0,324,0.0,0.0,0.0,0.0,0.0,0.0,0.0,5,0,5,2.0,0.0,2.0
12316,0,0,0,0,0,0,0,29,0.0,0.0,0.0,0.0,0.0,0.0,0.0,15,0,15,4.0,0.0,4.0
212222,0,0,0,0,0,0,0,406,0.0,0.0,0.0,0.0,0.0,0.0,0.0,2,0,2,1.0,0.0,1.0
101054,1,1,0,0,1,0,0,586,1.0,1.0,0.0,0.0,1.0,0.0,0.0,2,1,1,2.0,1.0,1.0
9903525,0,0,0,0,0,0,0,19,0.0,0.0,0.0,0.0,0.0,0.0,0.0,28,0,28,9.0,0.0,9.0
9502364,0,0,0,0,0,0,0,1009,,,,,,,,1,0,1,1.0,0.0,1.0
111456,0,0,0,0,0,0,0,1155,,,,,,,,3,0,3,,,
302058,1,1,0,0,1,0,0,1537,,,,,,,,1,1,0,,,
9608429,1,1,0,0,0,1,2,22,1.0,1.0,0.0,0.0,0.0,1.0,2.0,4,1,3,1.0,1.0,0.0
9302236,0,0,0,0,0,0,0,1433,,,,,,,,1,0,1,,,
210231,0,0,0,0,0,0,0,6,0.0,0.0,0.0,0.0,0.0,0.0,0.0,6,0,6,1.0,0.0,1.0
9807491,0,0,0,0,0,0,0,1852,,,,,,,,4,0,4,1.0,0.0,1.0
6191,0,0,0,0,0,0,0,124,0.0,0.0,0.0,0.0,0.0,0.0,0.0,3,0,3,,,
302066,1,1,0,0,0,1,5,41,0.0,0.0,0.0,0.0,0.0,0.0,0.0,38,1,37,13.0,0.0,13.0
212044,0,0,0,0,0,0,0,27,0.0,0.0,0.0,0.0,0.0,0.0,0.0,25,0,25,9.0,0.0,9.0
209318,0,0,0,0,0,0,0,289,0.0,0.0,0.0,0.0,0.0,0.0,0.0,2,0,2,2.0,0.0,2.0
207017,0,0,0,0,0,0,0,76,0.0,0.0,0.0,0.0,0.0,0.0,0.0,6,0,6,2.0,0.0,2.0
203026,0,0,0,0,0,0,0,255,0.0,0.0,0.0,0.0,0.0,0.0,0.0,5,0,5,4.0,0.0,4.0
207166,0,0,0,0,0,0,0,2,0.0,0.0,0.0,0.0,0.0,0.0,0.0,10,0,10,1.0,0.0,1.0
208051,0,0,0,0,0,0,0,113,0.0,0.0,0.0,0.0,0.0,0.0,0.0,4,0,4,3.0,0.0,3.0
204053,0,0,0,0,0,0,0,79,0.0,0.0,0.0,0.0,0.0,0.0,0.0,7,0,7,2.0,0.0,2.0
8142,0,0,0,0,0,0,0,131,0.0,0.0,0.0,0.0,0.0,0.0,0.0,6,0,6,2.0,0.0,2.0
9812295,0,0,0,0,0,0,0,118,0.0,0.0,0.0,0.0,0.0,0.0,0.0,2,0,2,1.0,0.0,1.0
212115,0,0,0,0,0,0,0,86,0.0,0.0,0.0,0.0,0.0,0.0,0.0,8,0,8,3.0,0.0,3.0
12330,0,0,0,0,0,0,0,54,0.0,0.0,0.0,0.0,0.0,0.0,0.0,8,0,8,1.0,0.0,1.0
109273,0,0,0,0,0,0,0,126,0.0,0.0,0.0,0.0,0.0,0.0,0.0,12,0,12,6.0,0.0,6.0
9909413,0,0,0,0,0,0,0,1211,,,,,,,,1,0,1,,,
302229,0,0,0,0,0,0,0,1,0.0,0.0,0.0,0.0,0.0,0.0,0.0,84,0,84,12.0,0.0,12.0
201116,0,0,0,0,0,0,0,311,0.0,0.0,0.0,0.0,0.0,0.0,0.0,5,0,5,4.0,0.0,4.0
9707397,0,0,0,0,0,0,0,199,0.0,0.0,0.0,0.0,0.0,0.0,0.0,2,0,2,1.0,0.0,1.0
208253,0,0,0,0,0,0,0,9,0.0,0.0,0.0,0.0,0.0,0.0,0.0,18,0,18,6.0,0.0,6.0
9511356,0,0,0,0,0,0,0,360,0.0,0.0,0.0,0.0,0.0,0.0,0.0,4,0,4,,,
9504282,0,0,0,0,0,0,0,217,,,,,,,,1,0,1,1.0,0.0,1.0
9908403,0,0,0,0,0,0,0,21,,,,,,,,5,0,5,,,
111310,0,0,0,0,0,0,0,136,0.0,0.0,0.0,0.0,0.0,0.0,0.0,6,0,6,6.0,0.0,6.0
11061,0,0,0,0,0,0,0,1779,,,,,,,,6,0,6,,,
9910430,0,0,0,0,0,0,0,26,0.0,0.0,0.0,0.0,0.0,0.0,0.0,5,0,5,1.0,0.0,1.0
9504304,33,9,24,67,33,0,0,100,25.0,4.0,21.0,56.0,25.0,0.0,0.0,33,33,0,16.0,16.0,0.0
9508393,30,5,25,71,4,26,46,13,11.0,2.0,9.0,21.0,0.0,11.0,16.0,33,30,3,6.0,4.0,2.0
9406263,49,15,34,94,33,16,42,67,14.0,2.0,12.0,28.0,14.0,0.0,0.0,54,49,5,7.0,7.0,0.0
12208,15,4,11,24,0,15,148,1,5.0,4.0,1.0,1.0,0.0,5.0,22.0,44,15,29,13.0,7.0,6.0
9810260,79,8,71,537,3,76,940,1,61.0,3.0,58.0,427.0,1.0,60.0,790.0,117,79,38,64.0,45.0,19.0
9308287,58,12,46,218,9,49,216,6,44.0,6.0,38.0,195.0,3.0,41.0,189.0,66,58,8,29.0,22.0,7.0
9409287,73,10,63,344,13,60,158,6,56.0,8.0,48.0,278.0,5.0,51.0,141.0,79,73,6,26.0,21.0,5.0
7233,11,5,6,10,3,8,23,3,4.0,4.0,0.0,0.0,0.0,4.0,15.0,18,11,7,10.0,4.0,6.0
9907243,34,9,25,78,6,28,140,32,13.0,4.0,9.0,35.0,1.0,12.0,19.0,77,34,43,11.0,9.0,2.0
9904408,98,11,87,645,7,91,818,34,46.0,3.0,43.0,374.0,1.0,45.0,466.0,153,98,55,59.0,36.0,23.0
110260,1,1,0,0,0,1,6,1,0.0,0.0,0.0,0.0,0.0,0.0,0.0,22,1,21,4.0,0.0,4.0
9306323,41,12,29,97,41,0,0,34,9.0,2.0,7.0,25.0,9.0,0.0,0.0,41,41,0,8.0,8.0,0.0
9406205,47,21,26,48,22,25,46,35,10.0,5.0,5.0,8.0,6.0,4.0,4.0,62,47,15,6.0,5.0,1.0
9511282,3,1,2,3,2,1,2,114,2.0,1.0,1.0,1.0,1.0,1.0,2.0,9,3,6,2.0,0.0,2.0
9301281,48,18,30,70,48,0,0,35,8.0,2.0,6.0,13.0,8.0,0.0,0.0,48,48,0,5.0,5.0,0.0
103338,6,5,1,2,2,4,5,170,2.0,1.0,1.0,1.0,2.0,0.0,0.0,15,6,9,3.0,3.0,0.0
101114,6,4,2,3,4,2,6,170,3.0,2.0,1.0,1.0,1.0,2.0,6.0,10,6,4,6.0,2.0,4.0
9806279,67,7,60,267,15,52,132,95,31.0,3.0,28.0,130.0,9.0,22.0,53.0,76,67,9,26.0,23.0,3.0
9504417,3,3,0,0,2,1,1,41,1.0,1.0,0.0,0.0,1.0,0.0,0.0,5,3,2,2.0,1.0,1.0
9611397,50,19,31,91,14,36,115,4,4.0,2.0,2.0,3.0,0.0,4.0,9.0,68,50,18,5.0,2.0,3.0
9709275,6,4,2,3,0,6,40,62,1.0,1.0,0.0,0.0,0.0,1.0,6.0,25,6,19,5.0,1.0,4.0
9808217,5,3,2,2,1,4,16,33,2.0,2.0,0.0,0.0,0.0,2.0,12.0,14,5,9,9.0,2.0,7.0
9908288,137,52,85,208,76,61,105,30,14.0,7.0,7.0,8.0,10.0,4.0,4.0,152,137,15,9.0,8.0,1.0
9612383,12,4,8,14,8,4,18,35,2.0,1.0,1.0,1.0,0.0,2.0,9.0,24,12,12,8.0,2.0,6.0
107266,30,2,28,112,0,30,248,37,19.0,1.0,18.0,82.0,0.0,19.0,151.0,66,30,36,29.0,18.0,11.0
9410233,11,6,5,9,1,10,44,26,6.0,4.0,2.0,4.0,0.0,6.0,27.0,27,11,16,9.0,4.0,5.0
9802294,34,3,31,119,9,25,93,4,12.0,2.0,10.0,25.0,0.0,12.0,20.0,51,34,17,10.0,8.0,2.0
9906292,7,4,3,4,0,7,48,26,5.0,2.0,3.0,4.0,0.0,5.0,30.0,23,7,16,12.0,4.0,8.0
9306265,9,6,3,3,7,2,3,35,3.0,3.0,0.0,0.0,2.0,1.0,2.0,11,9,2,3.0,1.0,2.0
9308330,34,13,21,66,31,3,3,86,15.0,8.0,7.0,19.0,15.0,0.0,0.0,36,34,2,10.0,10.0,0.0
9410364,35,12,23,56,12,23,47,35,12.0,5.0,7.0,28.0,3.0,9.0,13.0,42,35,7,6.0,5.0,1.0
9903422,153,7,146,1152,2,151,1017,2,83.0,4.0,79.0,590.0,0.0,83.0,722.0,167,153,14,51.0,37.0,14.0
9507317,1,1,0,0,1,0,0,15,0.0,0.0,0.0,0.0,0.0,0.0,0.0,11,1,10,2.0,0.0,2.0
110021,13,7,6,8,7,6,16,5,2.0,1.0,1.0,1.0,2.0,0.0,0.0,33,13,20,2.0,0.0,2.0
9505233,37,8,29,101,27,10,19,32,11.0,4.0,7.0,10.0,7.0,4.0,5.0,44,37,7,9.0,9.0,0.0
9301271,20,8,12,27,16,4,4,90,10.0,2.0,8.0,22.0,10.0,0.0,0.0,21,20,1,2.0,2.0,0.0
9302221,48,8,40,131,48,0,0,223,10.0,2.0,8.0,20.0,10.0,0.0,0.0,48,48,0,9.0,9.0,0.0
9311291,2,1,1,1,2,0,0,341,0.0,0.0,0.0,0.0,0.0,0.0,0.0,6,2,4,2.0,0.0,2.0
9611358,9,2,7,11,0,9,61,25,5.0,1.0,4.0,7.0,0.0,5.0,29.0,28,9,19,9.0,4.0,5.0
9601310,54,6,48,258,5,49,170,23,37.0,4.0,33.0,163.0,3.0,34.0,129.0,65,54,11,31.0,25.0,6.0
9409388,49,3,46,212,33,16,16,25,22.0,2.0,20.0,94.0,10.0,12.0,12.0,50,49,1,20.0,19.0,1.0
9311269,214,34,180,766,73,141,428,10,31.0,11.0,20.0,57.0,3.0,28.0,95.0,237,214,23,12.0,7.0,5.0
9306242,147,16,131,731,147,0,0,10,14.0,2.0,12.0,31.0,14.0,0.0,0.0,147,147,0,12.0,12.0,0.0
9403364,123,21,102,501,123,0,0,42,26.0,3.0,23.0,108.0,26.0,0.0,0.0,123,123,0,13.0,13.0,0.0
9212278,156,12,144,832,147,9,9,3,40.0,2.0,38.0,196.0,40.0,0.0,0.0,157,156,1,26.0,26.0,0.0
9302316,219,18,201,1636,219,0,0,0,85.0,4.0,81.0,869.0,85.0,0.0,0.0,220,219,1,54.0,54.0,0.0
9806272,58,6,52,245,10,48,139,0,28.0,2.0,26.0,149.0,0.0,28.0,105.0,65,58,7,32.0,27.0,5.0
9901388,61,8,53,224,3,58,521,0,27.0,2.0,25.0,107.0,0.0,27.0,330.0,121,61,60,39.0,22.0,17.0
9404308,26,12,14,18,18,8,8,0,13.0,7.0,6.0,7.0,7.0,6.0,6.0,27,26,1,8.0,8.0,0.0
9707215,60,7,53,179,32,28,47,3,25.0,1.0,24.0,80.0,6.0,19.0,19.0,66,60,6,9.0,9.0,0.0
1311,4,3,1,1,4,0,0,221,2.0,2.0,0.0,0.0,2.0,0.0,0.0,8,4,4,2.0,2.0,0.0
9811266,19,12,7,19,0,19,174,3,11.0,4.0,7.0,17.0,0.0,11.0,127.0,51,19,32,27.0,10.0,17.0
9908294,3,1,2,2,1,2,3,1892,,,,,,,,10,3,7,,,
9802445,116,14,102,408,75,41,64,46,25.0,4.0,21.0,67.0,3.0,22.0,37.0,119,116,3,11.0,11.0,0.0
9402244,3,2,1,1,3,0,0,56,,,,,,,,3,3,0,,,
9805343,32,2,30,94,0,32,48,0,11.0,2.0,9.0,17.0,1.0,10.0,10.0,37,32,5,7.0,6.0,1.0
9702372,22,15,7,9,9,13,71,0,4.0,3.0,1.0,1.0,2.0,2.0,5.0,43,22,21,5.0,2.0,3.0
9710431,103,14,89,486,90,13,15,28,42.0,3.0,39.0,250.0,42.0,0.0,0.0,108,103,5,29.0,29.0,0.0
9802330,4,3,1,2,0,4,11,67,2.0,2.0,0.0,0.0,0.0,2.0,8.0,13,4,9,8.0,3.0,5.0
9606467,24,7,17,56,5,19,63,10,7.0,2.0,5.0,14.0,1.0,6.0,11.0,33,24,9,12.0,9.0,3.0
9711421,19,7,12,38,4,15,38,0,8.0,3.0,5.0,11.0,0.0,8.0,20.0,26,19,7,3.0,2.0,1.0
9804262,24,4,20,95,7,17,23,0,20.0,2.0,18.0,91.0,4.0,16.0,17.0,28,24,4,19.0,18.0,1.0
9210256,31,4,27,96,31,0,0,81,22.0,1.0,21.0,67.0,22.0,0.0,0.0,31,31,0,11.0,11.0,0.0
9606383,47,11,36,91,4,43,208,3,19.0,5.0,14.0,33.0,1.0,18.0,108.0,67,47,20,19.0,9.0,10.0
9407339,557,44,513,4697,407,150,250,17,180.0,2.0,178.0,2209.0,86.0,94.0,135.0,568,557,11,74.0,73.0,1.0
9812256,72,14,58,368,5,67,464,46,48.0,6.0,42.0,266.0,3.0,45.0,293.0,160,72,88,40.0,33.0,7.0
9710460,87,8,79,413,3,84,407,46,66.0,4.0,62.0,338.0,0.0,66.0,328.0,101,87,14,30.0,26.0,4.0
9506417,61,7,54,329,23,38,122,71,35.0,2.0,33.0,215.0,5.0,30.0,100.0,69,61,8,33.0,28.0,5.0
9410384,58,16,42,120,48,10,10,28,11.0,3.0,8.0,30.0,11.0,0.0,0.0,61,58,3,5.0,5.0,0.0
9712221,38,7,31,108,5,33,353,15,25.0,4.0,21.0,89.0,0.0,25.0,322.0,69,38,31,42.0,17.0,25.0
9702361,45,2,43,230,8,37,67,0,17.0,1.0,16.0,58.0,6.0,11.0,11.0,52,45,7,18.0,16.0,2.0
9910433,9,5,4,6,0,9,46,0,3.0,2.0,1.0,1.0,0.0,3.0,12.0,18,9,9,13.0,5.0,8.0
9411298,29,11,18,25,1,28,47,10,8.0,3.0,5.0,7.0,8.0,0.0,0.0,36,29,7,4.0,4.0,0.0
9504314,83,10,73,393,13,70,134,12,47.0,6.0,41.0,154.0,5.0,42.0,87.0,88,83,5,28.0,24.0,4.0
9408224,96,5,91,916,63,33,33,12,77.0,3.0,74.0,819.0,77.0,0.0,0.0,99,96,3,42.0,42.0,0.0
9704347,22,9,13,34,2,20,259,15,10.0,4.0,6.0,19.0,0.0,10.0,218.0,86,22,64,41.0,8.0,33.0
9706519,7,5,2,3,0,7,56,36,2.0,1.0,1.0,1.0,0.0,2.0,29.0,38,7,31,20.0,2.0,18.0
11337,17,9,8,8,4,13,92,1,3.0,2.0,1.0,1.0,0.0,3.0,35.0,59,17,42,8.0,2.0,6.0
9909202,41,3,38,218,2,39,102,34,33.0,3.0,30.0,197.0,1.0,32.0,75.0,53,41,12,29.0,26.0,3.0
10195,28,6,22,50,0,28,169,2,13.0,3.0,10.0,25.0,0.0,13.0,103.0,44,28,16,20.0,10.0,10.0
9511462,12,6,6,6,1,11,77,1,8.0,5.0,3.0,3.0,0.0,8.0,57.0,34,12,22,14.0,4.0,10.0
9305348,108,17,91,523,108,0,0,29,49.0,2.0,47.0,266.0,49.0,0.0,0.0,108,108,0,28.0,28.0,0.0
9606237,62,10,52,175,14,48,78,60,13.0,3.0,10.0,49.0,1.0,12.0,12.0,72,62,10,16.0,14.0,2.0
9705244,58,3,55,344,12,46,285,34,43.0,2.0,41.0,292.0,6.0,37.0,244.0,77,58,19,42.0,29.0,13.0
111144,16,2,14,55,0,16,43,62,16.0,2.0,14.0,55.0,0.0,16.0,43.0,28,16,12,19.0,15.0,4.0
9507386,118,6,112,1066,17,101,276,23,53.0,1.0,52.0,570.0,4.0,49.0,49.0,143,118,25,44.0,43.0,1.0
9612468,26,1,25,108,0,26,124,5,21.0,1.0,20.0,90.0,0.0,21.0,107.0,34,26,8,13.0,13.0,0.0
9707302,13,1,12,27,0,13,94,5,12.0,1.0,11.0,26.0,0.0,12.0,93.0,27,13,14,22.0,11.0,11.0
9702337,20,3,17,42,2,18,39,87,10.0,1.0,9.0,18.0,1.0,9.0,18.0,30,20,10,11.0,8.0,3.0
9410413,10,4,6,9,4,6,6,93,0.0,0.0,0.0,0.0,0.0,0.0,0.0,18,10,8,4.0,1.0,3.0
9705245,21,5,16,43,1,20,74,33,11.0,3.0,8.0,22.0,0.0,11.0,51.0,33,21,12,11.0,7.0,4.0
9807447,25,6,19,39,1,24,135,1,12.0,4.0,8.0,12.0,0.0,12.0,92.0,46,25,21,11.0,8.0,3.0
106067,64,5,59,160,1,63,392,7,18.0,2.0,16.0,29.0,2.0,16.0,38.0,87,64,23,21.0,15.0,6.0
9805270,106,7,99,681,15,91,423,24,58.0,4.0,54.0,418.0,2.0,56.0,278.0,122,106,16,34.0,26.0,8.0
6045,30,7,23,43,2,28,137,89,5.0,3.0,2.0,2.0,0.0,5.0,24.0,63,30,33,12.0,4.0,8.0
9808431,46,8,38,172,7,39,77,7,14.0,1.0,13.0,61.0,0.0,14.0,24.0,57,46,11,15.0,14.0,1.0
9701396,66,11,55,349,1,65,289,1,45.0,6.0,39.0,266.0,0.0,45.0,227.0,86,66,20,37.0,34.0,3.0
9701271,4,2,2,2,1,3,7,156,3.0,1.0,2.0,2.0,0.0,3.0,7.0,9,4,5,6.0,1.0,5.0
101276,20,5,15,54,0,20,173,1,8.0,2.0,6.0,17.0,0.0,8.0,65.0,52,20,32,12.0,5.0,7.0
9506291,25,2,23,51,25,0,0,23,10.0,1.0,9.0,14.0,10.0,0.0,0.0,25,25,0,8.0,8.0,0.0
9905451,1,1,0,0,1,0,0,1793,,,,,,,,1,1,0,,,
9501369,154,38,116,411,99,55,99,14,32.0,3.0,29.0,162.0,16.0,16.0,36.0,162,154,8,19.0,18.0,1.0
9706207,23,3,20,49,1,22,114,21,15.0,5.0,10.0,25.0,1.0,14.0,64.0,42,23,19,13.0,9.0,4.0
9608361,41,8,33,105,4,37,96,7,26.0,7.0,19.0,63.0,3.0,23.0,47.0,52,41,11,13.0,11.0,2.0
9409301,52,8,44,182,22,30,61,18,22.0,3.0,19.0,73.0,4.0,18.0,37.0,60,52,8,7.0,5.0,2.0
9407244,15,4,11,19,13,2,2,235,6.0,3.0,3.0,5.0,5.0,1.0,1.0,17,15,2,5.0,4.0,1.0
9607386,13,6,7,14,7,6,7,46,2.0,2.0,0.0,0.0,2.0,0.0,0.0,15,13,2,3.0,3.0,0.0
9212248,59,16,43,228,15,44,75,15,27.0,4.0,23.0,151.0,2.0,25.0,43.0,64,59,5,14.0,14.0,0.0
9406368,20,6,14,37,2,18,87,15,14.0,3.0,11.0,33.0,0.0,14.0,63.0,37,20,17,5.0,3.0,2.0
9909288,3,3,0,0,0,3,3,76,2.0,2.0,0.0,0.0,0.0,2.0,2.0,5,3,2,3.0,2.0,1.0
9411307,27,3,24,85,9,18,43,76,24.0,1.0,23.0,80.0,7.0,17.0,42.0,30,27,3,21.0,18.0,3.0
9605449,4,2,2,3,1,3,8,98,0.0,0.0,0.0,0.0,0.0,0.0,0.0,11,4,7,1.0,1.0,0.0
9409393,66,10,56,446,1,65,237,19,46.0,5.0,41.0,355.0,0.0,46.0,137.0,79,66,13,18.0,12.0,6.0
9312333,27,6,21,125,6,21,56,19,19.0,3.0,16.0,107.0,6.0,13.0,13.0,31,27,4,17.0,13.0,4.0
9506266,5,2,3,5,5,0,0,97,4.0,1.0,3.0,5.0,4.0,0.0,0.0,6,5,1,2.0,2.0,0.0
9709387,18,2,16,42,17,1,1,126,16.0,2.0,14.0,37.0,15.0,1.0,1.0,19,18,1,11.0,11.0,0.0
9703314,17,9,8,10,3,14,62,57,9.0,3.0,6.0,8.0,0.0,9.0,35.0,24,17,7,12.0,8.0,4.0
9707390,82,5,77,449,20,62,256,16,50.0,2.0,48.0,309.0,7.0,43.0,184.0,93,82,11,37.0,30.0,7.0
9311290,56,11,45,155,50,6,6,16,24.0,1.0,23.0,76.0,24.0,0.0,0.0,58,56,2,19.0,19.0,0.0
9209218,11,6,5,5,11,0,0,309,4.0,3.0,1.0,1.0,4.0,0.0,0.0,11,11,0,2.0,2.0,0.0
9602352,27,13,14,24,11,16,25,30,10.0,2.0,8.0,11.0,4.0,6.0,9.0,39,27,12,5.0,5.0,0.0
9412209,46,12,34,197,34,12,19,4,18.0,2.0,16.0,73.0,18.0,0.0,0.0,53,46,7,13.0,13.0,0.0
9303236,39,10,29,90,39,0,0,30,8.0,4.0,4.0,5.0,8.0,0.0,0.0,40,39,1,4.0,4.0,0.0
9511308,6,4,2,5,2,4,8,98,2.0,2.0,0.0,0.0,0.0,2.0,4.0,10,6,4,6.0,4.0,2.0
9812411,7,3,4,5,4,3,7,86,3.0,1.0,2.0,3.0,3.0,0.0,0.0,14,7,7,3.0,1.0,2.0
9205209,27,11,16,32,27,0,0,190,5.0,2.0,3.0,4.0,5.0,0.0,0.0,27,27,0,8.0,8.0,0.0
9402288,80,19,61,197,21,59,110,6,32.0,14.0,18.0,40.0,1.0,31.0,69.0,84,80,4,19.0,19.0,0.0
9712237,11,2,9,17,6,5,8,193,4.0,2.0,2.0,3.0,2.0,2.0,3.0,18,11,7,1.0,0.0,1.0
9806429,8,5,3,3,2,6,80,24,4.0,2.0,2.0,2.0,0.0,4.0,62.0,48,8,40,23.0,3.0,20.0
9211226,21,6,15,33,11,10,10,78,7.0,1.0,6.0,10.0,0.0,7.0,7.0,22,21,1,9.0,8.0,1.0
9605406,12,5,7,9,0,12,103,6,8.0,3.0,5.0,7.0,0.0,8.0,80.0,34,12,22,18.0,2.0,16.0
9203210,12,7,5,6,11,1,2,134,4.0,2.0,2.0,3.0,4.0,0.0,0.0,14,12,2,3.0,3.0,0.0
9401214,51,4,47,254,35,16,16,19,26.0,3.0,23.0,101.0,14.0,12.0,12.0,52,51,1,14.0,14.0,0.0
9607404,49,12,37,145,9,40,126,8,18.0,4.0,14.0,65.0,0.0,18.0,56.0,62,49,13,19.0,15.0,4.0
9503466,2,2,0,0,2,0,0,157,1.0,1.0,0.0,0.0,1.0,0.0,0.0,4,2,2,1.0,1.0,0.0
9406214,24,12,12,33,24,0,0,22,10.0,3.0,7.0,24.0,10.0,0.0,0.0,26,24,2,3.0,3.0,0.0
9406318,26,2,24,119,9,17,17,38,23.0,2.0,21.0,105.0,8.0,15.0,15.0,27,26,1,6.0,6.0,0.0
9906536,14,1,13,34,1,13,61,45,12.0,1.0,11.0,31.0,1.0,11.0,52.0,24,14,10,16.0,10.0,6.0
9307326,25,3,22,64,25,0,0,22,22.0,3.0,19.0,60.0,22.0,0.0,0.0,25,25,0,17.0,17.0,0.0
9401323,15,6,9,13,4,11,11,22,8.0,6.0,2.0,3.0,8.0,0.0,0.0,16,15,1,6.0,6.0,0.0
9902327,51,4,47,268,5,46,223,38,41.0,2.0,39.0,238.0,1.0,40.0,183.0,67,51,16,41.0,30.0,11.0
9408266,20,6,14,33,14,6,6,88,9.0,2.0,7.0,9.0,5.0,4.0,4.0,21,20,1,6.0,5.0,1.0
9708365,4,2,2,2,3,1,1,88,2.0,2.0,0.0,0.0,1.0,1.0,1.0,6,4,2,3.0,2.0,1.0
3168,32,1,31,87,31,1,1,177,27.0,1.0,26.0,77.0,27.0,0.0,0.0,35,32,3,16.0,16.0,0.0
9704286,21,7,14,34,9,12,28,42,0.0,0.0,0.0,0.0,0.0,0.0,0.0,38,21,17,5.0,5.0,0.0
9704399,10,2,8,19,0,10,69,21,10.0,2.0,8.0,19.0,0.0,10.0,67.0,25,10,15,21.0,9.0,12.0
9207232,20,2,18,67,20,0,0,140,14.0,1.0,13.0,37.0,14.0,0.0,0.0,20,20,0,8.0,8.0,0.0
9711223,53,7,46,159,1,52,234,39,30.0,5.0,25.0,67.0,0.0,30.0,145.0,63,53,10,34.0,26.0,8.0
9901229,98,17,81,345,20,78,328,16,42.0,3.0,39.0,187.0,1.0,41.0,211.0,115,98,17,30.0,20.0,10.0
9910253,8,3,5,10,1,7,50,19,7.0,3.0,4.0,9.0,0.0,7.0,50.0,21,8,13,3.0,1.0,2.0
9902241,4,3,1,1,0,4,16,66,1.0,1.0,0.0,0.0,0.0,1.0,2.0,15,4,11,3.0,2.0,1.0
9508311,15,11,4,5,6,9,17,77,5.0,4.0,1.0,1.0,5.0,0.0,0.0,24,15,9,3.0,3.0,0.0
5228,34,4,30,107,2,32,210,20,28.0,2.0,26.0,97.0,0.0,28.0,200.0,48,34,14,32.0,19.0,13.0
9902335,24,2,22,114,0,24,81,20,18.0,1.0,17.0,103.0,0.0,18.0,69.0,34,24,10,3.0,3.0,0.0
9908310,59,3,56,419,0,59,576,20,54.0,3.0,51.0,403.0,0.0,54.0,546.0,74,59,15,60.0,46.0,14.0
9308283,14,5,9,12,1,13,43,29,7.0,2.0,5.0,7.0,0.0,7.0,20.0,23,14,9,3.0,3.0,0.0
9504319,49,15,34,179,18,31,46,49,25.0,6.0,19.0,71.0,6.0,19.0,23.0,57,49,8,18.0,16.0,2.0
9512348,62,30,32,68,32,30,49,192,4.0,2.0,2.0,4.0,0.0,4.0,8.0,73,62,11,8.0,7.0,1.0
9802298,25,8,17,35,3,22,78,54,6.0,1.0,5.0,9.0,0.0,6.0,23.0,40,25,15,5.0,5.0,0.0
3215,2,2,0,0,0,2,33,20,2.0,2.0,0.0,0.0,0.0,2.0,33.0,26,2,24,20.0,2.0,18.0
204193,12,1,11,45,1,11,31,37,11.0,1.0,10.0,40.0,1.0,10.0,26.0,25,12,13,14.0,11.0,3.0
9809406,44,4,40,320,0,44,254,2,38.0,2.0,36.0,293.0,0.0,38.0,228.0,61,44,17,24.0,20.0,4.0
9207217,53,9,44,159,53,0,0,6,12.0,4.0,8.0,16.0,12.0,0.0,0.0,53,53,0,6.0,6.0,0.0
9311287,3,3,0,0,0,3,8,78,2.0,2.0,0.0,0.0,0.0,2.0,5.0,9,3,6,2.0,1.0,1.0
9702333,24,4,20,66,0,24,78,5,14.0,1.0,13.0,40.0,0.0,14.0,18.0,39,24,15,17.0,14.0,3.0
9611319,5,4,1,1,1,4,7,10,1.0,1.0,0.0,0.0,0.0,1.0,3.0,11,5,6,1.0,1.0,0.0
9612229,25,11,14,20,7,18,135,5,2.0,1.0,1.0,1.0,0.0,2.0,14.0,98,25,73,15.0,2.0,13.0
9405278,8,5,3,6,0,8,50,75,2.0,2.0,0.0,0.0,0.0,2.0,12.0,34,8,26,4.0,3.0,1.0
9710373,13,3,10,32,0,13,140,15,9.0,2.0,7.0,25.0,0.0,9.0,125.0,35,13,22,26.0,8.0,18.0
9602263,17,7,10,19,1,16,53,99,5.0,3.0,2.0,3.0,0.0,5.0,17.0,43,17,26,8.0,3.0,5.0
9806477,13,1,12,20,1,12,50,42,7.0,1.0,6.0,7.0,0.0,7.0,33.0,29,13,16,8.0,3.0,5.0
9612268,26,8,18,33,8,18,52,71,9.0,2.0,7.0,11.0,1.0,8.0,8.0,58,26,32,11.0,9.0,2.0
9512446,16,10,6,7,2,14,83,61,1.0,1.0,0.0,0.0,0.0,1.0,10.0,53,16,37,12.0,1.0,11.0
9606370,89,13,76,304,17,72,133,5,25.0,2.0,23.0,103.0,9.0,16.0,16.0,102,89,13,17.0,17.0,0.0
101208,16,7,9,18,3,13,74,4,3.0,2.0,1.0,2.0,0.0,3.0,11.0,44,16,28,10.0,4.0,6.0
9601210,5,5,0,0,4,1,2,302,2.0,2.0,0.0,0.0,2.0,0.0,0.0,9,5,4,1.0,1.0,0.0
9703452,7,4,3,5,1,6,14,5,0.0,0.0,0.0,0.0,0.0,0.0,0.0,18,7,11,2.0,0.0,2.0
9912476,9,2,7,20,0,9,97,4,6.0,2.0,4.0,13.0,0.0,6.0,37.0,37,9,28,1.0,1.0,0.0
9812418,82,23,59,157,21,61,123,70,17.0,1.0,16.0,44.0,0.0,17.0,48.0,92,82,10,9.0,9.0,0.0
9904292,28,3,25,79,4,24,56,3,18.0,1.0,17.0,57.0,0.0,18.0,42.0,32,28,4,10.0,9.0,1.0
9903340,48,11,37,113,4,44,212,3,8.0,3.0,5.0,8.0,0.0,8.0,56.0,92,48,44,19.0,5.0,14.0
9207261,2,1,1,1,2,0,0,500,1.0,1.0,0.0,0.0,1.0,0.0,0.0,2,2,0,1.0,1.0,0.0
9704361,83,14,69,393,11,72,228,18,47.0,4.0,43.0,289.0,1.0,46.0,149.0,96,83,13,35.0,31.0,4.0
9609248,18,10,8,21,8,10,28,41,10.0,3.0,7.0,17.0,1.0,9.0,24.0,26,18,8,12.0,6.0,6.0
11174,0,0,0,0,0,0,0,322,0.0,0.0,0.0,0.0,0.0,0.0,0.0,10,0,10,3.0,0.0,3.0
9701425,15,5,10,16,0,15,29,84,12.0,4.0,8.0,12.0,0.0,12.0,26.0,21,15,6,8.0,6.0,2.0
9404346,11,1,10,25,10,1,1,49,7.0,1.0,6.0,12.0,7.0,0.0,0.0,12,11,1,5.0,5.0,0.0
9602310,7,3,4,7,0,7,23,5,5.0,2.0,3.0,6.0,0.0,5.0,17.0,15,7,8,3.0,2.0,1.0
5183,20,5,15,38,0,20,53,7,2.0,1.0,1.0,1.0,0.0,2.0,2.0,30,20,10,6.0,4.0,2.0
9404310,4,3,1,1,4,0,0,74,1.0,1.0,0.0,0.0,1.0,0.0,0.0,4,4,0,1.0,1.0,0.0
9403255,3,3,0,0,2,1,1,303,1.0,1.0,0.0,0.0,1.0,0.0,0.0,5,3,2,1.0,1.0,0.0
9401267,15,2,13,36,0,15,49,29,10.0,2.0,8.0,16.0,1.0,9.0,25.0,25,15,10,9.0,6.0,3.0
9608251,78,11,67,385,24,54,120,32,51.0,5.0,46.0,276.0,15.0,36.0,42.0,89,78,11,19.0,18.0,1.0
9406328,36,11,25,52,8,28,50,10,9.0,2.0,7.0,14.0,0.0,9.0,12.0,44,36,8,11.0,9.0,2.0
9801218,10,5,5,8,3,7,11,55,7.0,2.0,5.0,8.0,2.0,5.0,5.0,14,10,4,3.0,1.0,2.0
9503388,10,4,6,20,0,10,91,60,7.0,2.0,5.0,16.0,0.0,7.0,75.0,33,10,23,19.0,6.0,13.0
9810513,9,7,2,2,9,0,0,276,2.0,2.0,0.0,0.0,2.0,0.0,0.0,16,9,7,2.0,2.0,0.0
9907540,3,2,1,1,3,0,0,235,2.0,2.0,0.0,0.0,2.0,0.0,0.0,5,3,2,2.0,0.0,2.0
9511201,3,3,0,0,3,0,0,362,1.0,1.0,0.0,0.0,1.0,0.0,0.0,4,3,1,1.0,0.0,1.0
111059,101,12,89,356,8,93,238,23,33.0,4.0,29.0,113.0,1.0,32.0,125.0,119,101,18,30.0,21.0,9.0
9610470,12,4,8,10,0,12,71,5,7.0,2.0,5.0,7.0,0.0,7.0,44.0,27,12,15,4.0,1.0,3.0
102243,20,2,18,103,2,18,177,23,18.0,1.0,17.0,102.0,0.0,18.0,176.0,35,20,15,19.0,13.0,6.0
3187,27,6,21,75,0,27,214,5,14.0,2.0,12.0,40.0,0.0,14.0,111.0,55,27,28,25.0,15.0,10.0
103082,9,9,0,0,4,5,15,18,2.0,2.0,0.0,0.0,2.0,0.0,0.0,14,9,5,2.0,2.0,0.0
9810297,26,6,20,57,0,26,172,60,8.0,2.0,6.0,14.0,0.0,8.0,85.0,51,26,25,24.0,7.0,17.0
9902409,15,7,8,15,5,10,29,87,3.0,1.0,2.0,3.0,0.0,3.0,6.0,27,15,12,5.0,5.0,0.0
7078,9,3,6,12,1,8,41,7,2.0,1.0,1.0,1.0,0.0,2.0,18.0,23,9,14,3.0,1.0,2.0
9501365,7,1,6,13,0,7,15,18,4.0,1.0,3.0,6.0,0.0,4.0,7.0,11,7,4,6.0,4.0,2.0
9405252,8,3,5,9,3,5,7,10,2.0,1.0,1.0,1.0,2.0,0.0,0.0,10,8,2,,,
9508374,3,2,1,1,3,0,0,105,1.0,1.0,0.0,0.0,1.0,0.0,0.0,6,3,3,1.0,1.0,0.0
9299,40,14,26,88,7,33,181,0,11.0,1.0,10.0,33.0,0.0,11.0,77.0,72,40,32,19.0,5.0,14.0
8245,17,6,11,27,1,16,124,50,14.0,4.0,10.0,24.0,0.0,14.0,120.0,32,17,15,24.0,10.0,14.0
9707512,6,2,4,7,2,4,6,162,1.0,1.0,0.0,0.0,1.0,0.0,0.0,14,6,8,1.0,1.0,0.0
8086,10,3,7,14,3,7,23,118,8.0,1.0,7.0,12.0,1.0,7.0,23.0,16,10,6,12.0,7.0,5.0
9505320,76,6,70,456,0,76,251,11,54.0,2.0,52.0,400.0,0.0,54.0,200.0,80,76,4,23.0,22.0,1.0
104058,10,8,2,2,5,5,26,11,2.0,2.0,0.0,0.0,0.0,2.0,4.0,31,10,21,6.0,2.0,4.0
9612310,5,4,1,2,1,4,10,252,1.0,1.0,0.0,0.0,0.0,1.0,2.0,11,5,6,4.0,1.0,3.0
9809367,19,4,15,49,3,16,29,43,6.0,1.0,5.0,8.0,0.0,6.0,9.0,22,19,3,11.0,9.0,2.0
9306337,55,8,47,171,55,0,0,39,22.0,4.0,18.0,61.0,22.0,0.0,0.0,55,55,0,13.0,13.0,0.0
6154,44,5,39,197,2,42,224,19,14.0,3.0,11.0,40.0,1.0,13.0,67.0,80,44,36,18.0,10.0,8.0
6311,27,7,20,61,11,16,52,4,9.0,2.0,7.0,22.0,9.0,0.0,0.0,41,27,14,9.0,9.0,0.0
9603330,21,7,14,30,5,16,19,293,3.0,2.0,1.0,2.0,2.0,1.0,1.0,25,21,4,2.0,1.0,1.0
9412219,21,6,15,36,9,12,15,52,14.0,6.0,8.0,21.0,5.0,9.0,9.0,23,21,2,8.0,7.0,1.0
9902299,5,4,1,1,1,4,22,39,3.0,3.0,0.0,0.0,0.0,3.0,18.0,21,5,16,15.0,2.0,13.0
9612249,1,1,0,0,1,0,0,2000,,,,,,,,1,1,0,,,
9901362,87,32,55,156,13,74,423,15,9.0,3.0,6.0,10.0,0.0,9.0,151.0,176,87,89,35.0,5.0,30.0
9911365,12,7,5,6,1,11,77,12,2.0,1.0,1.0,1.0,0.0,2.0,10.0,45,12,33,9.0,3.0,6.0
101076,6,5,1,1,1,5,16,44,2.0,2.0,0.0,0.0,0.0,2.0,7.0,20,6,14,6.0,2.0,4.0
9035,1,1,0,0,0,1,5,16,0.0,0.0,0.0,0.0,0.0,0.0,0.0,15,1,14,7.0,0.0,7.0
9903248,3,2,1,2,1,2,4,44,0.0,0.0,0.0,0.0,0.0,0.0,0.0,8,3,5,1.0,0.0,1.0
104178,9,3,6,13,0,9,189,19,8.0,2.0,6.0,13.0,0.0,8.0,149.0,56,9,47,34.0,6.0,28.0
206067,21,5,16,37,0,21,407,19,18.0,3.0,15.0,34.0,0.0,18.0,372.0,72,21,51,51.0,15.0,36.0
9907511,4,2,2,3,0,4,17,140,3.0,1.0,2.0,3.0,0.0,3.0,10.0,14,4,10,9.0,1.0,8.0
106243,7,4,3,5,0,7,34,19,4.0,2.0,2.0,2.0,0.0,4.0,9.0,20,7,13,7.0,4.0,3.0
9906338,6,1,5,11,0,6,64,43,5.0,1.0,4.0,9.0,0.0,5.0,55.0,28,6,22,19.0,5.0,14.0
9807378,8,4,4,7,7,1,2,372,3.0,2.0,1.0,1.0,3.0,0.0,0.0,10,8,2,4.0,4.0,0.0
109085,26,2,24,164,0,26,163,28,24.0,2.0,22.0,155.0,0.0,24.0,91.0,37,26,11,28.0,22.0,6.0
9406234,2,2,0,0,1,1,1,149,0.0,0.0,0.0,0.0,0.0,0.0,0.0,8,2,6,3.0,0.0,3.0
208260,0,0,0,0,0,0,0,2098,,,,,,,,4,0,4,,,
9701322,15,11,4,4,9,6,35,26,3.0,1.0,2.0,2.0,3.0,0.0,0.0,29,15,14,2.0,2.0,0.0
9408255,22,9,13,28,19,3,3,91,6.0,4.0,2.0,5.0,6.0,0.0,0.0,24,22,2,4.0,4.0,0.0
10141,4,1,3,6,0,4,19,168,3.0,1.0,2.0,3.0,0.0,3.0,7.0,12,4,8,4.0,3.0,1.0
9904252,11,3,8,14,1,10,72,2,8.0,1.0,7.0,11.0,0.0,8.0,70.0,32,11,21,4.0,0.0,4.0
9908254,17,6,11,20,4,13,37,35,6.0,2.0,4.0,4.0,0.0,6.0,15.0,28,17,11,10.0,6.0,4.0
103028,16,3,13,43,2,14,92,10,12.0,1.0,11.0,38.0,0.0,12.0,74.0,46,16,30,19.0,7.0,12.0
9610296,8,4,4,5,0,8,28,10,2.0,1.0,1.0,1.0,0.0,2.0,5.0,25,8,17,6.0,2.0,4.0
2286,36,12,24,55,6,30,148,5,3.0,1.0,2.0,3.0,0.0,3.0,18.0,77,36,41,22.0,4.0,18.0
9909326,23,10,13,21,0,23,102,2,5.0,2.0,3.0,5.0,5.0,0.0,0.0,38,23,15,1.0,1.0,0.0
3149,22,6,16,39,5,17,78,63,6.0,1.0,5.0,8.0,0.0,6.0,20.0,47,22,25,10.0,6.0,4.0
9909393,17,7,10,28,1,16,46,28,12.0,5.0,7.0,18.0,0.0,12.0,34.0,24,17,7,9.0,6.0,3.0
9602233,22,5,17,47,3,19,64,50,8.0,4.0,4.0,5.0,0.0,8.0,21.0,31,22,9,10.0,7.0,3.0
9603213,21,8,13,18,0,21,59,107,6.0,4.0,2.0,2.0,1.0,5.0,8.0,29,21,8,10.0,7.0,3.0
9902428,6,3,3,4,2,4,16,86,3.0,3.0,0.0,0.0,0.0,3.0,13.0,19,6,13,7.0,2.0,5.0
9905403,19,9,10,24,2,17,103,5,2.0,1.0,1.0,1.0,0.0,2.0,24.0,50,19,31,19.0,2.0,17.0
9401274,4,3,1,1,0,4,12,358,2.0,1.0,1.0,1.0,0.0,2.0,6.0,12,4,8,5.0,2.0,3.0
201071,57,25,32,73,1,56,775,1,10.0,1.0,9.0,19.0,0.0,10.0,162.0,468,57,411,24.0,3.0,21.0
9073,6,2,4,7,0,6,124,34,5.0,2.0,3.0,4.0,0.0,5.0,114.0,50,6,44,38.0,4.0,34.0
9504333,65,12,53,240,50,15,19,67,24.0,1.0,23.0,107.0,24.0,0.0,0.0,70,65,5,19.0,19.0,0.0
9909476,65,7,58,393,20,45,98,7,27.0,2.0,25.0,149.0,14.0,13.0,13.0,76,65,11,30.0,28.0,2.0
9411388,16,7,9,21,16,0,0,134,10.0,3.0,7.0,18.0,10.0,0.0,0.0,16,16,0,9.0,9.0,0.0
9502360,28,8,20,52,22,6,6,79,9.0,3.0,6.0,14.0,5.0,4.0,4.0,29,28,1,5.0,5.0,0.0
9601289,19,5,14,32,9,10,16,72,9.0,3.0,6.0,12.0,2.0,7.0,10.0,26,19,7,8.0,4.0,4.0
9809427,57,7,50,196,0,57,530,11,51.0,5.0,46.0,190.0,0.0,51.0,442.0,89,57,32,41.0,30.0,11.0
9804217,24,2,22,68,2,22,125,11,14.0,2.0,12.0,44.0,0.0,14.0,95.0,36,24,12,9.0,8.0,1.0
9702230,14,4,10,23,0,14,53,17,10.0,2.0,8.0,18.0,0.0,10.0,40.0,30,14,16,5.0,4.0,1.0
9505379,65,7,58,257,0,65,346,17,50.0,4.0,46.0,217.0,0.0,50.0,278.0,81,65,16,31.0,24.0,7.0
9303301,7,5,2,4,7,0,0,483,2.0,2.0,0.0,0.0,2.0,0.0,0.0,7,7,0,2.0,2.0,0.0
9504403,6,5,1,1,1,5,17,235,2.0,2.0,0.0,0.0,0.0,2.0,6.0,14,6,8,5.0,1.0,4.0
9501303,16,6,10,20,11,5,6,126,9.0,1.0,8.0,17.0,7.0,2.0,2.0,19,16,3,8.0,5.0,3.0
9206248,3,1,2,2,0,3,3,967,2.0,1.0,1.0,1.0,2.0,0.0,0.0,4,3,1,1.0,1.0,0.0
9411246,7,4,3,7,0,7,9,67,1.0,1.0,0.0,0.0,0.0,1.0,1.0,9,7,2,2.0,1.0,1.0
9512269,3,2,1,1,1,2,20,8,2.0,1.0,1.0,1.0,0.0,2.0,4.0,22,3,19,2.0,0.0,2.0
9407381,9,3,6,14,2,7,34,176,7.0,2.0,5.0,12.0,1.0,6.0,27.0,19,9,10,15.0,6.0,9.0
12260,41,12,29,71,11,30,36,4,14.0,2.0,12.0,24.0,14.0,0.0,0.0,45,41,4,8.0,6.0,2.0
9406393,8,7,1,2,8,0,0,179,2.0,1.0,1.0,1.0,2.0,0.0,0.0,10,8,2,1.0,1.0,0.0
9712213,18,2,16,32,1,17,140,12,16.0,2.0,14.0,30.0,0.0,16.0,138.0,28,18,10,25.0,15.0,10.0
9410327,13,7,6,6,8,5,5,360,1.0,1.0,0.0,0.0,0.0,1.0,1.0,15,13,2,2.0,2.0,0.0
9902354,37,4,33,159,2,35,78,28,23.0,1.0,22.0,103.0,1.0,22.0,33.0,53,37,16,20.0,19.0,1.0
9404211,10,2,8,26,9,1,1,192,5.0,1.0,4.0,9.0,5.0,0.0,0.0,11,10,1,2.0,1.0,1.0
9508398,18,7,11,18,15,3,3,14,0.0,0.0,0.0,0.0,0.0,0.0,0.0,23,18,5,3.0,0.0,3.0
9407374,19,9,10,13,19,0,0,14,5.0,3.0,2.0,2.0,5.0,0.0,0.0,19,19,0,4.0,4.0,0.0
9706502,9,7,2,3,4,5,7,351,4.0,3.0,1.0,1.0,4.0,0.0,0.0,14,9,5,1.0,1.0,0.0
107209,2,2,0,0,0,2,20,24,2.0,2.0,0.0,0.0,0.0,2.0,15.0,19,2,17,15.0,2.0,13.0
9911461,8,3,5,12,1,7,39,24,6.0,3.0,3.0,9.0,0.0,6.0,27.0,17,8,9,12.0,5.0,7.0
9711350,4,1,3,6,4,0,0,64,4.0,1.0,3.0,6.0,4.0,0.0,0.0,4,4,0,4.0,4.0,0.0
9608405,4,2,2,2,2,2,5,73,1.0,1.0,0.0,0.0,0.0,1.0,1.0,8,4,4,1.0,1.0,0.0
9712404,3,2,1,1,2,1,1,101,0.0,0.0,0.0,0.0,0.0,0.0,0.0,22,3,19,6.0,0.0,6.0
7248,30,8,22,38,6,24,46,14,13.0,2.0,11.0,20.0,2.0,11.0,21.0,37,30,7,4.0,4.0,0.0
2182,10,1,9,21,0,10,71,54,7.0,2.0,5.0,7.0,0.0,7.0,34.0,24,10,14,9.0,5.0,4.0
9707464,17,4,13,33,12,5,7,140,9.0,2.0,7.0,21.0,9.0,0.0,0.0,19,17,2,4.0,4.0,0.0
9405326,25,3,22,46,20,5,5,14,14.0,2.0,12.0,25.0,11.0,3.0,3.0,27,25,2,4.0,4.0,0.0
9706413,22,5,17,45,4,18,79,27,5.0,1.0,4.0,5.0,0.0,5.0,11.0,34,22,12,10.0,6.0,4.0
9406274,31,4,27,74,31,0,0,47,12.0,2.0,10.0,21.0,12.0,0.0,0.0,31,31,0,7.0,7.0,0.0
9510302,2,1,1,1,1,1,1,337,2.0,1.0,1.0,1.0,1.0,1.0,1.0,3,2,1,3.0,2.0,1.0
9511398,4,2,2,2,4,0,0,44,2.0,1.0,1.0,1.0,2.0,0.0,0.0,4,4,0,2.0,2.0,0.0
9407272,6,4,2,3,5,1,1,77,2.0,2.0,0.0,0.0,2.0,0.0,0.0,7,6,1,2.0,2.0,0.0
9910391,3,3,0,0,0,3,33,11,2.0,2.0,0.0,0.0,0.0,2.0,28.0,25,3,22,9.0,2.0,7.0
9252,2,1,1,1,0,2,13,17,1.0,1.0,0.0,0.0,0.0,1.0,1.0,13,2,11,2.0,1.0,1.0
9405261,7,3,4,5,1,6,20,183,2.0,1.0,1.0,1.0,0.0,2.0,5.0,12,7,5,3.0,1.0,2.0
9609237,8,4,4,5,3,5,11,150,3.0,2.0,1.0,1.0,0.0,3.0,4.0,13,8,5,3.0,2.0,1.0
9705290,46,4,42,185,1,45,228,8,11.0,2.0,9.0,25.0,0.0,11.0,95.0,75,46,29,17.0,17.0,0.0
9606246,14,8,6,11,7,7,15,16,4.0,2.0,2.0,3.0,1.0,3.0,3.0,18,14,4,6.0,4.0,2.0
9706470,8,5,3,3,2,6,21,39,2.0,1.0,1.0,1.0,2.0,0.0,0.0,23,8,15,3.0,1.0,2.0
9907257,8,3,5,8,3,5,23,300,4.0,1.0,3.0,5.0,1.0,3.0,3.0,15,8,7,7.0,4.0,3.0
9712286,4,3,1,1,4,0,0,66,2.0,2.0,0.0,0.0,2.0,0.0,0.0,4,4,0,1.0,1.0,0.0
9604247,5,4,1,1,2,3,4,132,2.0,2.0,0.0,0.0,1.0,1.0,1.0,7,5,2,1.0,1.0,0.0
9506317,75,2,73,559,6,69,144,8,59.0,1.0,58.0,475.0,7.0,52.0,107.0,80,75,5,41.0,38.0,3.0
9410225,13,4,9,21,1,12,65,15,9.0,2.0,7.0,18.0,0.0,9.0,51.0,33,13,20,5.0,3.0,2.0
9405424,18,3,15,41,1,17,31,15,5.0,3.0,2.0,3.0,5.0,0.0,0.0,23,18,5,2.0,1.0,1.0
9509352,18,3,15,46,2,16,68,15,5.0,2.0,3.0,6.0,2.0,3.0,7.0,29,18,11,11.0,4.0,7.0
9307243,53,7,46,307,41,12,22,53,42.0,3.0,39.0,282.0,42.0,0.0,0.0,57,53,4,33.0,33.0,0.0
9808244,16,6,10,12,3,13,65,3,7.0,4.0,3.0,3.0,0.0,7.0,33.0,33,16,17,8.0,6.0,2.0
9909540,26,5,21,74,2,24,242,4,21.0,3.0,18.0,67.0,0.0,21.0,234.0,42,26,16,33.0,18.0,15.0
9907423,55,9,46,208,15,40,78,0,29.0,3.0,26.0,136.0,6.0,23.0,28.0,78,55,23,20.0,19.0,1.0
9905254,3,2,1,1,1,2,2,0,1.0,1.0,0.0,0.0,1.0,0.0,0.0,14,3,11,2.0,1.0,1.0
12247,6,4,2,3,4,2,3,215,3.0,1.0,2.0,3.0,3.0,0.0,0.0,10,6,4,3.0,3.0,0.0
1147,3,2,1,2,0,3,14,52,2.0,1.0,1.0,1.0,0.0,2.0,7.0,12,3,9,10.0,1.0,9.0
9704367,2,1,1,1,2,0,0,320,0.0,0.0,0.0,0.0,0.0,0.0,0.0,5,2,3,2.0,1.0,1.0
9802446,3,2,1,2,0,3,20,5,1.0,1.0,0.0,0.0,0.0,1.0,2.0,19,3,16,4.0,0.0,4.0
9801272,44,4,40,225,0,44,520,15,39.0,4.0,35.0,217.0,0.0,39.0,493.0,86,44,42,56.0,18.0,38.0
9507287,8,4,4,7,1,7,31,35,7.0,3.0,4.0,7.0,0.0,7.0,30.0,16,8,8,12.0,6.0,6.0
108217,13,2,11,29,13,0,0,146,12.0,2.0,10.0,26.0,12.0,0.0,0.0,13,13,0,11.0,11.0,0.0
9902427,7,5,2,4,1,6,20,120,5.0,4.0,1.0,1.0,1.0,4.0,15.0,13,7,6,10.0,4.0,6.0
6285,2,2,0,0,1,1,3,14,1.0,1.0,0.0,0.0,0.0,1.0,3.0,7,2,5,1.0,0.0,1.0
9311319,7,5,2,6,7,0,0,94,5.0,3.0,2.0,6.0,5.0,0.0,0.0,9,7,2,1.0,1.0,0.0
9708346,26,7,19,77,2,24,99,8,22.0,6.0,16.0,65.0,0.0,22.0,93.0,33,26,7,26.0,20.0,6.0
9804313,1,1,0,0,0,1,7,10,0.0,0.0,0.0,0.0,0.0,0.0,0.0,18,1,17,8.0,0.0,8.0
9812427,15,6,9,17,0,15,70,69,11.0,4.0,7.0,12.0,0.0,11.0,56.0,29,15,14,14.0,5.0,9.0
9508208,9,7,2,2,3,6,18,10,1.0,1.0,0.0,0.0,0.0,1.0,4.0,20,9,11,2.0,2.0,0.0
9911247,7,4,3,3,4,3,14,123,3.0,3.0,0.0,0.0,0.0,3.0,10.0,17,7,10,8.0,3.0,5.0
9912208,6,3,3,4,4,2,4,763,1.0,1.0,0.0,0.0,1.0,0.0,0.0,8,6,2,1.0,1.0,0.0
12362,12,3,9,24,0,12,53,21,10.0,2.0,8.0,23.0,0.0,10.0,33.0,26,12,14,10.0,6.0,4.0
9403326,16,8,8,14,16,0,0,6,5.0,1.0,4.0,7.0,5.0,0.0,0.0,16,16,0,2.0,2.0,0.0
9408272,7,3,4,9,7,0,0,364,5.0,1.0,4.0,9.0,5.0,0.0,0.0,7,7,0,5.0,5.0,0.0
9801288,1,1,0,0,0,1,1,306,0.0,0.0,0.0,0.0,0.0,0.0,0.0,15,1,14,2.0,0.0,2.0
5029,20,6,14,33,8,12,13,102,7.0,1.0,6.0,15.0,7.0,0.0,0.0,25,20,5,8.0,7.0,1.0
9805355,3,2,1,1,0,3,15,30,1.0,1.0,0.0,0.0,0.0,1.0,7.0,19,3,16,6.0,1.0,5.0
9904209,10,2,8,22,1,9,47,95,8.0,2.0,6.0,18.0,1.0,7.0,30.0,21,10,11,16.0,10.0,6.0
9601325,8,4,4,7,1,7,32,60,4.0,1.0,3.0,5.0,0.0,4.0,15.0,20,8,12,8.0,2.0,6.0
9908516,25,2,23,108,2,23,161,32,21.0,1.0,20.0,97.0,0.0,21.0,151.0,39,25,14,30.0,19.0,11.0
9907496,35,3,32,177,0,35,322,32,28.0,2.0,26.0,159.0,0.0,28.0,257.0,77,35,42,41.0,26.0,15.0
1271,4,2,2,2,1,3,4,89,2.0,1.0,1.0,1.0,0.0,2.0,2.0,9,4,5,3.0,2.0,1.0
9408231,7,1,6,9,0,7,8,23,6.0,1.0,5.0,7.0,0.0,6.0,6.0,9,7,2,1.0,1.0,0.0
9301280,15,5,10,30,15,0,0,131,10.0,2.0,8.0,24.0,10.0,0.0,0.0,15,15,0,9.0,9.0,0.0
9510280,5,1,4,5,1,4,9,14,1.0,1.0,0.0,0.0,1.0,0.0,0.0,9,5,4,1.0,0.0,1.0
9701338,19,5,14,44,2,17,31,130,13.0,4.0,9.0,31.0,1.0,12.0,22.0,24,19,5,13.0,11.0,2.0
9411278,4,4,0,0,1,3,4,206,2.0,2.0,0.0,0.0,0.0,2.0,3.0,7,4,3,2.0,2.0,0.0
9707412,51,14,37,110,9,42,398,36,16.0,6.0,10.0,22.0,0.0,16.0,333.0,105,51,54,52.0,11.0,41.0
5142,20,13,7,8,2,18,219,5,3.0,2.0,1.0,1.0,0.0,3.0,39.0,126,20,106,22.0,2.0,20.0
9711414,26,10,16,58,2,24,59,12,12.0,4.0,8.0,22.0,1.0,11.0,13.0,35,26,9,10.0,9.0,1.0
9905475,21,6,15,29,2,19,49,0,9.0,1.0,8.0,14.0,0.0,9.0,18.0,33,21,12,6.0,5.0,1.0
9508351,14,8,6,8,11,3,9,8,2.0,1.0,1.0,1.0,2.0,0.0,0.0,38,14,24,3.0,1.0,2.0
9703403,4,3,1,1,1,3,16,89,3.0,2.0,1.0,1.0,0.0,3.0,13.0,15,4,11,3.0,1.0,2.0
8034,7,2,5,6,1,6,25,89,7.0,2.0,5.0,6.0,1.0,6.0,12.0,16,7,9,5.0,3.0,2.0
9612491,1,1,0,0,0,1,2,6,0.0,0.0,0.0,0.0,0.0,0.0,0.0,17,1,16,3.0,0.0,3.0
7245,4,4,0,0,0,4,33,30,4.0,4.0,0.0,0.0,0.0,4.0,32.0,23,4,19,15.0,1.0,14.0
9902420,33,2,31,91,8,25,89,21,7.0,1.0,6.0,14.0,0.0,7.0,21.0,50,33,17,15.0,14.0,1.0
9804305,2,2,0,0,0,2,14,215,1.0,1.0,0.0,0.0,0.0,1.0,3.0,19,2,17,2.0,1.0,1.0
9801243,5,4,1,1,0,5,14,170,2.0,2.0,0.0,0.0,0.0,2.0,4.0,12,5,7,4.0,2.0,2.0
9206217,5,4,1,1,5,0,0,272,2.0,2.0,0.0,0.0,2.0,0.0,0.0,5,5,0,2.0,2.0,0.0
9808376,3,3,0,0,0,3,12,1,0.0,0.0,0.0,0.0,0.0,0.0,0.0,24,3,21,5.0,0.0,5.0
9411232,24,12,12,21,17,7,9,13,7.0,5.0,2.0,3.0,4.0,3.0,3.0,28,24,4,4.0,4.0,0.0
9902235,2,2,0,0,0,2,11,58,0.0,0.0,0.0,0.0,0.0,0.0,0.0,36,2,34,12.0,0.0,12.0
9503333,12,3,9,17,4,8,12,68,5.0,2.0,3.0,3.0,1.0,4.0,4.0,15,12,3,5.0,4.0,1.0
9811420,4,4,0,0,0,4,26,73,4.0,4.0,0.0,0.0,0.0,4.0,24.0,14,4,10,1.0,0.0,1.0
9903295,0,0,0,0,0,0,0,150,0.0,0.0,0.0,0.0,0.0,0.0,0.0,13,0,13,1.0,0.0,1.0
1028,12,3,9,13,1,11,75,6,6.0,1.0,5.0,5.0,0.0,6.0,21.0,27,12,15,14.0,6.0,8.0
9912451,30,5,25,97,1,29,389,70,28.0,4.0,24.0,88.0,0.0,28.0,387.0,46,30,16,41.0,26.0,15.0
110063,8,4,4,8,1,7,54,24,4.0,1.0,3.0,4.0,0.0,4.0,8.0,32,8,24,5.0,2.0,3.0
9905548,5,5,0,0,1,4,12,43,0.0,0.0,0.0,0.0,0.0,0.0,0.0,99,5,94,4.0,1.0,3.0
9704435,4,3,1,1,1,3,3,14,3.0,3.0,0.0,0.0,0.0,3.0,3.0,7,4,3,1.0,1.0,0.0
9501258,9,3,6,14,1,8,14,75,1.0,1.0,0.0,0.0,0.0,1.0,4.0,19,9,10,6.0,6.0,0.0
106278,14,3,11,28,0,14,215,8,12.0,2.0,10.0,23.0,0.0,12.0,192.0,51,14,37,37.0,7.0,30.0
2009,5,4,1,2,0,5,19,2,0.0,0.0,0.0,0.0,0.0,0.0,0.0,17,5,12,3.0,3.0,0.0
9703414,9,6,3,3,1,8,22,38,4.0,4.0,0.0,0.0,0.0,4.0,13.0,20,9,11,3.0,3.0,0.0
6134,12,4,8,20,0,12,29,88,7.0,2.0,5.0,16.0,0.0,7.0,13.0,21,12,9,8.0,7.0,1.0
9910441,12,2,10,31,0,12,139,21,12.0,2.0,10.0,31.0,0.0,12.0,139.0,32,12,20,30.0,12.0,18.0
107274,10,4,6,13,5,5,15,0,1.0,1.0,0.0,0.0,1.0,0.0,0.0,23,10,13,4.0,0.0,4.0
9709341,7,4,3,3,2,5,12,200,1.0,1.0,0.0,0.0,0.0,1.0,4.0,17,7,10,1.0,1.0,0.0
9610275,20,7,13,31,3,17,52,13,9.0,5.0,4.0,8.0,0.0,9.0,39.0,30,20,10,12.0,6.0,6.0
9406208,7,5,2,3,7,0,0,355,4.0,2.0,2.0,3.0,4.0,0.0,0.0,7,7,0,3.0,3.0,0.0
5267,4,1,3,3,1,3,14,3,0.0,0.0,0.0,0.0,0.0,0.0,0.0,14,4,10,4.0,1.0,3.0
9209255,20,3,17,23,20,0,0,26,16.0,3.0,13.0,17.0,16.0,0.0,0.0,20,20,0,2.0,2.0,0.0
9809360,16,3,13,27,6,10,22,32,12.0,2.0,10.0,21.0,3.0,9.0,19.0,22,16,6,2.0,2.0,0.0
102052,6,4,2,3,2,4,9,0,0.0,0.0,0.0,0.0,0.0,0.0,0.0,47,6,41,25.0,0.0,25.0
112072,3,3,0,0,2,1,5,122,0.0,0.0,0.0,0.0,0.0,0.0,0.0,11,3,8,7.0,1.0,6.0
104294,20,8,12,21,2,18,63,3,5.0,2.0,3.0,4.0,0.0,5.0,5.0,32,20,12,8.0,6.0,2.0
211318,1,1,0,0,0,1,5,393,1.0,1.0,0.0,0.0,0.0,1.0,3.0,11,1,10,5.0,1.0,4.0
9511325,6,3,3,3,1,5,13,68,2.0,2.0,0.0,0.0,0.0,2.0,2.0,12,6,6,2.0,1.0,1.0
108161,23,3,20,81,1,22,230,37,21.0,1.0,20.0,81.0,0.0,21.0,215.0,54,23,31,35.0,19.0,16.0
9710240,4,3,1,1,0,4,12,31,2.0,1.0,1.0,1.0,0.0,2.0,10.0,12,4,8,3.0,2.0,1.0
9908305,15,7,8,9,3,12,53,2,1.0,1.0,0.0,0.0,0.0,1.0,4.0,40,15,25,4.0,1.0,3.0
104242,15,6,9,19,0,15,236,23,11.0,3.0,8.0,18.0,0.0,11.0,176.0,69,15,54,29.0,9.0,20.0
9501371,7,4,3,4,3,4,4,134,3.0,2.0,1.0,1.0,3.0,0.0,0.0,8,7,1,2.0,2.0,0.0
9703438,16,6,10,23,0,16,88,17,6.0,4.0,2.0,3.0,0.0,6.0,36.0,36,16,20,9.0,8.0,1.0
3318,3,3,0,0,0,3,36,33,1.0,1.0,0.0,0.0,0.0,1.0,20.0,38,3,35,21.0,1.0,20.0
9411311,14,9,5,8,7,7,12,13,4.0,3.0,1.0,1.0,2.0,2.0,2.0,19,14,5,2.0,2.0,0.0
9604254,3,2,1,1,0,3,4,25,1.0,1.0,0.0,0.0,1.0,0.0,0.0,5,3,2,3.0,1.0,2.0
9906535,2,2,0,0,0,2,3,92,1.0,1.0,0.0,0.0,0.0,1.0,1.0,10,2,8,3.0,1.0,2.0
6090,7,2,5,7,0,7,26,0,7.0,2.0,5.0,7.0,0.0,7.0,26.0,11,7,4,,,
9604275,4,4,0,0,3,1,1,370,1.0,1.0,0.0,0.0,0.0,1.0,1.0,5,4,1,2.0,1.0,1.0
11172,13,2,11,29,0,13,102,56,6.0,2.0,4.0,5.0,0.0,6.0,44.0,42,13,29,14.0,2.0,12.0
10277,3,1,2,3,0,3,30,15,3.0,1.0,2.0,3.0,0.0,3.0,27.0,19,3,16,6.0,3.0,3.0
201036,6,6,0,0,0,6,32,19,2.0,2.0,0.0,0.0,0.0,2.0,4.0,58,6,52,11.0,0.0,11.0
9404312,4,1,3,3,0,4,40,176,4.0,1.0,3.0,3.0,0.0,4.0,40.0,18,4,14,14.0,4.0,10.0
4065,10,3,7,15,1,9,22,48,4.0,2.0,2.0,2.0,0.0,4.0,6.0,26,10,16,4.0,0.0,4.0
7303,7,5,2,2,0,7,36,14,3.0,2.0,1.0,1.0,0.0,3.0,6.0,28,7,21,4.0,2.0,2.0
9611452,10,3,7,12,1,9,15,130,8.0,3.0,5.0,8.0,1.0,7.0,9.0,14,10,4,2.0,1.0,1.0
111043,2,2,0,0,1,1,10,43,1.0,1.0,0.0,0.0,0.0,1.0,4.0,20,2,18,6.0,1.0,5.0
106335,9,6,3,3,1,8,17,3,2.0,2.0,0.0,0.0,1.0,1.0,1.0,18,9,9,3.0,2.0,1.0
110291,9,4,5,8,0,9,51,129,7.0,3.0,4.0,7.0,0.0,7.0,26.0,32,9,23,10.0,6.0,4.0
110249,22,6,16,35,5,17,156,3,10.0,2.0,8.0,22.0,0.0,10.0,105.0,74,22,52,16.0,5.0,11.0
9812499,21,5,16,43,2,19,62,3,10.0,4.0,6.0,15.0,2.0,8.0,8.0,42,21,21,10.0,8.0,2.0
208132,5,3,2,2,0,5,49,0,4.0,2.0,2.0,2.0,0.0,4.0,35.0,32,5,27,10.0,2.0,8.0
205067,20,9,11,29,0,20,159,37,16.0,6.0,10.0,26.0,0.0,16.0,122.0,51,20,31,25.0,13.0,12.0
9909378,8,4,4,5,6,2,11,92,1.0,1.0,0.0,0.0,0.0,1.0,10.0,24,8,16,11.0,1.0,10.0
9511275,18,4,14,42,2,16,76,69,13.0,2.0,11.0,28.0,0.0,13.0,69.0,30,18,12,13.0,6.0,7.0
9811285,7,3,4,6,0,7,113,9,6.0,2.0,4.0,6.0,0.0,6.0,47.0,30,7,23,14.0,6.0,8.0
204360,16,8,8,14,1,15,99,3,6.0,2.0,4.0,6.0,0.0,6.0,34.0,57,16,41,4.0,3.0,1.0
202171,4,3,1,2,4,0,0,128,3.0,2.0,1.0,2.0,3.0,0.0,0.0,4,4,0,1.0,1.0,0.0
8334,25,12,13,23,13,12,36,0,1.0,1.0,0.0,0.0,0.0,1.0,14.0,70,25,45,5.0,5.0,0.0
9411201,13,9,4,5,6,7,8,10,5.0,3.0,2.0,2.0,1.0,4.0,4.0,15,13,2,4.0,3.0,1.0
9708319,8,1,7,12,2,6,6,65,8.0,1.0,7.0,12.0,2.0,6.0,6.0,9,8,1,2.0,1.0,1.0
203244,11,6,5,9,0,11,100,28,8.0,3.0,5.0,9.0,0.0,8.0,51.0,37,11,26,17.0,7.0,10.0
9805425,2,2,0,0,0,2,7,29,1.0,1.0,0.0,0.0,0.0,1.0,2.0,15,2,13,3.0,0.0,3.0
9705453,17,8,9,18,1,16,77,1,5.0,5.0,0.0,0.0,1.0,4.0,21.0,31,17,14,9.0,7.0,2.0
9402325,13,3,10,23,4,9,9,17,2.0,2.0,0.0,0.0,2.0,0.0,0.0,15,13,2,4.0,3.0,1.0
9803238,7,5,2,3,6,1,2,354,2.0,2.0,0.0,0.0,2.0,0.0,0.0,9,7,2,1.0,1.0,0.0
9905226,31,16,15,25,0,31,325,11,2.0,2.0,0.0,0.0,0.0,2.0,2.0,168,31,137,16.0,6.0,10.0
9910438,31,10,21,60,1,30,217,13,21.0,6.0,15.0,44.0,0.0,21.0,131.0,53,31,22,20.0,10.0,10.0
9905543,23,4,19,48,2,21,114,13,11.0,1.0,10.0,24.0,0.0,11.0,51.0,51,23,28,16.0,10.0,6.0
9712518,4,3,1,1,4,0,0,44,1.0,1.0,0.0,0.0,1.0,0.0,0.0,9,4,5,2.0,1.0,1.0
9409333,8,2,6,11,8,0,0,72,4.0,1.0,3.0,5.0,4.0,0.0,0.0,8,8,0,4.0,4.0,0.0
9910283,13,6,7,16,3,10,127,4,10.0,4.0,6.0,15.0,0.0,10.0,127.0,27,13,14,24.0,10.0,14.0
9409435,3,2,1,1,3,0,0,69,0.0,0.0,0.0,0.0,0.0,0.0,0.0,10,3,7,2.0,0.0,2.0
9408372,1,1,0,0,0,1,1,751,0.0,0.0,0.0,0.0,0.0,0.0,0.0,2,1,1,1.0,0.0,1.0
9709396,2,2,0,0,1,1,3,85,0.0,0.0,0.0,0.0,0.0,0.0,0.0,9,2,7,4.0,0.0,4.0
9610375,1,1,0,0,0,1,3,35,1.0,1.0,0.0,0.0,0.0,1.0,1.0,6,1,5,1.0,0.0,1.0
9403331,19,6,13,27,11,8,8,163,10.0,3.0,7.0,15.0,2.0,8.0,8.0,20,19,1,9.0,8.0,1.0
9403382,3,1,2,3,3,0,0,2099,3.0,1.0,2.0,3.0,3.0,0.0,0.0,3,3,0,3.0,3.0,0.0
10328,13,6,7,13,1,12,122,6,6.0,2.0,4.0,9.0,0.0,6.0,78.0,94,13,81,28.0,0.0,28.0
9807425,7,4,3,3,0,7,17,13,4.0,2.0,2.0,2.0,0.0,4.0,4.0,11,7,4,2.0,1.0,1.0
9608404,9,2,7,20,2,7,13,255,6.0,1.0,5.0,9.0,1.0,5.0,10.0,13,9,4,8.0,5.0,3.0
9811509,17,3,14,34,12,5,6,128,13.0,1.0,12.0,29.0,13.0,0.0,0.0,21,17,4,12.0,12.0,0.0
9810412,14,7,7,26,0,14,60,60,8.0,2.0,6.0,25.0,0.0,8.0,19.0,33,14,19,12.0,8.0,4.0
103335,16,2,14,74,0,16,195,109,16.0,2.0,14.0,74.0,0.0,16.0,193.0,33,16,17,31.0,16.0,15.0
9509412,4,4,0,0,2,2,7,26,1.0,1.0,0.0,0.0,0.0,1.0,2.0,11,4,7,1.0,0.0,1.0
9503253,10,4,6,16,6,4,4,13,6.0,2.0,4.0,10.0,3.0,3.0,3.0,11,10,1,7.0,6.0,1.0
9302255,9,7,2,2,8,1,1,93,3.0,3.0,0.0,0.0,3.0,0.0,0.0,11,9,2,2.0,2.0,0.0
9903350,15,12,3,4,4,11,49,21,2.0,2.0,0.0,0.0,0.0,2.0,11.0,34,15,19,4.0,2.0,2.0
6084,3,3,0,0,0,3,10,182,1.0,1.0,0.0,0.0,0.0,1.0,6.0,21,3,18,8.0,1.0,7.0
9801383,11,5,6,8,4,7,10,25,3.0,2.0,1.0,1.0,3.0,0.0,0.0,13,11,2,3.0,3.0,0.0
9710432,9,3,6,12,3,6,18,49,6.0,1.0,5.0,11.0,6.0,0.0,0.0,25,9,16,2.0,2.0,0.0
8107,7,5,2,4,0,7,53,7,3.0,3.0,0.0,0.0,0.0,3.0,12.0,19,7,12,7.0,4.0,3.0
106293,3,3,0,0,0,3,5,4,0.0,0.0,0.0,0.0,0.0,0.0,0.0,22,3,19,1.0,1.0,0.0
9504240,1,1,0,0,1,0,0,71,0.0,0.0,0.0,0.0,0.0,0.0,0.0,3,1,2,,,
9308253,1,1,0,0,1,0,0,1534,,,,,,,,1,1,0,1.0,1.0,0.0
9705265,5,5,0,0,0,5,18,5,0.0,0.0,0.0,0.0,0.0,0.0,0.0,21,5,16,3.0,1.0,2.0
9309328,3,1,2,2,3,0,0,77,1.0,1.0,0.0,0.0,1.0,0.0,0.0,3,3,0,1.0,1.0,0.0
9206240,6,3,3,4,6,0,0,246,4.0,2.0,2.0,3.0,4.0,0.0,0.0,6,6,0,3.0,3.0,0.0
9805307,2,1,1,1,0,2,4,58,2.0,1.0,1.0,1.0,0.0,2.0,4.0,8,2,6,1.0,1.0,0.0
9302226,3,3,0,0,2,1,2,407,0.0,0.0,0.0,0.0,0.0,0.0,0.0,6,3,3,2.0,0.0,2.0
10065,3,3,0,0,1,2,3,0,0.0,0.0,0.0,0.0,0.0,0.0,0.0,23,3,20,3.0,1.0,2.0
9612308,7,4,3,3,3,4,9,157,1.0,1.0,0.0,0.0,0.0,1.0,2.0,25,7,18,2.0,0.0,2.0
101258,4,1,3,4,0,4,19,177,4.0,1.0,3.0,4.0,0.0,4.0,19.0,11,4,7,10.0,4.0,6.0
9805369,0,0,0,0,0,0,0,16,0.0,0.0,0.0,0.0,0.0,0.0,0.0,9,0,9,1.0,0.0,1.0
9702365,6,4,2,2,3,3,6,45,2.0,1.0,1.0,1.0,0.0,2.0,3.0,11,6,5,1.0,0.0,1.0
9410213,8,1,7,11,0,8,50,124,7.0,1.0,6.0,10.0,0.0,7.0,47.0,21,8,13,17.0,7.0,10.0
9912491,9,3,6,8,1,8,29,3,3.0,1.0,2.0,2.0,0.0,3.0,7.0,21,9,12,7.0,3.0,4.0
9811414,9,5,4,5,2,7,28,25,1.0,1.0,0.0,0.0,0.0,1.0,1.0,24,9,15,2.0,2.0,0.0
10113,9,5,4,7,3,6,27,5,0.0,0.0,0.0,0.0,0.0,0.0,0.0,24,9,15,1.0,1.0,0.0
9810480,7,5,2,3,0,7,25,147,3.0,2.0,1.0,1.0,0.0,3.0,10.0,17,7,10,6.0,1.0,5.0
9406273,3,2,1,1,3,0,0,30,,,,,,,,3,3,0,1.0,1.0,0.0
3006,14,7,7,9,3,11,36,65,5.0,2.0,3.0,3.0,0.0,5.0,21.0,28,14,14,8.0,1.0,7.0
9601235,11,5,6,11,5,6,8,105,6.0,2.0,4.0,6.0,6.0,0.0,0.0,13,11,2,2.0,2.0,0.0
9704380,15,3,12,38,1,14,144,36,13.0,2.0,11.0,36.0,0.0,13.0,139.0,33,15,18,26.0,12.0,14.0
9808465,3,3,0,0,2,1,1,10,0.0,0.0,0.0,0.0,0.0,0.0,0.0,44,3,41,7.0,0.0,7.0
9402250,8,3,5,8,6,2,2,138,4.0,1.0,3.0,6.0,4.0,0.0,0.0,9,8,1,4.0,4.0,0.0
9208211,6,2,4,6,6,0,0,270,3.0,1.0,2.0,3.0,3.0,0.0,0.0,6,6,0,3.0,3.0,0.0
9910532,4,4,0,0,2,2,13,50,1.0,1.0,0.0,0.0,0.0,1.0,2.0,30,4,26,4.0,0.0,4.0
9401287,6,3,3,3,6,0,0,528,4.0,1.0,3.0,3.0,4.0,0.0,0.0,7,6,1,3.0,3.0,0.0
9606276,2,1,1,1,2,0,0,6,0.0,0.0,0.0,0.0,0.0,0.0,0.0,13,2,11,1.0,0.0,1.0
1123,6,5,1,1,2,4,4,31,1.0,1.0,0.0,0.0,1.0,0.0,0.0,13,6,7,2.0,1.0,1.0
9809413,5,2,3,3,0,5,46,17,4.0,2.0,2.0,2.0,0.0,4.0,39.0,30,5,25,21.0,1.0,20.0
108241,4,1,3,4,0,4,26,68,0.0,0.0,0.0,0.0,0.0,0.0,0.0,33,4,29,9.0,4.0,5.0
9910485,3,1,2,3,0,3,15,14,3.0,1.0,2.0,3.0,0.0,3.0,15.0,13,3,10,2.0,0.0,2.0
11236,1,1,0,0,0,1,5,95,0.0,0.0,0.0,0.0,0.0,0.0,0.0,27,1,26,2.0,0.0,2.0
9512279,2,2,0,0,2,0,0,331,1.0,1.0,0.0,0.0,1.0,0.0,0.0,2,2,0,1.0,1.0,0.0
9807201,8,4,4,5,0,8,47,56,8.0,4.0,4.0,5.0,0.0,8.0,47.0,20,8,12,16.0,6.0,10.0
9803471,3,1,2,2,0,3,9,243,0.0,0.0,0.0,0.0,0.0,0.0,0.0,23,3,20,6.0,0.0,6.0
101002,6,2,4,7,1,5,7,32,4.0,1.0,3.0,6.0,0.0,4.0,4.0,26,6,20,4.0,4.0,0.0
209239,2,1,1,1,0,2,10,193,2.0,1.0,1.0,1.0,0.0,2.0,7.0,18,2,16,7.0,2.0,5.0
9809277,8,3,5,9,0,8,27,9,7.0,3.0,4.0,8.0,0.0,7.0,17.0,17,8,9,2.0,2.0,0.0
112037,6,2,4,6,0,6,31,38,2.0,1.0,1.0,1.0,0.0,2.0,12.0,15,6,9,10.0,3.0,7.0
9811417,10,3,7,11,3,7,32,11,1.0,1.0,0.0,0.0,0.0,1.0,1.0,25,10,15,2.0,1.0,1.0
9801331,3,3,0,0,0,3,23,10,1.0,1.0,0.0,0.0,0.0,1.0,8.0,59,3,56,10.0,0.0,10.0
9902464,4,3,1,1,1,3,12,22,2.0,1.0,1.0,1.0,0.0,2.0,9.0,12,4,8,1.0,1.0,0.0
105180,9,4,5,8,0,9,90,18,6.0,3.0,3.0,5.0,0.0,6.0,50.0,42,9,33,17.0,7.0,10.0
9405287,8,4,4,5,8,0,0,203,2.0,1.0,1.0,1.0,2.0,0.0,0.0,8,8,0,4.0,4.0,0.0
110339,4,3,1,1,0,4,13,2,0.0,0.0,0.0,0.0,0.0,0.0,0.0,13,4,9,2.0,0.0,2.0
9403205,1,1,0,0,1,0,0,142,,,,,,,,1,1,0,,,
9804347,11,4,7,15,7,4,4,240,6.0,2.0,4.0,10.0,6.0,0.0,0.0,13,11,2,6.0,6.0,0.0
9602210,7,7,0,0,7,0,0,422,4.0,4.0,0.0,0.0,4.0,0.0,0.0,7,7,0,3.0,3.0,0.0
9902403,7,3,4,4,0,7,12,108,6.0,2.0,4.0,4.0,0.0,6.0,9.0,11,7,4,5.0,5.0,0.0
6123,11,6,5,9,0,11,40,28,9.0,5.0,4.0,8.0,0.0,9.0,32.0,25,11,14,10.0,5.0,5.0
4203,2,1,1,1,0,2,21,17,2.0,1.0,1.0,1.0,0.0,2.0,21.0,19,2,17,1.0,0.0,1.0
9701399,9,5,4,5,5,4,6,7,3.0,1.0,2.0,3.0,3.0,0.0,0.0,13,9,4,3.0,3.0,0.0
4271,10,4,6,16,5,5,7,121,9.0,3.0,6.0,16.0,4.0,5.0,5.0,14,10,4,9.0,8.0,1.0
107206,16,5,11,41,0,16,155,1,16.0,5.0,11.0,41.0,0.0,16.0,155.0,33,16,17,27.0,14.0,13.0
208268,4,2,2,2,0,4,98,46,2.0,1.0,1.0,1.0,0.0,2.0,28.0,56,4,52,10.0,2.0,8.0
3190,4,4,0,0,0,4,9,15,1.0,1.0,0.0,0.0,0.0,1.0,3.0,27,4,23,6.0,1.0,5.0
211012,3,3,0,0,1,2,10,219,0.0,0.0,0.0,0.0,0.0,0.0,0.0,31,3,28,8.0,0.0,8.0
9710271,5,2,3,4,2,3,3,292,3.0,1.0,2.0,3.0,1.0,2.0,2.0,12,5,7,4.0,3.0,1.0
9907433,5,5,0,0,5,0,0,315,2.0,2.0,0.0,0.0,2.0,0.0,0.0,5,5,0,2.0,2.0,0.0
9707543,19,4,15,32,16,3,3,8,11.0,3.0,8.0,14.0,11.0,0.0,0.0,22,19,3,10.0,10.0,0.0
9503216,8,2,6,17,3,5,7,33,3.0,1.0,2.0,3.0,3.0,0.0,0.0,26,8,18,7.0,7.0,0.0
6260,2,2,0,0,0,2,2,46,0.0,0.0,0.0,0.0,0.0,0.0,0.0,13,2,11,2.0,0.0,2.0
9307359,2,2,0,0,2,0,0,402,1.0,1.0,0.0,0.0,1.0,0.0,0.0,2,2,0,,,
9207266,16,3,13,31,16,0,0,329,7.0,3.0,4.0,6.0,7.0,0.0,0.0,16,16,0,7.0,7.0,0.0
9508209,8,4,4,5,3,5,17,204,8.0,4.0,4.0,5.0,3.0,5.0,9.0,15,8,7,4.0,2.0,2.0
9908336,5,3,2,4,0,5,46,17,4.0,2.0,2.0,4.0,0.0,4.0,38.0,32,5,27,4.0,3.0,1.0
9712377,3,2,1,2,1,2,5,187,2.0,1.0,1.0,1.0,0.0,2.0,3.0,8,3,5,3.0,1.0,2.0
9711361,13,7,6,9,13,0,0,13,10.0,4.0,6.0,9.0,10.0,0.0,0.0,13,13,0,7.0,7.0,0.0
9911292,2,2,0,0,0,2,8,36,0.0,0.0,0.0,0.0,0.0,0.0,0.0,28,2,26,18.0,0.0,18.0
9810551,4,3,1,1,0,4,25,57,1.0,1.0,0.0,0.0,0.0,1.0,8.0,32,4,28,8.0,0.0,8.0
9806503,0,0,0,0,0,0,0,154,0.0,0.0,0.0,0.0,0.0,0.0,0.0,7,0,7,7.0,0.0,7.0
9410243,13,8,5,5,13,0,0,188,4.0,3.0,1.0,1.0,4.0,0.0,0.0,14,13,1,1.0,1.0,0.0
110220,1,1,0,0,0,1,11,22,0.0,0.0,0.0,0.0,0.0,0.0,0.0,84,1,83,10.0,1.0,9.0
108180,2,2,0,0,1,1,6,22,0.0,0.0,0.0,0.0,0.0,0.0,0.0,9,2,7,7.0,0.0,7.0
9707272,7,3,4,9,2,5,7,111,6.0,2.0,4.0,9.0,4.0,2.0,2.0,10,7,3,6.0,5.0,1.0
9906484,6,5,1,1,2,4,6,77,1.0,1.0,0.0,0.0,0.0,1.0,2.0,11,6,5,2.0,2.0,0.0
106277,5,3,2,3,0,5,39,48,4.0,2.0,2.0,3.0,0.0,4.0,34.0,40,5,35,17.0,3.0,14.0
9710288,3,3,0,0,0,3,24,8,0.0,0.0,0.0,0.0,0.0,0.0,0.0,53,3,50,5.0,0.0,5.0
9805495,11,3,8,20,3,8,19,72,6.0,2.0,4.0,11.0,1.0,5.0,8.0,18,11,7,8.0,7.0,1.0
9705408,8,1,7,15,8,0,0,122,7.0,1.0,6.0,12.0,7.0,0.0,0.0,8,8,0,6.0,6.0,0.0
9910287,6,2,4,5,0,6,48,4,4.0,2.0,2.0,2.0,0.0,4.0,40.0,35,6,29,16.0,2.0,14.0
9909554,21,5,16,59,0,21,292,70,21.0,5.0,16.0,59.0,0.0,21.0,292.0,39,21,18,35.0,20.0,15.0
12158,2,1,1,1,2,0,0,0,0.0,0.0,0.0,0.0,0.0,0.0,0.0,12,2,10,4.0,0.0,4.0
9811261,11,5,6,7,7,4,4,513,3.0,3.0,0.0,0.0,3.0,0.0,0.0,15,11,4,3.0,3.0,0.0
9506269,26,8,18,39,2,24,30,84,8.0,4.0,4.0,5.0,5.0,3.0,3.0,30,26,4,9.0,8.0,1.0
9909424,1,1,0,0,0,1,9,3,0.0,0.0,0.0,0.0,0.0,0.0,0.0,25,1,24,1.0,0.0,1.0
12292,12,2,10,15,0,12,58,51,11.0,2.0,9.0,14.0,0.0,11.0,47.0,24,12,12,17.0,8.0,9.0
209035,5,3,2,3,0,5,22,3,1.0,1.0,0.0,0.0,1.0,0.0,0.0,29,5,24,1.0,0.0,1.0
112359,13,6,7,10,0,13,140,3,5.0,4.0,1.0,2.0,0.0,5.0,50.0,68,13,55,21.0,6.0,15.0
204080,11,4,7,17,0,11,170,37,10.0,3.0,7.0,17.0,0.0,10.0,123.0,107,11,96,32.0,7.0,25.0
9609385,15,3,12,37,15,0,0,45,14.0,3.0,11.0,36.0,14.0,0.0,0.0,15,15,0,10.0,10.0,0.0
9807383,7,2,5,9,2,5,9,108,4.0,2.0,2.0,2.0,2.0,2.0,2.0,13,7,6,2.0,2.0,0.0
1074,9,4,5,5,0,9,33,41,5.0,2.0,3.0,3.0,0.0,5.0,14.0,33,9,24,3.0,3.0,0.0
9212296,13,8,5,15,0,13,21,329,6.0,5.0,1.0,1.0,0.0,6.0,8.0,15,13,2,5.0,4.0,1.0
9904434,7,3,4,7,1,6,15,6,2.0,1.0,1.0,1.0,1.0,1.0,1.0,20,7,13,7.0,4.0,3.0
211245,8,5,3,4,0,8,22,1,1.0,1.0,0.0,0.0,0.0,1.0,3.0,35,8,27,6.0,0.0,6.0
202025,6,5,1,1,1,5,6,51,0.0,0.0,0.0,0.0,0.0,0.0,0.0,35,6,29,2.0,1.0,1.0
9905561,4,3,1,1,3,1,1,57,2.0,1.0,1.0,1.0,2.0,0.0,0.0,8,4,4,2.0,2.0,0.0
9506299,5,3,2,3,2,3,4,195,4.0,2.0,2.0,3.0,1.0,3.0,3.0,9,5,4,5.0,4.0,1.0
9409299,5,5,0,0,3,2,6,295,2.0,2.0,0.0,0.0,2.0,0.0,0.0,8,5,3,2.0,2.0,0.0
9607409,5,5,0,0,3,2,2,316,2.0,2.0,0.0,0.0,2.0,0.0,0.0,6,5,1,2.0,2.0,0.0
105226,2,2,0,0,1,1,1,19,0.0,0.0,0.0,0.0,0.0,0.0,0.0,9,2,7,,,
6093,2,2,0,0,1,1,9,298,1.0,1.0,0.0,0.0,0.0,1.0,3.0,11,2,9,4.0,1.0,3.0
9911438,8,6,2,4,3,5,18,100,5.0,4.0,1.0,3.0,0.0,5.0,18.0,13,8,5,9.0,5.0,4.0
9912547,42,16,26,59,0,42,180,11,5.0,1.0,4.0,5.0,0.0,5.0,15.0,65,42,23,6.0,6.0,0.0
9605217,2,1,1,1,0,2,2,87,1.0,1.0,0.0,0.0,1.0,0.0,0.0,4,2,2,3.0,2.0,1.0
110155,6,4,2,2,1,5,97,109,3.0,2.0,1.0,1.0,0.0,3.0,90.0,38,6,32,33.0,3.0,30.0
9903426,9,6,3,4,0,9,52,9,3.0,2.0,1.0,2.0,0.0,3.0,25.0,23,9,14,13.0,3.0,10.0
9604342,2,1,1,1,0,2,2,414,0.0,0.0,0.0,0.0,0.0,0.0,0.0,5,2,3,2.0,0.0,2.0
9809259,1,1,0,0,1,0,0,92,0.0,0.0,0.0,0.0,0.0,0.0,0.0,8,1,7,3.0,0.0,3.0
5051,9,1,8,13,0,9,40,21,4.0,1.0,3.0,4.0,0.0,4.0,16.0,30,9,21,10.0,4.0,6.0
107175,4,1,3,4,0,4,18,83,3.0,1.0,2.0,3.0,0.0,3.0,13.0,22,4,18,10.0,3.0,7.0
9801370,3,1,2,2,0,3,7,33,2.0,1.0,1.0,1.0,0.0,2.0,5.0,8,3,5,3.0,2.0,1.0
9512260,4,3,1,1,1,3,7,204,3.0,3.0,0.0,0.0,0.0,3.0,6.0,9,4,5,2.0,1.0,1.0
9311272,3,2,1,2,3,0,0,1367,,,,,,,,3,3,0,1.0,1.0,0.0
9304316,9,4,5,7,9,0,0,305,7.0,4.0,3.0,4.0,7.0,0.0,0.0,9,9,0,3.0,3.0,0.0
9245,11,4,7,15,0,11,81,2,6.0,2.0,4.0,7.0,0.0,6.0,48.0,22,11,11,15.0,6.0,9.0
211310,1,1,0,0,0,1,9,12,1.0,1.0,0.0,0.0,0.0,1.0,9.0,17,1,16,9.0,0.0,9.0
208012,10,5,5,9,0,10,150,23,6.0,2.0,4.0,6.0,0.0,6.0,64.0,77,10,67,30.0,5.0,25.0
202275,7,6,1,1,0,7,166,23,2.0,2.0,0.0,0.0,0.0,2.0,49.0,86,7,79,28.0,2.0,26.0
9806389,3,2,1,1,0,3,5,136,1.0,1.0,0.0,0.0,0.0,1.0,1.0,9,3,6,2.0,1.0,1.0
9606320,4,1,3,4,1,3,3,130,4.0,1.0,3.0,4.0,1.0,3.0,3.0,6,4,2,2.0,2.0,0.0
9212209,2,2,0,0,2,0,0,325,2.0,2.0,0.0,0.0,2.0,0.0,0.0,2,2,0,1.0,1.0,0.0
112132,12,3,9,18,0,12,227,37,12.0,3.0,9.0,18.0,0.0,12.0,205.0,47,12,35,35.0,11.0,24.0
102235,5,3,2,3,4,1,5,381,3.0,2.0,1.0,1.0,2.0,1.0,1.0,10,5,5,6.0,1.0,5.0
212277,0,0,0,0,0,0,0,1,,,,,,,,7,0,7,,,
106124,12,2,10,21,0,12,141,9,11.0,2.0,9.0,19.0,0.0,11.0,132.0,37,12,25,24.0,6.0,18.0
111386,1,1,0,0,1,0,0,45,0.0,0.0,0.0,0.0,0.0,0.0,0.0,14,1,13,1.0,0.0,1.0
9409343,2,2,0,0,2,0,0,64,1.0,1.0,0.0,0.0,1.0,0.0,0.0,2,2,0,1.0,1.0,0.0
101237,3,1,2,2,0,3,8,69,0.0,0.0,0.0,0.0,0.0,0.0,0.0,24,3,21,13.0,0.0,13.0
9710241,2,1,1,1,1,1,1,266,2.0,1.0,1.0,1.0,2.0,0.0,0.0,6,2,4,2.0,2.0,0.0
9909312,6,4,2,2,0,6,15,1,0.0,0.0,0.0,0.0,0.0,0.0,0.0,28,6,22,2.0,0.0,2.0
102269,8,7,1,2,5,3,13,113,1.0,1.0,0.0,0.0,0.0,1.0,7.0,42,8,34,17.0,1.0,16.0
9910282,7,1,6,10,0,7,50,54,5.0,1.0,4.0,6.0,0.0,5.0,26.0,26,7,19,15.0,4.0,11.0
9609302,5,2,3,4,0,5,5,25,2.0,1.0,1.0,1.0,0.0,2.0,2.0,6,5,1,2.0,2.0,0.0
9511318,12,7,5,8,4,8,8,247,8.0,5.0,3.0,6.0,0.0,8.0,8.0,15,12,3,8.0,7.0,1.0
105270,2,2,0,0,0,2,11,184,0.0,0.0,0.0,0.0,0.0,0.0,0.0,23,2,21,5.0,0.0,5.0
9811219,4,2,2,2,1,3,8,33,3.0,3.0,0.0,0.0,1.0,2.0,6.0,12,4,8,2.0,2.0,0.0
210296,2,2,0,0,0,2,27,28,2.0,2.0,0.0,0.0,0.0,2.0,20.0,57,2,55,32.0,2.0,30.0
9702294,2,1,1,1,0,2,5,222,2.0,1.0,1.0,1.0,0.0,2.0,5.0,6,2,4,4.0,2.0,2.0
9701249,6,3,3,3,0,6,33,17,3.0,3.0,0.0,0.0,0.0,3.0,25.0,22,6,16,3.0,3.0,0.0
105289,2,2,0,0,1,1,1,197,0.0,0.0,0.0,0.0,0.0,0.0,0.0,14,2,12,5.0,0.0,5.0
9506421,5,4,1,1,0,5,13,8,2.0,1.0,1.0,1.0,1.0,1.0,2.0,15,5,10,2.0,2.0,0.0
9708409,1,1,0,0,0,1,2,204,1.0,1.0,0.0,0.0,0.0,1.0,2.0,14,1,13,1.0,0.0,1.0
9802331,1,1,0,0,0,1,11,60,1.0,1.0,0.0,0.0,0.0,1.0,8.0,29,1,28,16.0,1.0,15.0
9708232,7,3,4,5,1,6,14,100,3.0,2.0,1.0,1.0,0.0,3.0,6.0,13,7,6,6.0,3.0,3.0
10137,5,5,0,0,0,5,13,17,1.0,1.0,0.0,0.0,0.0,1.0,7.0,32,5,27,4.0,1.0,3.0
109190,2,1,1,1,0,2,5,29,0.0,0.0,0.0,0.0,0.0,0.0,0.0,12,2,10,4.0,2.0,2.0
9905352,6,5,1,1,0,6,9,47,5.0,4.0,1.0,1.0,1.0,4.0,4.0,15,6,9,6.0,4.0,2.0
9910495,6,6,0,0,1,5,36,35,4.0,4.0,0.0,0.0,0.0,4.0,26.0,41,6,35,7.0,0.0,7.0
9609399,6,3,3,5,0,6,16,105,3.0,1.0,2.0,3.0,0.0,3.0,8.0,11,6,5,6.0,3.0,3.0
9906489,6,1,5,7,0,6,35,13,5.0,1.0,4.0,6.0,0.0,5.0,32.0,25,6,19,4.0,1.0,3.0
9610505,1,1,0,0,0,1,5,17,1.0,1.0,0.0,0.0,0.0,1.0,5.0,33,1,32,23.0,0.0,23.0
9709231,14,5,9,20,6,8,21,84,12.0,5.0,7.0,17.0,4.0,8.0,21.0,20,14,6,10.0,4.0,6.0
205334,8,8,0,0,1,7,44,65,3.0,3.0,0.0,0.0,0.0,3.0,31.0,48,8,40,17.0,2.0,15.0
9306279,0,0,0,0,0,0,0,75,0.0,0.0,0.0,0.0,0.0,0.0,0.0,13,0,13,1.0,0.0,1.0
9302213,24,16,8,9,24,0,0,344,9.0,7.0,2.0,3.0,9.0,0.0,0.0,24,24,0,4.0,4.0,0.0
9612201,3,3,0,0,0,3,5,160,1.0,1.0,0.0,0.0,0.0,1.0,1.0,6,3,3,2.0,1.0,1.0
9605454,9,3,6,14,2,7,15,82,8.0,2.0,6.0,13.0,1.0,7.0,15.0,12,9,3,9.0,6.0,3.0
9801308,4,3,1,1,3,1,3,145,1.0,1.0,0.0,0.0,0.0,1.0,3.0,7,4,3,4.0,1.0,3.0
204211,12,8,4,5,1,11,64,11,7.0,4.0,3.0,4.0,0.0,7.0,53.0,29,12,17,4.0,1.0,3.0
9906357,11,3,8,15,2,9,19,145,8.0,1.0,7.0,14.0,1.0,7.0,13.0,16,11,5,11.0,8.0,3.0
9502319,7,3,4,6,1,6,7,44,1.0,1.0,0.0,0.0,0.0,1.0,1.0,11,7,4,5.0,4.0,1.0
9905302,8,5,3,4,1,7,13,131,4.0,2.0,2.0,3.0,0.0,4.0,9.0,16,8,8,6.0,3.0,3.0
9512296,8,4,4,6,2,6,10,326,5.0,2.0,3.0,4.0,3.0,2.0,2.0,11,8,3,3.0,3.0,0.0
102064,7,1,6,12,0,7,47,20,7.0,1.0,6.0,12.0,0.0,7.0,44.0,27,7,20,10.0,6.0,4.0
212212,11,3,8,15,0,11,102,0,1.0,1.0,0.0,0.0,0.0,1.0,16.0,44,11,33,17.0,1.0,16.0
9910300,3,2,1,1,1,2,3,64,3.0,2.0,1.0,1.0,1.0,2.0,2.0,16,3,13,7.0,0.0,7.0
9208235,2,2,0,0,2,0,0,1415,,,,,,,,2,2,0,1.0,1.0,0.0
111003,2,1,1,1,0,2,14,23,0.0,0.0,0.0,0.0,0.0,0.0,0.0,54,2,52,4.0,0.0,4.0
12033,5,1,4,6,0,5,32,158,4.0,1.0,3.0,4.0,0.0,4.0,20.0,27,5,22,10.0,4.0,6.0
208034,5,3,2,2,0,5,25,193,1.0,1.0,0.0,0.0,0.0,1.0,5.0,22,5,17,1.0,0.0,1.0
9804383,2,2,0,0,0,2,8,166,2.0,2.0,0.0,0.0,0.0,2.0,6.0,9,2,7,5.0,1.0,4.0
9701397,2,1,1,1,0,2,2,527,2.0,1.0,1.0,1.0,0.0,2.0,2.0,3,2,1,3.0,2.0,1.0
9911274,1,1,0,0,0,1,6,12,1.0,1.0,0.0,0.0,0.0,1.0,6.0,30,1,29,19.0,0.0,19.0
205027,1,1,0,0,0,1,1,20,0.0,0.0,0.0,0.0,0.0,0.0,0.0,26,1,25,3.0,0.0,3.0
9909316,0,0,0,0,0,0,0,60,0.0,0.0,0.0,0.0,0.0,0.0,0.0,27,0,27,4.0,0.0,4.0
1257,4,4,0,0,1,3,22,10,1.0,1.0,0.0,0.0,0.0,1.0,6.0,45,4,41,9.0,0.0,9.0
9707304,2,2,0,0,1,1,3,29,1.0,1.0,0.0,0.0,0.0,1.0,3.0,29,2,27,1.0,0.0,1.0
9611341,6,2,4,6,0,6,57,71,5.0,1.0,4.0,6.0,0.0,5.0,52.0,27,6,21,21.0,5.0,16.0
9911533,8,2,6,14,0,8,11,216,8.0,2.0,6.0,14.0,0.0,8.0,9.0,13,8,5,8.0,7.0,1.0
212021,2,1,1,1,2,0,0,6,0.0,0.0,0.0,0.0,0.0,0.0,0.0,15,2,13,4.0,0.0,4.0
9610439,4,1,3,3,2,2,2,148,3.0,1.0,2.0,2.0,1.0,2.0,2.0,8,4,4,4.0,3.0,1.0
9310219,1,1,0,0,1,0,0,1910,,,,,,,,2,1,1,,,
107141,10,3,7,22,0,10,48,52,9.0,3.0,6.0,19.0,0.0,9.0,42.0,18,10,8,14.0,8.0,6.0
9304284,2,2,0,0,1,1,2,15,2.0,2.0,0.0,0.0,2.0,0.0,0.0,7,2,5,1.0,1.0,0.0
9309290,1,1,0,0,1,0,0,280,1.0,1.0,0.0,0.0,1.0,0.0,0.0,2,1,1,2.0,1.0,1.0
9912228,4,4,0,0,1,3,6,308,1.0,1.0,0.0,0.0,0.0,1.0,3.0,8,4,4,5.0,2.0,3.0
8238,3,2,1,1,0,3,11,58,1.0,1.0,0.0,0.0,0.0,1.0,3.0,42,3,39,11.0,1.0,10.0
104055,4,3,1,1,1,3,6,178,3.0,2.0,1.0,1.0,2.0,1.0,1.0,17,4,13,3.0,2.0,1.0
112304,2,2,0,0,0,2,9,91,2.0,2.0,0.0,0.0,0.0,2.0,7.0,10,2,8,9.0,2.0,7.0
201051,4,3,1,1,3,1,3,558,2.0,2.0,0.0,0.0,2.0,0.0,0.0,9,4,5,4.0,2.0,2.0
6245,0,0,0,0,0,0,0,110,0.0,0.0,0.0,0.0,0.0,0.0,0.0,8,0,8,,,
5140,2,2,0,0,0,2,11,27,2.0,2.0,0.0,0.0,0.0,2.0,10.0,21,2,19,6.0,1.0,5.0
1214,10,5,5,6,0,10,37,27,9.0,4.0,5.0,6.0,0.0,9.0,29.0,21,10,11,7.0,6.0,1.0
6276,5,4,1,1,4,1,1,5,2.0,2.0,0.0,0.0,2.0,0.0,0.0,10,5,5,1.0,1.0,0.0
4183,13,4,9,12,3,10,48,29,2.0,2.0,0.0,0.0,0.0,2.0,8.0,74,13,61,9.0,2.0,7.0
9809245,10,1,9,25,0,10,47,52,10.0,1.0,9.0,25.0,0.0,10.0,47.0,32,10,22,17.0,9.0,8.0
9509403,1,1,0,0,1,0,0,65,1.0,1.0,0.0,0.0,1.0,0.0,0.0,4,1,3,1.0,1.0,0.0
9607458,3,2,1,1,0,3,4,229,3.0,2.0,1.0,1.0,0.0,3.0,3.0,6,3,3,4.0,3.0,1.0
9908329,2,2,0,0,0,2,6,31,2.0,2.0,0.0,0.0,0.0,2.0,5.0,10,2,8,1.0,0.0,1.0
206297,4,4,0,0,0,4,31,32,2.0,2.0,0.0,0.0,0.0,2.0,2.0,30,4,26,2.0,2.0,0.0
9412394,4,1,3,5,2,2,2,79,4.0,1.0,3.0,5.0,4.0,0.0,0.0,5,4,1,2.0,2.0,0.0
9911222,2,2,0,0,1,1,5,153,2.0,2.0,0.0,0.0,1.0,1.0,2.0,7,2,5,3.0,2.0,1.0
6156,7,5,2,3,0,7,9,264,3.0,3.0,0.0,0.0,3.0,0.0,0.0,11,7,4,2.0,2.0,0.0
207205,1,1,0,0,0,1,1,76,0.0,0.0,0.0,0.0,0.0,0.0,0.0,9,1,8,5.0,0.0,5.0
9606302,9,5,4,6,1,8,12,48,5.0,2.0,3.0,3.0,1.0,4.0,4.0,12,9,3,4.0,4.0,0.0
110187,3,1,2,3,0,3,4,0,3.0,1.0,2.0,3.0,0.0,3.0,3.0,7,3,4,,,
201042,1,1,0,0,0,1,5,0,,,,,,,,8,1,7,1.0,0.0,1.0
9603373,2,2,0,0,0,2,5,76,1.0,1.0,0.0,0.0,0.0,1.0,4.0,12,2,10,8.0,1.0,7.0
9506227,5,2,3,5,1,4,6,291,3.0,1.0,2.0,2.0,0.0,3.0,3.0,10,5,5,3.0,1.0,2.0
9406413,6,5,1,1,1,5,11,86,2.0,2.0,0.0,0.0,0.0,2.0,4.0,10,6,4,7.0,3.0,4.0
8312,4,2,2,2,4,0,0,191,4.0,2.0,2.0,2.0,4.0,0.0,0.0,4,4,0,3.0,3.0,0.0
9207223,8,8,0,0,7,1,1,489,1.0,1.0,0.0,0.0,0.0,1.0,1.0,9,8,1,1.0,1.0,0.0
9704418,3,1,2,2,1,2,3,120,3.0,1.0,2.0,2.0,3.0,0.0,0.0,8,3,5,2.0,1.0,1.0
212211,0,0,0,0,0,0,0,26,0.0,0.0,0.0,0.0,0.0,0.0,0.0,17,0,17,2.0,0.0,2.0
9709504,1,1,0,0,1,0,0,92,,,,,,,,1,1,0,,,
204115,25,9,16,29,1,24,179,16,10.0,4.0,6.0,7.0,0.0,10.0,61.0,88,25,63,17.0,4.0,13.0
9710322,7,3,4,7,2,5,10,305,5.0,2.0,3.0,6.0,0.0,5.0,9.0,10,7,3,7.0,5.0,2.0
12241,14,5,9,26,2,12,52,108,12.0,3.0,9.0,26.0,0.0,12.0,52.0,23,14,9,15.0,8.0,7.0
9905507,2,2,0,0,1,1,1,209,,,,,,,,5,2,3,1.0,1.0,0.0
210320,5,3,2,2,0,5,62,37,4.0,2.0,2.0,2.0,0.0,4.0,54.0,38,5,33,23.0,3.0,20.0
9707443,1,1,0,0,0,1,2,12,0.0,0.0,0.0,0.0,0.0,0.0,0.0,67,1,66,6.0,0.0,6.0
9908447,5,2,3,3,2,3,4,121,4.0,2.0,2.0,2.0,4.0,0.0,0.0,10,5,5,2.0,2.0,0.0
10056,1,1,0,0,0,1,1,67,0.0,0.0,0.0,0.0,0.0,0.0,0.0,5,1,4,2.0,0.0,2.0
205059,1,1,0,0,0,1,2,47,0.0,0.0,0.0,0.0,0.0,0.0,0.0,11,1,10,1.0,0.0,1.0
9305329,6,2,4,7,6,0,0,329,4.0,2.0,2.0,3.0,4.0,0.0,0.0,6,6,0,5.0,5.0,0.0
10160,7,3,4,6,1,6,11,106,6.0,3.0,3.0,5.0,1.0,5.0,7.0,14,7,7,5.0,4.0,1.0
9507340,8,6,2,3,3,5,9,320,3.0,2.0,1.0,1.0,0.0,3.0,5.0,12,8,4,4.0,3.0,1.0
9403377,0,0,0,0,0,0,0,189,0.0,0.0,0.0,0.0,0.0,0.0,0.0,2,0,2,1.0,0.0,1.0
206207,9,4,5,7,0,9,51,3,7.0,3.0,4.0,6.0,1.0,6.0,33.0,33,9,24,7.0,0.0,7.0
9709230,6,2,4,4,3,3,3,233,6.0,2.0,4.0,4.0,3.0,3.0,3.0,7,6,1,6.0,5.0,1.0
205172,4,3,1,1,2,2,7,25,2.0,1.0,1.0,1.0,1.0,1.0,2.0,12,4,8,5.0,2.0,3.0
9709256,1,1,0,0,1,0,0,30,,,,,,,,5,1,4,1.0,1.0,0.0
208275,3,2,1,1,0,3,14,9,3.0,2.0,1.0,1.0,0.0,3.0,14.0,13,3,10,,,
9612323,7,1,6,12,7,0,0,305,7.0,1.0,6.0,12.0,7.0,0.0,0.0,9,7,2,6.0,6.0,0.0
4157,2,2,0,0,0,2,2,67,0.0,0.0,0.0,0.0,0.0,0.0,0.0,15,2,13,1.0,1.0,0.0
1313,4,2,2,3,0,4,4,1,3.0,2.0,1.0,1.0,0.0,3.0,3.0,21,4,17,3.0,3.0,0.0
9412351,1,1,0,0,1,0,0,1682,0.0,0.0,0.0,0.0,0.0,0.0,0.0,2,1,1,1.0,0.0,1.0
203166,12,2,10,18,0,12,162,24,10.0,2.0,8.0,13.0,0.0,10.0,134.0,74,12,62,44.0,3.0,41.0
9804387,3,2,1,1,1,2,10,52,2.0,1.0,1.0,1.0,0.0,2.0,10.0,9,3,6,7.0,2.0,5.0
9305221,4,4,0,0,4,0,0,526,3.0,3.0,0.0,0.0,3.0,0.0,0.0,4,4,0,3.0,3.0,0.0
9703459,3,2,1,2,2,1,4,74,1.0,1.0,0.0,0.0,0.0,1.0,3.0,10,3,7,5.0,1.0,4.0
9308280,1,1,0,0,1,0,0,559,1.0,1.0,0.0,0.0,1.0,0.0,0.0,2,1,1,2.0,1.0,1.0
102086,5,2,3,4,0,5,21,105,5.0,2.0,3.0,4.0,0.0,5.0,21.0,12,5,7,9.0,4.0,5.0
102327,0,0,0,0,0,0,0,18,0.0,0.0,0.0,0.0,0.0,0.0,0.0,19,0,19,1.0,0.0,1.0
9611212,3,1,2,2,0,3,5,30,3.0,1.0,2.0,2.0,0.0,3.0,5.0,5,3,2,4.0,3.0,1.0
8031,2,1,1,1,2,0,0,184,0.0,0.0,0.0,0.0,0.0,0.0,0.0,6,2,4,3.0,0.0,3.0
208224,1,1,0,0,0,1,4,8,1.0,1.0,0.0,0.0,0.0,1.0,2.0,26,1,25,1.0,1.0,0.0
8231,3,2,1,1,0,3,13,63,3.0,2.0,1.0,1.0,0.0,3.0,11.0,13,3,10,6.0,1.0,5.0
9801392,10,3,7,10,10,0,0,185,7.0,2.0,5.0,7.0,7.0,0.0,0.0,11,10,1,6.0,6.0,0.0
201034,1,1,0,0,0,1,4,171,1.0,1.0,0.0,0.0,0.0,1.0,4.0,7,1,6,7.0,1.0,6.0
10302,3,1,2,3,0,3,10,101,3.0,1.0,2.0,3.0,0.0,3.0,5.0,10,3,7,7.0,3.0,4.0
11074,12,5,7,19,1,11,97,82,11.0,4.0,7.0,18.0,1.0,10.0,90.0,41,12,29,28.0,6.0,22.0
11210,1,1,0,0,0,1,1,560,1.0,1.0,0.0,0.0,0.0,1.0,1.0,2,1,1,2.0,1.0,1.0
106188,3,1,2,3,0,3,13,209,3.0,1.0,2.0,3.0,0.0,3.0,13.0,8,3,5,8.0,3.0,5.0
211061,0,0,0,0,0,0,0,189,0.0,0.0,0.0,0.0,0.0,0.0,0.0,7,0,7,6.0,0.0,6.0
110007,4,4,0,0,0,4,5,219,2.0,2.0,0.0,0.0,0.0,2.0,3.0,7,4,3,4.0,3.0,1.0
9505371,3,2,1,1,3,0,0,235,3.0,2.0,1.0,1.0,3.0,0.0,0.0,3,3,0,1.0,1.0,0.0
104011,1,1,0,0,0,1,3,33,1.0,1.0,0.0,0.0,0.0,1.0,3.0,18,1,17,1.0,0.0,1.0
10060,4,2,2,2,0,4,21,11,3.0,2.0,1.0,1.0,0.0,3.0,7.0,19,4,15,7.0,3.0,4.0
9801413,1,1,0,0,0,1,1,222,1.0,1.0,0.0,0.0,0.0,1.0,1.0,4,1,3,1.0,1.0,0.0
9909547,4,1,3,4,4,0,0,178,4.0,1.0,3.0,4.0,4.0,0.0,0.0,4,4,0,3.0,3.0,0.0
101006,2,2,0,0,0,2,6,80,1.0,1.0,0.0,0.0,0.0,1.0,1.0,10,2,8,3.0,1.0,2.0
9711300,1,1,0,0,0,1,3,13,1.0,1.0,0.0,0.0,0.0,1.0,2.0,13,1,12,5.0,1.0,4.0
203071,0,0,0,0,0,0,0,6,0.0,0.0,0.0,0.0,0.0,0.0,0.0,13,0,13,1.0,0.0,1.0
11192,14,8,6,6,1,13,46,46,3.0,2.0,1.0,1.0,0.0,3.0,18.0,35,14,21,2.0,2.0,0.0
9806321,5,3,2,3,2,3,5,101,1.0,1.0,0.0,0.0,0.0,1.0,2.0,14,5,9,3.0,1.0,2.0
111450,0,0,0,0,0,0,0,98,0.0,0.0,0.0,0.0,0.0,0.0,0.0,3,0,3,,,
9903325,5,2,3,5,0,5,11,105,5.0,2.0,3.0,5.0,0.0,5.0,11.0,12,5,7,7.0,4.0,3.0
212048,1,1,0,0,0,1,5,312,1.0,1.0,0.0,0.0,0.0,1.0,3.0,8,1,7,5.0,1.0,4.0
9402293,7,3,4,5,7,0,0,269,5.0,2.0,3.0,4.0,5.0,0.0,0.0,7,7,0,4.0,4.0,0.0
104180,2,1,1,1,0,2,9,4,0.0,0.0,0.0,0.0,0.0,0.0,0.0,23,2,21,2.0,0.0,2.0
9511404,6,3,3,6,0,6,21,76,6.0,3.0,3.0,6.0,0.0,6.0,21.0,13,6,7,11.0,6.0,5.0
205306,3,2,1,1,0,3,12,7,1.0,1.0,0.0,0.0,0.0,1.0,1.0,28,3,25,3.0,1.0,2.0
111171,0,0,0,0,0,0,0,145,0.0,0.0,0.0,0.0,0.0,0.0,0.0,7,0,7,2.0,0.0,2.0
9608400,1,1,0,0,0,1,5,14,,,,,,,,9,1,8,,,
9710564,1,1,0,0,1,0,0,41,0.0,0.0,0.0,0.0,0.0,0.0,0.0,13,1,12,5.0,0.0,5.0
9404298,1,1,0,0,1,0,0,1058,,,,,,,,1,1,0,,,
204028,15,3,12,26,0,15,192,11,12.0,2.0,10.0,21.0,0.0,12.0,184.0,51,15,36,33.0,10.0,23.0
2228,13,3,10,15,3,10,23,195,10.0,1.0,9.0,14.0,10.0,0.0,0.0,22,13,9,8.0,8.0,0.0
11114,4,3,1,1,0,4,23,65,3.0,2.0,1.0,1.0,0.0,3.0,18.0,32,4,28,12.0,3.0,9.0
9904269,3,2,1,1,0,3,12,40,3.0,2.0,1.0,1.0,0.0,3.0,11.0,12,3,9,4.0,1.0,3.0
104022,10,5,5,9,2,8,22,178,7.0,3.0,4.0,8.0,1.0,6.0,10.0,27,10,17,8.0,6.0,2.0
9509427,9,3,6,11,3,6,6,174,9.0,3.0,6.0,11.0,9.0,0.0,0.0,18,9,9,5.0,5.0,0.0
9604278,1,1,0,0,1,0,0,385,1.0,1.0,0.0,0.0,1.0,0.0,0.0,3,1,2,2.0,0.0,2.0
101075,3,3,0,0,1,2,10,44,0.0,0.0,0.0,0.0,0.0,0.0,0.0,20,3,17,7.0,2.0,5.0
9903433,1,1,0,0,1,0,0,384,0.0,0.0,0.0,0.0,0.0,0.0,0.0,8,1,7,4.0,1.0,3.0
9706295,1,1,0,0,1,0,0,347,1.0,1.0,0.0,0.0,1.0,0.0,0.0,1,1,0,,,
9608448,6,3,3,7,5,1,2,125,3.0,1.0,2.0,2.0,3.0,0.0,0.0,9,6,3,3.0,3.0,0.0
209135,0,0,0,0,0,0,0,17,0.0,0.0,0.0,0.0,0.0,0.0,0.0,46,0,46,23.0,0.0,23.0
206015,9,4,5,8,3,6,23,71,5.0,3.0,2.0,4.0,1.0,4.0,16.0,19,9,10,3.0,2.0,1.0
1109,2,2,0,0,0,2,9,2,1.0,1.0,0.0,0.0,0.0,1.0,3.0,11,2,9,5.0,1.0,4.0
205031,5,4,1,1,1,4,22,108,2.0,1.0,1.0,1.0,0.0,2.0,9.0,39,5,34,7.0,1.0,6.0
9905258,3,3,0,0,2,1,1,31,,,,,,,,4,3,1,1.0,1.0,0.0
9710407,3,3,0,0,0,3,11,181,3.0,3.0,0.0,0.0,0.0,3.0,11.0,16,3,13,8.0,1.0,7.0
5304,5,5,0,0,3,2,5,16,0.0,0.0,0.0,0.0,0.0,0.0,0.0,17,5,12,1.0,1.0,0.0
202123,6,5,1,1,1,5,7,339,3.0,3.0,0.0,0.0,1.0,2.0,2.0,9,6,3,3.0,2.0,1.0
10331,2,1,1,1,0,2,4,215,2.0,1.0,1.0,1.0,0.0,2.0,2.0,4,2,2,4.0,2.0,2.0
9607267,0,0,0,0,0,0,0,217,0.0,0.0,0.0,0.0,0.0,0.0,0.0,3,0,3,1.0,0.0,1.0
205062,1,1,0,0,0,1,5,241,1.0,1.0,0.0,0.0,0.0,1.0,2.0,15,1,14,4.0,1.0,3.0
302017,0,0,0,0,0,0,0,0,0.0,0.0,0.0,0.0,0.0,0.0,0.0,15,0,15,1.0,0.0,1.0
110290,2,1,1,1,1,1,1,405,1.0,1.0,0.0,0.0,0.0,1.0,1.0,3,2,1,2.0,1.0,1.0
5077,4,2,2,5,0,4,12,49,4.0,2.0,2.0,5.0,0.0,4.0,12.0,14,4,10,2.0,0.0,2.0
109206,2,1,1,1,0,2,8,21,2.0,1.0,1.0,1.0,0.0,2.0,3.0,20,2,18,6.0,2.0,4.0
9810314,0,0,0,0,0,0,0,186,0.0,0.0,0.0,0.0,0.0,0.0,0.0,1,0,1,1.0,0.0,1.0
101266,4,2,2,3,0,4,22,69,4.0,2.0,2.0,3.0,0.0,4.0,11.0,27,4,23,1.0,0.0,1.0
12169,1,1,0,0,1,0,0,791,1.0,1.0,0.0,0.0,1.0,0.0,0.0,9,1,8,2.0,1.0,1.0
9206226,2,2,0,0,2,0,0,466,1.0,1.0,0.0,0.0,1.0,0.0,0.0,2,2,0,1.0,1.0,0.0
107079,1,1,0,0,0,1,5,24,0.0,0.0,0.0,0.0,0.0,0.0,0.0,16,1,15,3.0,1.0,2.0
301071,0,0,0,0,0,0,0,21,0.0,0.0,0.0,0.0,0.0,0.0,0.0,50,0,50,17.0,0.0,17.0
9312287,0,0,0,0,0,0,0,164,0.0,0.0,0.0,0.0,0.0,0.0,0.0,11,0,11,1.0,0.0,1.0
209252,1,1,0,0,0,1,14,12,0.0,0.0,0.0,0.0,0.0,0.0,0.0,31,1,30,5.0,1.0,4.0
9507430,6,3,3,3,6,0,0,174,6.0,3.0,3.0,3.0,6.0,0.0,0.0,6,6,0,3.0,3.0,0.0
9812502,2,2,0,0,1,1,7,52,1.0,1.0,0.0,0.0,0.0,1.0,3.0,14,2,12,2.0,1.0,1.0
107174,2,2,0,0,0,2,3,15,1.0,1.0,0.0,0.0,0.0,1.0,2.0,15,2,13,3.0,1.0,2.0
9010,5,3,2,2,1,4,14,8,5.0,3.0,2.0,2.0,1.0,4.0,13.0,12,5,7,2.0,2.0,0.0
9501351,0,0,0,0,0,0,0,916,,,,,,,,2,0,2,,,
9906386,8,5,3,4,8,0,0,352,4.0,4.0,0.0,0.0,4.0,0.0,0.0,8,8,0,2.0,2.0,0.0
5023,2,2,0,0,2,0,0,144,1.0,1.0,0.0,0.0,1.0,0.0,0.0,3,2,1,,,
9708413,9,3,6,10,0,9,29,41,2.0,1.0,1.0,1.0,0.0,2.0,5.0,26,9,17,8.0,5.0,3.0
112347,2,2,0,0,1,1,12,25,1.0,1.0,0.0,0.0,0.0,1.0,10.0,66,2,64,13.0,1.0,12.0
101337,1,1,0,0,0,1,8,34,1.0,1.0,0.0,0.0,0.0,1.0,8.0,24,1,23,4.0,0.0,4.0
9804452,7,5,2,2,5,2,2,262,3.0,2.0,1.0,1.0,3.0,0.0,0.0,8,7,1,3.0,3.0,0.0
9503231,4,3,1,1,4,0,0,444,4.0,3.0,1.0,1.0,4.0,0.0,0.0,5,4,1,4.0,4.0,0.0
9175,1,1,0,0,0,1,4,43,1.0,1.0,0.0,0.0,0.0,1.0,4.0,14,1,13,10.0,1.0,9.0
9809387,1,1,0,0,0,1,3,1,0.0,0.0,0.0,0.0,0.0,0.0,0.0,26,1,25,2.0,1.0,1.0
107037,4,1,3,5,0,4,7,49,4.0,1.0,3.0,5.0,0.0,4.0,5.0,10,4,6,3.0,1.0,2.0
202243,0,0,0,0,0,0,0,622,0.0,0.0,0.0,0.0,0.0,0.0,0.0,4,0,4,2.0,0.0,2.0
9806473,4,3,1,1,2,2,7,15,0.0,0.0,0.0,0.0,0.0,0.0,0.0,20,4,16,5.0,0.0,5.0
203200,5,4,1,1,0,5,21,12,0.0,0.0,0.0,0.0,0.0,0.0,0.0,54,5,49,3.0,0.0,3.0
9509332,2,2,0,0,2,0,0,489,1.0,1.0,0.0,0.0,1.0,0.0,0.0,7,2,5,1.0,0.0,1.0
4124,6,3,3,5,0,6,62,2,3.0,3.0,0.0,0.0,0.0,3.0,36.0,39,6,33,21.0,4.0,17.0
105170,2,2,0,0,1,1,9,20,1.0,1.0,0.0,0.0,0.0,1.0,9.0,19,2,17,1.0,0.0,1.0
9806502,2,2,0,0,1,1,3,9,1.0,1.0,0.0,0.0,0.0,1.0,2.0,17,2,15,1.0,0.0,1.0
9601339,4,4,0,0,0,4,10,96,2.0,2.0,0.0,0.0,0.0,2.0,6.0,22,4,18,12.0,2.0,10.0
9804276,0,0,0,0,0,0,0,197,0.0,0.0,0.0,0.0,0.0,0.0,0.0,1,0,1,1.0,0.0,1.0
103129,0,0,0,0,0,0,0,72,0.0,0.0,0.0,0.0,0.0,0.0,0.0,7,0,7,3.0,0.0,3.0
9709224,1,1,0,0,0,1,3,167,1.0,1.0,0.0,0.0,0.0,1.0,3.0,6,1,5,5.0,1.0,4.0
9911328,0,0,0,0,0,0,0,1339,,,,,,,,1,0,1,,,
102196,2,2,0,0,0,2,18,5,0.0,0.0,0.0,0.0,0.0,0.0,0.0,25,2,23,2.0,0.0,2.0
9909451,3,2,1,1,0,3,8,180,3.0,2.0,1.0,1.0,0.0,3.0,8.0,15,3,12,11.0,3.0,8.0
9910509,6,4,2,4,0,6,28,155,5.0,4.0,1.0,3.0,0.0,5.0,18.0,21,6,15,11.0,5.0,6.0
208174,0,0,0,0,0,0,0,335,0.0,0.0,0.0,0.0,0.0,0.0,0.0,4,0,4,1.0,0.0,1.0
204048,3,1,2,2,0,3,8,106,3.0,1.0,2.0,2.0,0.0,3.0,8.0,6,3,3,6.0,3.0,3.0
203275,6,3,3,9,0,6,16,219,6.0,3.0,3.0,9.0,0.0,6.0,16.0,10,6,4,8.0,5.0,3.0
9812438,0,0,0,0,0,0,0,117,0.0,0.0,0.0,0.0,0.0,0.0,0.0,3,0,3,1.0,0.0,1.0
206127,0,0,0,0,0,0,0,1,0.0,0.0,0.0,0.0,0.0,0.0,0.0,18,0,18,5.0,0.0,5.0
201058,0,0,0,0,0,0,0,368,0.0,0.0,0.0,0.0,0.0,0.0,0.0,2,0,2,1.0,0.0,1.0
211403,0,0,0,0,0,0,0,54,,,,,,,,2,0,2,,,
10241,0,0,0,0,0,0,0,112,0.0,0.0,0.0,0.0,0.0,0.0,0.0,3,0,3,,,
208173,0,0,0,0,0,0,0,129,0.0,0.0,0.0,0.0,0.0,0.0,0.0,3,0,3,1.0,0.0,1.0
9810497,0,0,0,0,0,0,0,13,0.0,0.0,0.0,0.0,0.0,0.0,0.0,12,0,12,3.0,0.0,3.0
9509203,1,1,0,0,0,1,1,162,0.0,0.0,0.0,0.0,0.0,0.0,0.0,4,1,3,,,
112152,2,2,0,0,1,1,10,37,1.0,1.0,0.0,0.0,0.0,1.0,8.0,17,2,15,9.0,1.0,8.0
203045,2,2,0,0,1,1,5,7,1.0,1.0,0.0,0.0,0.0,1.0,2.0,16,2,14,4.0,0.0,4.0
9210243,2,1,1,1,2,0,0,112,,,,,,,,2,2,0,,,
9912267,6,4,2,2,4,2,3,40,4.0,2.0,2.0,2.0,4.0,0.0,0.0,11,6,5,4.0,4.0,0.0
9510316,7,4,3,3,7,0,0,159,3.0,2.0,1.0,1.0,3.0,0.0,0.0,7,7,0,3.0,3.0,0.0
211346,1,1,0,0,0,1,5,37,0.0,0.0,0.0,0.0,0.0,0.0,0.0,19,1,18,1.0,0.0,1.0
209156,1,1,0,0,0,1,6,83,1.0,1.0,0.0,0.0,1.0,0.0,0.0,8,1,7,1.0,1.0,0.0
9311371,0,0,0,0,0,0,0,207,0.0,0.0,0.0,0.0,0.0,0.0,0.0,1,0,1,1.0,0.0,1.0
9711505,0,0,0,0,0,0,0,181,0.0,0.0,0.0,0.0,0.0,0.0,0.0,6,0,6,1.0,0.0,1.0
12207,0,0,0,0,0,0,0,71,0.0,0.0,0.0,0.0,0.0,0.0,0.0,2,0,2,1.0,0.0,1.0
209339,1,1,0,0,1,0,0,423,1.0,1.0,0.0,0.0,1.0,0.0,0.0,4,1,3,1.0,1.0,0.0
211287,5,4,1,1,0,5,89,11,4.0,3.0,1.0,1.0,0.0,4.0,60.0,47,5,42,23.0,3.0,20.0
9910426,0,0,0,0,0,0,0,9,,,,,,,,11,0,11,,,
207276,2,1,1,1,0,2,34,16,2.0,1.0,1.0,1.0,0.0,2.0,25.0,56,2,54,12.0,2.0,10.0
9906260,5,5,0,0,0,5,38,15,5.0,5.0,0.0,0.0,0.0,5.0,30.0,20,5,15,6.0,3.0,3.0
203119,6,4,2,4,0,6,32,201,6.0,4.0,2.0,4.0,0.0,6.0,28.0,14,6,8,12.0,6.0,6.0
204140,2,1,1,1,0,2,31,6,0.0,0.0,0.0,0.0,0.0,0.0,0.0,41,2,39,12.0,0.0,12.0
9409256,1,1,0,0,1,0,0,1200,1.0,1.0,0.0,0.0,1.0,0.0,0.0,2,1,1,1.0,1.0,0.0
111458,0,0,0,0,0,0,0,97,0.0,0.0,0.0,0.0,0.0,0.0,0.0,4,0,4,,,
9906537,0,0,0,0,0,0,0,599,0.0,0.0,0.0,0.0,0.0,0.0,0.0,4,0,4,2.0,0.0,2.0
9301215,1,1,0,0,1,0,0,97,,,,,,,,1,1,0,1.0,1.0,0.0
9902278,0,0,0,0,0,0,0,110,0.0,0.0,0.0,0.0,0.0,0.0,0.0,4,0,4,4.0,0.0,4.0
9907538,2,2,0,0,1,1,1,263,1.0,1.0,0.0,0.0,1.0,0.0,0.0,6,2,4,1.0,1.0,0.0
9406322,1,1,0,0,0,1,2,114,1.0,1.0,0.0,0.0,0.0,1.0,2.0,4,1,3,3.0,1.0,2.0
207299,1,1,0,0,0,1,12,16,1.0,1.0,0.0,0.0,0.0,1.0,8.0,25,1,24,13.0,1.0,12.0
9604372,0,0,0,0,0,0,0,270,0.0,0.0,0.0,0.0,0.0,0.0,0.0,4,0,4,3.0,0.0,3.0
212232,1,1,0,0,0,1,5,28,0.0,0.0,0.0,0.0,0.0,0.0,0.0,19,1,18,11.0,0.0,11.0
112075,0,0,0,0,0,0,0,104,0.0,0.0,0.0,0.0,0.0,0.0,0.0,13,0,13,5.0,0.0,5.0
104107,1,1,0,0,0,1,2,36,1.0,1.0,0.0,0.0,0.0,1.0,2.0,11,1,10,5.0,1.0,4.0
9809473,1,1,0,0,1,0,0,110,1.0,1.0,0.0,0.0,1.0,0.0,0.0,2,1,1,1.0,1.0,0.0
204266,0,0,0,0,0,0,0,287,0.0,0.0,0.0,0.0,0.0,0.0,0.0,9,0,9,2.0,0.0,2.0
212257,1,1,0,0,0,1,6,11,0.0,0.0,0.0,0.0,0.0,0.0,0.0,26,1,25,14.0,0.0,14.0
9601270,2,1,1,1,2,0,0,388,2.0,1.0,1.0,1.0,2.0,0.0,0.0,2,2,0,2.0,2.0,0.0
9504346,0,0,0,0,0,0,0,1435,,,,,,,,1,0,1,,,
9509367,0,0,0,0,0,0,0,371,0.0,0.0,0.0,0.0,0.0,0.0,0.0,3,0,3,2.0,0.0,2.0
9408398,0,0,0,0,0,0,0,1135,,,,,,,,1,0,1,,,
108044,2,2,0,0,2,0,0,272,0.0,0.0,0.0,0.0,0.0,0.0,0.0,8,2,6,2.0,0.0,2.0
9703307,1,1,0,0,1,0,0,189,0.0,0.0,0.0,0.0,0.0,0.0,0.0,4,1,3,1.0,0.0,1.0
9901373,0,0,0,0,0,0,0,308,0.0,0.0,0.0,0.0,0.0,0.0,0.0,6,0,6,1.0,0.0,1.0
301022,0,0,0,0,0,0,0,275,0.0,0.0,0.0,0.0,0.0,0.0,0.0,5,0,5,1.0,0.0,1.0
11239,1,1,0,0,1,0,0,1586,,,,,,,,3,1,2,1.0,1.0,0.0
9909314,0,0,0,0,0,0,0,217,0.0,0.0,0.0,0.0,0.0,0.0,0.0,8,0,8,5.0,0.0,5.0
9505216,1,1,0,0,1,0,0,292,1.0,1.0,0.0,0.0,1.0,0.0,0.0,2,1,1,1.0,1.0,0.0
1111,0,0,0,0,0,0,0,1770,0.0,0.0,0.0,0.0,0.0,0.0,0.0,5,0,5,,,
212175,2,2,0,0,0,2,11,37,1.0,1.0,0.0,0.0,0.0,1.0,6.0,25,2,23,3.0,0.0,3.0
9510401,0,0,0,0,0,0,0,2120,,,,,,,,1,0,1,,,
210080,0,0,0,0,0,0,0,129,0.0,0.0,0.0,0.0,0.0,0.0,0.0,9,0,9,1.0,0.0,1.0
208052,0,0,0,0,0,0,0,198,0.0,0.0,0.0,0.0,0.0,0.0,0.0,2,0,2,2.0,0.0,2.0
208108,1,1,0,0,0,1,2,45,0.0,0.0,0.0,0.0,0.0,0.0,0.0,6,1,5,2.0,0.0,2.0
7122,2,1,1,1,2,0,0,45,,,,,,,,2,2,0,2.0,2.0,0.0
110095,3,3,0,0,0,3,24,26,1.0,1.0,0.0,0.0,0.0,1.0,2.0,26,3,23,6.0,2.0,4.0
208276,1,1,0,0,0,1,6,21,0.0,0.0,0.0,0.0,0.0,0.0,0.0,13,1,12,5.0,1.0,4.0
9806285,1,1,0,0,0,1,3,16,1.0,1.0,0.0,0.0,1.0,0.0,0.0,4,1,3,1.0,1.0,0.0
211198,1,1,0,0,1,0,0,27,0.0,0.0,0.0,0.0,0.0,0.0,0.0,20,1,19,13.0,0.0,13.0
12165,1,1,0,0,0,1,2,99,1.0,1.0,0.0,0.0,1.0,0.0,0.0,7,1,6,1.0,1.0,0.0
112070,2,2,0,0,0,2,8,4,1.0,1.0,0.0,0.0,1.0,0.0,0.0,18,2,16,4.0,1.0,3.0
301217,0,0,0,0,0,0,0,21,0.0,0.0,0.0,0.0,0.0,0.0,0.0,7,0,7,,,
301050,1,1,0,0,0,1,2,949,0.0,0.0,0.0,0.0,0.0,0.0,0.0,7,1,6,1.0,0.0,1.0
9809507,3,2,1,1,0,3,33,94,3.0,2.0,1.0,1.0,0.0,3.0,29.0,24,3,21,12.0,2.0,10.0
110359,1,1,0,0,0,1,2,31,1.0,1.0,0.0,0.0,1.0,0.0,0.0,3,1,2,,,
9411221,1,1,0,0,0,1,1,124,,,,,,,,3,1,2,1.0,1.0,0.0
111159,2,2,0,0,0,2,5,64,2.0,2.0,0.0,0.0,0.0,2.0,5.0,10,2,8,7.0,1.0,6.0
4152,4,3,1,1,1,3,3,34,0.0,0.0,0.0,0.0,0.0,0.0,0.0,14,4,10,1.0,0.0,1.0
108015,2,2,0,0,2,0,0,161,1.0,1.0,0.0,0.0,1.0,0.0,0.0,3,2,1,2.0,2.0,0.0
9712513,1,1,0,0,0,1,3,35,1.0,1.0,0.0,0.0,0.0,1.0,3.0,21,1,20,9.0,0.0,9.0
209284,0,0,0,0,0,0,0,64,0.0,0.0,0.0,0.0,0.0,0.0,0.0,8,0,8,2.0,0.0,2.0
9704210,1,1,0,0,0,1,1,506,1.0,1.0,0.0,0.0,0.0,1.0,1.0,2,1,1,2.0,1.0,1.0
9810379,1,1,0,0,1,0,0,687,0.0,0.0,0.0,0.0,0.0,0.0,0.0,2,1,1,1.0,0.0,1.0
9511211,1,1,0,0,0,1,2,106,,,,,,,,4,1,3,1.0,1.0,0.0
208277,0,0,0,0,0,0,0,5,0.0,0.0,0.0,0.0,0.0,0.0,0.0,24,0,24,11.0,0.0,11.0
9911288,2,2,0,0,0,2,6,26,0.0,0.0,0.0,0.0,0.0,0.0,0.0,11,2,9,1.0,1.0,0.0
9505345,3,2,1,1,2,1,1,226,2.0,1.0,1.0,1.0,2.0,0.0,0.0,5,3,2,1.0,1.0,0.0
9805291,5,2,3,4,2,3,11,91,2.0,1.0,1.0,1.0,0.0,2.0,9.0,14,5,9,7.0,2.0,5.0
205200,0,0,0,0,0,0,0,91,0.0,0.0,0.0,0.0,0.0,0.0,0.0,8,0,8,6.0,0.0,6.0
9811490,1,1,0,0,0,1,6,55,1.0,1.0,0.0,0.0,0.0,1.0,6.0,7,1,6,2.0,1.0,1.0
207078,1,1,0,0,0,1,1,146,1.0,1.0,0.0,0.0,0.0,1.0,1.0,2,1,1,1.0,1.0,0.0
9905490,1,1,0,0,0,1,1,27,,,,,,,,6,1,5,1.0,1.0,0.0
112043,2,2,0,0,0,2,2,63,1.0,1.0,0.0,0.0,0.0,1.0,1.0,20,2,18,6.0,0.0,6.0
9906436,0,0,0,0,0,0,0,1110,0.0,0.0,0.0,0.0,0.0,0.0,0.0,3,0,3,,,
9710437,0,0,0,0,0,0,0,96,0.0,0.0,0.0,0.0,0.0,0.0,0.0,2,0,2,,,
206267,1,1,0,0,0,1,10,27,0.0,0.0,0.0,0.0,0.0,0.0,0.0,18,1,17,11.0,1.0,10.0
9505205,2,2,0,0,2,0,0,266,1.0,1.0,0.0,0.0,1.0,0.0,0.0,3,2,1,1.0,1.0,0.0
212024,0,0,0,0,0,0,0,153,0.0,0.0,0.0,0.0,0.0,0.0,0.0,1,0,1,1.0,0.0,1.0
211112,1,1,0,0,0,1,2,44,0.0,0.0,0.0,0.0,0.0,0.0,0.0,20,1,19,6.0,0.0,6.0
204201,2,1,1,1,0,2,3,136,1.0,1.0,0.0,0.0,0.0,1.0,2.0,7,2,5,5.0,2.0,3.0
211259,0,0,0,0,0,0,0,8,0.0,0.0,0.0,0.0,0.0,0.0,0.0,46,0,46,18.0,0.0,18.0
206005,4,1,3,3,0,4,25,108,4.0,1.0,3.0,3.0,0.0,4.0,20.0,18,4,14,4.0,2.0,2.0
9710215,0,0,0,0,0,0,0,225,0.0,0.0,0.0,0.0,0.0,0.0,0.0,1,0,1,1.0,0.0,1.0
12269,0,0,0,0,0,0,0,48,0.0,0.0,0.0,0.0,0.0,0.0,0.0,26,0,26,4.0,0.0,4.0
9412318,2,1,1,1,1,1,1,184,2.0,1.0,1.0,1.0,2.0,0.0,0.0,5,2,3,2.0,2.0,0.0
9308247,0,0,0,0,0,0,0,218,0.0,0.0,0.0,0.0,0.0,0.0,0.0,1,0,1,1.0,0.0,1.0
211416,0,0,0,0,0,0,0,165,0.0,0.0,0.0,0.0,0.0,0.0,0.0,12,0,12,11.0,0.0,11.0
12190,0,0,0,0,0,0,0,128,0.0,0.0,0.0,0.0,0.0,0.0,0.0,9,0,9,7.0,0.0,7.0
9509253,0,0,0,0,0,0,0,1847,0.0,0.0,0.0,0.0,0.0,0.0,0.0,2,0,2,1.0,0.0,1.0
9902445,0,0,0,0,0,0,0,11,,,,,,,,8,0,8,,,
9910440,0,0,0,0,0,0,0,271,0.0,0.0,0.0,0.0,0.0,0.0,0.0,4,0,4,1.0,0.0,1.0
9907311,0,0,0,0,0,0,0,1,0.0,0.0,0.0,0.0,0.0,0.0,0.0,8,0,8,2.0,0.0,2.0
9706395,2,1,1,1,0,2,2,338,2.0,1.0,1.0,1.0,0.0,2.0,2.0,3,2,1,3.0,2.0,1.0
9804427,0,0,0,0,0,0,0,119,0.0,0.0,0.0,0.0,0.0,0.0,0.0,7,0,7,1.0,0.0,1.0
301059,1,1,0,0,0,1,5,2,0.0,0.0,0.0,0.0,0.0,0.0,0.0,20,1,19,4.0,1.0,3.0
302127,0,0,0,0,0,0,0,126,0.0,0.0,0.0,0.0,0.0,0.0,0.0,6,0,6,4.0,0.0,4.0
106340,2,1,1,1,2,0,0,469,2.0,1.0,1.0,1.0,2.0,0.0,0.0,3,2,1,2.0,2.0,0.0
9903210,0,0,0,0,0,0,0,801,0.0,0.0,0.0,0.0,0.0,0.0,0.0,2,0,2,2.0,0.0,2.0
206073,1,1,0,0,0,1,14,11,1.0,1.0,0.0,0.0,0.0,1.0,14.0,17,1,16,,,
301124,0,0,0,0,0,0,0,70,0.0,0.0,0.0,0.0,0.0,0.0,0.0,8,0,8,4.0,0.0,4.0
8174,0,0,0,0,0,0,0,98,0.0,0.0,0.0,0.0,0.0,0.0,0.0,8,0,8,2.0,0.0,2.0
9811429,0,0,0,0,0,0,0,144,0.0,0.0,0.0,0.0,0.0,0.0,0.0,4,0,4,1.0,0.0,1.0
9710496,0,0,0,0,0,0,0,105,,,,,,,,6,0,6,1.0,0.0,1.0
9501215,0,0,0,0,0,0,0,102,0.0,0.0,0.0,0.0,0.0,0.0,0.0,5,0,5,,,
208053,1,1,0,0,1,0,0,38,1.0,1.0,0.0,0.0,1.0,0.0,0.0,8,1,7,2.0,1.0,1.0
8229,0,0,0,0,0,0,0,174,0.0,0.0,0.0,0.0,0.0,0.0,0.0,5,0,5,3.0,0.0,3.0
9507302,0,0,0,0,0,0,0,29,0.0,0.0,0.0,0.0,0.0,0.0,0.0,13,0,13,4.0,0.0,4.0
9508318,0,0,0,0,0,0,0,371,0.0,0.0,0.0,0.0,0.0,0.0,0.0,2,0,2,1.0,0.0,1.0
9805400,1,1,0,0,1,0,0,248,0.0,0.0,0.0,0.0,0.0,0.0,0.0,3,1,2,2.0,0.0,2.0
204174,4,2,2,2,0,4,25,38,2.0,1.0,1.0,1.0,0.0,2.0,12.0,20,4,16,13.0,2.0,11.0
111153,0,0,0,0,0,0,0,197,0.0,0.0,0.0,0.0,0.0,0.0,0.0,14,0,14,5.0,0.0,5.0
110212,1,1,0,0,0,1,3,200,1.0,1.0,0.0,0.0,0.0,1.0,1.0,5,1,4,2.0,1.0,1.0
9706445,1,1,0,0,1,0,0,27,,,,,,,,4,1,3,1.0,0.0,1.0
211330,0,0,0,0,0,0,0,65,0.0,0.0,0.0,0.0,0.0,0.0,0.0,23,0,23,11.0,0.0,11.0
208186,0,0,0,0,0,0,0,337,0.0,0.0,0.0,0.0,0.0,0.0,0.0,4,0,4,3.0,0.0,3.0
9903232,0,0,0,0,0,0,0,167,0.0,0.0,0.0,0.0,0.0,0.0,0.0,7,0,7,1.0,0.0,1.0
9810225,1,1,0,0,0,1,4,352,1.0,1.0,0.0,0.0,0.0,1.0,2.0,8,1,7,5.0,1.0,4.0
206039,0,0,0,0,0,0,0,1759,0.0,0.0,0.0,0.0,0.0,0.0,0.0,5,0,5,1.0,0.0,1.0
205204,3,3,0,0,0,3,12,23,0.0,0.0,0.0,0.0,0.0,0.0,0.0,32,3,29,18.0,0.0,18.0
212404,1,1,0,0,0,1,17,21,1.0,1.0,0.0,0.0,0.0,1.0,11.0,33,1,32,11.0,1.0,10.0
9809471,0,0,0,0,0,0,0,8,0.0,0.0,0.0,0.0,0.0,0.0,0.0,8,0,8,,,
9712348,0,0,0,0,0,0,0,101,,,,,,,,4,0,4,,,
9606245,0,0,0,0,0,0,0,34,,,,,,,,6,0,6,,,
206312,1,1,0,0,0,1,1,1933,,,,,,,,7,1,6,,,
9907230,0,0,0,0,0,0,0,5,0.0,0.0,0.0,0.0,0.0,0.0,0.0,10,0,10,,,
205139,0,0,0,0,0,0,0,247,0.0,0.0,0.0,0.0,0.0,0.0,0.0,3,0,3,2.0,0.0,2.0
9705325,0,0,0,0,0,0,0,229,0.0,0.0,0.0,0.0,0.0,0.0,0.0,2,0,2,2.0,0.0,2.0
301256,1,1,0,0,0,1,27,1,1.0,1.0,0.0,0.0,0.0,1.0,15.0,50,1,49,8.0,0.0,8.0
203250,0,0,0,0,0,0,0,22,0.0,0.0,0.0,0.0,0.0,0.0,0.0,18,0,18,11.0,0.0,11.0
201185,0,0,0,0,0,0,0,73,0.0,0.0,0.0,0.0,0.0,0.0,0.0,14,0,14,1.0,0.0,1.0
9709304,0,0,0,0,0,0,0,16,0.0,0.0,0.0,0.0,0.0,0.0,0.0,15,0,15,3.0,0.0,3.0
110293,5,3,2,5,1,4,17,131,4.0,2.0,2.0,5.0,0.0,4.0,17.0,23,5,18,10.0,4.0,6.0
1052,1,1,0,0,0,1,2,3,1.0,1.0,0.0,0.0,1.0,0.0,0.0,12,1,11,2.0,1.0,1.0
9506367,1,1,0,0,0,1,1,286,0.0,0.0,0.0,0.0,0.0,0.0,0.0,3,1,2,,,
9710344,0,0,0,0,0,0,0,6,0.0,0.0,0.0,0.0,0.0,0.0,0.0,12,0,12,3.0,0.0,3.0
210187,0,0,0,0,0,0,0,36,0.0,0.0,0.0,0.0,0.0,0.0,0.0,10,0,10,3.0,0.0,3.0
9909213,0,0,0,0,0,0,0,24,0.0,0.0,0.0,0.0,0.0,0.0,0.0,7,0,7,,,
212164,0,0,0,0,0,0,0,6,,,,,,,,6,0,6,,,
9809309,4,2,2,2,2,2,4,328,2.0,1.0,1.0,1.0,0.0,2.0,4.0,13,4,9,5.0,2.0,3.0
2197,2,2,0,0,0,2,4,131,2.0,2.0,0.0,0.0,0.0,2.0,4.0,7,2,5,3.0,0.0,3.0
112257,1,1,0,0,0,1,2,1,0.0,0.0,0.0,0.0,0.0,0.0,0.0,28,1,27,8.0,0.0,8.0
206303,0,0,0,0,0,0,0,14,0.0,0.0,0.0,0.0,0.0,0.0,0.0,17,0,17,6.0,0.0,6.0
9712548,0,0,0,0,0,0,0,18,,,,,,,,6,0,6,,,
9912518,0,0,0,0,0,0,0,9,0.0,0.0,0.0,0.0,0.0,0.0,0.0,19,0,19,16.0,0.0,16.0
301140,0,0,0,0,0,0,0,460,0.0,0.0,0.0,0.0,0.0,0.0,0.0,5,0,5,1.0,0.0,1.0
9506372,0,0,0,0,0,0,0,110,0.0,0.0,0.0,0.0,0.0,0.0,0.0,4,0,4,1.0,0.0,1.0
4090,1,1,0,0,0,1,10,12,0.0,0.0,0.0,0.0,0.0,0.0,0.0,22,1,21,6.0,0.0,6.0
12270,0,0,0,0,0,0,0,464,0.0,0.0,0.0,0.0,0.0,0.0,0.0,3,0,3,3.0,0.0,3.0
203257,3,3,0,0,0,3,8,121,2.0,2.0,0.0,0.0,0.0,2.0,3.0,15,3,12,4.0,2.0,2.0
11301,1,1,0,0,0,1,1,132,1.0,1.0,0.0,0.0,0.0,1.0,1.0,8,1,7,3.0,1.0,2.0
11246,1,1,0,0,0,1,1,468,1.0,1.0,0.0,0.0,0.0,1.0,1.0,2,1,1,2.0,1.0,1.0
9709299,0,0,0,0,0,0,0,710,0.0,0.0,0.0,0.0,0.0,0.0,0.0,1,0,1,1.0,0.0,1.0
9607203,0,0,0,0,0,0,0,711,0.0,0.0,0.0,0.0,0.0,0.0,0.0,1,0,1,1.0,0.0,1.0
10047,1,1,0,0,0,1,2,59,1.0,1.0,0.0,0.0,0.0,1.0,2.0,10,1,9,2.0,1.0,1.0
10239,0,0,0,0,0,0,0,2104,,,,,,,,2,0,2,,,
206188,0,0,0,0,0,0,0,14,0.0,0.0,0.0,0.0,0.0,0.0,0.0,8,0,8,2.0,0.0,2.0
9802360,0,0,0,0,0,0,0,84,,,,,,,,3,0,3,1.0,0.0,1.0
9706553,0,0,0,0,0,0,0,827,,,,,,,,1,0,1,,,
209008,0,0,0,0,0,0,0,6,0.0,0.0,0.0,0.0,0.0,0.0,0.0,12,0,12,2.0,0.0,2.0
11329,0,0,0,0,0,0,0,32,0.0,0.0,0.0,0.0,0.0,0.0,0.0,20,0,20,6.0,0.0,6.0
102095,3,3,0,0,0,3,8,51,2.0,2.0,0.0,0.0,0.0,2.0,2.0,10,3,7,3.0,2.0,1.0
202225,0,0,0,0,0,0,0,54,0.0,0.0,0.0,0.0,0.0,0.0,0.0,4,0,4,,,
9707538,0,0,0,0,0,0,0,22,0.0,0.0,0.0,0.0,0.0,0.0,0.0,9,0,9,5.0,0.0,5.0
11007,0,0,0,0,0,0,0,11,0.0,0.0,0.0,0.0,0.0,0.0,0.0,21,0,21,2.0,0.0,2.0
210128,1,1,0,0,1,0,0,800,1.0,1.0,0.0,0.0,1.0,0.0,0.0,7,1,6,1.0,1.0,0.0
2124,0,0,0,0,0,0,0,717,0.0,0.0,0.0,0.0,0.0,0.0,0.0,1,0,1,1.0,0.0,1.0
107134,0,0,0,0,0,0,0,1080,,,,,,,,3,0,3,2.0,0.0,2.0
9811416,0,0,0,0,0,0,0,17,0.0,0.0,0.0,0.0,0.0,0.0,0.0,20,0,20,2.0,0.0,2.0
212154,0,0,0,0,0,0,0,47,0.0,0.0,0.0,0.0,0.0,0.0,0.0,28,0,28,5.0,0.0,5.0
9709216,0,0,0,0,0,0,0,98,,,,,,,,1,0,1,,,
107143,2,2,0,0,0,2,12,21,2.0,2.0,0.0,0.0,0.0,2.0,12.0,17,2,15,16.0,1.0,15.0
9803353,0,0,0,0,0,0,0,114,0.0,0.0,0.0,0.0,0.0,0.0,0.0,17,0,17,11.0,0.0,11.0
9507333,0,0,0,0,0,0,0,69,0.0,0.0,0.0,0.0,0.0,0.0,0.0,5,0,5,4.0,0.0,4.0
2201,0,0,0,0,0,0,0,117,0.0,0.0,0.0,0.0,0.0,0.0,0.0,14,0,14,4.0,0.0,4.0
11367,0,0,0,0,0,0,0,95,0.0,0.0,0.0,0.0,0.0,0.0,0.0,7,0,7,1.0,0.0,1.0
302261,0,0,0,0,0,0,0,1500,0.0,0.0,0.0,0.0,0.0,0.0,0.0,2,0,2,,,
9605282,0,0,0,0,0,0,0,74,,,,,,,,3,0,3,,,
302258,0,0,0,0,0,0,0,23,0.0,0.0,0.0,0.0,0.0,0.0,0.0,28,0,28,16.0,0.0,16.0
9706549,0,0,0,0,0,0,0,82,0.0,0.0,0.0,0.0,0.0,0.0,0.0,4,0,4,1.0,0.0,1.0
210093,0,0,0,0,0,0,0,81,0.0,0.0,0.0,0.0,0.0,0.0,0.0,22,0,22,14.0,0.0,14.0
9805409,1,1,0,0,1,0,0,77,0.0,0.0,0.0,0.0,0.0,0.0,0.0,5,1,4,1.0,0.0,1.0
206053,0,0,0,0,0,0,0,21,0.0,0.0,0.0,0.0,0.0,0.0,0.0,28,0,28,1.0,0.0,1.0
9412317,0,0,0,0,0,0,0,35,0.0,0.0,0.0,0.0,0.0,0.0,0.0,9,0,9,,,
3002,0,0,0,0,0,0,0,1550,0.0,0.0,0.0,0.0,0.0,0.0,0.0,1,0,1,,,
9306276,0,0,0,0,0,0,0,1029,,,,,,,,1,0,1,,,
11128,0,0,0,0,0,0,0,56,0.0,0.0,0.0,0.0,0.0,0.0,0.0,2,0,2,1.0,0.0,1.0
9904251,1,1,0,0,0,1,7,151,1.0,1.0,0.0,0.0,0.0,1.0,3.0,16,1,15,3.0,1.0,2.0
9909342,0,0,0,0,0,0,0,29,0.0,0.0,0.0,0.0,0.0,0.0,0.0,6,0,6,1.0,0.0,1.0
9905382,0,0,0,0,0,0,0,723,0.0,0.0,0.0,0.0,0.0,0.0,0.0,1,0,1,1.0,0.0,1.0
9809373,1,1,0,0,0,1,3,57,0.0,0.0,0.0,0.0,0.0,0.0,0.0,24,1,23,10.0,0.0,10.0
9904508,0,0,0,0,0,0,0,70,0.0,0.0,0.0,0.0,0.0,0.0,0.0,5,0,5,,,
109176,1,1,0,0,0,1,3,21,0.0,0.0,0.0,0.0,0.0,0.0,0.0,35,1,34,26.0,0.0,26.0
301203,0,0,0,0,0,0,0,162,0.0,0.0,0.0,0.0,0.0,0.0,0.0,22,0,22,8.0,0.0,8.0
12295,0,0,0,0,0,0,0,117,0.0,0.0,0.0,0.0,0.0,0.0,0.0,23,0,23,14.0,0.0,14.0
1085,0,0,0,0,0,0,0,188,,,,,,,,3,0,3,,,
210279,0,0,0,0,0,0,0,405,0.0,0.0,0.0,0.0,0.0,0.0,0.0,3,0,3,3.0,0.0,3.0
212163,0,0,0,0,0,0,0,36,0.0,0.0,0.0,0.0,0.0,0.0,0.0,16,0,16,5.0,0.0,5.0
9806410,0,0,0,0,0,0,0,259,0.0,0.0,0.0,0.0,0.0,0.0,0.0,1,0,1,1.0,0.0,1.0
11326,0,0,0,0,0,0,0,240,0.0,0.0,0.0,0.0,0.0,0.0,0.0,12,0,12,3.0,0.0,3.0
9410399,1,1,0,0,1,0,0,52,,,,,,,,1,1,0,,,
211028,0,0,0,0,0,0,0,9,0.0,0.0,0.0,0.0,0.0,0.0,0.0,14,0,14,7.0,0.0,7.0
12114,1,1,0,0,0,1,16,78,1.0,1.0,0.0,0.0,0.0,1.0,11.0,17,1,16,8.0,1.0,7.0
9802243,0,0,0,0,0,0,0,25,0.0,0.0,0.0,0.0,0.0,0.0,0.0,5,0,5,1.0,0.0,1.0
301178,0,0,0,0,0,0,0,252,0.0,0.0,0.0,0.0,0.0,0.0,0.0,6,0,6,4.0,0.0,4.0
12335,1,1,0,0,0,1,1,7,,,,,,,,8,1,7,1.0,1.0,0.0
107169,0,0,0,0,0,0,0,23,0.0,0.0,0.0,0.0,0.0,0.0,0.0,38,0,38,20.0,0.0,20.0
212167,1,1,0,0,0,1,4,109,1.0,1.0,0.0,0.0,0.0,1.0,4.0,23,1,22,20.0,0.0,20.0
9411356,0,0,0,0,0,0,0,126,0.0,0.0,0.0,0.0,0.0,0.0,0.0,1,0,1,,,
9605352,0,0,0,0,0,0,0,306,0.0,0.0,0.0,0.0,0.0,0.0,0.0,2,0,2,,,
209211,0,0,0,0,0,0,0,7,0.0,0.0,0.0,0.0,0.0,0.0,0.0,21,0,21,5.0,0.0,5.0
9906553,0,0,0,0,0,0,0,1817,0.0,0.0,0.0,0.0,0.0,0.0,0.0,5,0,5,,,
9506408,0,0,0,0,0,0,0,1423,,,,,,,,3,0,3,,,
9810444,0,0,0,0,0,0,0,54,0.0,0.0,0.0,0.0,0.0,0.0,0.0,4,0,4,,,
9801220,0,0,0,0,0,0,0,19,0.0,0.0,0.0,0.0,0.0,0.0,0.0,4,0,4,1.0,0.0,1.0
104159,1,1,0,0,0,1,9,29,1.0,1.0,0.0,0.0,0.0,1.0,8.0,11,1,10,9.0,1.0,8.0
9502228,0,0,0,0,0,0,0,10,0.0,0.0,0.0,0.0,0.0,0.0,0.0,8,0,8,1.0,0.0,1.0
212349,0,0,0,0,0,0,0,216,0.0,0.0,0.0,0.0,0.0,0.0,0.0,3,0,3,3.0,0.0,3.0
9712206,0,0,0,0,0,0,0,10,0.0,0.0,0.0,0.0,0.0,0.0,0.0,13,0,13,4.0,0.0,4.0
9805276,0,0,0,0,0,0,0,103,0.0,0.0,0.0,0.0,0.0,0.0,0.0,15,0,15,2.0,0.0,2.0
9507383,0,0,0,0,0,0,0,132,0.0,0.0,0.0,0.0,0.0,0.0,0.0,1,0,1,1.0,0.0,1.0
9504249,0,0,0,0,0,0,0,208,0.0,0.0,0.0,0.0,0.0,0.0,0.0,6,0,6,2.0,0.0,2.0
1099,0,0,0,0,0,0,0,1,0.0,0.0,0.0,0.0,0.0,0.0,0.0,23,0,23,2.0,0.0,2.0
112187,0,0,0,0,0,0,0,56,0.0,0.0,0.0,0.0,0.0,0.0,0.0,29,0,29,4.0,0.0,4.0
9609421,1,1,0,0,0,1,4,234,1.0,1.0,0.0,0.0,0.0,1.0,4.0,8,1,7,7.0,1.0,6.0
9408347,0,0,0,0,0,0,0,274,0.0,0.0,0.0,0.0,0.0,0.0,0.0,1,0,1,,,
208211,0,0,0,0,0,0,0,2,0.0,0.0,0.0,0.0,0.0,0.0,0.0,32,0,32,22.0,0.0,22.0
110151,0,0,0,0,0,0,0,275,0.0,0.0,0.0,0.0,0.0,0.0,0.0,13,0,13,5.0,0.0,5.0
9311206,0,0,0,0,0,0,0,1197,,,,,,,,3,0,3,,,
9409328,0,0,0,0,0,0,0,40,0.0,0.0,0.0,0.0,0.0,0.0,0.0,8,0,8,1.0,0.0,1.0
9703416,2,1,1,1,0,2,2,133,2.0,1.0,1.0,1.0,0.0,2.0,2.0,3,2,1,2.0,2.0,0.0
9809536,0,0,0,0,0,0,0,33,,,,,,,,9,0,9,1.0,0.0,1.0
9803417,0,0,0,0,0,0,0,203,0.0,0.0,0.0,0.0,0.0,0.0,0.0,3,0,3,,,
9603280,0,0,0,0,0,0,0,104,0.0,0.0,0.0,0.0,0.0,0.0,0.0,4,0,4,1.0,0.0,1.0
9406358,0,0,0,0,0,0,0,159,0.0,0.0,0.0,0.0,0.0,0.0,0.0,1,0,1,1.0,0.0,1.0
212216,0,0,0,0,0,0,0,80,0.0,0.0,0.0,0.0,0.0,0.0,0.0,15,0,15,5.0,0.0,5.0
9912316,0,0,0,0,0,0,0,374,0.0,0.0,0.0,0.0,0.0,0.0,0.0,2,0,2,2.0,0.0,2.0
9708479,1,1,0,0,0,1,4,17,1.0,1.0,0.0,0.0,0.0,1.0,4.0,15,1,14,4.0,1.0,3.0
210066,0,0,0,0,0,0,0,0,0.0,0.0,0.0,0.0,0.0,0.0,0.0,16,0,16,6.0,0.0,6.0
9207270,0,0,0,0,0,0,0,1128,,,,,,,,1,0,1,,,
9906351,0,0,0,0,0,0,0,26,0.0,0.0,0.0,0.0,0.0,0.0,0.0,6,0,6,3.0,0.0,3.0
9908345,0,0,0,0,0,0,0,1553,,,,,,,,2,0,2,,,
9709462,0,0,0,0,0,0,0,274,0.0,0.0,0.0,0.0,0.0,0.0,0.0,1,0,1,1.0,0.0,1.0
207109,0,0,0,0,0,0,0,1496,0.0,0.0,0.0,0.0,0.0,0.0,0.0,1,0,1,,,
208124,1,1,0,0,0,1,17,27,0.0,0.0,0.0,0.0,0.0,0.0,0.0,27,1,26,12.0,1.0,11.0
301225,0,0,0,0,0,0,0,228,0.0,0.0,0.0,0.0,0.0,0.0,0.0,13,0,13,5.0,0.0,5.0
12380,0,0,0,0,0,0,0,9,,,,,,,,7,0,7,1.0,0.0,1.0
301175,0,0,0,0,0,0,0,252,0.0,0.0,0.0,0.0,0.0,0.0,0.0,9,0,9,4.0,0.0,4.0
5002,0,0,0,0,0,0,0,149,0.0,0.0,0.0,0.0,0.0,0.0,0.0,3,0,3,2.0,0.0,2.0
9084,0,0,0,0,0,0,0,151,0.0,0.0,0.0,0.0,0.0,0.0,0.0,18,0,18,10.0,0.0,10.0
9907534,0,0,0,0,0,0,0,638,0.0,0.0,0.0,0.0,0.0,0.0,0.0,4,0,4,2.0,0.0,2.0
9909450,0,0,0,0,0,0,0,29,0.0,0.0,0.0,0.0,0.0,0.0,0.0,11,0,11,10.0,0.0,10.0
206139,0,0,0,0,0,0,0,739,0.0,0.0,0.0,0.0,0.0,0.0,0.0,1,0,1,1.0,0.0,1.0
9411227,0,0,0,0,0,0,0,1263,0.0,0.0,0.0,0.0,0.0,0.0,0.0,2,0,2,1.0,0.0,1.0
205079,0,0,0,0,0,0,0,197,,,,,,,,1,0,1,,,
9411216,0,0,0,0,0,0,0,110,0.0,0.0,0.0,0.0,0.0,0.0,0.0,4,0,4,,,
211084,0,0,0,0,0,0,0,800,0.0,0.0,0.0,0.0,0.0,0.0,0.0,2,0,2,1.0,0.0,1.0
207249,0,0,0,0,0,0,0,1,0.0,0.0,0.0,0.0,0.0,0.0,0.0,12,0,12,3.0,0.0,3.0
212084,0,0,0,0,0,0,0,38,0.0,0.0,0.0,0.0,0.0,0.0,0.0,6,0,6,2.0,0.0,2.0
9907292,0,0,0,0,0,0,0,172,0.0,0.0,0.0,0.0,0.0,0.0,0.0,4,0,4,3.0,0.0,3.0
106010,0,0,0,0,0,0,0,122,0.0,0.0,0.0,0.0,0.0,0.0,0.0,2,0,2,2.0,0.0,2.0
12112,0,0,0,0,0,0,0,118,0.0,0.0,0.0,0.0,0.0,0.0,0.0,4,0,4,4.0,0.0,4.0
9902444,0,0,0,0,0,0,0,137,0.0,0.0,0.0,0.0,0.0,0.0,0.0,8,0,8,,,
209182,0,0,0,0,0,0,0,13,0.0,0.0,0.0,0.0,0.0,0.0,0.0,8,0,8,,,
112091,0,0,0,0,0,0,0,67,,,,,,,,2,0,2,,,
9909548,0,0,0,0,0,0,0,136,0.0,0.0,0.0,0.0,0.0,0.0,0.0,6,0,6,1.0,0.0,1.0
111444,0,0,0,0,0,0,0,11,0.0,0.0,0.0,0.0,0.0,0.0,0.0,6,0,6,1.0,0.0,1.0
9505235,23,6,17,54,23,0,0,100,20.0,4.0,16.0,48.0,20.0,0.0,0.0,23,23,0,14.0,14.0,0.0
9602366,133,51,82,252,64,69,217,67,35.0,5.0,30.0,119.0,3.0,32.0,78.0,155,133,22,25.0,21.0,4.0
1113,46,16,30,57,13,33,105,7,4.0,3.0,1.0,1.0,0.0,4.0,21.0,71,46,25,11.0,1.0,10.0
12271,29,8,21,44,0,29,154,1,9.0,4.0,5.0,6.0,0.0,9.0,45.0,52,29,23,18.0,7.0,11.0
9810438,4,3,1,2,2,2,3,29,0.0,0.0,0.0,0.0,0.0,0.0,0.0,12,4,8,2.0,1.0,1.0
9308288,189,22,167,1357,60,129,424,6,67.0,3.0,64.0,633.0,67.0,0.0,0.0,195,189,6,39.0,39.0,0.0
9409309,54,19,35,97,26,28,65,29,6.0,2.0,4.0,6.0,1.0,5.0,13.0,63,54,9,8.0,8.0,0.0
7339,7,6,1,1,2,5,38,6,3.0,3.0,0.0,0.0,0.0,3.0,27.0,40,7,33,21.0,0.0,21.0
9907270,15,8,7,9,1,14,47,6,6.0,3.0,3.0,3.0,6.0,0.0,0.0,35,15,20,5.0,3.0,2.0
9906434,84,6,78,580,1,83,686,34,60.0,4.0,56.0,455.0,0.0,60.0,502.0,124,84,40,61.0,44.0,17.0
111167,3,2,1,1,0,3,22,6,1.0,1.0,0.0,0.0,0.0,1.0,1.0,23,3,20,3.0,1.0,2.0
9307263,10,4,6,14,10,0,0,34,4.0,2.0,2.0,3.0,4.0,0.0,0.0,10,10,0,4.0,4.0,0.0
9506326,21,2,19,51,17,4,4,4,12.0,1.0,11.0,31.0,12.0,0.0,0.0,24,21,3,7.0,7.0,0.0
9604309,19,4,15,46,1,18,66,35,15.0,3.0,12.0,38.0,0.0,15.0,57.0,30,19,11,15.0,11.0,4.0
9305232,55,8,47,161,14,41,41,26,31.0,3.0,28.0,97.0,1.0,30.0,30.0,56,55,1,23.0,22.0,1.0
107180,10,1,9,15,5,5,21,4,4.0,1.0,3.0,6.0,2.0,2.0,10.0,22,10,12,4.0,4.0,0.0
104199,8,4,4,5,0,8,47,2,1.0,1.0,0.0,0.0,0.0,1.0,11.0,26,8,18,14.0,1.0,13.0
9807209,21,7,14,30,3,18,67,33,10.0,5.0,5.0,12.0,5.0,5.0,8.0,36,21,15,9.0,2.0,7.0
9504434,37,12,25,69,17,20,36,133,9.0,3.0,6.0,14.0,4.0,5.0,5.0,46,37,9,11.0,10.0,1.0
9611455,27,3,24,131,2,25,87,33,22.0,1.0,21.0,111.0,0.0,22.0,74.0,36,27,9,26.0,21.0,5.0
9709284,6,2,4,6,0,6,39,33,3.0,1.0,2.0,2.0,0.0,3.0,12.0,22,6,16,6.0,2.0,4.0
9808278,21,7,14,36,2,19,58,4,5.0,5.0,0.0,0.0,0.0,5.0,19.0,33,21,12,10.0,4.0,6.0
9908388,27,9,18,69,2,25,93,80,15.0,6.0,9.0,44.0,0.0,15.0,46.0,40,27,13,17.0,12.0,5.0
9707454,7,2,5,8,2,5,12,210,6.0,2.0,4.0,7.0,2.0,4.0,7.0,20,7,13,6.0,4.0,2.0
107268,19,4,15,43,0,19,130,37,10.0,2.0,8.0,26.0,0.0,10.0,84.0,39,19,20,20.0,9.0,11.0
9410242,13,7,6,12,0,13,46,26,7.0,3.0,4.0,7.0,0.0,7.0,17.0,21,13,8,10.0,7.0,3.0
9802368,16,4,12,24,3,13,60,26,13.0,3.0,10.0,21.0,0.0,13.0,57.0,23,16,7,9.0,5.0,4.0
9906327,35,6,29,121,0,35,346,2,24.0,3.0,21.0,91.0,0.0,24.0,254.0,72,35,37,31.0,17.0,14.0
9306306,25,5,20,66,25,0,0,35,10.0,2.0,8.0,20.0,10.0,0.0,0.0,25,25,0,7.0,7.0,0.0
9308342,16,8,8,9,12,4,4,86,8.0,4.0,4.0,4.0,8.0,0.0,0.0,17,16,1,6.0,6.0,0.0
9502206,58,6,52,230,4,54,143,69,33.0,2.0,31.0,149.0,1.0,32.0,103.0,65,58,7,21.0,16.0,5.0
9903507,18,3,15,40,2,16,62,86,9.0,3.0,6.0,15.0,0.0,9.0,46.0,28,18,10,13.0,6.0,7.0
9507463,30,4,26,62,30,0,0,141,18.0,2.0,16.0,38.0,18.0,0.0,0.0,31,30,1,9.0,9.0,0.0
110035,16,2,14,35,1,15,123,2,9.0,1.0,8.0,16.0,0.0,9.0,79.0,34,16,18,21.0,9.0,12.0
9602415,83,25,58,137,20,63,165,4,21.0,5.0,16.0,40.0,3.0,18.0,20.0,108,83,25,11.0,10.0,1.0
9308214,41,6,35,137,41,0,0,90,34.0,4.0,30.0,123.0,34.0,0.0,0.0,42,41,1,20.0,20.0,0.0
9303320,227,46,181,845,163,64,80,3,29.0,1.0,28.0,123.0,29.0,0.0,0.0,229,227,2,17.0,17.0,0.0
9403285,7,3,4,8,2,5,5,149,7.0,3.0,4.0,8.0,2.0,5.0,5.0,8,7,1,4.0,4.0,0.0
9611445,16,2,14,27,0,16,62,25,12.0,1.0,11.0,19.0,0.0,12.0,39.0,23,16,7,14.0,9.0,5.0
9602417,55,20,35,94,53,2,2,19,5.0,1.0,4.0,9.0,5.0,0.0,0.0,56,55,1,5.0,5.0,0.0
9305273,15,12,3,4,2,13,13,25,8.0,7.0,1.0,1.0,0.0,8.0,8.0,16,15,1,3.0,3.0,0.0
9403312,32,7,25,78,23,9,9,81,19.0,3.0,16.0,59.0,10.0,9.0,9.0,33,32,1,9.0,9.0,0.0
9406249,39,14,25,52,26,13,40,10,10.0,2.0,8.0,17.0,10.0,0.0,0.0,47,39,8,8.0,8.0,0.0
9408302,3,3,0,0,1,2,2,42,,,,,,,,4,3,1,,,
9306290,60,7,53,275,28,32,32,87,37.0,3.0,34.0,217.0,15.0,22.0,22.0,61,60,1,32.0,31.0,1.0
9503439,104,15,89,432,104,0,0,0,30.0,8.0,22.0,76.0,30.0,0.0,0.0,104,104,0,18.0,18.0,0.0
9806328,121,17,104,564,11,110,877,0,52.0,9.0,43.0,283.0,2.0,50.0,457.0,173,121,52,49.0,36.0,13.0
9902215,22,3,19,50,10,12,12,0,11.0,1.0,10.0,25.0,11.0,0.0,0.0,23,22,1,1.0,1.0,0.0
9809415,91,10,81,555,5,86,365,3,67.0,2.0,65.0,457.0,2.0,65.0,291.0,102,91,11,43.0,35.0,8.0
9710417,42,9,33,142,18,24,33,3,20.0,3.0,17.0,74.0,9.0,11.0,11.0,48,42,6,5.0,5.0,0.0
2044,16,9,7,9,5,11,66,3,4.0,2.0,2.0,2.0,0.0,4.0,25.0,53,16,37,15.0,1.0,14.0
9811363,57,7,50,218,3,54,415,12,25.0,3.0,22.0,112.0,0.0,25.0,172.0,98,57,41,23.0,18.0,5.0
9909206,8,3,5,5,1,7,38,3,2.0,2.0,0.0,0.0,0.0,2.0,17.0,24,8,16,10.0,2.0,8.0
9807226,3,2,1,1,3,0,0,19,0.0,0.0,0.0,0.0,0.0,0.0,0.0,11,3,8,5.0,0.0,5.0
9407331,1,1,0,0,0,1,1,250,0.0,0.0,0.0,0.0,0.0,0.0,0.0,3,1,2,1.0,0.0,1.0
9806218,30,7,23,56,2,28,56,0,2.0,1.0,1.0,1.0,2.0,0.0,0.0,33,30,3,6.0,4.0,2.0
9707282,32,3,29,83,0,32,117,0,14.0,1.0,13.0,46.0,2.0,12.0,33.0,75,32,43,14.0,11.0,3.0
9711416,5,1,4,6,4,1,1,0,2.0,1.0,1.0,1.0,2.0,0.0,0.0,8,5,3,2.0,2.0,0.0
9807515,10,3,7,16,1,9,30,30,8.0,2.0,6.0,13.0,1.0,7.0,16.0,18,10,8,12.0,8.0,4.0
9610293,42,10,32,108,4,38,100,10,7.0,4.0,3.0,6.0,1.0,6.0,11.0,52,42,10,16.0,13.0,3.0
9712278,11,4,7,13,0,11,31,0,2.0,2.0,0.0,0.0,0.0,2.0,5.0,16,11,5,2.0,1.0,1.0
9810435,43,9,34,112,5,38,99,3,20.0,2.0,18.0,52.0,1.0,19.0,45.0,63,43,20,9.0,8.0,1.0
9301261,18,4,14,30,18,0,0,81,11.0,1.0,10.0,20.0,11.0,0.0,0.0,18,18,0,8.0,8.0,0.0
9801409,9,2,7,14,0,9,26,81,8.0,2.0,6.0,13.0,0.0,8.0,20.0,18,9,9,6.0,3.0,3.0
9411365,211,22,189,1614,9,202,728,17,144.0,9.0,135.0,1359.0,0.0,144.0,571.0,224,211,13,71.0,64.0,7.0
9607250,26,6,20,52,12,14,29,181,18.0,3.0,15.0,38.0,13.0,5.0,5.0,33,26,7,11.0,10.0,1.0
9712468,25,5,20,49,0,25,135,46,19.0,4.0,15.0,35.0,0.0,19.0,111.0,35,25,10,15.0,10.0,5.0
9507246,60,10,50,279,2,58,233,71,33.0,3.0,30.0,185.0,1.0,32.0,190.0,74,60,14,37.0,27.0,10.0
9510352,3,3,0,0,3,0,0,346,1.0,1.0,0.0,0.0,1.0,0.0,0.0,3,3,0,1.0,1.0,0.0
9801265,3,3,0,0,0,3,13,94,1.0,1.0,0.0,0.0,0.0,1.0,10.0,30,3,27,10.0,1.0,9.0
9504343,8,2,6,8,8,0,0,82,2.0,1.0,1.0,1.0,2.0,0.0,0.0,8,8,0,2.0,2.0,0.0
9903302,12,3,9,23,0,12,78,0,7.0,2.0,5.0,9.0,0.0,7.0,23.0,31,12,19,16.0,9.0,7.0
9501277,130,16,114,361,53,77,116,10,29.0,5.0,24.0,68.0,10.0,19.0,31.0,134,130,4,13.0,13.0,0.0
9506354,87,10,77,317,87,0,0,12,28.0,3.0,25.0,80.0,28.0,0.0,0.0,87,87,0,17.0,17.0,0.0
9502237,86,6,80,755,18,68,91,12,69.0,2.0,67.0,690.0,13.0,56.0,62.0,91,86,5,48.0,47.0,1.0
9705416,45,11,34,178,0,45,471,36,31.0,7.0,24.0,130.0,0.0,31.0,386.0,80,45,35,44.0,28.0,16.0
9707214,20,6,14,28,3,17,28,36,15.0,4.0,11.0,23.0,0.0,15.0,23.0,28,20,8,2.0,2.0,0.0
12099,16,6,10,23,0,16,58,58,6.0,3.0,3.0,4.0,0.0,6.0,26.0,23,16,7,11.0,6.0,5.0
9910211,24,3,21,50,5,19,52,1,8.0,1.0,7.0,10.0,4.0,4.0,10.0,40,24,16,8.0,5.0,3.0
12096,20,6,14,31,1,19,157,32,6.0,5.0,1.0,1.0,0.0,6.0,64.0,47,20,27,15.0,5.0,10.0
9604233,50,5,45,208,3,47,320,1,41.0,5.0,36.0,159.0,1.0,40.0,288.0,67,50,17,30.0,17.0,13.0
9306259,94,26,68,288,94,0,0,9,16.0,3.0,13.0,58.0,16.0,0.0,0.0,94,94,0,14.0,14.0,0.0
9606484,15,10,5,6,6,9,9,23,8.0,3.0,5.0,6.0,1.0,7.0,7.0,19,15,4,4.0,4.0,0.0
9707347,51,7,44,146,22,29,62,89,13.0,2.0,11.0,35.0,0.0,13.0,18.0,57,51,6,10.0,10.0,0.0
111406,1,1,0,0,1,0,0,1795,,,,,,,,1,1,0,,,
9601367,165,5,160,1510,47,118,271,5,89.0,1.0,88.0,1019.0,12.0,77.0,162.0,174,165,9,59.0,57.0,2.0
9612490,19,6,13,25,3,16,58,5,13.0,4.0,9.0,20.0,0.0,13.0,49.0,39,19,20,6.0,0.0,6.0
9707386,24,3,21,64,0,24,174,5,18.0,3.0,15.0,50.0,0.0,18.0,147.0,37,24,13,18.0,12.0,6.0
9901265,18,7,11,36,0,18,120,1,5.0,2.0,3.0,4.0,0.0,5.0,17.0,53,18,35,9.0,5.0,4.0
9411286,52,20,32,93,39,13,14,74,10.0,2.0,8.0,20.0,5.0,5.0,5.0,54,52,2,10.0,10.0,0.0
9707419,13,8,5,5,2,11,16,120,3.0,1.0,2.0,2.0,3.0,0.0,0.0,24,13,11,3.0,3.0,0.0
9807496,16,4,12,20,0,16,47,1,7.0,2.0,5.0,7.0,7.0,0.0,0.0,25,16,9,10.0,7.0,3.0
106081,55,19,36,84,0,55,407,7,16.0,5.0,11.0,15.0,0.0,16.0,57.0,85,55,30,22.0,14.0,8.0
9809423,64,2,62,320,4,60,399,24,36.0,3.0,33.0,175.0,2.0,34.0,112.0,90,64,26,26.0,22.0,4.0
10073,3,3,0,0,1,2,9,34,2.0,2.0,0.0,0.0,0.0,2.0,8.0,11,3,8,1.0,1.0,0.0
9809282,24,5,19,33,3,21,40,1,6.0,5.0,1.0,1.0,3.0,3.0,3.0,33,24,9,5.0,3.0,2.0
9707368,13,6,7,11,2,11,25,1,1.0,1.0,0.0,0.0,0.0,1.0,1.0,19,13,6,5.0,2.0,3.0
9702318,64,6,58,276,1,63,275,7,34.0,2.0,32.0,171.0,0.0,34.0,135.0,82,64,18,30.0,25.0,5.0
102295,4,2,2,3,0,4,28,1,2.0,1.0,1.0,1.0,0.0,2.0,11.0,32,4,28,13.0,2.0,11.0
9602292,19,5,14,27,1,18,21,23,8.0,5.0,3.0,5.0,0.0,8.0,8.0,23,19,4,8.0,7.0,1.0
9905462,5,3,2,3,5,0,0,86,1.0,1.0,0.0,0.0,1.0,0.0,0.0,5,5,0,1.0,1.0,0.0
6246,1,1,0,0,0,1,7,21,1.0,1.0,0.0,0.0,0.0,1.0,5.0,9,1,8,,,
9707516,16,4,12,24,0,16,41,21,11.0,4.0,7.0,16.0,0.0,11.0,30.0,21,16,5,1.0,1.0,0.0
9609449,67,12,55,293,5,62,529,7,35.0,4.0,31.0,175.0,2.0,33.0,148.0,107,67,40,15.0,13.0,2.0
9412225,30,6,24,55,9,21,117,75,5.0,2.0,3.0,4.0,0.0,5.0,41.0,42,30,12,18.0,8.0,10.0
9602305,21,6,15,21,13,8,23,36,1.0,1.0,0.0,0.0,0.0,1.0,4.0,36,21,15,14.0,0.0,14.0
9609497,7,5,2,2,0,7,29,12,1.0,1.0,0.0,0.0,0.0,1.0,2.0,46,7,39,4.0,0.0,4.0
9212288,38,10,28,165,8,30,49,15,24.0,4.0,20.0,138.0,5.0,19.0,35.0,40,38,2,20.0,18.0,2.0
9512421,20,5,15,43,0,20,74,69,9.0,6.0,3.0,6.0,0.0,9.0,20.0,34,20,14,12.0,9.0,3.0
9407405,17,7,10,27,17,0,0,76,12.0,4.0,8.0,22.0,12.0,0.0,0.0,17,17,0,4.0,4.0,0.0
9411415,21,8,13,58,21,0,0,76,15.0,4.0,11.0,51.0,15.0,0.0,0.0,21,21,0,13.0,13.0,0.0
9605460,15,2,13,28,8,7,20,12,7.0,2.0,5.0,10.0,1.0,6.0,17.0,26,15,11,7.0,7.0,0.0
9507442,12,5,7,20,1,11,23,19,9.0,2.0,7.0,17.0,1.0,8.0,18.0,15,12,3,3.0,3.0,0.0
9405248,3,1,2,3,0,3,17,19,0.0,0.0,0.0,0.0,0.0,0.0,0.0,16,3,13,7.0,0.0,7.0
9302250,31,5,26,69,31,0,0,98,10.0,2.0,8.0,21.0,10.0,0.0,0.0,31,31,0,10.0,10.0,0.0
9712222,82,5,77,648,9,73,227,24,60.0,2.0,58.0,572.0,5.0,55.0,140.0,94,82,12,49.0,44.0,5.0
9705278,11,4,7,16,1,10,16,11,9.0,2.0,7.0,15.0,1.0,8.0,13.0,13,11,2,9.0,7.0,2.0
9711309,23,4,19,78,1,22,121,16,16.0,2.0,14.0,43.0,0.0,16.0,70.0,41,23,18,19.0,15.0,4.0
9401266,51,17,34,126,51,0,0,16,24.0,6.0,18.0,65.0,24.0,0.0,0.0,51,51,0,19.0,19.0,0.0
9310298,26,10,16,26,21,5,5,236,10.0,5.0,5.0,12.0,10.0,0.0,0.0,27,26,1,9.0,9.0,0.0
8197,2,1,1,1,0,2,6,80,0.0,0.0,0.0,0.0,0.0,0.0,0.0,19,2,17,4.0,0.0,4.0
9603271,41,14,27,70,20,21,35,62,10.0,5.0,5.0,12.0,0.0,10.0,24.0,46,41,5,11.0,7.0,4.0
9404313,67,7,60,274,57,10,11,30,41.0,4.0,37.0,170.0,41.0,0.0,0.0,69,67,2,17.0,17.0,0.0
9811437,12,4,8,14,1,11,78,30,7.0,1.0,6.0,7.0,0.0,7.0,24.0,38,12,26,14.0,7.0,7.0
9302284,24,5,19,43,24,0,0,86,8.0,3.0,5.0,10.0,8.0,0.0,0.0,24,24,0,4.0,4.0,0.0
9208242,39,6,33,183,39,0,0,36,28.0,3.0,25.0,120.0,28.0,0.0,0.0,39,39,0,21.0,21.0,0.0
9603202,120,17,103,409,16,104,608,6,34.0,5.0,29.0,97.0,1.0,33.0,324.0,145,120,25,18.0,15.0,3.0
9712242,12,4,8,17,12,0,0,193,5.0,2.0,3.0,5.0,5.0,0.0,0.0,12,12,0,2.0,2.0,0.0
9812371,46,8,38,152,7,39,176,24,28.0,2.0,26.0,107.0,0.0,28.0,133.0,57,46,11,17.0,14.0,3.0
9308344,6,2,4,8,6,0,0,79,5.0,1.0,4.0,8.0,5.0,0.0,0.0,6,6,0,,,
9610471,13,6,7,12,0,13,108,6,8.0,5.0,3.0,6.0,0.0,8.0,75.0,36,13,23,22.0,4.0,18.0
9211230,4,2,2,2,4,0,0,530,2.0,2.0,0.0,0.0,2.0,0.0,0.0,4,4,0,3.0,3.0,0.0
9506451,170,23,147,705,115,55,61,14,73.0,2.0,71.0,390.0,41.0,32.0,36.0,174,170,4,31.0,30.0,1.0
9607426,5,3,2,3,1,4,12,8,2.0,2.0,0.0,0.0,0.0,2.0,5.0,37,5,32,4.0,3.0,1.0
9403304,28,5,23,41,23,5,9,157,6.0,2.0,4.0,10.0,6.0,0.0,0.0,31,28,3,6.0,6.0,0.0
9506438,21,8,13,24,7,14,48,22,8.0,2.0,6.0,11.0,4.0,4.0,7.0,36,21,15,10.0,9.0,1.0
9409269,21,3,18,61,1,20,37,38,18.0,1.0,17.0,54.0,1.0,17.0,28.0,25,21,4,13.0,12.0,1.0
9907267,19,4,15,36,2,17,132,45,14.0,3.0,11.0,30.0,0.0,14.0,109.0,37,19,18,27.0,12.0,15.0
9402361,7,2,5,5,0,7,7,275,2.0,2.0,0.0,0.0,2.0,0.0,0.0,8,7,1,2.0,2.0,0.0
9403335,20,5,15,54,7,13,20,22,14.0,3.0,11.0,40.0,2.0,12.0,18.0,22,20,2,14.0,13.0,1.0
9902348,12,8,4,6,4,8,27,70,4.0,3.0,1.0,2.0,1.0,3.0,7.0,31,12,19,4.0,1.0,3.0
9411358,11,9,2,3,7,4,4,88,5.0,5.0,0.0,0.0,3.0,2.0,2.0,12,11,1,3.0,2.0,1.0
9709343,6,1,5,7,1,5,8,88,6.0,1.0,5.0,7.0,1.0,5.0,8.0,10,6,4,10.0,6.0,4.0
3169,32,12,20,44,2,30,58,177,23.0,6.0,17.0,35.0,0.0,23.0,34.0,40,32,8,14.0,13.0,1.0
9709273,16,2,14,45,1,15,55,21,13.0,2.0,11.0,39.0,0.0,13.0,52.0,25,16,9,16.0,10.0,6.0
9707296,16,2,14,35,0,16,32,42,7.0,1.0,6.0,13.0,0.0,7.0,17.0,20,16,4,9.0,7.0,2.0
9208249,51,12,39,117,51,0,0,19,18.0,5.0,13.0,39.0,18.0,0.0,0.0,51,51,0,8.0,8.0,0.0
9711394,7,4,3,3,2,5,10,4,3.0,2.0,1.0,1.0,3.0,0.0,0.0,18,7,11,3.0,3.0,0.0
9901331,35,5,30,117,0,35,241,16,23.0,2.0,21.0,77.0,0.0,23.0,156.0,72,35,37,23.0,10.0,13.0
9910563,9,6,3,4,0,9,40,19,5.0,2.0,3.0,4.0,0.0,5.0,28.0,20,9,11,3.0,1.0,2.0
9906483,1,1,0,0,1,0,0,43,,,,,,,,7,1,6,,,
9601385,7,5,2,3,0,7,20,39,2.0,2.0,0.0,0.0,0.0,2.0,6.0,14,7,7,5.0,2.0,3.0
6034,22,3,19,91,0,22,264,20,21.0,2.0,19.0,91.0,0.0,21.0,254.0,45,22,23,33.0,12.0,21.0
9903502,106,4,102,1116,2,104,636,20,86.0,1.0,85.0,1046.0,0.0,86.0,570.0,120,106,14,71.0,61.0,10.0
9908314,13,1,12,51,0,13,81,20,13.0,1.0,12.0,51.0,0.0,13.0,80.0,21,13,8,20.0,13.0,7.0
9311256,8,2,6,10,7,1,1,303,2.0,1.0,1.0,1.0,2.0,0.0,0.0,9,8,1,3.0,3.0,0.0
9505298,29,9,20,81,1,28,110,49,21.0,4.0,17.0,60.0,1.0,20.0,53.0,40,29,11,12.0,7.0,5.0
9603293,5,4,1,1,4,1,1,211,0.0,0.0,0.0,0.0,0.0,0.0,0.0,7,5,2,,,
1171,34,8,26,105,3,31,96,20,23.0,3.0,20.0,93.0,0.0,23.0,73.0,44,34,10,16.0,15.0,1.0
7021,7,3,4,7,2,5,16,42,5.0,1.0,4.0,7.0,0.0,5.0,8.0,18,7,11,10.0,4.0,6.0
9610237,23,10,13,13,5,18,25,87,8.0,3.0,5.0,5.0,1.0,7.0,8.0,32,23,9,3.0,3.0,0.0
9812296,30,4,26,72,7,23,39,2,8.0,1.0,7.0,16.0,8.0,0.0,0.0,32,30,2,8.0,8.0,0.0
9209277,38,9,29,91,16,22,27,85,8.0,2.0,6.0,12.0,2.0,6.0,6.0,40,38,2,5.0,5.0,0.0
9405360,11,6,5,5,1,10,22,78,1.0,1.0,0.0,0.0,0.0,1.0,3.0,20,11,9,3.0,3.0,0.0
9702359,66,9,57,220,1,65,359,5,14.0,6.0,8.0,12.0,0.0,14.0,95.0,88,66,22,24.0,19.0,5.0
9707497,25,7,18,31,2,23,166,61,4.0,1.0,3.0,3.0,0.0,4.0,26.0,92,25,67,18.0,3.0,15.0
9612363,53,7,46,230,21,32,78,4,26.0,1.0,25.0,150.0,26.0,0.0,0.0,65,53,12,8.0,8.0,0.0
9405429,18,4,14,28,18,0,0,10,6.0,2.0,4.0,9.0,6.0,0.0,0.0,18,18,0,9.0,9.0,0.0
1122,28,4,24,100,0,28,86,73,18.0,3.0,15.0,65.0,0.0,18.0,35.0,41,28,13,15.0,15.0,0.0
9606241,23,2,21,79,9,14,38,42,14.0,1.0,13.0,40.0,14.0,0.0,0.0,28,23,5,11.0,11.0,0.0
4050,16,3,13,42,0,16,118,73,16.0,3.0,13.0,42.0,0.0,16.0,118.0,29,16,13,21.0,9.0,12.0
9703388,7,3,4,8,0,7,47,114,5.0,2.0,3.0,5.0,0.0,5.0,32.0,26,7,19,14.0,5.0,9.0
9603336,27,8,19,35,1,26,112,18,3.0,1.0,2.0,2.0,0.0,3.0,18.0,55,27,28,7.0,6.0,1.0
9608221,30,10,20,34,7,23,55,5,10.0,5.0,5.0,9.0,1.0,9.0,26.0,39,30,9,10.0,5.0,5.0
9608321,35,8,27,102,7,28,132,23,7.0,6.0,1.0,1.0,0.0,7.0,43.0,52,35,17,9.0,3.0,6.0
9607271,16,5,11,17,9,7,16,139,6.0,2.0,4.0,6.0,6.0,0.0,0.0,21,16,5,7.0,5.0,2.0
9704331,33,14,19,48,21,12,26,36,8.0,1.0,7.0,21.0,8.0,0.0,0.0,42,33,9,8.0,8.0,0.0
9912516,82,13,69,270,12,70,320,4,32.0,3.0,29.0,120.0,1.0,31.0,122.0,114,82,32,11.0,11.0,0.0
9901358,38,7,31,185,1,37,86,70,36.0,5.0,31.0,185.0,0.0,36.0,85.0,41,38,3,32.0,30.0,2.0
9904395,69,5,64,478,3,66,511,3,53.0,5.0,48.0,392.0,1.0,52.0,427.0,107,69,38,37.0,13.0,24.0
9904219,48,1,47,307,3,45,163,55,30.0,1.0,29.0,172.0,0.0,30.0,101.0,60,48,12,33.0,28.0,5.0
9610468,10,8,2,2,9,1,1,500,2.0,2.0,0.0,0.0,2.0,0.0,0.0,14,10,4,2.0,0.0,2.0
9704384,10,4,6,6,0,10,58,18,5.0,2.0,3.0,3.0,1.0,4.0,9.0,39,10,29,8.0,3.0,5.0
9609267,13,5,8,18,4,9,28,36,6.0,2.0,4.0,8.0,0.0,6.0,11.0,17,13,4,10.0,6.0,4.0
1004,2,1,1,1,2,0,0,322,2.0,1.0,1.0,1.0,2.0,0.0,0.0,2,2,0,2.0,2.0,0.0
9704434,10,5,5,8,3,7,15,84,10.0,5.0,5.0,8.0,3.0,7.0,12.0,14,10,4,5.0,4.0,1.0
9312205,11,8,3,4,11,0,0,338,4.0,2.0,2.0,3.0,4.0,0.0,0.0,11,11,0,4.0,4.0,0.0
9603370,2,2,0,0,0,2,23,10,1.0,1.0,0.0,0.0,0.0,1.0,9.0,61,2,59,17.0,1.0,16.0
9806521,6,6,0,0,1,5,14,1,1.0,1.0,0.0,0.0,1.0,0.0,0.0,28,6,22,5.0,0.0,5.0
9607462,10,4,6,8,5,5,8,100,4.0,1.0,3.0,4.0,1.0,3.0,4.0,17,10,7,5.0,4.0,1.0
9601265,15,3,12,24,14,1,1,1,4.0,1.0,3.0,3.0,4.0,0.0,0.0,17,15,2,5.0,5.0,0.0
9402270,56,12,44,122,42,14,14,9,12.0,1.0,11.0,32.0,1.0,11.0,11.0,57,56,1,11.0,10.0,1.0
9610485,16,7,9,17,2,14,50,55,5.0,4.0,1.0,1.0,1.0,4.0,10.0,32,16,16,7.0,4.0,3.0
9505384,17,5,12,21,1,16,58,10,6.0,2.0,4.0,5.0,0.0,6.0,9.0,36,17,19,7.0,5.0,2.0
9811211,7,5,2,3,1,6,11,55,,,,,,,,19,7,12,1.0,1.0,0.0
9712305,88,18,70,402,8,80,439,18,20.0,5.0,15.0,66.0,2.0,18.0,56.0,129,88,41,22.0,6.0,16.0
9903506,3,3,0,0,3,0,0,182,1.0,1.0,0.0,0.0,1.0,0.0,0.0,8,3,5,1.0,1.0,0.0
9401285,22,1,21,60,12,10,10,104,13.0,2.0,11.0,21.0,5.0,8.0,8.0,23,22,1,12.0,11.0,1.0
9208221,52,6,46,219,52,0,0,124,32.0,4.0,28.0,157.0,32.0,0.0,0.0,52,52,0,24.0,24.0,0.0
111064,12,7,5,6,0,12,236,18,10.0,6.0,4.0,4.0,0.0,10.0,150.0,72,12,60,30.0,6.0,24.0
9612359,8,6,2,3,0,8,41,5,2.0,1.0,1.0,1.0,0.0,2.0,8.0,35,8,27,13.0,3.0,10.0
102255,47,8,39,202,10,37,294,23,27.0,2.0,25.0,177.0,0.0,27.0,270.0,70,47,23,25.0,16.0,9.0
3222,28,8,20,64,1,27,208,5,14.0,2.0,12.0,35.0,0.0,14.0,115.0,51,28,23,26.0,15.0,11.0
9309292,6,5,1,1,6,0,0,288,1.0,1.0,0.0,0.0,1.0,0.0,0.0,7,6,1,1.0,1.0,0.0
1309,18,4,14,33,1,17,117,18,11.0,2.0,9.0,24.0,0.0,11.0,81.0,57,18,39,20.0,9.0,11.0
9903333,14,5,9,15,4,10,105,5,4.0,3.0,1.0,2.0,0.0,4.0,75.0,43,14,29,31.0,4.0,27.0
7259,16,5,11,40,0,16,251,7,11.0,2.0,9.0,28.0,0.0,11.0,176.0,57,16,41,32.0,11.0,21.0
9502399,32,5,27,96,3,29,99,18,16.0,2.0,14.0,54.0,2.0,14.0,31.0,51,32,19,9.0,8.0,1.0
9507236,9,5,4,7,3,6,30,151,5.0,2.0,3.0,6.0,1.0,4.0,6.0,27,9,18,2.0,0.0,2.0
9402342,43,12,31,92,25,18,22,66,14.0,2.0,12.0,46.0,14.0,0.0,0.0,45,43,2,11.0,10.0,1.0
11190,8,6,2,2,6,2,4,314,2.0,1.0,1.0,1.0,1.0,1.0,1.0,11,8,3,4.0,2.0,2.0
8258,13,3,10,20,0,13,80,50,9.0,1.0,8.0,16.0,0.0,9.0,61.0,34,13,21,17.0,6.0,11.0
9207212,41,25,16,34,41,0,0,4,8.0,2.0,6.0,8.0,8.0,0.0,0.0,41,41,0,5.0,5.0,0.0
9246,26,10,16,45,4,22,57,11,8.0,3.0,5.0,13.0,4.0,4.0,4.0,31,26,5,9.0,7.0,2.0
9701284,107,5,102,1062,0,107,403,11,87.0,2.0,85.0,997.0,1.0,86.0,295.0,120,107,13,58.0,53.0,5.0
105331,1,1,0,0,1,0,0,19,0.0,0.0,0.0,0.0,0.0,0.0,0.0,26,1,25,6.0,0.0,6.0
9612454,34,4,30,79,9,25,82,16,20.0,1.0,19.0,45.0,4.0,16.0,39.0,47,34,13,17.0,13.0,4.0
9810208,9,5,4,5,9,0,0,80,3.0,2.0,1.0,1.0,3.0,0.0,0.0,9,9,0,2.0,2.0,0.0
9310350,82,30,52,137,82,0,0,44,15.0,6.0,9.0,24.0,15.0,0.0,0.0,82,82,0,9.0,9.0,0.0
9906308,12,5,7,12,1,11,28,16,4.0,2.0,2.0,5.0,1.0,3.0,6.0,28,12,16,5.0,3.0,2.0
9208240,17,6,11,28,17,0,0,304,10.0,3.0,7.0,19.0,10.0,0.0,0.0,17,17,0,8.0,8.0,0.0
9909368,18,8,10,22,5,13,17,129,9.0,3.0,6.0,11.0,1.0,8.0,10.0,28,18,10,6.0,5.0,1.0
9603444,11,8,3,4,8,3,3,167,3.0,2.0,1.0,1.0,1.0,2.0,2.0,13,11,2,1.0,0.0,1.0
1084,8,5,3,3,4,4,15,57,2.0,2.0,0.0,0.0,0.0,2.0,12.0,18,8,10,8.0,2.0,6.0
9702389,39,10,29,90,6,33,90,39,22.0,6.0,16.0,41.0,4.0,18.0,48.0,48,39,9,16.0,10.0,6.0
9901406,23,11,12,20,2,21,70,46,5.0,3.0,2.0,2.0,1.0,4.0,12.0,45,23,22,9.0,4.0,5.0
6046,35,5,30,63,4,31,167,2,13.0,2.0,11.0,19.0,1.0,12.0,30.0,52,35,17,15.0,9.0,6.0
109047,5,4,1,1,0,5,7,138,1.0,1.0,0.0,0.0,0.0,1.0,2.0,30,5,25,3.0,2.0,1.0
10029,13,5,8,11,0,13,126,16,8.0,3.0,5.0,6.0,0.0,8.0,82.0,51,13,38,20.0,8.0,12.0
9903358,173,19,154,850,9,164,481,11,65.0,4.0,61.0,436.0,0.0,65.0,195.0,192,173,19,45.0,41.0,4.0
109028,5,3,2,3,0,5,34,16,2.0,2.0,0.0,0.0,0.0,2.0,11.0,23,5,18,2.0,1.0,1.0
209100,14,3,11,16,3,11,61,19,3.0,1.0,2.0,2.0,1.0,2.0,14.0,44,14,30,20.0,2.0,18.0
9905237,42,5,37,176,28,14,14,19,22.0,1.0,21.0,121.0,22.0,0.0,0.0,43,42,1,19.0,19.0,0.0
107010,5,2,3,4,0,5,34,16,4.0,2.0,2.0,3.0,0.0,4.0,28.0,20,5,15,3.0,2.0,1.0
9908458,22,4,18,61,0,22,180,8,13.0,1.0,12.0,44.0,1.0,12.0,96.0,61,22,39,25.0,10.0,15.0
9405318,4,4,0,0,1,3,5,372,2.0,2.0,0.0,0.0,0.0,2.0,2.0,8,4,4,1.0,1.0,0.0
109202,12,7,5,8,2,10,83,28,1.0,1.0,0.0,0.0,0.0,1.0,5.0,78,12,66,7.0,0.0,7.0
9802303,2,1,1,1,1,1,10,40,1.0,1.0,0.0,0.0,0.0,1.0,10.0,14,2,12,12.0,1.0,11.0
2071,30,11,19,50,0,30,112,9,14.0,3.0,11.0,27.0,0.0,14.0,44.0,50,30,20,8.0,4.0,4.0
9702260,10,4,6,11,3,7,20,48,6.0,3.0,3.0,5.0,0.0,6.0,19.0,19,10,9,8.0,3.0,5.0
9505210,11,2,9,13,3,8,22,91,2.0,1.0,1.0,1.0,0.0,2.0,4.0,19,11,8,3.0,2.0,1.0
11295,32,7,25,55,0,32,316,2,20.0,4.0,16.0,36.0,0.0,20.0,129.0,57,32,25,32.0,16.0,16.0
9306222,10,1,9,22,10,0,0,142,9.0,1.0,8.0,21.0,9.0,0.0,0.0,10,10,0,6.0,6.0,0.0
9909218,18,7,11,22,0,18,374,2,13.0,2.0,11.0,21.0,0.0,13.0,335.0,69,18,51,50.0,9.0,41.0
107030,10,1,9,21,0,10,79,10,9.0,1.0,8.0,19.0,0.0,9.0,50.0,32,10,22,14.0,4.0,10.0
9611286,5,1,4,6,0,5,17,10,1.0,1.0,0.0,0.0,0.0,1.0,3.0,13,5,8,8.0,3.0,5.0
4266,9,2,7,10,2,7,19,37,2.0,1.0,1.0,1.0,0.0,2.0,3.0,24,9,15,4.0,2.0,2.0
9307226,24,6,18,31,14,10,10,10,2.0,2.0,0.0,0.0,2.0,0.0,0.0,25,24,1,4.0,4.0,0.0
4123,7,4,3,5,1,6,14,120,5.0,2.0,3.0,5.0,0.0,5.0,11.0,19,7,12,7.0,4.0,3.0
3055,17,3,14,66,2,15,27,0,15.0,2.0,13.0,63.0,2.0,13.0,22.0,23,17,6,17.0,15.0,2.0
9603201,15,4,11,30,1,14,18,50,7.0,3.0,4.0,7.0,1.0,6.0,7.0,19,15,4,9.0,8.0,1.0
9606261,12,6,6,14,1,11,56,18,6.0,2.0,4.0,7.0,0.0,6.0,19.0,29,12,17,10.0,7.0,3.0
1175,23,4,19,52,0,23,134,95,14.0,1.0,13.0,36.0,0.0,14.0,64.0,39,23,16,23.0,11.0,12.0
9909317,2,2,0,0,1,1,4,35,0.0,0.0,0.0,0.0,0.0,0.0,0.0,25,2,23,1.0,0.0,1.0
9407382,19,5,14,36,1,18,18,69,6.0,4.0,2.0,2.0,0.0,6.0,6.0,20,19,1,13.0,12.0,1.0
202128,4,3,1,1,0,4,25,8,0.0,0.0,0.0,0.0,0.0,0.0,0.0,29,4,25,3.0,1.0,2.0
9105,1,1,0,0,0,1,5,32,,,,,,,,7,1,6,,,
9602322,23,3,20,73,0,23,73,58,10.0,1.0,9.0,11.0,0.0,10.0,26.0,32,23,9,11.0,8.0,3.0
9909479,16,7,9,14,7,9,22,1,5.0,4.0,1.0,1.0,5.0,0.0,0.0,23,16,7,6.0,4.0,2.0
9504385,4,3,1,1,3,1,1,134,2.0,2.0,0.0,0.0,2.0,0.0,0.0,10,4,6,4.0,0.0,4.0
9710226,1,1,0,0,1,0,0,79,,,,,,,,1,1,0,,,
9602291,5,3,2,3,3,2,2,72,3.0,1.0,2.0,3.0,3.0,0.0,0.0,6,5,1,2.0,2.0,0.0
9809433,44,6,38,172,1,43,426,11,32.0,3.0,29.0,135.0,0.0,32.0,353.0,78,44,34,21.0,13.0,8.0
9806536,5,3,2,3,3,2,4,279,0.0,0.0,0.0,0.0,0.0,0.0,0.0,11,5,6,2.0,1.0,1.0
9405236,42,13,29,68,42,0,0,144,11.0,5.0,6.0,13.0,11.0,0.0,0.0,42,42,0,6.0,6.0,0.0
9607236,12,3,9,16,0,12,92,17,11.0,3.0,8.0,14.0,0.0,11.0,86.0,22,12,10,17.0,8.0,9.0
9308367,1,1,0,0,1,0,0,982,,,,,,,,1,1,0,,,
9506450,8,7,1,1,2,6,20,26,4.0,4.0,0.0,0.0,1.0,3.0,8.0,14,8,6,6.0,3.0,3.0
9611313,11,3,8,10,2,9,15,24,3.0,1.0,2.0,2.0,3.0,0.0,0.0,15,11,4,4.0,3.0,1.0
9404277,40,9,31,97,33,7,10,14,8.0,2.0,6.0,20.0,8.0,0.0,0.0,43,40,3,7.0,7.0,0.0
9706231,4,3,1,1,0,4,22,8,3.0,2.0,1.0,1.0,0.0,3.0,9.0,16,4,12,7.0,2.0,5.0
9612284,49,16,33,65,49,0,0,25,9.0,5.0,4.0,8.0,9.0,0.0,0.0,49,49,0,7.0,7.0,0.0
202150,0,0,0,0,0,0,0,37,0.0,0.0,0.0,0.0,0.0,0.0,0.0,6,0,6,,,
102117,10,5,5,9,1,9,58,4,6.0,3.0,3.0,7.0,0.0,6.0,53.0,28,10,18,19.0,5.0,14.0
9705309,4,4,0,0,3,1,2,61,0.0,0.0,0.0,0.0,0.0,0.0,0.0,33,4,29,9.0,0.0,9.0
9712535,39,6,33,133,0,39,289,12,29.0,3.0,26.0,117.0,0.0,29.0,258.0,55,39,16,35.0,24.0,11.0
9403243,40,13,27,52,40,0,0,57,14.0,5.0,9.0,16.0,14.0,0.0,0.0,40,40,0,8.0,8.0,0.0
9903459,21,4,17,45,6,15,46,50,8.0,1.0,7.0,15.0,0.0,8.0,24.0,29,21,8,8.0,6.0,2.0
9406206,10,4,6,20,2,8,15,192,6.0,2.0,4.0,12.0,0.0,6.0,11.0,14,10,4,6.0,5.0,1.0
9602229,5,4,1,1,4,1,1,101,3.0,3.0,0.0,0.0,3.0,0.0,0.0,6,5,1,1.0,1.0,0.0
9408336,11,6,5,12,1,10,19,77,8.0,4.0,4.0,7.0,0.0,8.0,13.0,17,11,6,8.0,6.0,2.0
9707352,16,2,14,55,0,16,31,54,15.0,2.0,13.0,53.0,0.0,15.0,30.0,20,16,4,16.0,14.0,2.0
9907240,78,11,67,438,4,74,639,24,51.0,3.0,48.0,347.0,0.0,51.0,443.0,114,78,36,35.0,22.0,13.0
9505442,4,1,3,4,1,3,9,245,1.0,1.0,0.0,0.0,0.0,1.0,2.0,10,4,6,4.0,2.0,2.0
9711351,14,6,8,14,14,0,0,64,4.0,2.0,2.0,2.0,4.0,0.0,0.0,14,14,0,2.0,2.0,0.0
9608374,8,7,1,1,1,7,14,21,5.0,4.0,1.0,1.0,0.0,5.0,9.0,14,8,6,5.0,1.0,4.0
9803316,85,15,70,278,12,73,390,9,37.0,3.0,34.0,113.0,13.0,24.0,34.0,108,85,23,21.0,19.0,2.0
11215,73,31,42,86,7,66,344,14,20.0,9.0,11.0,22.0,0.0,20.0,149.0,121,73,48,31.0,10.0,21.0
3177,32,5,27,69,7,25,95,135,9.0,2.0,7.0,18.0,1.0,8.0,26.0,67,32,35,15.0,6.0,9.0
9712473,12,2,10,23,0,12,86,14,6.0,2.0,4.0,10.0,0.0,6.0,53.0,25,12,13,16.0,5.0,11.0
9401342,17,9,8,11,17,0,0,232,4.0,2.0,2.0,2.0,4.0,0.0,0.0,17,17,0,3.0,3.0,0.0
9706511,45,3,42,130,3,42,162,27,20.0,2.0,18.0,40.0,2.0,18.0,38.0,61,45,16,18.0,12.0,6.0
1272,11,5,6,7,0,11,53,54,5.0,4.0,1.0,1.0,0.0,5.0,26.0,26,11,15,10.0,0.0,10.0
9603402,3,3,0,0,2,1,1,337,2.0,2.0,0.0,0.0,1.0,1.0,1.0,4,3,1,3.0,2.0,1.0
9512371,2,1,1,1,2,0,0,44,0.0,0.0,0.0,0.0,0.0,0.0,0.0,8,2,6,2.0,0.0,2.0
9512204,11,7,4,4,6,5,11,77,8.0,6.0,2.0,2.0,4.0,4.0,4.0,14,11,3,6.0,5.0,1.0
9911244,7,6,1,1,2,5,8,20,0.0,0.0,0.0,0.0,0.0,0.0,0.0,33,7,26,2.0,1.0,1.0
9911436,41,10,31,101,0,41,288,17,29.0,9.0,20.0,71.0,0.0,29.0,220.0,58,41,17,11.0,10.0,1.0
9502204,12,8,4,5,11,1,1,84,3.0,2.0,1.0,1.0,3.0,0.0,0.0,13,12,1,2.0,2.0,0.0
9610380,26,8,18,32,23,3,4,16,4.0,2.0,2.0,3.0,3.0,1.0,2.0,29,26,3,2.0,2.0,0.0
9705318,27,4,23,93,2,25,74,8,11.0,2.0,9.0,27.0,2.0,9.0,19.0,36,27,9,17.0,13.0,4.0
9606334,1,1,0,0,1,0,0,232,0.0,0.0,0.0,0.0,0.0,0.0,0.0,4,1,3,2.0,0.0,2.0
9706496,9,1,8,12,0,9,14,39,6.0,1.0,5.0,8.0,0.0,6.0,7.0,12,9,3,2.0,2.0,0.0
9903519,5,1,4,7,1,4,12,300,4.0,1.0,3.0,6.0,3.0,1.0,1.0,9,5,4,7.0,4.0,3.0
9802248,10,3,7,17,0,10,75,8,6.0,1.0,5.0,8.0,0.0,6.0,43.0,26,10,16,18.0,6.0,12.0
9606335,3,3,0,0,1,2,3,97,1.0,1.0,0.0,0.0,0.0,1.0,2.0,5,3,2,3.0,1.0,2.0
9512407,29,7,22,78,19,10,10,8,18.0,2.0,16.0,58.0,18.0,0.0,0.0,32,29,3,5.0,5.0,0.0
9605438,1,1,0,0,1,0,0,270,0.0,0.0,0.0,0.0,0.0,0.0,0.0,4,1,3,1.0,0.0,1.0
9406268,14,5,9,34,1,13,28,15,7.0,3.0,4.0,7.0,6.0,1.0,1.0,19,14,5,7.0,7.0,0.0
9509387,1,1,0,0,1,0,0,0,0.0,0.0,0.0,0.0,0.0,0.0,0.0,24,1,23,10.0,0.0,10.0
9205243,40,11,29,116,40,0,0,124,26.0,6.0,20.0,83.0,26.0,0.0,0.0,40,40,0,18.0,18.0,0.0
9607405,9,5,4,5,1,8,23,60,4.0,2.0,2.0,2.0,0.0,4.0,15.0,14,9,5,2.0,2.0,0.0
1145,8,7,1,1,1,7,18,2,3.0,3.0,0.0,0.0,0.0,3.0,5.0,35,8,27,6.0,3.0,3.0
9910270,4,2,2,3,1,3,5,0,0.0,0.0,0.0,0.0,0.0,0.0,0.0,14,4,10,2.0,0.0,2.0
9707398,28,4,24,110,7,21,31,0,20.0,2.0,18.0,84.0,6.0,14.0,15.0,34,28,6,17.0,16.0,1.0
9908489,5,4,1,1,1,4,13,0,1.0,1.0,0.0,0.0,0.0,1.0,2.0,19,5,14,4.0,1.0,3.0
1261,5,1,4,9,1,4,4,52,4.0,1.0,3.0,5.0,1.0,3.0,3.0,9,5,4,4.0,4.0,0.0
9705242,36,6,30,162,17,19,28,52,28.0,2.0,26.0,144.0,18.0,10.0,13.0,39,36,3,23.0,22.0,1.0
7134,7,3,4,12,2,5,9,92,6.0,2.0,4.0,12.0,2.0,4.0,4.0,18,7,11,3.0,2.0,1.0
9802240,4,1,3,5,1,3,45,15,3.0,1.0,2.0,3.0,0.0,3.0,45.0,19,4,15,18.0,3.0,15.0
9701336,37,10,27,58,16,21,47,92,13.0,4.0,9.0,18.0,3.0,10.0,24.0,45,37,8,5.0,4.0,1.0
110377,7,2,5,13,0,7,27,146,7.0,2.0,5.0,13.0,0.0,7.0,27.0,13,7,6,12.0,7.0,5.0
9909361,6,2,4,8,0,6,21,120,6.0,2.0,4.0,8.0,0.0,6.0,19.0,13,6,7,11.0,6.0,5.0
10206,5,2,3,6,0,5,10,0,3.0,1.0,2.0,3.0,3.0,0.0,0.0,15,5,10,2.0,0.0,2.0
9211282,39,2,37,113,39,0,0,40,32.0,1.0,31.0,96.0,32.0,0.0,0.0,39,39,0,6.0,6.0,0.0
9708467,12,6,6,14,0,12,24,8,11.0,5.0,6.0,14.0,0.0,11.0,22.0,15,12,3,2.0,1.0,1.0
9904247,5,4,1,1,2,3,18,18,1.0,1.0,0.0,0.0,0.0,1.0,7.0,19,5,14,11.0,2.0,9.0
9908351,7,2,5,9,0,7,50,69,6.0,2.0,4.0,8.0,0.0,6.0,37.0,20,7,13,12.0,4.0,8.0
9708469,15,4,11,29,1,14,69,10,5.0,1.0,4.0,8.0,0.0,5.0,6.0,43,15,28,10.0,4.0,6.0
9708215,11,4,7,11,6,5,8,123,7.0,2.0,5.0,9.0,4.0,3.0,3.0,15,11,4,5.0,5.0,0.0
9802370,26,11,15,32,1,25,127,22,5.0,3.0,2.0,2.0,2.0,3.0,8.0,67,26,41,13.0,7.0,6.0
9710370,13,4,9,22,6,7,37,22,6.0,2.0,4.0,10.0,1.0,5.0,28.0,25,13,12,12.0,5.0,7.0
9505387,16,3,13,34,9,7,14,85,8.0,1.0,7.0,23.0,5.0,3.0,3.0,31,16,15,9.0,9.0,0.0
9301277,7,2,5,6,7,0,0,114,4.0,1.0,3.0,4.0,4.0,0.0,0.0,7,7,0,5.0,5.0,0.0
9702352,5,3,2,3,1,4,22,27,2.0,2.0,0.0,0.0,0.0,2.0,6.0,15,5,10,2.0,1.0,1.0
6307,45,12,33,90,5,40,300,30,28.0,9.0,19.0,64.0,0.0,28.0,222.0,76,45,31,29.0,11.0,18.0
9810416,13,3,10,30,1,12,49,30,7.0,2.0,5.0,15.0,0.0,7.0,26.0,30,13,17,9.0,7.0,2.0
9912447,19,8,11,20,0,19,127,30,14.0,6.0,8.0,16.0,0.0,14.0,95.0,39,19,20,21.0,8.0,13.0
9608214,14,3,11,22,0,14,52,60,6.0,1.0,5.0,10.0,0.0,6.0,22.0,32,14,18,4.0,4.0,0.0
9909315,25,6,19,85,0,25,233,32,21.0,3.0,18.0,81.0,0.0,21.0,206.0,49,25,24,36.0,19.0,17.0
9912253,11,4,7,18,0,11,173,32,8.0,4.0,4.0,11.0,0.0,8.0,133.0,61,11,50,37.0,7.0,30.0
1276,1,1,0,0,1,0,0,316,0.0,0.0,0.0,0.0,0.0,0.0,0.0,2,1,1,1.0,0.0,1.0
9504398,16,6,10,17,9,7,15,25,8.0,1.0,7.0,14.0,3.0,5.0,5.0,21,16,5,3.0,3.0,0.0
9909259,7,4,3,4,0,7,47,21,0.0,0.0,0.0,0.0,0.0,0.0,0.0,38,7,31,2.0,2.0,0.0
9510460,7,2,5,8,1,6,12,14,4.0,1.0,3.0,3.0,0.0,4.0,9.0,14,7,7,3.0,3.0,0.0
9309217,15,9,6,18,15,0,0,67,3.0,3.0,0.0,0.0,3.0,0.0,0.0,16,15,1,2.0,2.0,0.0
9505434,14,8,6,8,13,1,1,13,2.0,1.0,1.0,1.0,2.0,0.0,0.0,16,14,2,2.0,1.0,1.0
9807483,6,3,3,4,0,6,6,36,2.0,1.0,1.0,1.0,2.0,0.0,0.0,7,6,1,1.0,1.0,0.0
7288,4,1,3,4,0,4,57,12,3.0,1.0,2.0,2.0,0.0,3.0,23.0,35,4,31,12.0,3.0,9.0
9711435,14,2,12,21,2,12,95,12,11.0,2.0,9.0,15.0,0.0,11.0,93.0,33,14,19,20.0,10.0,10.0
105111,6,3,3,5,2,4,11,169,6.0,3.0,3.0,5.0,2.0,4.0,11.0,10,6,4,7.0,3.0,4.0
9510224,10,6,4,4,2,8,51,10,1.0,1.0,0.0,0.0,0.0,1.0,6.0,69,10,59,11.0,1.0,10.0
9906437,6,2,4,6,0,6,29,13,3.0,1.0,2.0,2.0,0.0,3.0,13.0,12,6,6,,,
103042,6,1,5,9,0,6,12,89,5.0,1.0,4.0,8.0,0.0,5.0,5.0,19,6,13,6.0,5.0,1.0
9701262,3,3,0,0,1,2,7,6,1.0,1.0,0.0,0.0,0.0,1.0,2.0,12,3,9,3.0,1.0,2.0
8033,10,6,4,5,10,0,0,30,4.0,1.0,3.0,4.0,4.0,0.0,0.0,10,10,0,1.0,1.0,0.0
3025,12,5,7,12,0,12,49,21,4.0,3.0,1.0,1.0,0.0,4.0,15.0,26,12,14,10.0,7.0,3.0
9501312,10,7,3,3,2,8,27,112,6.0,4.0,2.0,2.0,0.0,6.0,10.0,17,10,7,6.0,5.0,1.0
9801373,4,4,0,0,0,4,4,95,1.0,1.0,0.0,0.0,0.0,1.0,1.0,11,4,7,6.0,0.0,6.0
9210205,15,10,5,5,15,0,0,245,5.0,3.0,2.0,2.0,5.0,0.0,0.0,15,15,0,3.0,3.0,0.0
9709223,20,5,15,31,0,20,175,1,10.0,2.0,8.0,15.0,0.0,10.0,86.0,48,20,28,14.0,2.0,12.0
9503322,4,3,1,1,3,1,1,450,1.0,1.0,0.0,0.0,0.0,1.0,1.0,5,4,1,2.0,1.0,1.0
9709348,46,12,34,129,3,43,196,13,27.0,4.0,23.0,90.0,1.0,26.0,77.0,67,46,21,14.0,12.0,2.0
9505377,3,2,1,1,1,2,4,14,0.0,0.0,0.0,0.0,0.0,0.0,0.0,6,3,3,1.0,0.0,1.0
9606439,3,3,0,0,1,2,3,112,1.0,1.0,0.0,0.0,1.0,0.0,0.0,12,3,9,3.0,0.0,3.0
9402362,26,5,21,55,26,0,0,150,13.0,1.0,12.0,27.0,13.0,0.0,0.0,26,26,0,6.0,6.0,0.0
9912503,39,5,34,314,1,38,119,109,35.0,1.0,34.0,309.0,0.0,35.0,95.0,49,39,10,36.0,32.0,4.0
9912542,30,10,20,83,2,28,361,70,26.0,7.0,19.0,73.0,0.0,26.0,358.0,45,30,15,40.0,25.0,15.0
110216,8,4,4,9,0,8,139,24,8.0,4.0,4.0,9.0,0.0,8.0,131.0,44,8,36,32.0,5.0,27.0
104078,2,2,0,0,0,2,7,9,0.0,0.0,0.0,0.0,0.0,0.0,0.0,18,2,16,10.0,0.0,10.0
9710534,4,4,0,0,1,3,5,54,0.0,0.0,0.0,0.0,0.0,0.0,0.0,12,4,8,1.0,1.0,0.0
9505268,3,1,2,2,3,0,0,61,,,,,,,,4,3,1,,,
106308,12,2,10,18,1,11,65,8,6.0,1.0,5.0,10.0,0.0,6.0,37.0,29,12,17,17.0,5.0,12.0
9912453,8,3,5,10,0,8,36,2,5.0,1.0,4.0,8.0,5.0,0.0,0.0,23,8,15,2.0,2.0,0.0
9405208,5,4,1,2,3,2,3,38,2.0,2.0,0.0,0.0,0.0,2.0,3.0,7,5,2,1.0,1.0,0.0
7093,6,6,0,0,0,6,14,38,3.0,3.0,0.0,0.0,0.0,3.0,5.0,20,6,14,5.0,3.0,2.0
9912510,4,1,3,6,0,4,14,21,4.0,1.0,3.0,6.0,0.0,4.0,14.0,8,4,4,2.0,2.0,0.0
108109,5,4,1,1,1,4,22,0,3.0,3.0,0.0,0.0,0.0,3.0,16.0,31,5,26,19.0,1.0,18.0
9807529,15,5,10,14,11,4,4,200,14.0,4.0,10.0,14.0,10.0,4.0,4.0,22,15,7,9.0,9.0,0.0
9705216,20,8,12,32,2,18,49,13,13.0,5.0,8.0,20.0,0.0,13.0,34.0,26,20,6,10.0,7.0,3.0
9204231,6,1,5,7,6,0,0,205,5.0,1.0,4.0,6.0,5.0,0.0,0.0,6,6,0,5.0,5.0,0.0
9903273,9,3,6,10,1,8,71,3,7.0,2.0,5.0,9.0,0.0,7.0,62.0,31,9,22,6.0,0.0,6.0
9411394,9,4,5,10,9,0,0,499,2.0,1.0,1.0,1.0,2.0,0.0,0.0,9,9,0,2.0,2.0,0.0
9911243,19,6,13,21,0,19,184,15,7.0,1.0,6.0,9.0,0.0,7.0,120.0,64,19,45,37.0,5.0,32.0
102265,54,12,42,167,10,44,308,0,14.0,1.0,13.0,53.0,0.0,14.0,157.0,105,54,51,29.0,16.0,13.0
112103,25,8,17,33,1,24,206,0,4.0,2.0,2.0,2.0,0.0,4.0,53.0,81,25,56,33.0,1.0,32.0
106291,21,4,17,45,16,5,10,107,12.0,1.0,11.0,29.0,12.0,0.0,0.0,27,21,6,7.0,7.0,0.0
203177,4,3,1,1,2,2,12,22,2.0,1.0,1.0,1.0,0.0,2.0,8.0,17,4,13,7.0,2.0,5.0
9606273,8,2,6,16,2,6,10,68,5.0,1.0,4.0,10.0,4.0,1.0,1.0,12,8,4,3.0,3.0,0.0
108170,23,3,20,80,0,23,320,37,20.0,3.0,17.0,67.0,0.0,20.0,293.0,54,23,31,41.0,19.0,22.0
9507304,8,2,6,9,8,0,0,67,4.0,1.0,3.0,4.0,4.0,0.0,0.0,9,8,1,5.0,5.0,0.0
9911329,13,8,5,10,2,11,66,5,0.0,0.0,0.0,0.0,0.0,0.0,0.0,80,13,67,7.0,1.0,6.0
9401295,5,3,2,2,5,0,0,330,1.0,1.0,0.0,0.0,1.0,0.0,0.0,5,5,0,1.0,1.0,0.0
9612438,10,6,4,5,4,6,15,33,4.0,3.0,1.0,1.0,0.0,4.0,7.0,18,10,8,7.0,3.0,4.0
9706284,5,3,2,3,0,5,13,167,5.0,3.0,2.0,3.0,0.0,5.0,13.0,9,5,4,9.0,5.0,4.0
9509208,14,4,10,29,4,10,13,33,10.0,2.0,8.0,20.0,2.0,8.0,10.0,17,14,3,1.0,1.0,0.0
9710341,6,5,1,1,1,5,20,13,5.0,4.0,1.0,1.0,0.0,5.0,20.0,36,6,30,12.0,3.0,9.0
9505270,4,3,1,1,1,3,3,25,4.0,3.0,1.0,1.0,1.0,3.0,3.0,5,4,1,2.0,2.0,0.0
9803304,11,1,10,19,6,5,9,95,7.0,1.0,6.0,14.0,3.0,4.0,4.0,15,11,4,2.0,1.0,1.0
9709266,1,1,0,0,0,1,1,297,1.0,1.0,0.0,0.0,0.0,1.0,1.0,3,1,2,2.0,1.0,1.0
9606340,4,2,2,2,2,2,2,370,2.0,1.0,1.0,1.0,0.0,2.0,2.0,5,4,1,3.0,2.0,1.0
12366,1,1,0,0,0,1,1,46,0.0,0.0,0.0,0.0,0.0,0.0,0.0,15,1,14,1.0,0.0,1.0
9905441,26,4,22,80,0,26,288,15,20.0,2.0,18.0,68.0,0.0,20.0,242.0,54,26,28,31.0,12.0,19.0
102128,25,10,15,28,7,18,72,19,10.0,2.0,8.0,17.0,3.0,7.0,8.0,66,25,41,7.0,7.0,0.0
9406362,2,1,1,1,0,2,10,176,2.0,1.0,1.0,1.0,0.0,2.0,10.0,7,2,5,7.0,2.0,5.0
5063,6,3,3,4,0,6,14,48,2.0,2.0,0.0,0.0,0.0,2.0,5.0,34,6,28,8.0,0.0,8.0
9101,21,13,8,10,2,19,41,135,8.0,4.0,4.0,5.0,0.0,8.0,19.0,29,21,8,10.0,5.0,5.0
9805225,15,2,13,57,3,12,15,130,14.0,2.0,12.0,51.0,3.0,11.0,11.0,17,15,2,13.0,13.0,0.0
201195,63,40,23,38,15,48,163,66,13.0,6.0,7.0,15.0,0.0,13.0,76.0,102,63,39,22.0,9.0,13.0
107164,34,5,29,119,7,27,80,46,22.0,1.0,21.0,99.0,3.0,19.0,49.0,46,34,12,20.0,17.0,3.0
111340,9,5,4,6,2,7,16,9,1.0,1.0,0.0,0.0,0.0,1.0,5.0,89,9,80,12.0,0.0,12.0
110287,19,5,14,50,0,19,138,0,8.0,2.0,6.0,21.0,0.0,8.0,65.0,46,19,27,18.0,9.0,9.0
9902240,13,4,9,16,4,9,43,3,7.0,3.0,4.0,6.0,0.0,7.0,23.0,27,13,14,9.0,3.0,6.0
105199,4,3,1,1,1,3,24,4,2.0,2.0,0.0,0.0,0.0,2.0,18.0,16,4,12,14.0,2.0,12.0
108001,5,4,1,1,2,3,16,37,0.0,0.0,0.0,0.0,0.0,0.0,0.0,24,5,19,8.0,0.0,8.0
11139,2,2,0,0,1,1,4,170,1.0,1.0,0.0,0.0,1.0,0.0,0.0,6,2,4,,,
9605418,5,1,4,5,4,1,1,348,3.0,2.0,1.0,1.0,3.0,0.0,0.0,9,5,4,4.0,4.0,0.0
9909362,11,9,2,3,0,11,58,9,2.0,2.0,0.0,0.0,0.0,2.0,11.0,60,11,49,9.0,3.0,6.0
206258,4,3,1,1,0,4,85,3,2.0,2.0,0.0,0.0,0.0,2.0,32.0,64,4,60,12.0,3.0,9.0
110366,18,7,11,23,0,18,33,3,7.0,3.0,4.0,8.0,7.0,0.0,0.0,22,18,4,11.0,8.0,3.0
9806397,7,6,1,1,2,5,22,41,3.0,2.0,1.0,1.0,0.0,3.0,15.0,38,7,31,10.0,0.0,10.0
9703214,12,6,6,9,5,7,13,91,6.0,2.0,4.0,5.0,5.0,1.0,1.0,23,12,11,4.0,3.0,1.0
9804382,5,3,2,3,0,5,24,166,4.0,2.0,2.0,3.0,0.0,4.0,17.0,14,5,9,9.0,3.0,6.0
9704281,8,2,6,15,3,5,5,187,6.0,2.0,4.0,11.0,2.0,4.0,4.0,13,8,5,7.0,6.0,1.0
9407225,2,2,0,0,0,2,5,62,1.0,1.0,0.0,0.0,0.0,1.0,3.0,11,2,9,7.0,1.0,6.0
9712480,2,2,0,0,2,0,0,297,0.0,0.0,0.0,0.0,0.0,0.0,0.0,8,2,6,1.0,0.0,1.0
9712497,21,4,17,45,1,20,101,1,12.0,1.0,11.0,27.0,0.0,12.0,61.0,37,21,16,13.0,6.0,7.0
107064,11,5,6,10,0,11,65,14,2.0,1.0,1.0,1.0,0.0,2.0,12.0,38,11,27,5.0,2.0,3.0
9804418,1,1,0,0,0,1,8,11,1.0,1.0,0.0,0.0,0.0,1.0,8.0,11,1,10,,,
9502243,13,3,10,22,2,11,25,13,9.0,2.0,7.0,14.0,4.0,5.0,6.0,19,13,6,8.0,7.0,1.0
9712259,2,2,0,0,0,2,7,12,0.0,0.0,0.0,0.0,0.0,0.0,0.0,14,2,12,2.0,0.0,2.0
9806291,12,10,2,2,8,4,31,44,2.0,1.0,1.0,1.0,1.0,1.0,13.0,40,12,28,8.0,0.0,8.0
9502258,9,3,6,6,6,3,5,72,2.0,2.0,0.0,0.0,1.0,1.0,1.0,19,9,10,3.0,1.0,2.0
9905571,20,6,14,37,0,20,195,32,16.0,5.0,11.0,29.0,0.0,16.0,152.0,67,20,47,22.0,11.0,11.0
9709309,1,1,0,0,1,0,0,280,0.0,0.0,0.0,0.0,0.0,0.0,0.0,4,1,3,3.0,0.0,3.0
9503206,20,4,16,36,17,3,3,144,5.0,2.0,3.0,5.0,5.0,0.0,0.0,21,20,1,5.0,5.0,0.0
9803253,14,5,9,25,3,11,21,107,9.0,1.0,8.0,23.0,2.0,7.0,12.0,18,14,4,10.0,8.0,2.0
9807561,2,2,0,0,0,2,4,235,0.0,0.0,0.0,0.0,0.0,0.0,0.0,10,2,8,4.0,0.0,4.0
9811307,11,4,7,12,0,11,35,20,1.0,1.0,0.0,0.0,0.0,1.0,1.0,21,11,10,9.0,7.0,2.0
9612366,1,1,0,0,0,1,2,6,1.0,1.0,0.0,0.0,1.0,0.0,0.0,13,1,12,,,
12336,4,3,1,1,0,4,28,6,2.0,2.0,0.0,0.0,0.0,2.0,5.0,31,4,27,5.0,2.0,3.0
9808478,0,0,0,0,0,0,0,1,0.0,0.0,0.0,0.0,0.0,0.0,0.0,20,0,20,1.0,0.0,1.0
9703217,8,5,3,3,6,2,2,255,2.0,2.0,0.0,0.0,2.0,0.0,0.0,12,8,4,2.0,2.0,0.0
9902292,16,4,12,29,2,14,35,128,12.0,1.0,11.0,26.0,0.0,12.0,29.0,28,16,12,14.0,11.0,3.0
203254,5,2,3,4,0,5,107,109,5.0,2.0,3.0,4.0,0.0,5.0,105.0,31,5,26,28.0,5.0,23.0
2101,6,4,2,2,3,3,10,109,0.0,0.0,0.0,0.0,0.0,0.0,0.0,22,6,16,8.0,0.0,8.0
9510334,2,1,1,1,1,1,8,26,1.0,1.0,0.0,0.0,0.0,1.0,7.0,11,2,9,7.0,1.0,6.0
9502290,7,6,1,1,5,2,2,24,1.0,1.0,0.0,0.0,1.0,0.0,0.0,9,7,2,1.0,1.0,0.0
9405242,10,8,2,2,10,0,0,225,4.0,3.0,1.0,1.0,4.0,0.0,0.0,10,10,0,2.0,2.0,0.0
9709290,7,4,3,3,2,5,6,143,2.0,1.0,1.0,1.0,2.0,0.0,0.0,13,7,6,3.0,2.0,1.0
9906311,18,6,12,42,1,17,130,50,15.0,5.0,10.0,37.0,0.0,15.0,122.0,35,18,17,25.0,11.0,14.0
9907249,7,2,5,9,2,5,8,71,4.0,1.0,3.0,6.0,1.0,3.0,4.0,12,7,5,2.0,0.0,2.0
9803348,3,3,0,0,0,3,5,36,2.0,2.0,0.0,0.0,2.0,0.0,0.0,14,3,11,2.0,1.0,1.0
9704223,16,4,12,28,0,16,16,7,16.0,4.0,12.0,28.0,16.0,0.0,0.0,22,16,6,13.0,12.0,1.0
107270,5,4,1,1,0,5,37,48,2.0,1.0,1.0,1.0,0.0,2.0,13.0,39,5,34,15.0,1.0,14.0
9607343,3,2,1,1,0,3,21,75,1.0,1.0,0.0,0.0,0.0,1.0,6.0,19,3,16,6.0,0.0,6.0
9506478,4,3,1,1,2,2,2,15,0.0,0.0,0.0,0.0,0.0,0.0,0.0,11,4,7,1.0,0.0,1.0
9705293,8,5,3,3,0,8,33,169,2.0,2.0,0.0,0.0,0.0,2.0,9.0,33,8,25,11.0,2.0,9.0
9605291,7,3,4,6,3,4,5,57,3.0,1.0,2.0,2.0,1.0,2.0,2.0,10,7,3,4.0,4.0,0.0
9708489,2,2,0,0,0,2,2,38,0.0,0.0,0.0,0.0,0.0,0.0,0.0,11,2,9,2.0,0.0,2.0
9712230,7,4,3,3,4,3,5,31,5.0,3.0,2.0,2.0,2.0,3.0,5.0,10,7,3,2.0,2.0,0.0
9405205,3,3,0,0,2,1,2,26,1.0,1.0,0.0,0.0,1.0,0.0,0.0,8,3,5,1.0,1.0,0.0
101163,3,2,1,1,3,0,0,0,1.0,1.0,0.0,0.0,1.0,0.0,0.0,3,3,0,2.0,2.0,0.0
9906406,8,3,5,9,4,4,6,8,4.0,2.0,2.0,3.0,2.0,2.0,2.0,11,8,3,2.0,1.0,1.0
105192,4,2,2,3,0,4,22,177,4.0,2.0,2.0,3.0,0.0,4.0,18.0,12,4,8,10.0,4.0,6.0
9706552,2,1,1,1,1,1,1,16,0.0,0.0,0.0,0.0,0.0,0.0,0.0,15,2,13,1.0,1.0,0.0
9506412,7,4,3,4,7,0,0,125,4.0,1.0,3.0,4.0,4.0,0.0,0.0,7,7,0,,,
9506273,48,10,38,129,3,45,260,53,27.0,3.0,24.0,98.0,0.0,27.0,214.0,63,48,15,34.0,23.0,11.0
9912366,7,2,5,6,1,6,42,3,6.0,1.0,5.0,6.0,0.0,6.0,19.0,23,7,16,12.0,6.0,6.0
112223,0,0,0,0,0,0,0,186,0.0,0.0,0.0,0.0,0.0,0.0,0.0,5,0,5,4.0,0.0,4.0
203054,1,1,0,0,0,1,1,121,1.0,1.0,0.0,0.0,0.0,1.0,1.0,8,1,7,1.0,0.0,1.0
9902412,5,3,2,3,1,4,16,14,3.0,2.0,1.0,2.0,0.0,3.0,6.0,12,5,7,6.0,3.0,3.0
9406340,9,5,4,5,9,0,0,30,8.0,4.0,4.0,5.0,8.0,0.0,0.0,9,9,0,2.0,2.0,0.0
9705314,4,2,2,2,0,4,32,8,3.0,1.0,2.0,2.0,0.0,3.0,7.0,24,4,20,9.0,2.0,7.0
9609243,6,6,0,0,3,3,6,14,1.0,1.0,0.0,0.0,1.0,0.0,0.0,21,6,15,1.0,1.0,0.0
9707301,19,6,13,39,7,12,28,241,7.0,3.0,4.0,7.0,5.0,2.0,2.0,35,19,16,12.0,10.0,2.0
9803228,8,4,4,6,0,8,61,5,6.0,3.0,3.0,5.0,0.0,6.0,50.0,27,8,19,4.0,2.0,2.0
9512235,1,1,0,0,0,1,3,138,1.0,1.0,0.0,0.0,0.0,1.0,2.0,6,1,5,3.0,1.0,2.0
9305242,1,1,0,0,1,0,0,1253,,,,,,,,1,1,0,,,
9512321,20,6,14,33,7,13,30,50,10.0,1.0,9.0,16.0,1.0,9.0,19.0,27,20,7,10.0,8.0,2.0
107281,5,2,3,4,0,5,29,50,1.0,1.0,0.0,0.0,0.0,1.0,6.0,18,5,13,9.0,1.0,8.0
103194,9,1,8,15,1,8,27,49,6.0,1.0,5.0,9.0,0.0,6.0,17.0,19,9,10,9.0,6.0,3.0
9703257,21,9,12,22,1,20,42,31,7.0,5.0,2.0,4.0,0.0,7.0,15.0,26,21,5,5.0,5.0,0.0
9905497,3,2,1,1,0,3,5,27,1.0,1.0,0.0,0.0,0.0,1.0,1.0,8,3,5,1.0,1.0,0.0
9612278,4,2,2,2,2,2,2,14,1.0,1.0,0.0,0.0,1.0,0.0,0.0,7,4,3,3.0,3.0,0.0
111411,0,0,0,0,0,0,0,97,0.0,0.0,0.0,0.0,0.0,0.0,0.0,5,0,5,,,
3225,5,4,1,1,0,5,31,12,1.0,1.0,0.0,0.0,0.0,1.0,14.0,38,5,33,4.0,1.0,3.0
9706504,5,3,2,2,0,5,26,51,5.0,3.0,2.0,2.0,0.0,5.0,18.0,19,5,14,7.0,3.0,4.0
9810273,7,2,5,10,0,7,55,56,7.0,2.0,5.0,10.0,0.0,7.0,55.0,17,7,10,16.0,6.0,10.0
9805402,6,6,0,0,2,4,11,56,4.0,4.0,0.0,0.0,0.0,4.0,9.0,10,6,4,1.0,1.0,0.0
106163,19,1,18,94,0,19,116,37,18.0,1.0,17.0,91.0,0.0,18.0,100.0,28,19,9,23.0,17.0,6.0
211251,6,3,3,4,0,6,48,193,4.0,3.0,1.0,1.0,0.0,4.0,26.0,52,6,46,18.0,3.0,15.0
9510291,2,1,1,1,0,2,8,47,2.0,1.0,1.0,1.0,1.0,1.0,1.0,12,2,10,1.0,1.0,0.0
9302233,13,8,5,8,6,7,7,38,7.0,4.0,3.0,3.0,2.0,5.0,5.0,14,13,1,3.0,3.0,0.0
6147,11,2,9,20,4,7,10,172,8.0,1.0,7.0,17.0,1.0,7.0,7.0,14,11,3,8.0,7.0,1.0
9608421,4,4,0,0,2,2,3,5,0.0,0.0,0.0,0.0,0.0,0.0,0.0,19,4,15,1.0,0.0,1.0
9406242,8,6,2,2,8,0,0,22,3.0,1.0,2.0,2.0,3.0,0.0,0.0,12,8,4,3.0,3.0,0.0
9904499,6,4,2,3,5,1,1,395,4.0,2.0,2.0,3.0,4.0,0.0,0.0,7,6,1,3.0,3.0,0.0
9403380,5,5,0,0,3,2,2,100,2.0,2.0,0.0,0.0,0.0,2.0,2.0,6,5,1,1.0,1.0,0.0
212343,1,1,0,0,0,1,1,8,0.0,0.0,0.0,0.0,0.0,0.0,0.0,14,1,13,6.0,0.0,6.0
9404249,8,1,7,23,8,0,0,142,8.0,1.0,7.0,23.0,8.0,0.0,0.0,8,8,0,7.0,7.0,0.0
9809496,5,1,4,6,0,5,13,303,4.0,1.0,3.0,5.0,0.0,4.0,4.0,18,5,13,5.0,4.0,1.0
9809272,5,2,3,3,0,5,24,191,4.0,1.0,3.0,3.0,0.0,4.0,15.0,16,5,11,12.0,4.0,8.0
9404254,1,1,0,0,1,0,0,941,,,,,,,,1,1,0,,,
9017,7,5,2,2,3,4,17,28,3.0,2.0,1.0,1.0,0.0,3.0,7.0,21,7,14,7.0,2.0,5.0
10112,2,1,1,1,0,2,8,17,,,,,,,,9,2,7,6.0,2.0,4.0
9704323,8,2,6,8,0,8,62,7,7.0,2.0,5.0,7.0,0.0,7.0,47.0,27,8,19,16.0,5.0,11.0
9601204,3,2,1,1,1,2,15,1,2.0,1.0,1.0,1.0,0.0,2.0,11.0,26,3,23,13.0,1.0,12.0
9704437,1,1,0,0,1,0,0,391,0.0,0.0,0.0,0.0,0.0,0.0,0.0,7,1,6,3.0,0.0,3.0
209244,5,2,3,4,0,5,69,73,0.0,0.0,0.0,0.0,0.0,0.0,0.0,281,5,276,36.0,0.0,36.0
3270,9,3,6,14,0,9,63,73,9.0,3.0,6.0,14.0,0.0,9.0,63.0,18,9,9,17.0,8.0,9.0
211019,4,2,2,2,0,4,20,219,2.0,1.0,1.0,1.0,0.0,2.0,4.0,16,4,12,6.0,2.0,4.0
9801439,6,4,2,3,1,5,11,15,3.0,2.0,1.0,1.0,2.0,1.0,1.0,18,6,12,5.0,3.0,2.0
9811366,13,5,8,14,2,11,41,13,7.0,2.0,5.0,10.0,0.0,7.0,29.0,22,13,9,12.0,5.0,7.0
9807527,9,7,2,3,1,8,39,16,7.0,5.0,2.0,3.0,0.0,7.0,36.0,17,9,8,,,
9507257,6,2,4,8,4,2,2,61,0.0,0.0,0.0,0.0,0.0,0.0,0.0,17,6,11,1.0,0.0,1.0
7033,5,4,1,1,1,4,14,91,1.0,1.0,0.0,0.0,0.0,1.0,3.0,17,5,12,4.0,2.0,2.0
9602204,2,1,1,1,2,0,0,1345,1.0,1.0,0.0,0.0,1.0,0.0,0.0,2,2,0,1.0,1.0,0.0
9210213,6,3,3,6,6,0,0,19,2.0,2.0,0.0,0.0,2.0,0.0,0.0,6,6,0,5.0,5.0,0.0
9812379,1,1,0,0,0,1,2,238,1.0,1.0,0.0,0.0,0.0,1.0,2.0,5,1,4,3.0,1.0,2.0
9908355,17,3,14,53,1,16,68,68,14.0,3.0,11.0,44.0,0.0,14.0,57.0,27,17,10,18.0,13.0,5.0
9410329,7,4,3,3,0,7,13,187,3.0,3.0,0.0,0.0,1.0,2.0,2.0,10,7,3,3.0,2.0,1.0
9709238,2,2,0,0,0,2,9,245,1.0,1.0,0.0,0.0,0.0,1.0,3.0,12,2,10,6.0,1.0,5.0
9405235,4,4,0,0,0,4,8,62,3.0,3.0,0.0,0.0,0.0,3.0,7.0,14,4,10,5.0,0.0,5.0
9812212,12,5,7,8,2,10,32,57,7.0,3.0,4.0,5.0,0.0,7.0,23.0,25,12,13,8.0,3.0,5.0
9603348,8,2,6,8,0,8,20,154,8.0,2.0,6.0,8.0,0.0,8.0,20.0,15,8,7,10.0,5.0,5.0
9412244,10,1,9,16,9,1,1,79,6.0,1.0,5.0,9.0,6.0,0.0,0.0,15,10,5,4.0,4.0,0.0
212107,2,2,0,0,0,2,12,22,1.0,1.0,0.0,0.0,0.0,1.0,6.0,39,2,37,15.0,1.0,14.0
111181,3,2,1,1,0,3,5,205,0.0,0.0,0.0,0.0,0.0,0.0,0.0,8,3,5,5.0,0.0,5.0
9803394,26,13,13,55,3,23,49,112,19.0,6.0,13.0,54.0,0.0,19.0,32.0,39,26,13,18.0,15.0,3.0
9803326,9,4,5,7,2,7,7,204,0.0,0.0,0.0,0.0,0.0,0.0,0.0,26,9,17,5.0,5.0,0.0
111318,2,1,1,1,0,2,41,48,2.0,1.0,1.0,1.0,0.0,2.0,37.0,25,2,23,18.0,2.0,16.0
2156,12,9,3,3,9,3,3,9,7.0,7.0,0.0,0.0,7.0,0.0,0.0,13,12,1,3.0,2.0,1.0
9607380,1,1,0,0,0,1,1,155,0.0,0.0,0.0,0.0,0.0,0.0,0.0,5,1,4,3.0,0.0,3.0
9806428,20,3,17,61,0,20,61,122,16.0,3.0,13.0,46.0,0.0,16.0,26.0,32,20,12,16.0,14.0,2.0
9911541,26,6,20,72,3,23,57,4,19.0,5.0,14.0,50.0,3.0,16.0,30.0,44,26,18,9.0,7.0,2.0
12060,1,1,0,0,1,0,0,327,0.0,0.0,0.0,0.0,0.0,0.0,0.0,3,1,2,2.0,1.0,1.0
111432,18,5,13,30,1,17,71,0,10.0,2.0,8.0,21.0,0.0,10.0,47.0,31,18,13,18.0,9.0,9.0
9903483,7,3,4,5,1,6,24,8,1.0,1.0,0.0,0.0,0.0,1.0,1.0,17,7,10,2.0,2.0,0.0
9712250,7,4,3,5,4,3,5,65,4.0,2.0,2.0,3.0,2.0,2.0,3.0,10,7,3,1.0,0.0,1.0
9602331,4,4,0,0,0,4,7,41,2.0,2.0,0.0,0.0,0.0,2.0,3.0,18,4,14,4.0,2.0,2.0
104071,9,6,3,3,0,9,48,51,6.0,3.0,3.0,3.0,0.0,6.0,34.0,27,9,18,17.0,6.0,11.0
209117,3,2,1,1,0,3,32,0,2.0,1.0,1.0,1.0,0.0,2.0,14.0,60,3,57,22.0,0.0,22.0
204240,5,5,0,0,1,4,39,10,1.0,1.0,0.0,0.0,0.0,1.0,6.0,74,5,69,13.0,1.0,12.0
206307,6,2,4,8,0,6,55,37,6.0,2.0,4.0,8.0,0.0,6.0,54.0,42,6,36,18.0,4.0,14.0
9804257,11,3,8,12,3,8,16,47,6.0,2.0,4.0,5.0,1.0,5.0,5.0,17,11,6,5.0,5.0,0.0
9903495,11,4,7,14,6,5,5,273,2.0,2.0,0.0,0.0,0.0,2.0,2.0,21,11,10,7.0,7.0,0.0
9407348,7,5,2,2,6,1,1,36,2.0,2.0,0.0,0.0,1.0,1.0,1.0,9,7,2,4.0,4.0,0.0
9405393,4,1,3,5,0,4,19,19,0.0,0.0,0.0,0.0,0.0,0.0,0.0,10,4,6,9.0,4.0,5.0
9904410,4,4,0,0,1,3,15,112,3.0,3.0,0.0,0.0,0.0,3.0,15.0,12,4,8,9.0,3.0,6.0
211359,7,4,3,3,0,7,17,29,0.0,0.0,0.0,0.0,0.0,0.0,0.0,36,7,29,2.0,0.0,2.0
206280,4,4,0,0,0,4,16,38,1.0,1.0,0.0,0.0,0.0,1.0,8.0,21,4,17,12.0,1.0,11.0
205073,3,3,0,0,0,3,15,121,2.0,2.0,0.0,0.0,0.0,2.0,7.0,20,3,17,7.0,2.0,5.0
9804395,0,0,0,0,0,0,0,212,0.0,0.0,0.0,0.0,0.0,0.0,0.0,4,0,4,3.0,0.0,3.0
9406367,0,0,0,0,0,0,0,358,0.0,0.0,0.0,0.0,0.0,0.0,0.0,7,0,7,4.0,0.0,4.0
8277,0,0,0,0,0,0,0,59,0.0,0.0,0.0,0.0,0.0,0.0,0.0,5,0,5,1.0,0.0,1.0
109147,2,2,0,0,0,2,7,19,1.0,1.0,0.0,0.0,0.0,1.0,2.0,15,2,13,4.0,1.0,3.0
9909321,3,1,2,2,0,3,10,191,3.0,1.0,2.0,2.0,0.0,3.0,10.0,10,3,7,9.0,3.0,6.0
212161,1,1,0,0,0,1,20,57,1.0,1.0,0.0,0.0,0.0,1.0,11.0,33,1,32,7.0,0.0,7.0
107044,1,1,0,0,0,1,3,144,1.0,1.0,0.0,0.0,0.0,1.0,3.0,10,1,9,5.0,1.0,4.0
9506279,0,0,0,0,0,0,0,44,,,,,,,,2,0,2,1.0,0.0,1.0
103315,8,2,6,11,2,6,10,109,7.0,2.0,5.0,10.0,1.0,6.0,10.0,10,8,2,1.0,1.0,0.0
9504255,0,0,0,0,0,0,0,17,,,,,,,,5,0,5,1.0,0.0,1.0
10053,1,1,0,0,1,0,0,116,,,,,,,,3,1,2,,,
9812240,1,1,0,0,1,0,0,18,0.0,0.0,0.0,0.0,0.0,0.0,0.0,6,1,5,1.0,0.0,1.0
9147,5,5,0,0,0,5,38,40,4.0,4.0,0.0,0.0,0.0,4.0,36.0,19,5,14,16.0,4.0,12.0
12128,2,2,0,0,1,1,6,174,1.0,1.0,0.0,0.0,0.0,1.0,6.0,15,2,13,11.0,1.0,10.0
9801419,3,3,0,0,0,3,4,24,3.0,3.0,0.0,0.0,3.0,0.0,0.0,10,3,7,1.0,1.0,0.0
9606288,1,1,0,0,1,0,0,25,0.0,0.0,0.0,0.0,0.0,0.0,0.0,7,1,6,1.0,0.0,1.0
9409459,5,2,3,3,0,5,5,90,5.0,2.0,3.0,3.0,0.0,5.0,5.0,6,5,1,,,
111321,0,0,0,0,0,0,0,333,0.0,0.0,0.0,0.0,0.0,0.0,0.0,1,0,1,1.0,0.0,1.0
10147,3,2,1,1,0,3,10,168,3.0,2.0,1.0,1.0,0.0,3.0,10.0,7,3,4,6.0,2.0,4.0
101026,1,1,0,0,0,1,2,0,0.0,0.0,0.0,0.0,0.0,0.0,0.0,23,1,22,2.0,0.0,2.0
208067,5,3,2,2,0,5,77,23,4.0,2.0,2.0,2.0,0.0,4.0,52.0,42,5,37,25.0,4.0,21.0
11177,9,6,3,4,0,9,84,2,1.0,1.0,0.0,0.0,0.0,1.0,9.0,66,9,57,15.0,0.0,15.0
9809218,3,3,0,0,1,2,12,136,2.0,2.0,0.0,0.0,0.0,2.0,11.0,13,3,10,9.0,1.0,8.0
9703324,11,6,5,10,2,9,57,130,6.0,2.0,4.0,6.0,0.0,6.0,29.0,24,11,13,13.0,6.0,7.0
9307209,2,2,0,0,1,1,1,325,2.0,2.0,0.0,0.0,1.0,1.0,1.0,3,2,1,3.0,2.0,1.0
9304209,13,9,4,5,9,4,4,363,4.0,2.0,2.0,3.0,1.0,3.0,3.0,14,13,1,3.0,2.0,1.0
9184,0,0,0,0,0,0,0,41,0.0,0.0,0.0,0.0,0.0,0.0,0.0,2,0,2,2.0,0.0,2.0
12063,2,2,0,0,0,2,12,1,0.0,0.0,0.0,0.0,0.0,0.0,0.0,48,2,46,5.0,0.0,5.0
106228,2,1,1,1,0,2,14,9,2.0,1.0,1.0,1.0,0.0,2.0,14.0,13,2,11,1.0,1.0,0.0
203092,9,1,8,15,0,9,59,62,8.0,1.0,7.0,14.0,0.0,8.0,48.0,32,9,23,17.0,8.0,9.0
9511203,7,4,3,4,7,0,0,64,1.0,1.0,0.0,0.0,1.0,0.0,0.0,7,7,0,2.0,2.0,0.0
103341,2,2,0,0,0,2,13,60,1.0,1.0,0.0,0.0,0.0,1.0,3.0,16,2,14,4.0,0.0,4.0
9407263,3,3,0,0,3,0,0,29,1.0,1.0,0.0,0.0,1.0,0.0,0.0,7,3,4,1.0,0.0,1.0
9910327,4,3,1,2,0,4,17,74,1.0,1.0,0.0,0.0,0.0,1.0,2.0,22,4,18,5.0,1.0,4.0
106184,8,4,4,6,0,8,55,68,8.0,4.0,4.0,6.0,1.0,7.0,48.0,21,8,13,15.0,6.0,9.0
9150,5,2,3,5,0,5,30,66,1.0,1.0,0.0,0.0,0.0,1.0,4.0,18,5,13,2.0,1.0,1.0
9805223,3,2,1,1,0,3,23,98,3.0,2.0,1.0,1.0,0.0,3.0,23.0,14,3,11,11.0,3.0,8.0
102073,0,0,0,0,0,0,0,230,0.0,0.0,0.0,0.0,0.0,0.0,0.0,2,0,2,2.0,0.0,2.0
110178,2,1,1,1,0,2,4,212,1.0,1.0,0.0,0.0,0.0,1.0,3.0,7,2,5,4.0,2.0,2.0
9901366,2,2,0,0,0,2,2,6,0.0,0.0,0.0,0.0,0.0,0.0,0.0,27,2,25,3.0,0.0,3.0
205068,5,2,3,3,0,5,84,28,4.0,1.0,3.0,3.0,0.0,4.0,81.0,32,5,27,30.0,4.0,26.0
9608255,5,4,1,1,1,4,12,104,3.0,2.0,1.0,1.0,0.0,3.0,9.0,9,5,4,6.0,2.0,4.0
6293,1,1,0,0,0,1,22,40,1.0,1.0,0.0,0.0,0.0,1.0,16.0,25,1,24,17.0,1.0,16.0
201179,2,2,0,0,0,2,5,53,0.0,0.0,0.0,0.0,0.0,0.0,0.0,17,2,15,2.0,1.0,1.0
9508260,2,2,0,0,0,2,5,17,1.0,1.0,0.0,0.0,0.0,1.0,2.0,22,2,20,2.0,0.0,2.0
9412368,4,1,3,4,4,0,0,134,3.0,1.0,2.0,3.0,3.0,0.0,0.0,4,4,0,,,
9604239,4,1,3,5,0,4,17,60,2.0,1.0,1.0,1.0,0.0,2.0,5.0,22,4,18,9.0,2.0,7.0
9907323,4,2,2,2,2,2,7,113,0.0,0.0,0.0,0.0,0.0,0.0,0.0,18,4,14,5.0,1.0,4.0
9810547,1,1,0,0,0,1,6,17,1.0,1.0,0.0,0.0,0.0,1.0,6.0,14,1,13,,,
9409318,6,4,2,2,0,6,28,1,1.0,1.0,0.0,0.0,0.0,1.0,1.0,15,6,9,2.0,1.0,1.0
9810465,2,1,1,1,0,2,4,127,2.0,1.0,1.0,1.0,1.0,1.0,1.0,6,2,4,,,
9305347,3,3,0,0,3,0,0,1400,,,,,,,,3,3,0,1.0,1.0,0.0
9610349,8,5,3,4,5,3,5,30,3.0,1.0,2.0,3.0,3.0,0.0,0.0,13,8,5,1.0,0.0,1.0
9603264,6,5,1,1,3,3,9,52,1.0,1.0,0.0,0.0,0.0,1.0,3.0,20,6,14,5.0,0.0,5.0
105039,1,1,0,0,1,0,0,16,0.0,0.0,0.0,0.0,0.0,0.0,0.0,23,1,22,6.0,0.0,6.0
9712388,9,4,5,8,2,7,13,84,8.0,4.0,4.0,7.0,2.0,6.0,12.0,15,9,6,6.0,2.0,4.0
203128,3,3,0,0,0,3,23,65,3.0,3.0,0.0,0.0,0.0,3.0,20.0,26,3,23,12.0,2.0,10.0
203236,3,3,0,0,1,2,3,289,1.0,1.0,0.0,0.0,0.0,1.0,1.0,11,3,8,8.0,1.0,7.0
3302,2,1,1,1,0,2,12,22,2.0,1.0,1.0,1.0,0.0,2.0,12.0,8,2,6,1.0,1.0,0.0
9308320,2,1,1,1,2,0,0,485,2.0,1.0,1.0,1.0,2.0,0.0,0.0,2,2,0,2.0,2.0,0.0
9612290,7,2,5,10,7,0,0,82,2.0,1.0,1.0,1.0,2.0,0.0,0.0,7,7,0,2.0,2.0,0.0
9910285,3,3,0,0,3,0,0,262,1.0,1.0,0.0,0.0,1.0,0.0,0.0,4,3,1,1.0,1.0,0.0
203030,6,2,4,5,0,6,108,11,5.0,1.0,4.0,5.0,0.0,5.0,103.0,65,6,59,41.0,4.0,37.0
11258,2,2,0,0,1,1,7,6,1.0,1.0,0.0,0.0,0.0,1.0,2.0,26,2,24,7.0,0.0,7.0
9702406,5,4,1,1,3,2,5,203,2.0,2.0,0.0,0.0,0.0,2.0,4.0,10,5,5,4.0,2.0,2.0
9304220,5,3,2,3,5,0,0,136,4.0,2.0,2.0,3.0,4.0,0.0,0.0,5,5,0,2.0,2.0,0.0
9603357,5,3,2,4,1,4,4,83,1.0,1.0,0.0,0.0,1.0,0.0,0.0,7,5,2,5.0,3.0,2.0
111098,10,4,6,12,0,10,59,20,7.0,4.0,3.0,5.0,0.0,7.0,49.0,27,10,17,8.0,6.0,2.0
212270,14,9,5,10,2,12,82,0,5.0,2.0,3.0,4.0,0.0,5.0,39.0,34,14,20,17.0,3.0,14.0
9907338,12,4,8,17,6,6,10,76,7.0,2.0,5.0,11.0,1.0,6.0,10.0,15,12,3,9.0,6.0,3.0
9709239,4,3,1,1,0,4,20,5,3.0,2.0,1.0,1.0,0.0,3.0,15.0,14,4,10,9.0,3.0,6.0
111155,3,2,1,1,0,3,41,23,1.0,1.0,0.0,0.0,0.0,1.0,22.0,40,3,37,24.0,1.0,23.0
12150,4,2,2,2,0,4,24,158,3.0,2.0,1.0,1.0,0.0,3.0,16.0,16,4,12,9.0,3.0,6.0
209265,2,1,1,1,0,2,11,1,0.0,0.0,0.0,0.0,0.0,0.0,0.0,17,2,15,,,
9609495,5,2,3,5,0,5,9,166,5.0,2.0,3.0,5.0,0.0,5.0,7.0,8,5,3,6.0,4.0,2.0
9903482,1,1,0,0,0,1,17,10,0.0,0.0,0.0,0.0,0.0,0.0,0.0,39,1,38,7.0,0.0,7.0
9712484,2,1,1,1,0,2,4,12,0.0,0.0,0.0,0.0,0.0,0.0,0.0,9,2,7,2.0,0.0,2.0
105079,8,2,6,8,0,8,51,20,7.0,1.0,6.0,8.0,0.0,7.0,49.0,20,8,12,5.0,5.0,0.0
9503395,0,0,0,0,0,0,0,271,0.0,0.0,0.0,0.0,0.0,0.0,0.0,3,0,3,2.0,0.0,2.0
2226,7,6,1,1,3,4,6,18,3.0,3.0,0.0,0.0,2.0,1.0,1.0,11,7,4,2.0,1.0,1.0
9809284,1,1,0,0,0,1,6,1,0.0,0.0,0.0,0.0,0.0,0.0,0.0,26,1,25,2.0,0.0,2.0
9708218,3,2,1,1,0,3,18,71,2.0,1.0,1.0,1.0,0.0,2.0,13.0,18,3,15,1.0,1.0,0.0
8163,5,5,0,0,2,3,22,59,3.0,3.0,0.0,0.0,0.0,3.0,19.0,17,5,12,10.0,3.0,7.0
210319,4,4,0,0,0,4,35,6,2.0,2.0,0.0,0.0,0.0,2.0,28.0,33,4,29,5.0,2.0,3.0
9404290,11,6,5,7,11,0,0,148,10.0,5.0,5.0,7.0,10.0,0.0,0.0,12,11,1,6.0,6.0,0.0
112245,7,2,5,8,0,7,38,78,5.0,2.0,3.0,5.0,0.0,5.0,23.0,33,7,26,12.0,5.0,7.0
201299,5,5,0,0,1,4,18,31,4.0,4.0,0.0,0.0,1.0,3.0,13.0,23,5,18,9.0,1.0,8.0
9308307,4,4,0,0,4,0,0,660,1.0,1.0,0.0,0.0,1.0,0.0,0.0,4,4,0,1.0,1.0,0.0
9403299,1,1,0,0,1,0,0,171,0.0,0.0,0.0,0.0,0.0,0.0,0.0,4,1,3,3.0,0.0,3.0
3253,5,2,3,4,0,5,34,36,5.0,2.0,3.0,4.0,0.0,5.0,14.0,13,5,8,8.0,5.0,3.0
10349,5,3,2,4,0,5,22,32,4.0,2.0,2.0,4.0,0.0,4.0,9.0,23,5,18,12.0,3.0,9.0
106225,1,1,0,0,1,0,0,147,0.0,0.0,0.0,0.0,0.0,0.0,0.0,14,1,13,5.0,0.0,5.0
9212300,1,1,0,0,1,0,0,91,1.0,1.0,0.0,0.0,1.0,0.0,0.0,1,1,0,1.0,1.0,0.0
108058,1,1,0,0,1,0,0,558,1.0,1.0,0.0,0.0,1.0,0.0,0.0,1,1,0,1.0,1.0,0.0
9707356,8,5,3,4,2,6,15,110,4.0,2.0,2.0,2.0,0.0,4.0,8.0,12,8,4,2.0,1.0,1.0
8038,11,8,3,3,1,10,27,27,9.0,6.0,3.0,3.0,0.0,9.0,22.0,23,11,12,6.0,6.0,0.0
7171,1,1,0,0,1,0,0,67,0.0,0.0,0.0,0.0,0.0,0.0,0.0,10,1,9,1.0,0.0,1.0
201132,2,2,0,0,1,1,4,4,0.0,0.0,0.0,0.0,0.0,0.0,0.0,12,2,10,1.0,0.0,1.0
9710511,5,3,2,3,4,1,3,475,1.0,1.0,0.0,0.0,1.0,0.0,0.0,9,5,4,1.0,1.0,0.0
9510339,1,1,0,0,1,0,0,1572,,,,,,,,4,1,3,,,
103181,2,2,0,0,0,2,9,40,1.0,1.0,0.0,0.0,0.0,1.0,4.0,20,2,18,4.0,1.0,3.0
11330,2,1,1,1,2,0,0,75,0.0,0.0,0.0,0.0,0.0,0.0,0.0,34,2,32,11.0,0.0,11.0
9810299,3,1,2,3,0,3,4,31,3.0,1.0,2.0,3.0,0.0,3.0,4.0,9,3,6,3.0,3.0,0.0
207070,5,1,4,8,1,4,14,55,5.0,1.0,4.0,8.0,4.0,1.0,1.0,26,5,21,3.0,0.0,3.0
9307288,1,1,0,0,1,0,0,75,,,,,,,,4,1,3,,,
9904447,2,1,1,1,0,2,4,153,2.0,1.0,1.0,1.0,2.0,0.0,0.0,4,2,2,2.0,2.0,0.0
9802353,2,2,0,0,1,1,2,65,1.0,1.0,0.0,0.0,0.0,1.0,1.0,4,2,2,3.0,2.0,1.0
9810431,1,1,0,0,0,1,2,76,0.0,0.0,0.0,0.0,0.0,0.0,0.0,6,1,5,3.0,0.0,3.0
9805302,4,3,1,1,0,4,8,15,0.0,0.0,0.0,0.0,0.0,0.0,0.0,29,4,25,21.0,0.0,21.0
9911333,2,2,0,0,1,1,2,207,0.0,0.0,0.0,0.0,0.0,0.0,0.0,4,2,2,1.0,0.0,1.0
2174,5,4,1,1,0,5,5,242,3.0,2.0,1.0,1.0,0.0,3.0,3.0,9,5,4,2.0,2.0,0.0
110122,5,3,2,2,5,0,0,18,1.0,1.0,0.0,0.0,1.0,0.0,0.0,7,5,2,1.0,0.0,1.0
9506308,3,2,1,1,1,2,3,195,0.0,0.0,0.0,0.0,0.0,0.0,0.0,5,3,2,2.0,1.0,1.0
3069,0,0,0,0,0,0,0,299,0.0,0.0,0.0,0.0,0.0,0.0,0.0,9,0,9,1.0,0.0,1.0
104036,2,2,0,0,0,2,7,191,2.0,2.0,0.0,0.0,0.0,2.0,6.0,8,2,6,3.0,2.0,1.0
9504425,2,2,0,0,0,2,2,85,0.0,0.0,0.0,0.0,0.0,0.0,0.0,10,2,8,2.0,0.0,2.0
9803376,4,1,3,4,1,3,10,120,4.0,1.0,3.0,4.0,1.0,3.0,3.0,8,4,4,6.0,4.0,2.0
10105,2,2,0,0,0,2,5,191,2.0,2.0,0.0,0.0,0.0,2.0,4.0,13,2,11,4.0,1.0,3.0
201064,0,0,0,0,0,0,0,70,0.0,0.0,0.0,0.0,0.0,0.0,0.0,5,0,5,1.0,0.0,1.0
206290,5,4,1,1,0,5,50,16,4.0,3.0,1.0,1.0,0.0,4.0,46.0,26,5,21,10.0,3.0,7.0
9907392,1,1,0,0,0,1,3,16,0.0,0.0,0.0,0.0,0.0,0.0,0.0,21,1,20,2.0,0.0,2.0
109032,11,4,7,14,3,8,45,108,8.0,2.0,6.0,13.0,0.0,8.0,45.0,20,11,9,12.0,7.0,5.0
301260,0,0,0,0,0,0,0,249,0.0,0.0,0.0,0.0,0.0,0.0,0.0,6,0,6,2.0,0.0,2.0
201303,8,3,5,8,0,8,34,146,8.0,3.0,5.0,8.0,0.0,8.0,33.0,16,8,8,12.0,6.0,6.0
9408293,1,1,0,0,1,0,0,1718,,,,,,,,1,1,0,,,
9811209,2,2,0,0,2,0,0,157,,,,,,,,2,2,0,,,
105227,6,2,4,5,0,6,70,8,3.0,2.0,1.0,1.0,0.0,3.0,32.0,38,6,32,16.0,3.0,13.0
9912489,2,1,1,1,2,0,0,258,0.0,0.0,0.0,0.0,0.0,0.0,0.0,12,2,10,4.0,0.0,4.0
9305333,4,4,0,0,4,0,0,523,3.0,3.0,0.0,0.0,3.0,0.0,0.0,4,4,0,3.0,3.0,0.0
104192,2,1,1,1,0,2,17,11,2.0,1.0,1.0,1.0,0.0,2.0,7.0,37,2,35,6.0,2.0,4.0
9606257,4,3,1,1,1,3,3,85,2.0,1.0,1.0,1.0,2.0,0.0,0.0,7,4,3,4.0,2.0,2.0
9212211,4,3,1,2,4,0,0,69,2.0,2.0,0.0,0.0,2.0,0.0,0.0,4,4,0,1.0,1.0,0.0
208136,4,4,0,0,0,4,37,3,2.0,2.0,0.0,0.0,0.0,2.0,18.0,30,4,26,15.0,2.0,13.0
9803402,2,1,1,1,2,0,0,233,2.0,1.0,1.0,1.0,2.0,0.0,0.0,3,2,1,3.0,2.0,1.0
101197,1,1,0,0,1,0,0,1969,1.0,1.0,0.0,0.0,1.0,0.0,0.0,3,1,2,,,
9801255,4,3,1,1,0,4,7,133,3.0,3.0,0.0,0.0,0.0,3.0,5.0,10,4,6,6.0,1.0,5.0
204321,1,1,0,0,0,1,12,9,1.0,1.0,0.0,0.0,0.0,1.0,9.0,27,1,26,8.0,0.0,8.0
9802427,2,1,1,1,0,2,6,305,2.0,1.0,1.0,1.0,0.0,2.0,6.0,7,2,5,5.0,2.0,3.0
5300,7,3,4,10,0,7,9,136,5.0,1.0,4.0,10.0,0.0,5.0,5.0,9,7,2,6.0,5.0,1.0
9408283,4,2,2,3,4,0,0,330,3.0,2.0,1.0,1.0,3.0,0.0,0.0,4,4,0,3.0,3.0,0.0
9809576,4,1,3,3,1,3,30,53,2.0,1.0,1.0,1.0,0.0,2.0,22.0,31,4,27,22.0,1.0,21.0
209340,2,2,0,0,0,2,19,24,2.0,2.0,0.0,0.0,0.0,2.0,17.0,46,2,44,30.0,0.0,30.0
9901454,1,1,0,0,0,1,4,52,1.0,1.0,0.0,0.0,0.0,1.0,4.0,8,1,7,,,
9504297,0,0,0,0,0,0,0,150,,,,,,,,1,0,1,,,
9706477,1,1,0,0,0,1,1,74,0.0,0.0,0.0,0.0,0.0,0.0,0.0,8,1,7,2.0,0.0,2.0
9208212,1,1,0,0,1,0,0,559,1.0,1.0,0.0,0.0,1.0,0.0,0.0,1,1,0,1.0,1.0,0.0
105328,3,2,1,1,0,3,8,105,3.0,2.0,1.0,1.0,0.0,3.0,8.0,8,3,5,5.0,3.0,2.0
9512412,0,0,0,0,0,0,0,237,0.0,0.0,0.0,0.0,0.0,0.0,0.0,1,0,1,,,
9710299,3,1,2,2,0,3,6,35,0.0,0.0,0.0,0.0,0.0,0.0,0.0,26,3,23,5.0,3.0,2.0
9163,13,1,12,39,0,13,54,116,13.0,1.0,12.0,39.0,0.0,13.0,42.0,21,13,8,18.0,13.0,5.0
3293,0,0,0,0,0,0,0,171,0.0,0.0,0.0,0.0,0.0,0.0,0.0,6,0,6,2.0,0.0,2.0
8201,3,1,2,2,0,3,16,63,3.0,1.0,2.0,2.0,0.0,3.0,12.0,12,3,9,7.0,2.0,5.0
210154,0,0,0,0,0,0,0,100,0.0,0.0,0.0,0.0,0.0,0.0,0.0,25,0,25,2.0,0.0,2.0
101241,4,1,3,5,0,4,5,171,4.0,1.0,3.0,5.0,0.0,4.0,5.0,6,4,2,6.0,4.0,2.0
108223,2,1,1,1,0,2,6,101,2.0,1.0,1.0,1.0,0.0,2.0,5.0,9,2,7,5.0,2.0,3.0
9906460,9,1,8,22,0,9,24,82,9.0,1.0,8.0,22.0,0.0,9.0,24.0,15,9,6,11.0,6.0,5.0
8215,2,1,1,1,2,0,0,560,2.0,1.0,1.0,1.0,2.0,0.0,0.0,3,2,1,2.0,2.0,0.0
9908473,9,2,7,29,2,7,22,209,9.0,2.0,7.0,29.0,2.0,7.0,15.0,19,9,10,11.0,9.0,2.0
12091,4,4,0,0,1,3,10,189,4.0,4.0,0.0,0.0,1.0,3.0,10.0,12,4,8,8.0,3.0,5.0
9804394,3,2,1,1,0,3,15,117,3.0,2.0,1.0,1.0,0.0,3.0,11.0,16,3,13,6.0,2.0,4.0
9510249,3,1,2,2,2,1,6,235,3.0,1.0,2.0,2.0,2.0,1.0,2.0,9,3,6,3.0,2.0,1.0
9911269,1,1,0,0,0,1,2,1,0.0,0.0,0.0,0.0,0.0,0.0,0.0,50,1,49,10.0,0.0,10.0
9412232,1,1,0,0,0,1,1,369,1.0,1.0,0.0,0.0,0.0,1.0,1.0,2,1,1,2.0,1.0,1.0
9802322,6,3,3,4,6,0,0,195,3.0,1.0,2.0,2.0,3.0,0.0,0.0,6,6,0,3.0,3.0,0.0
8059,3,2,1,1,0,3,11,296,1.0,1.0,0.0,0.0,0.0,1.0,4.0,12,3,9,1.0,0.0,1.0
9286,11,5,6,13,0,11,53,80,9.0,4.0,5.0,11.0,0.0,9.0,38.0,23,11,12,14.0,8.0,6.0
9809235,0,0,0,0,0,0,0,34,0.0,0.0,0.0,0.0,0.0,0.0,0.0,10,0,10,2.0,0.0,2.0
211034,0,0,0,0,0,0,0,3,0.0,0.0,0.0,0.0,0.0,0.0,0.0,37,0,37,11.0,0.0,11.0
207059,2,2,0,0,0,2,7,2,2.0,2.0,0.0,0.0,0.0,2.0,3.0,29,2,27,7.0,1.0,6.0
9911352,0,0,0,0,0,0,0,97,0.0,0.0,0.0,0.0,0.0,0.0,0.0,3,0,3,2.0,0.0,2.0
112250,1,1,0,0,0,1,1,172,1.0,1.0,0.0,0.0,1.0,0.0,0.0,3,1,2,1.0,1.0,0.0
9911346,2,1,1,1,0,2,3,105,2.0,1.0,1.0,1.0,0.0,2.0,3.0,6,2,4,4.0,2.0,2.0
201295,2,1,1,1,0,2,7,23,0.0,0.0,0.0,0.0,0.0,0.0,0.0,44,2,42,20.0,0.0,20.0
9606298,1,1,0,0,1,0,0,269,1.0,1.0,0.0,0.0,1.0,0.0,0.0,1,1,0,1.0,1.0,0.0
9303297,1,1,0,0,1,0,0,93,0.0,0.0,0.0,0.0,0.0,0.0,0.0,5,1,4,1.0,0.0,1.0
9612216,1,1,0,0,0,1,5,76,1.0,1.0,0.0,0.0,0.0,1.0,5.0,6,1,5,6.0,1.0,5.0
206014,2,2,0,0,0,2,11,7,0.0,0.0,0.0,0.0,0.0,0.0,0.0,13,2,11,5.0,0.0,5.0
9501331,8,4,4,7,8,0,0,118,4.0,2.0,2.0,3.0,4.0,0.0,0.0,9,8,1,2.0,2.0,0.0
9608468,1,1,0,0,0,1,6,14,,,,,,,,7,1,6,,,
9607482,0,0,0,0,0,0,0,70,,,,,,,,4,0,4,,,
9603447,4,3,1,1,1,3,5,53,2.0,1.0,1.0,1.0,1.0,1.0,2.0,12,4,8,3.0,2.0,1.0
205037,8,3,5,10,0,8,160,11,8.0,3.0,5.0,10.0,0.0,8.0,159.0,52,8,44,37.0,8.0,29.0
9904296,6,4,2,3,0,6,9,195,5.0,3.0,2.0,3.0,5.0,0.0,0.0,12,6,6,5.0,5.0,0.0
104135,11,7,4,8,0,11,50,65,6.0,5.0,1.0,3.0,0.0,6.0,24.0,37,11,26,13.0,5.0,8.0
104289,10,3,7,11,1,9,30,31,5.0,2.0,3.0,3.0,0.0,5.0,10.0,27,10,17,4.0,4.0,0.0
9908225,10,1,9,25,6,4,4,8,5.0,1.0,4.0,9.0,4.0,1.0,1.0,12,10,2,7.0,7.0,0.0
9603309,0,0,0,0,0,0,0,223,0.0,0.0,0.0,0.0,0.0,0.0,0.0,3,0,3,1.0,0.0,1.0
3147,1,1,0,0,0,1,1,467,0.0,0.0,0.0,0.0,0.0,0.0,0.0,9,1,8,2.0,0.0,2.0
8309,1,1,0,0,0,1,1,16,1.0,1.0,0.0,0.0,0.0,1.0,1.0,33,1,32,20.0,0.0,20.0
9908465,5,3,2,3,0,5,10,288,2.0,1.0,1.0,1.0,1.0,1.0,1.0,15,5,10,1.0,1.0,0.0
9309261,8,5,3,5,8,0,0,96,5.0,3.0,2.0,3.0,5.0,0.0,0.0,9,8,1,1.0,1.0,0.0
9608319,10,7,3,4,2,8,12,137,3.0,3.0,0.0,0.0,1.0,2.0,3.0,19,10,9,5.0,3.0,2.0
208238,1,1,0,0,0,1,12,17,1.0,1.0,0.0,0.0,0.0,1.0,10.0,35,1,34,4.0,0.0,4.0
206083,3,2,1,1,1,2,2,71,2.0,1.0,1.0,1.0,2.0,0.0,0.0,8,3,5,1.0,1.0,0.0
206260,0,0,0,0,0,0,0,64,0.0,0.0,0.0,0.0,0.0,0.0,0.0,8,0,8,5.0,0.0,5.0
9911391,1,1,0,0,0,1,3,8,,,,,,,,7,1,6,,,
9505294,3,2,1,1,3,0,0,391,0.0,0.0,0.0,0.0,0.0,0.0,0.0,9,3,6,1.0,0.0,1.0
109065,0,0,0,0,0,0,0,185,0.0,0.0,0.0,0.0,0.0,0.0,0.0,3,0,3,3.0,0.0,3.0
6230,2,2,0,0,0,2,12,19,1.0,1.0,0.0,0.0,0.0,1.0,5.0,16,2,14,7.0,1.0,6.0
111123,5,3,2,2,2,3,6,339,4.0,2.0,2.0,2.0,3.0,1.0,1.0,10,5,5,6.0,4.0,2.0
9809511,0,0,0,0,0,0,0,7,0.0,0.0,0.0,0.0,0.0,0.0,0.0,17,0,17,1.0,0.0,1.0
207007,1,1,0,0,0,1,3,1,1.0,1.0,0.0,0.0,0.0,1.0,1.0,8,1,7,3.0,1.0,2.0
9403204,3,2,1,1,3,0,0,241,3.0,2.0,1.0,1.0,3.0,0.0,0.0,5,3,2,4.0,3.0,1.0
301061,6,5,1,1,0,6,40,0,2.0,2.0,0.0,0.0,0.0,2.0,7.0,116,6,110,11.0,0.0,11.0
103027,1,1,0,0,0,1,1,1631,,,,,,,,5,1,4,,,
5149,3,1,2,2,0,3,39,49,3.0,1.0,2.0,2.0,0.0,3.0,37.0,20,3,17,18.0,3.0,15.0
9908380,7,6,1,1,1,6,28,42,4.0,4.0,0.0,0.0,0.0,4.0,10.0,21,7,14,7.0,4.0,3.0
9710394,7,5,2,2,4,3,3,186,4.0,3.0,1.0,1.0,4.0,0.0,0.0,19,7,12,3.0,1.0,2.0
104144,2,1,1,1,0,2,50,69,2.0,1.0,1.0,1.0,0.0,2.0,20.0,29,2,27,12.0,2.0,10.0
203002,4,3,1,1,0,4,13,28,1.0,1.0,0.0,0.0,0.0,1.0,1.0,19,4,15,10.0,0.0,10.0
202135,2,1,1,1,0,2,16,29,0.0,0.0,0.0,0.0,0.0,0.0,0.0,14,2,12,4.0,0.0,4.0
9912241,3,1,2,3,0,3,16,8,3.0,1.0,2.0,3.0,0.0,3.0,9.0,17,3,14,6.0,3.0,3.0
105045,1,1,0,0,0,1,22,21,1.0,1.0,0.0,0.0,0.0,1.0,8.0,26,1,25,5.0,0.0,5.0
9710523,2,2,0,0,0,2,3,78,1.0,1.0,0.0,0.0,0.0,1.0,1.0,7,2,5,3.0,2.0,1.0
109041,5,3,2,2,0,5,82,7,2.0,1.0,1.0,1.0,0.0,2.0,51.0,57,5,52,25.0,2.0,23.0
9806251,1,1,0,0,0,1,6,174,1.0,1.0,0.0,0.0,0.0,1.0,3.0,12,1,11,1.0,0.0,1.0
12307,1,1,0,0,0,1,3,9,,,,,,,,8,1,7,2.0,0.0,2.0
101343,5,3,2,2,2,3,5,416,2.0,1.0,1.0,1.0,0.0,2.0,3.0,7,5,2,4.0,2.0,2.0
203183,4,4,0,0,1,3,14,8,2.0,2.0,0.0,0.0,0.0,2.0,3.0,38,4,34,9.0,0.0,9.0
7064,0,0,0,0,0,0,0,42,,,,,,,,2,0,2,,,
11298,4,4,0,0,0,4,14,101,0.0,0.0,0.0,0.0,0.0,0.0,0.0,45,4,41,8.0,0.0,8.0
102346,1,1,0,0,1,0,0,144,0.0,0.0,0.0,0.0,0.0,0.0,0.0,5,1,4,4.0,0.0,4.0
9808409,6,3,3,5,0,6,25,41,1.0,1.0,0.0,0.0,0.0,1.0,7.0,28,6,22,10.0,1.0,9.0
210179,3,3,0,0,0,3,11,102,3.0,3.0,0.0,0.0,1.0,2.0,4.0,11,3,8,5.0,3.0,2.0
204181,6,6,0,0,0,6,37,34,4.0,4.0,0.0,0.0,0.0,4.0,28.0,27,6,21,14.0,2.0,12.0
103156,0,0,0,0,0,0,0,224,0.0,0.0,0.0,0.0,0.0,0.0,0.0,5,0,5,4.0,0.0,4.0
9302241,1,1,0,0,1,0,0,1917,0.0,0.0,0.0,0.0,0.0,0.0,0.0,3,1,2,,,
9706506,0,0,0,0,0,0,0,211,0.0,0.0,0.0,0.0,0.0,0.0,0.0,2,0,2,1.0,0.0,1.0
101019,5,3,2,2,0,5,19,18,4.0,2.0,2.0,2.0,0.0,4.0,12.0,29,5,24,9.0,2.0,7.0
12070,1,1,0,0,0,1,2,65,1.0,1.0,0.0,0.0,0.0,1.0,2.0,5,1,4,2.0,1.0,1.0
106102,1,1,0,0,0,1,1,622,1.0,1.0,0.0,0.0,1.0,0.0,0.0,2,1,1,2.0,1.0,1.0
9509314,6,1,5,7,6,0,0,340,5.0,1.0,4.0,6.0,5.0,0.0,0.0,6,6,0,4.0,4.0,0.0
5295,2,1,1,1,0,2,26,12,2.0,1.0,1.0,1.0,0.0,2.0,20.0,17,2,15,3.0,1.0,2.0
9810287,0,0,0,0,0,0,0,70,0.0,0.0,0.0,0.0,0.0,0.0,0.0,4,0,4,,,
208222,2,2,0,0,0,2,5,50,0.0,0.0,0.0,0.0,0.0,0.0,0.0,26,2,24,7.0,0.0,7.0
205201,11,6,5,8,0,11,86,20,8.0,4.0,4.0,5.0,0.0,8.0,70.0,36,11,25,8.0,5.0,3.0
9803252,3,1,2,3,0,3,3,65,3.0,1.0,2.0,3.0,3.0,0.0,0.0,4,3,1,3.0,3.0,0.0
203038,0,0,0,0,0,0,0,7,0.0,0.0,0.0,0.0,0.0,0.0,0.0,29,0,29,14.0,0.0,14.0
101203,0,0,0,0,0,0,0,216,0.0,0.0,0.0,0.0,0.0,0.0,0.0,1,0,1,,,
9612244,4,4,0,0,3,1,2,72,2.0,2.0,0.0,0.0,2.0,0.0,0.0,6,4,2,2.0,1.0,1.0
9910363,1,1,0,0,0,1,1,64,1.0,1.0,0.0,0.0,0.0,1.0,1.0,10,1,9,2.0,0.0,2.0
206001,0,0,0,0,0,0,0,253,0.0,0.0,0.0,0.0,0.0,0.0,0.0,1,0,1,,,
104302,1,1,0,0,1,0,0,1142,,,,,,,,1,1,0,,,
9603429,3,2,1,1,0,3,4,180,3.0,2.0,1.0,1.0,0.0,3.0,4.0,5,3,2,5.0,3.0,2.0
105109,7,4,3,3,0,7,29,72,3.0,2.0,1.0,1.0,0.0,3.0,9.0,17,7,10,7.0,4.0,3.0
104084,5,5,0,0,1,4,8,31,3.0,3.0,0.0,0.0,3.0,0.0,0.0,10,5,5,3.0,3.0,0.0
206166,2,2,0,0,0,2,7,106,2.0,2.0,0.0,0.0,0.0,2.0,7.0,6,2,4,6.0,2.0,4.0
205266,2,2,0,0,0,2,6,219,2.0,2.0,0.0,0.0,0.0,2.0,5.0,7,2,5,1.0,1.0,0.0
9711493,0,0,0,0,0,0,0,450,0.0,0.0,0.0,0.0,0.0,0.0,0.0,3,0,3,2.0,0.0,2.0
201205,0,0,0,0,0,0,0,8,0.0,0.0,0.0,0.0,0.0,0.0,0.0,34,0,34,2.0,0.0,2.0
9310292,3,3,0,0,0,3,9,10,3.0,3.0,0.0,0.0,0.0,3.0,9.0,7,3,4,1.0,1.0,0.0
102166,1,1,0,0,0,1,3,0,0.0,0.0,0.0,0.0,0.0,0.0,0.0,17,1,16,2.0,0.0,2.0
111009,0,0,0,0,0,0,0,580,0.0,0.0,0.0,0.0,0.0,0.0,0.0,11,0,11,4.0,0.0,4.0
111370,0,0,0,0,0,0,0,673,0.0,0.0,0.0,0.0,0.0,0.0,0.0,2,0,2,1.0,0.0,1.0
9905411,1,1,0,0,1,0,0,513,0.0,0.0,0.0,0.0,0.0,0.0,0.0,2,1,1,1.0,0.0,1.0
10027,0,0,0,0,0,0,0,116,,,,,,,,2,0,2,,,
212284,1,1,0,0,0,1,6,11,0.0,0.0,0.0,0.0,0.0,0.0,0.0,16,1,15,2.0,0.0,2.0
101077,1,1,0,0,0,1,3,63,1.0,1.0,0.0,0.0,0.0,1.0,3.0,12,1,11,6.0,0.0,6.0
9509402,0,0,0,0,0,0,0,104,0.0,0.0,0.0,0.0,0.0,0.0,0.0,4,0,4,1.0,0.0,1.0
9812247,1,1,0,0,0,1,6,1,1.0,1.0,0.0,0.0,0.0,1.0,6.0,28,1,27,17.0,0.0,17.0
9808370,2,2,0,0,0,2,3,159,1.0,1.0,0.0,0.0,0.0,1.0,2.0,12,2,10,1.0,0.0,1.0
212028,5,4,1,1,0,5,42,2,3.0,2.0,1.0,1.0,0.0,3.0,22.0,36,5,31,17.0,2.0,15.0
1190,2,2,0,0,0,2,9,140,1.0,1.0,0.0,0.0,0.0,1.0,3.0,12,2,10,4.0,1.0,3.0
9706498,0,0,0,0,0,0,0,47,0.0,0.0,0.0,0.0,0.0,0.0,0.0,7,0,7,3.0,0.0,3.0
9701391,0,0,0,0,0,0,0,524,0.0,0.0,0.0,0.0,0.0,0.0,0.0,6,0,6,2.0,0.0,2.0
7002,6,4,2,2,2,4,4,71,0.0,0.0,0.0,0.0,0.0,0.0,0.0,17,6,11,5.0,0.0,5.0
211464,1,1,0,0,1,0,0,84,0.0,0.0,0.0,0.0,0.0,0.0,0.0,26,1,25,6.0,0.0,6.0
108243,8,3,5,14,0,8,27,11,6.0,2.0,4.0,13.0,1.0,5.0,9.0,21,8,13,3.0,2.0,1.0
9189,0,0,0,0,0,0,0,57,0.0,0.0,0.0,0.0,0.0,0.0,0.0,7,0,7,7.0,0.0,7.0
201047,5,2,3,4,2,3,6,209,3.0,1.0,2.0,3.0,3.0,0.0,0.0,10,5,5,,,
2175,0,0,0,0,0,0,0,35,0.0,0.0,0.0,0.0,0.0,0.0,0.0,6,0,6,3.0,0.0,3.0
1134,2,2,0,0,0,2,7,19,0.0,0.0,0.0,0.0,0.0,0.0,0.0,136,2,134,10.0,0.0,10.0
211197,2,2,0,0,0,2,33,7,2.0,2.0,0.0,0.0,0.0,2.0,27.0,24,2,22,16.0,2.0,14.0
9810203,0,0,0,0,0,0,0,188,0.0,0.0,0.0,0.0,0.0,0.0,0.0,6,0,6,3.0,0.0,3.0
9809328,2,1,1,1,0,2,6,53,1.0,1.0,0.0,0.0,0.0,1.0,4.0,10,2,8,1.0,0.0,1.0
9804226,1,1,0,0,0,1,1,599,1.0,1.0,0.0,0.0,0.0,1.0,1.0,2,1,1,2.0,1.0,1.0
9612386,0,0,0,0,0,0,0,237,0.0,0.0,0.0,0.0,0.0,0.0,0.0,5,0,5,1.0,0.0,1.0
109244,1,1,0,0,0,1,3,169,1.0,1.0,0.0,0.0,0.0,1.0,2.0,4,1,3,3.0,1.0,2.0
9912291,5,5,0,0,3,2,2,5,0.0,0.0,0.0,0.0,0.0,0.0,0.0,41,5,36,4.0,0.0,4.0
9409230,1,1,0,0,0,1,1,14,0.0,0.0,0.0,0.0,0.0,0.0,0.0,17,1,16,6.0,0.0,6.0
208155,2,1,1,1,0,2,17,16,2.0,1.0,1.0,1.0,0.0,2.0,8.0,35,2,33,2.0,1.0,1.0
9812211,3,2,1,1,1,2,3,270,2.0,1.0,1.0,1.0,0.0,2.0,3.0,5,3,2,4.0,2.0,2.0
208125,2,2,0,0,0,2,7,28,0.0,0.0,0.0,0.0,0.0,0.0,0.0,37,2,35,5.0,0.0,5.0
4212,3,2,1,1,1,2,8,104,2.0,1.0,1.0,1.0,0.0,2.0,2.0,8,3,5,4.0,2.0,2.0
104043,0,0,0,0,0,0,0,623,0.0,0.0,0.0,0.0,0.0,0.0,0.0,4,0,4,1.0,0.0,1.0
2188,1,1,0,0,0,1,1,375,1.0,1.0,0.0,0.0,0.0,1.0,1.0,3,1,2,3.0,1.0,2.0
12363,2,1,1,1,1,1,2,165,2.0,1.0,1.0,1.0,1.0,1.0,2.0,5,2,3,,,
212322,1,1,0,0,0,1,2,57,0.0,0.0,0.0,0.0,0.0,0.0,0.0,9,1,8,1.0,0.0,1.0
1207,1,1,0,0,1,0,0,32,0.0,0.0,0.0,0.0,0.0,0.0,0.0,26,1,25,20.0,0.0,20.0
9409385,0,0,0,0,0,0,0,2043,0.0,0.0,0.0,0.0,0.0,0.0,0.0,5,0,5,1.0,0.0,1.0
9607269,0,0,0,0,0,0,0,860,,,,,,,,2,0,2,,,
209025,0,0,0,0,0,0,0,45,0.0,0.0,0.0,0.0,0.0,0.0,0.0,14,0,14,10.0,0.0,10.0
9604274,3,3,0,0,2,1,1,272,2.0,2.0,0.0,0.0,2.0,0.0,0.0,4,3,1,2.0,1.0,1.0
9605249,2,2,0,0,0,2,2,188,1.0,1.0,0.0,0.0,0.0,1.0,1.0,4,2,2,2.0,1.0,1.0
9708281,2,2,0,0,1,1,1,248,2.0,2.0,0.0,0.0,1.0,1.0,1.0,5,2,3,3.0,2.0,1.0
9804207,0,0,0,0,0,0,0,194,0.0,0.0,0.0,0.0,0.0,0.0,0.0,2,0,2,,,
9603252,2,1,1,1,0,2,2,117,2.0,1.0,1.0,1.0,0.0,2.0,2.0,4,2,2,3.0,2.0,1.0
204216,4,3,1,1,0,4,13,221,2.0,2.0,0.0,0.0,0.0,2.0,7.0,11,4,7,6.0,2.0,4.0
205124,1,1,0,0,1,0,0,89,0.0,0.0,0.0,0.0,0.0,0.0,0.0,14,1,13,10.0,0.0,10.0
9211289,2,2,0,0,2,0,0,40,2.0,2.0,0.0,0.0,2.0,0.0,0.0,2,2,0,2.0,2.0,0.0
212331,3,3,0,0,1,2,18,37,2.0,2.0,0.0,0.0,0.0,2.0,18.0,42,3,39,20.0,2.0,18.0
301092,2,1,1,1,0,2,56,3,1.0,1.0,0.0,0.0,0.0,1.0,12.0,52,2,50,10.0,1.0,9.0
9808259,0,0,0,0,0,0,0,5,0.0,0.0,0.0,0.0,0.0,0.0,0.0,11,0,11,1.0,0.0,1.0
206185,1,1,0,0,1,0,0,198,1.0,1.0,0.0,0.0,1.0,0.0,0.0,4,1,3,1.0,1.0,0.0
210391,4,3,1,1,0,4,22,187,1.0,1.0,0.0,0.0,0.0,1.0,4.0,34,4,30,16.0,1.0,15.0
302266,0,0,0,0,0,0,0,4,0.0,0.0,0.0,0.0,0.0,0.0,0.0,42,0,42,5.0,0.0,5.0
6074,2,2,0,0,0,2,3,171,2.0,2.0,0.0,0.0,0.0,2.0,3.0,5,2,3,4.0,2.0,2.0
9812409,0,0,0,0,0,0,0,1370,0.0,0.0,0.0,0.0,0.0,0.0,0.0,3,0,3,,,
5266,1,1,0,0,0,1,5,251,0.0,0.0,0.0,0.0,0.0,0.0,0.0,7,1,6,,,
211232,1,1,0,0,0,1,1,27,0.0,0.0,0.0,0.0,0.0,0.0,0.0,19,1,18,3.0,0.0,3.0
9304291,1,1,0,0,1,0,0,99,1.0,1.0,0.0,0.0,1.0,0.0,0.0,1,1,0,1.0,1.0,0.0
9712539,1,1,0,0,1,0,0,39,0.0,0.0,0.0,0.0,0.0,0.0,0.0,16,1,15,1.0,0.0,1.0
11178,2,1,1,1,0,2,4,8,2.0,1.0,1.0,1.0,0.0,2.0,2.0,4,2,2,,,
9712227,1,1,0,0,0,1,5,25,0.0,0.0,0.0,0.0,0.0,0.0,0.0,10,1,9,7.0,0.0,7.0
9911508,2,1,1,1,0,2,6,109,0.0,0.0,0.0,0.0,0.0,0.0,0.0,10,2,8,1.0,0.0,1.0
9810346,0,0,0,0,0,0,0,208,0.0,0.0,0.0,0.0,0.0,0.0,0.0,6,0,6,3.0,0.0,3.0
9906493,0,0,0,0,0,0,0,1,0.0,0.0,0.0,0.0,0.0,0.0,0.0,41,0,41,1.0,0.0,1.0
110337,1,1,0,0,0,1,4,64,1.0,1.0,0.0,0.0,0.0,1.0,4.0,9,1,8,7.0,1.0,6.0
9194,0,0,0,0,0,0,0,127,0.0,0.0,0.0,0.0,0.0,0.0,0.0,8,0,8,,,
9609450,0,0,0,0,0,0,0,462,0.0,0.0,0.0,0.0,0.0,0.0,0.0,3,0,3,2.0,0.0,2.0
2274,0,0,0,0,0,0,0,21,0.0,0.0,0.0,0.0,0.0,0.0,0.0,4,0,4,,,
208247,2,2,0,0,0,2,6,64,1.0,1.0,0.0,0.0,0.0,1.0,2.0,7,2,5,4.0,2.0,2.0
9905482,1,1,0,0,0,1,4,15,1.0,1.0,0.0,0.0,0.0,1.0,2.0,9,1,8,3.0,1.0,2.0
9810372,1,1,0,0,1,0,0,687,1.0,1.0,0.0,0.0,1.0,0.0,0.0,1,1,0,1.0,1.0,0.0
210250,1,1,0,0,1,0,0,76,0.0,0.0,0.0,0.0,0.0,0.0,0.0,15,1,14,7.0,0.0,7.0
201313,1,1,0,0,0,1,9,1,1.0,1.0,0.0,0.0,0.0,1.0,4.0,28,1,27,1.0,1.0,0.0
12081,2,2,0,0,0,2,5,90,2.0,2.0,0.0,0.0,0.0,2.0,4.0,12,2,10,3.0,0.0,3.0
205223,4,4,0,0,1,3,7,9,0.0,0.0,0.0,0.0,0.0,0.0,0.0,13,4,9,4.0,0.0,4.0
9708391,4,3,1,1,0,4,20,91,4.0,3.0,1.0,1.0,0.0,4.0,20.0,16,4,12,8.0,3.0,5.0
9909491,0,0,0,0,0,0,0,150,0.0,0.0,0.0,0.0,0.0,0.0,0.0,5,0,5,,,
9242,1,1,0,0,1,0,0,389,1.0,1.0,0.0,0.0,1.0,0.0,0.0,2,1,1,1.0,1.0,0.0
201122,0,0,0,0,0,0,0,122,0.0,0.0,0.0,0.0,0.0,0.0,0.0,13,0,13,4.0,0.0,4.0
111034,1,1,0,0,0,1,2,141,0.0,0.0,0.0,0.0,0.0,0.0,0.0,12,1,11,2.0,1.0,1.0
201032,1,1,0,0,0,1,2,63,1.0,1.0,0.0,0.0,0.0,1.0,2.0,10,1,9,5.0,0.0,5.0
9605360,1,1,0,0,0,1,1,111,1.0,1.0,0.0,0.0,0.0,1.0,1.0,4,1,3,1.0,1.0,0.0
9507350,3,1,2,2,0,3,16,96,3.0,1.0,2.0,2.0,0.0,3.0,16.0,14,3,11,12.0,3.0,9.0
112166,3,3,0,0,0,3,32,27,3.0,3.0,0.0,0.0,0.0,3.0,26.0,28,3,25,13.0,2.0,11.0
9806341,0,0,0,0,0,0,0,140,0.0,0.0,0.0,0.0,0.0,0.0,0.0,6,0,6,5.0,0.0,5.0
9510446,0,0,0,0,0,0,0,1294,,,,,,,,2,0,2,1.0,0.0,1.0
3257,2,2,0,0,1,1,1,258,0.0,0.0,0.0,0.0,0.0,0.0,0.0,16,2,14,5.0,0.0,5.0
204168,2,1,1,1,1,1,1,136,1.0,1.0,0.0,0.0,1.0,0.0,0.0,3,2,1,3.0,2.0,1.0
111206,3,3,0,0,0,3,30,23,2.0,2.0,0.0,0.0,0.0,2.0,12.0,47,3,44,14.0,1.0,13.0
206022,3,3,0,0,0,3,18,108,3.0,3.0,0.0,0.0,0.0,3.0,17.0,14,3,11,4.0,1.0,3.0
209133,0,0,0,0,0,0,0,7,0.0,0.0,0.0,0.0,0.0,0.0,0.0,15,0,15,2.0,0.0,2.0
9903344,1,1,0,0,0,1,13,173,1.0,1.0,0.0,0.0,0.0,1.0,5.0,14,1,13,5.0,1.0,4.0
9806538,1,1,0,0,0,1,3,1,1.0,1.0,0.0,0.0,0.0,1.0,3.0,17,1,16,1.0,1.0,0.0
9901257,0,0,0,0,0,0,0,5,0.0,0.0,0.0,0.0,0.0,0.0,0.0,15,0,15,15.0,0.0,15.0
203240,2,2,0,0,0,2,7,165,2.0,2.0,0.0,0.0,0.0,2.0,7.0,9,2,7,9.0,2.0,7.0
206040,3,3,0,0,2,1,3,89,1.0,1.0,0.0,0.0,0.0,1.0,1.0,15,3,12,2.0,1.0,1.0
7139,0,0,0,0,0,0,0,5,0.0,0.0,0.0,0.0,0.0,0.0,0.0,41,0,41,23.0,0.0,23.0
12068,0,0,0,0,0,0,0,122,,,,,,,,1,0,1,,,
11008,0,0,0,0,0,0,0,696,0.0,0.0,0.0,0.0,0.0,0.0,0.0,2,0,2,1.0,0.0,1.0
9506306,1,1,0,0,0,1,7,49,1.0,1.0,0.0,0.0,0.0,1.0,3.0,9,1,8,4.0,1.0,3.0
9605416,2,1,1,1,2,0,0,169,,,,,,,,2,2,0,,,
8104,0,0,0,0,0,0,0,105,0.0,0.0,0.0,0.0,0.0,0.0,0.0,5,0,5,1.0,0.0,1.0
105228,1,1,0,0,0,1,6,4,1.0,1.0,0.0,0.0,0.0,1.0,5.0,21,1,20,,,
107238,1,1,0,0,0,1,4,126,1.0,1.0,0.0,0.0,0.0,1.0,4.0,5,1,4,3.0,1.0,2.0
210090,1,1,0,0,0,1,1,469,1.0,1.0,0.0,0.0,0.0,1.0,1.0,2,1,1,2.0,1.0,1.0
9810342,1,1,0,0,1,0,0,801,1.0,1.0,0.0,0.0,1.0,0.0,0.0,1,1,0,1.0,1.0,0.0
109236,0,0,0,0,0,0,0,400,0.0,0.0,0.0,0.0,0.0,0.0,0.0,11,0,11,3.0,0.0,3.0
111323,1,1,0,0,0,1,1,70,0.0,0.0,0.0,0.0,0.0,0.0,0.0,22,1,21,20.0,0.0,20.0
110198,0,0,0,0,0,0,0,89,0.0,0.0,0.0,0.0,0.0,0.0,0.0,10,0,10,7.0,0.0,7.0
9702257,2,2,0,0,1,1,1,144,2.0,2.0,0.0,0.0,1.0,1.0,1.0,3,2,1,1.0,1.0,0.0
9909359,0,0,0,0,0,0,0,115,0.0,0.0,0.0,0.0,0.0,0.0,0.0,13,0,13,8.0,0.0,8.0
9609236,0,0,0,0,0,0,0,17,0.0,0.0,0.0,0.0,0.0,0.0,0.0,12,0,12,1.0,0.0,1.0
7146,0,0,0,0,0,0,0,373,0.0,0.0,0.0,0.0,0.0,0.0,0.0,9,0,9,3.0,0.0,3.0
9909400,0,0,0,0,0,0,0,36,,,,,,,,6,0,6,2.0,0.0,2.0
302190,0,0,0,0,0,0,0,448,0.0,0.0,0.0,0.0,0.0,0.0,0.0,3,0,3,2.0,0.0,2.0
211143,0,0,0,0,0,0,0,55,0.0,0.0,0.0,0.0,0.0,0.0,0.0,19,0,19,1.0,0.0,1.0
112254,2,2,0,0,0,2,2,28,0.0,0.0,0.0,0.0,0.0,0.0,0.0,16,2,14,3.0,1.0,2.0
206181,1,1,0,0,0,1,4,38,1.0,1.0,0.0,0.0,0.0,1.0,4.0,15,1,14,6.0,1.0,5.0
108075,0,0,0,0,0,0,0,57,0.0,0.0,0.0,0.0,0.0,0.0,0.0,15,0,15,6.0,0.0,6.0
206175,0,0,0,0,0,0,0,110,0.0,0.0,0.0,0.0,0.0,0.0,0.0,5,0,5,2.0,0.0,2.0
108051,2,1,1,1,0,2,15,50,2.0,1.0,1.0,1.0,0.0,2.0,13.0,20,2,18,15.0,2.0,13.0
210033,1,1,0,0,0,1,4,65,1.0,1.0,0.0,0.0,0.0,1.0,4.0,10,1,9,1.0,0.0,1.0
9808323,0,0,0,0,0,0,0,21,0.0,0.0,0.0,0.0,0.0,0.0,0.0,7,0,7,6.0,0.0,6.0
9706396,0,0,0,0,0,0,0,1007,,,,,,,,1,0,1,,,
9805348,2,1,1,1,1,1,1,13,0.0,0.0,0.0,0.0,0.0,0.0,0.0,13,2,11,4.0,0.0,4.0
112176,0,0,0,0,0,0,0,1451,,,,,,,,1,0,1,,,
210015,1,1,0,0,0,1,4,109,0.0,0.0,0.0,0.0,0.0,0.0,0.0,60,1,59,30.0,0.0,30.0
209067,1,1,0,0,1,0,0,1714,,,,,,,,1,1,0,,,
9809519,2,2,0,0,2,0,0,84,0.0,0.0,0.0,0.0,0.0,0.0,0.0,6,2,4,2.0,2.0,0.0
208110,1,1,0,0,0,1,9,186,1.0,1.0,0.0,0.0,0.0,1.0,4.0,13,1,12,9.0,1.0,8.0
4261,0,0,0,0,0,0,0,343,0.0,0.0,0.0,0.0,0.0,0.0,0.0,4,0,4,2.0,0.0,2.0
302249,0,0,0,0,0,0,0,18,0.0,0.0,0.0,0.0,0.0,0.0,0.0,9,0,9,2.0,0.0,2.0
212138,1,1,0,0,0,1,4,625,1.0,1.0,0.0,0.0,0.0,1.0,4.0,6,1,5,1.0,0.0,1.0
12338,1,1,0,0,1,0,0,247,1.0,1.0,0.0,0.0,1.0,0.0,0.0,2,1,1,1.0,1.0,0.0
212060,0,0,0,0,0,0,0,145,0.0,0.0,0.0,0.0,0.0,0.0,0.0,5,0,5,1.0,0.0,1.0
205316,1,1,0,0,0,1,2,74,0.0,0.0,0.0,0.0,0.0,0.0,0.0,12,1,11,7.0,1.0,6.0
201011,1,1,0,0,0,1,10,22,1.0,1.0,0.0,0.0,0.0,1.0,10.0,30,1,29,13.0,1.0,12.0
9603260,0,0,0,0,0,0,0,77,0.0,0.0,0.0,0.0,0.0,0.0,0.0,1,0,1,,,
9605415,0,0,0,0,0,0,0,71,0.0,0.0,0.0,0.0,0.0,0.0,0.0,4,0,4,1.0,0.0,1.0
111220,4,3,1,1,1,3,22,131,2.0,1.0,1.0,1.0,0.0,2.0,16.0,32,4,28,16.0,2.0,14.0
9706456,0,0,0,0,0,0,0,1991,,,,,,,,2,0,2,,,
9508313,1,1,0,0,1,0,0,2133,,,,,,,,1,1,0,,,
9806257,0,0,0,0,0,0,0,2139,,,,,,,,2,0,2,,,
9311330,0,0,0,0,0,0,0,1570,,,,,,,,2,0,2,,,
206254,0,0,0,0,0,0,0,47,0.0,0.0,0.0,0.0,0.0,0.0,0.0,12,0,12,6.0,0.0,6.0
9311262,0,0,0,0,0,0,0,302,0.0,0.0,0.0,0.0,0.0,0.0,0.0,2,0,2,1.0,0.0,1.0
1068,0,0,0,0,0,0,0,287,0.0,0.0,0.0,0.0,0.0,0.0,0.0,6,0,6,2.0,0.0,2.0
102062,0,0,0,0,0,0,0,184,0.0,0.0,0.0,0.0,0.0,0.0,0.0,10,0,10,2.0,0.0,2.0
9907513,2,2,0,0,1,1,2,9,0.0,0.0,0.0,0.0,0.0,0.0,0.0,15,2,13,1.0,0.0,1.0
107172,1,1,0,0,0,1,5,14,1.0,1.0,0.0,0.0,0.0,1.0,4.0,12,1,11,5.0,1.0,4.0
9911487,0,0,0,0,0,0,0,32,,,,,,,,15,0,15,1.0,0.0,1.0
9711467,0,0,0,0,0,0,0,25,0.0,0.0,0.0,0.0,0.0,0.0,0.0,8,0,8,8.0,0.0,8.0
302079,0,0,0,0,0,0,0,11,0.0,0.0,0.0,0.0,0.0,0.0,0.0,11,0,11,4.0,0.0,4.0
9901287,0,0,0,0,0,0,0,36,0.0,0.0,0.0,0.0,0.0,0.0,0.0,16,0,16,2.0,0.0,2.0
9511442,0,0,0,0,0,0,0,59,0.0,0.0,0.0,0.0,0.0,0.0,0.0,5,0,5,1.0,0.0,1.0
9310205,0,0,0,0,0,0,0,94,,,,,,,,2,0,2,,,
9701310,0,0,0,0,0,0,0,56,0.0,0.0,0.0,0.0,0.0,0.0,0.0,23,0,23,14.0,0.0,14.0
5017,0,0,0,0,0,0,0,865,0.0,0.0,0.0,0.0,0.0,0.0,0.0,2,0,2,,,
204199,1,1,0,0,1,0,0,20,0.0,0.0,0.0,0.0,0.0,0.0,0.0,17,1,16,3.0,0.0,3.0
9704303,1,1,0,0,1,0,0,710,1.0,1.0,0.0,0.0,1.0,0.0,0.0,1,1,0,1.0,1.0,0.0
9606330,1,1,0,0,1,0,0,711,1.0,1.0,0.0,0.0,1.0,0.0,0.0,1,1,0,1.0,1.0,0.0
9902366,2,2,0,0,2,0,0,220,1.0,1.0,0.0,0.0,1.0,0.0,0.0,4,2,2,2.0,1.0,1.0
3329,0,0,0,0,0,0,0,79,0.0,0.0,0.0,0.0,0.0,0.0,0.0,3,0,3,,,
212246,0,0,0,0,0,0,0,14,0.0,0.0,0.0,0.0,0.0,0.0,0.0,11,0,11,2.0,0.0,2.0
1049,0,0,0,0,0,0,0,2,,,,,,,,11,0,11,,,
10046,0,0,0,0,0,0,0,406,0.0,0.0,0.0,0.0,0.0,0.0,0.0,5,0,5,1.0,0.0,1.0
209119,0,0,0,0,0,0,0,56,0.0,0.0,0.0,0.0,0.0,0.0,0.0,17,0,17,2.0,0.0,2.0
9707528,1,1,0,0,0,1,1,255,,,,,,,,4,1,3,1.0,0.0,1.0
212100,0,0,0,0,0,0,0,31,0.0,0.0,0.0,0.0,0.0,0.0,0.0,8,0,8,,,
104305,1,1,0,0,0,1,1,20,1.0,1.0,0.0,0.0,1.0,0.0,0.0,19,1,18,2.0,0.0,2.0
108209,0,0,0,0,0,0,0,263,0.0,0.0,0.0,0.0,0.0,0.0,0.0,13,0,13,2.0,0.0,2.0
8015,1,1,0,0,0,1,2,9,0.0,0.0,0.0,0.0,0.0,0.0,0.0,29,1,28,20.0,0.0,20.0
9504317,0,0,0,0,0,0,0,1830,0.0,0.0,0.0,0.0,0.0,0.0,0.0,2,0,2,2.0,0.0,2.0
9908344,1,1,0,0,1,0,0,717,1.0,1.0,0.0,0.0,1.0,0.0,0.0,3,1,2,1.0,1.0,0.0
9907429,2,2,0,0,0,2,5,200,1.0,1.0,0.0,0.0,0.0,1.0,2.0,8,2,6,4.0,1.0,3.0
110128,0,0,0,0,0,0,0,54,0.0,0.0,0.0,0.0,0.0,0.0,0.0,25,0,25,14.0,0.0,14.0
207034,1,1,0,0,0,1,4,258,1.0,1.0,0.0,0.0,0.0,1.0,4.0,8,1,7,7.0,1.0,6.0
205028,0,0,0,0,0,0,0,89,0.0,0.0,0.0,0.0,0.0,0.0,0.0,4,0,4,3.0,0.0,3.0
10052,0,0,0,0,0,0,0,8,0.0,0.0,0.0,0.0,0.0,0.0,0.0,9,0,9,,,
104012,0,0,0,0,0,0,0,314,0.0,0.0,0.0,0.0,0.0,0.0,0.0,4,0,4,2.0,0.0,2.0
207305,0,0,0,0,0,0,0,138,0.0,0.0,0.0,0.0,0.0,0.0,0.0,5,0,5,2.0,0.0,2.0
202085,1,1,0,0,0,1,6,11,1.0,1.0,0.0,0.0,0.0,1.0,5.0,25,1,24,5.0,1.0,4.0
9186,1,1,0,0,0,1,5,95,1.0,1.0,0.0,0.0,0.0,1.0,3.0,14,1,13,1.0,1.0,0.0
106259,0,0,0,0,0,0,0,21,0.0,0.0,0.0,0.0,0.0,0.0,0.0,18,0,18,7.0,0.0,7.0
8244,0,0,0,0,0,0,0,72,0.0,0.0,0.0,0.0,0.0,0.0,0.0,6,0,6,1.0,0.0,1.0
212386,1,1,0,0,0,1,14,23,1.0,1.0,0.0,0.0,0.0,1.0,11.0,16,1,15,4.0,0.0,4.0
9709272,0,0,0,0,0,0,0,8,0.0,0.0,0.0,0.0,0.0,0.0,0.0,11,0,11,6.0,0.0,6.0
9207230,0,0,0,0,0,0,0,358,0.0,0.0,0.0,0.0,0.0,0.0,0.0,1,0,1,,,
12159,0,0,0,0,0,0,0,196,0.0,0.0,0.0,0.0,0.0,0.0,0.0,4,0,4,2.0,0.0,2.0
9712323,0,0,0,0,0,0,0,6,0.0,0.0,0.0,0.0,0.0,0.0,0.0,16,0,16,1.0,0.0,1.0
211458,0,0,0,0,0,0,0,48,0.0,0.0,0.0,0.0,0.0,0.0,0.0,13,0,13,2.0,0.0,2.0
9807506,0,0,0,0,0,0,0,54,0.0,0.0,0.0,0.0,0.0,0.0,0.0,10,0,10,9.0,0.0,9.0
9707545,0,0,0,0,0,0,0,34,,,,,,,,8,0,8,,,
5001,0,0,0,0,0,0,0,272,0.0,0.0,0.0,0.0,0.0,0.0,0.0,2,0,2,2.0,0.0,2.0
211332,0,0,0,0,0,0,0,107,0.0,0.0,0.0,0.0,0.0,0.0,0.0,5,0,5,1.0,0.0,1.0
9405339,0,0,0,0,0,0,0,124,,,,,,,,1,0,1,,,
9603274,1,1,0,0,1,0,0,723,1.0,1.0,0.0,0.0,1.0,0.0,0.0,1,1,0,1.0,1.0,0.0
208002,0,0,0,0,0,0,0,83,0.0,0.0,0.0,0.0,0.0,0.0,0.0,32,0,32,5.0,0.0,5.0
202062,0,0,0,0,0,0,0,1,0.0,0.0,0.0,0.0,0.0,0.0,0.0,29,0,29,13.0,0.0,13.0
209064,0,0,0,0,0,0,0,327,0.0,0.0,0.0,0.0,0.0,0.0,0.0,1,0,1,1.0,0.0,1.0
212266,0,0,0,0,0,0,0,71,0.0,0.0,0.0,0.0,0.0,0.0,0.0,11,0,11,3.0,0.0,3.0
101214,0,0,0,0,0,0,0,52,0.0,0.0,0.0,0.0,0.0,0.0,0.0,4,0,4,2.0,0.0,2.0
9908241,0,0,0,0,0,0,0,110,0.0,0.0,0.0,0.0,0.0,0.0,0.0,2,0,2,1.0,0.0,1.0
110211,2,1,1,1,1,1,1,405,2.0,1.0,1.0,1.0,2.0,0.0,0.0,4,2,2,2.0,2.0,0.0
6111,0,0,0,0,0,0,0,147,0.0,0.0,0.0,0.0,0.0,0.0,0.0,11,0,11,6.0,0.0,6.0
9810494,0,0,0,0,0,0,0,1622,,,,,,,,4,0,4,,,
9708277,0,0,0,0,0,0,0,29,0.0,0.0,0.0,0.0,0.0,0.0,0.0,9,0,9,5.0,0.0,5.0
9305318,0,0,0,0,0,0,0,577,0.0,0.0,0.0,0.0,0.0,0.0,0.0,1,0,1,1.0,0.0,1.0
9812391,0,0,0,0,0,0,0,148,0.0,0.0,0.0,0.0,0.0,0.0,0.0,2,0,2,1.0,0.0,1.0
301258,0,0,0,0,0,0,0,185,0.0,0.0,0.0,0.0,0.0,0.0,0.0,14,0,14,3.0,0.0,3.0
212140,0,0,0,0,0,0,0,95,,,,,,,,5,0,5,1.0,0.0,1.0
9611405,0,0,0,0,0,0,0,10,0.0,0.0,0.0,0.0,0.0,0.0,0.0,12,0,12,3.0,0.0,3.0
203269,0,0,0,0,0,0,0,446,0.0,0.0,0.0,0.0,0.0,0.0,0.0,8,0,8,2.0,0.0,2.0
4154,0,0,0,0,0,0,0,0,0.0,0.0,0.0,0.0,0.0,0.0,0.0,18,0,18,7.0,0.0,7.0
9810348,0,0,0,0,0,0,0,188,0.0,0.0,0.0,0.0,0.0,0.0,0.0,10,0,10,2.0,0.0,2.0
103276,0,0,0,0,0,0,0,213,0.0,0.0,0.0,0.0,0.0,0.0,0.0,2,0,2,1.0,0.0,1.0
8001,0,0,0,0,0,0,0,4,0.0,0.0,0.0,0.0,0.0,0.0,0.0,15,0,15,1.0,0.0,1.0
9907278,0,0,0,0,0,0,0,187,0.0,0.0,0.0,0.0,0.0,0.0,0.0,7,0,7,2.0,0.0,2.0
9704237,0,0,0,0,0,0,0,1849,,,,,,,,2,0,2,1.0,0.0,1.0
9503302,1,1,0,0,1,0,0,5,0.0,0.0,0.0,0.0,0.0,0.0,0.0,21,1,20,3.0,0.0,3.0
301096,0,0,0,0,0,0,0,71,0.0,0.0,0.0,0.0,0.0,0.0,0.0,47,0,47,26.0,0.0,26.0
9407340,0,0,0,0,0,0,0,6,,,,,,,,6,0,6,,,
7074,0,0,0,0,0,0,0,71,0.0,0.0,0.0,0.0,0.0,0.0,0.0,3,0,3,2.0,0.0,2.0
6075,0,0,0,0,0,0,0,11,0.0,0.0,0.0,0.0,0.0,0.0,0.0,4,0,4,1.0,0.0,1.0
207325,0,0,0,0,0,0,0,14,0.0,0.0,0.0,0.0,0.0,0.0,0.0,6,0,6,2.0,0.0,2.0
104209,0,0,0,0,0,0,0,733,0.0,0.0,0.0,0.0,0.0,0.0,0.0,1,0,1,1.0,0.0,1.0
9604428,0,0,0,0,0,0,0,69,0.0,0.0,0.0,0.0,0.0,0.0,0.0,11,0,11,6.0,0.0,6.0
9911483,0,0,0,0,0,0,0,30,0.0,0.0,0.0,0.0,0.0,0.0,0.0,13,0,13,7.0,0.0,7.0
9507295,0,0,0,0,0,0,0,39,0.0,0.0,0.0,0.0,0.0,0.0,0.0,10,0,10,1.0,0.0,1.0
302218,0,0,0,0,0,0,0,0,0.0,0.0,0.0,0.0,0.0,0.0,0.0,12,0,12,2.0,0.0,2.0
9803293,0,0,0,0,0,0,0,99,0.0,0.0,0.0,0.0,0.0,0.0,0.0,8,0,8,2.0,0.0,2.0
1014,0,0,0,0,0,0,0,58,0.0,0.0,0.0,0.0,0.0,0.0,0.0,10,0,10,2.0,0.0,2.0
102210,0,0,0,0,0,0,0,59,0.0,0.0,0.0,0.0,0.0,0.0,0.0,5,0,5,1.0,0.0,1.0
301212,0,0,0,0,0,0,0,119,0.0,0.0,0.0,0.0,0.0,0.0,0.0,4,0,4,,,
211391,0,0,0,0,0,0,0,3,0.0,0.0,0.0,0.0,0.0,0.0,0.0,35,0,35,7.0,0.0,7.0
11066,0,0,0,0,0,0,0,264,0.0,0.0,0.0,0.0,0.0,0.0,0.0,7,0,7,3.0,0.0,3.0
212158,0,0,0,0,0,0,0,7,0.0,0.0,0.0,0.0,0.0,0.0,0.0,89,0,89,22.0,0.0,22.0
111228,0,0,0,0,0,0,0,177,0.0,0.0,0.0,0.0,0.0,0.0,0.0,5,0,5,4.0,0.0,4.0
211465,0,0,0,0,0,0,0,3,0.0,0.0,0.0,0.0,0.0,0.0,0.0,23,0,23,11.0,0.0,11.0
2037,0,0,0,0,0,0,0,224,0.0,0.0,0.0,0.0,0.0,0.0,0.0,2,0,2,2.0,0.0,2.0
104171,0,0,0,0,0,0,0,3,0.0,0.0,0.0,0.0,0.0,0.0,0.0,9,0,9,5.0,0.0,5.0
201196,0,0,0,0,0,0,0,87,0.0,0.0,0.0,0.0,0.0,0.0,0.0,11,0,11,4.0,0.0,4.0
212385,0,0,0,0,0,0,0,253,0.0,0.0,0.0,0.0,0.0,0.0,0.0,6,0,6,6.0,0.0,6.0
108151,0,0,0,0,0,0,0,7,0.0,0.0,0.0,0.0,0.0,0.0,0.0,20,0,20,2.0,0.0,2.0
9812480,0,0,0,0,0,0,0,104,0.0,0.0,0.0,0.0,0.0,0.0,0.0,25,0,25,6.0,0.0,6.0
209060,0,0,0,0,0,0,0,292,0.0,0.0,0.0,0.0,0.0,0.0,0.0,1,0,1,,,
11294,0,0,0,0,0,0,0,110,0.0,0.0,0.0,0.0,0.0,0.0,0.0,4,0,4,4.0,0.0,4.0
9706446,0,0,0,0,0,0,0,19,0.0,0.0,0.0,0.0,0.0,0.0,0.0,11,0,11,1.0,0.0,1.0
9711510,0,0,0,0,0,0,0,17,0.0,0.0,0.0,0.0,0.0,0.0,0.0,29,0,29,25.0,0.0,25.0
9507203,0,0,0,0,0,0,0,144,,,,,,,,1,0,1,,,
11325,0,0,0,0,0,0,0,1061,,,,,,,,2,0,2,,,
108200,0,0,0,0,0,0,0,23,0.0,0.0,0.0,0.0,0.0,0.0,0.0,37,0,37,20.0,0.0,20.0
9803499,0,0,0,0,0,0,0,1,0.0,0.0,0.0,0.0,0.0,0.0,0.0,27,0,27,1.0,0.0,1.0
9806237,0,0,0,0,0,0,0,6,0.0,0.0,0.0,0.0,0.0,0.0,0.0,32,0,32,4.0,0.0,4.0
2244,0,0,0,0,0,0,0,230,0.0,0.0,0.0,0.0,0.0,0.0,0.0,3,0,3,2.0,0.0,2.0
9501330,0,0,0,0,0,0,0,1299,,,,,,,,1,0,1,,,
210228,0,0,0,0,0,0,0,63,0.0,0.0,0.0,0.0,0.0,0.0,0.0,4,0,4,,,
9906519,1,1,0,0,1,0,0,638,1.0,1.0,0.0,0.0,1.0,0.0,0.0,1,1,0,1.0,1.0,0.0
111410,0,0,0,0,0,0,0,361,0.0,0.0,0.0,0.0,0.0,0.0,0.0,2,0,2,1.0,0.0,1.0
5187,1,1,0,0,1,0,0,739,1.0,1.0,0.0,0.0,1.0,0.0,0.0,1,1,0,1.0,1.0,0.0
212308,0,0,0,0,0,0,0,106,0.0,0.0,0.0,0.0,0.0,0.0,0.0,6,0,6,1.0,0.0,1.0
209123,0,0,0,0,0,0,0,0,0.0,0.0,0.0,0.0,0.0,0.0,0.0,5,0,5,4.0,0.0,4.0
9907396,0,0,0,0,0,0,0,2031,,,,,,,,4,0,4,,,
9502410,0,0,0,0,0,0,0,29,0.0,0.0,0.0,0.0,0.0,0.0,0.0,4,0,4,,,
9709435,0,0,0,0,0,0,0,39,0.0,0.0,0.0,0.0,0.0,0.0,0.0,18,0,18,2.0,0.0,2.0
9902344,0,0,0,0,0,0,0,40,,,,,,,,6,0,6,3.0,0.0,3.0
210176,0,0,0,0,0,0,0,94,0.0,0.0,0.0,0.0,0.0,0.0,0.0,30,0,30,15.0,0.0,15.0
9802233,0,0,0,0,0,0,0,1011,0.0,0.0,0.0,0.0,0.0,0.0,0.0,3,0,3,1.0,0.0,1.0
4131,0,0,0,0,0,0,0,742,0.0,0.0,0.0,0.0,0.0,0.0,0.0,1,0,1,1.0,0.0,1.0
9611309,0,0,0,0,0,0,0,10,0.0,0.0,0.0,0.0,0.0,0.0,0.0,7,0,7,6.0,0.0,6.0
302246,0,0,0,0,0,0,0,0,0.0,0.0,0.0,0.0,0.0,0.0,0.0,32,0,32,6.0,0.0,6.0
302029,0,0,0,0,0,0,0,239,0.0,0.0,0.0,0.0,0.0,0.0,0.0,2,0,2,,,
9508214,0,0,0,0,0,0,0,10,0.0,0.0,0.0,0.0,0.0,0.0,0.0,13,0,13,2.0,0.0,2.0
12083,0,0,0,0,0,0,0,1262,0.0,0.0,0.0,0.0,0.0,0.0,0.0,3,0,3,,,
9506257,10,8,2,2,9,1,1,100,1.0,1.0,0.0,0.0,1.0,0.0,0.0,11,10,1,1.0,1.0,0.0
9606210,1,1,0,0,1,0,0,100,,,,,,,,1,1,0,,,
1297,37,12,25,59,8,29,137,29,15.0,5.0,10.0,22.0,0.0,15.0,93.0,53,37,16,19.0,9.0,10.0
101118,16,4,12,27,0,16,120,1,11.0,2.0,9.0,21.0,0.0,11.0,48.0,42,16,26,6.0,5.0,1.0
9812396,74,14,60,341,1,73,711,1,47.0,6.0,41.0,234.0,0.0,47.0,568.0,107,74,33,60.0,37.0,23.0
9308349,138,11,127,1359,115,23,23,7,85.0,3.0,82.0,901.0,73.0,12.0,12.0,139,138,1,52.0,52.0,0.0
9409391,28,6,22,81,9,19,19,6,18.0,3.0,15.0,47.0,5.0,13.0,13.0,29,28,1,6.0,6.0,0.0
8234,1,1,0,0,1,0,0,296,0.0,0.0,0.0,0.0,0.0,0.0,0.0,6,1,5,1.0,0.0,1.0
9907300,6,3,3,6,1,5,11,1,5.0,2.0,3.0,6.0,2.0,3.0,5.0,12,6,6,7.0,5.0,2.0
9906497,11,4,7,16,6,5,8,1,2.0,1.0,1.0,1.0,1.0,1.0,1.0,18,11,7,2.0,2.0,0.0
9312215,70,18,52,263,23,47,86,15,38.0,5.0,33.0,215.0,4.0,34.0,70.0,73,70,3,29.0,26.0,3.0
9310355,20,6,14,49,1,19,19,34,5.0,4.0,1.0,1.0,5.0,0.0,0.0,21,20,1,9.0,8.0,1.0
9507396,35,16,19,54,16,19,19,4,11.0,3.0,8.0,18.0,2.0,9.0,9.0,46,35,11,7.0,6.0,1.0
9606435,13,3,10,19,0,13,62,114,8.0,2.0,6.0,10.0,0.0,8.0,46.0,40,13,27,17.0,8.0,9.0
9306256,83,19,64,262,78,5,5,35,34.0,4.0,30.0,158.0,34.0,0.0,0.0,85,83,2,10.0,10.0,0.0
201023,8,3,5,8,0,8,24,4,3.0,1.0,2.0,3.0,0.0,3.0,3.0,21,8,13,3.0,1.0,2.0
106204,56,16,40,83,10,46,471,18,14.0,6.0,8.0,17.0,0.0,14.0,127.0,151,56,95,27.0,12.0,15.0
9906208,2,1,1,1,0,2,4,33,0.0,0.0,0.0,0.0,0.0,0.0,0.0,12,2,10,2.0,2.0,0.0
9505212,3,1,2,3,0,3,6,170,0.0,0.0,0.0,0.0,0.0,0.0,0.0,7,3,4,2.0,0.0,2.0
9612211,16,1,15,48,16,0,0,48,11.0,1.0,10.0,28.0,11.0,0.0,0.0,16,16,0,4.0,4.0,0.0
9709493,3,2,1,2,0,3,4,33,3.0,2.0,1.0,2.0,0.0,3.0,3.0,7,3,4,2.0,2.0,0.0
9808400,39,6,33,125,9,30,70,48,16.0,2.0,14.0,47.0,2.0,14.0,21.0,45,39,6,15.0,14.0,1.0
9909222,16,4,12,25,0,16,114,48,10.0,2.0,8.0,14.0,0.0,10.0,59.0,46,16,30,19.0,10.0,9.0
9710237,15,7,8,19,6,9,18,210,5.0,2.0,3.0,4.0,0.0,5.0,9.0,27,15,12,7.0,4.0,3.0
110126,30,10,20,44,2,28,161,2,6.0,2.0,4.0,8.0,0.0,6.0,19.0,64,30,34,17.0,9.0,8.0
9412275,17,11,6,10,4,13,20,35,5.0,3.0,2.0,4.0,5.0,0.0,0.0,20,17,3,3.0,3.0,0.0
9803315,846,21,825,10796,846,0,0,2,201.0,2.0,199.0,3655.0,201.0,0.0,0.0,846,846,0,65.0,65.0,0.0
9907414,26,4,22,52,2,24,82,26,8.0,3.0,5.0,7.0,0.0,8.0,25.0,39,26,13,12.0,10.0,2.0
9308254,9,3,6,15,9,0,0,23,1.0,1.0,0.0,0.0,1.0,0.0,0.0,9,9,0,2.0,2.0,0.0
9312218,14,8,6,22,3,11,42,19,2.0,2.0,0.0,0.0,0.0,2.0,4.0,22,14,8,9.0,6.0,3.0
9502247,22,3,19,41,19,3,5,170,14.0,1.0,13.0,26.0,14.0,0.0,0.0,24,22,2,12.0,12.0,0.0
9904268,6,5,1,1,1,5,12,170,3.0,2.0,1.0,1.0,0.0,3.0,7.0,16,6,10,6.0,3.0,3.0
1152,6,4,2,2,1,5,14,4,1.0,1.0,0.0,0.0,1.0,0.0,0.0,17,6,11,2.0,0.0,2.0
110196,3,2,1,1,0,3,17,26,1.0,1.0,0.0,0.0,0.0,1.0,7.0,44,3,41,14.0,1.0,13.0
9611251,56,16,40,135,5,51,265,69,22.0,6.0,16.0,54.0,0.0,22.0,138.0,85,56,29,21.0,11.0,10.0
9210253,169,24,145,608,169,0,0,40,66.0,3.0,63.0,311.0,66.0,0.0,0.0,169,169,0,23.0,23.0,0.0
9304312,8,3,5,5,8,0,0,56,1.0,1.0,0.0,0.0,1.0,0.0,0.0,8,8,0,2.0,2.0,0.0
9408256,0,0,0,0,0,0,0,13,0.0,0.0,0.0,0.0,0.0,0.0,0.0,6,0,6,1.0,0.0,1.0
9205238,103,19,84,455,103,0,0,25,44.0,5.0,39.0,252.0,44.0,0.0,0.0,103,103,0,23.0,23.0,0.0
9602436,15,4,11,14,3,12,79,134,5.0,2.0,3.0,5.0,0.0,5.0,40.0,31,15,16,17.0,5.0,12.0
9304303,59,6,53,227,35,24,30,25,25.0,3.0,22.0,101.0,9.0,16.0,21.0,62,59,3,20.0,18.0,2.0
9501361,56,15,41,127,25,31,57,81,10.0,3.0,7.0,17.0,4.0,6.0,15.0,70,56,14,7.0,4.0,3.0
9407203,19,5,14,29,10,9,15,121,7.0,4.0,3.0,4.0,0.0,7.0,12.0,25,19,6,7.0,5.0,2.0
9505244,54,18,36,134,21,33,33,69,11.0,7.0,4.0,8.0,2.0,9.0,9.0,56,54,2,15.0,14.0,1.0
9308333,154,37,117,487,81,73,128,10,30.0,5.0,25.0,86.0,11.0,19.0,33.0,160,154,6,15.0,13.0,2.0
9504246,84,10,74,578,11,73,94,0,56.0,3.0,53.0,462.0,1.0,55.0,70.0,89,84,5,45.0,44.0,1.0
9806375,16,4,12,36,1,15,95,0,11.0,3.0,8.0,26.0,0.0,11.0,53.0,36,16,20,17.0,10.0,7.0
9903262,43,11,32,84,2,41,265,0,15.0,4.0,11.0,19.0,0.0,15.0,124.0,76,43,33,15.0,7.0,8.0
9812344,34,3,31,171,3,31,112,3,33.0,3.0,30.0,165.0,5.0,28.0,90.0,44,34,10,7.0,2.0,5.0
9710516,72,8,64,292,69,3,4,3,24.0,4.0,20.0,87.0,24.0,0.0,0.0,74,72,2,9.0,9.0,0.0
2155,33,7,26,58,8,25,86,3,9.0,4.0,5.0,9.0,9.0,0.0,0.0,46,33,13,9.0,9.0,0.0
9811447,73,8,65,322,9,64,361,3,40.0,2.0,38.0,197.0,1.0,39.0,185.0,120,73,47,33.0,24.0,9.0
9909208,5,2,3,3,3,2,2,182,0.0,0.0,0.0,0.0,0.0,0.0,0.0,11,5,6,2.0,1.0,1.0
9807466,16,7,9,14,2,14,37,42,2.0,1.0,1.0,1.0,0.0,2.0,3.0,24,16,8,3.0,2.0,1.0
9411390,6,1,5,10,0,6,6,50,0.0,0.0,0.0,0.0,0.0,0.0,0.0,10,6,4,2.0,0.0,2.0
9806339,20,3,17,72,15,5,9,3,0.0,0.0,0.0,0.0,0.0,0.0,0.0,28,20,8,1.0,1.0,0.0
9707541,11,7,4,6,1,10,35,41,2.0,2.0,0.0,0.0,0.0,2.0,11.0,34,11,23,7.0,1.0,6.0
9805311,14,2,12,25,4,10,16,0,6.0,1.0,5.0,10.0,3.0,3.0,4.0,25,14,11,1.0,0.0,1.0
9809322,1,1,0,0,1,0,0,928,,,,,,,,1,1,0,,,
9508275,60,5,55,314,32,28,61,50,37.0,2.0,35.0,236.0,19.0,18.0,18.0,63,60,3,25.0,25.0,0.0
9712281,7,6,1,1,7,0,0,159,1.0,1.0,0.0,0.0,1.0,0.0,0.0,7,7,0,2.0,2.0,0.0
9812244,4,3,1,1,2,2,3,50,0.0,0.0,0.0,0.0,0.0,0.0,0.0,39,4,35,3.0,1.0,2.0
9306235,41,7,34,97,32,9,9,81,21.0,2.0,19.0,60.0,13.0,8.0,8.0,42,41,1,12.0,12.0,0.0
9806425,4,2,2,2,2,2,9,167,1.0,1.0,0.0,0.0,0.0,1.0,5.0,12,4,8,5.0,1.0,4.0
9502270,74,8,66,236,61,13,13,17,22.0,2.0,20.0,71.0,12.0,10.0,10.0,75,74,1,14.0,14.0,0.0
9706212,16,3,13,30,1,15,24,181,15.0,5.0,10.0,24.0,1.0,14.0,17.0,26,16,10,12.0,10.0,2.0
9803255,13,4,9,14,5,8,16,46,5.0,1.0,4.0,6.0,1.0,4.0,8.0,18,13,5,2.0,2.0,0.0
9510306,4,2,2,2,4,0,0,46,1.0,1.0,0.0,0.0,1.0,0.0,0.0,5,4,1,1.0,0.0,1.0
9510419,3,2,1,1,0,3,8,0,,,,,,,,8,3,5,,,
9803201,13,2,11,20,12,1,1,294,8.0,1.0,7.0,15.0,8.0,0.0,0.0,18,13,5,7.0,7.0,0.0
9710403,16,1,15,48,1,15,58,0,2.0,1.0,1.0,1.0,0.0,2.0,4.0,31,16,15,5.0,2.0,3.0
9903399,39,5,34,102,4,35,64,0,11.0,2.0,9.0,19.0,0.0,11.0,25.0,43,39,4,17.0,15.0,2.0
9512268,9,4,5,6,0,9,25,10,3.0,2.0,1.0,2.0,3.0,0.0,0.0,14,9,5,8.0,4.0,4.0
9603363,75,13,62,263,18,57,244,12,28.0,8.0,20.0,90.0,1.0,27.0,141.0,87,75,12,29.0,19.0,10.0
9609443,65,8,57,290,4,61,143,12,49.0,4.0,45.0,260.0,5.0,44.0,77.0,91,65,26,38.0,36.0,2.0
9206212,22,9,13,20,22,0,0,223,5.0,3.0,2.0,3.0,5.0,0.0,0.0,22,22,0,4.0,4.0,0.0
9707274,14,6,8,17,1,13,283,36,12.0,5.0,7.0,15.0,0.0,12.0,265.0,60,14,46,47.0,10.0,37.0
102017,30,5,25,96,3,27,220,34,20.0,2.0,18.0,65.0,0.0,20.0,168.0,57,30,27,22.0,10.0,12.0
9912264,44,7,37,172,4,40,124,34,30.0,3.0,27.0,145.0,2.0,28.0,98.0,54,44,10,26.0,21.0,5.0
101336,59,17,42,164,2,57,1189,1,5.0,4.0,1.0,1.0,0.0,5.0,132.0,435,59,376,56.0,5.0,51.0
9604283,91,7,84,506,83,8,8,1,36.0,1.0,35.0,235.0,36.0,0.0,0.0,92,91,1,22.0,22.0,0.0
9309272,48,15,33,98,27,21,45,29,12.0,1.0,11.0,26.0,12.0,0.0,0.0,57,48,9,5.0,5.0,0.0
9610252,86,11,75,324,7,79,349,1,14.0,2.0,12.0,37.0,0.0,14.0,27.0,120,86,34,18.0,13.0,5.0
9708395,24,9,15,45,5,19,38,67,16.0,6.0,10.0,27.0,4.0,12.0,19.0,29,24,5,13.0,11.0,2.0
9603404,164,6,158,1347,16,148,565,7,86.0,3.0,83.0,805.0,2.0,84.0,317.0,177,164,13,54.0,49.0,5.0
9602239,141,12,129,978,13,128,286,5,69.0,2.0,67.0,650.0,0.0,69.0,162.0,151,141,10,50.0,47.0,3.0
9701244,80,12,68,308,3,77,399,5,31.0,3.0,28.0,119.0,0.0,31.0,190.0,108,80,28,29.0,19.0,10.0
9707537,33,8,25,67,1,32,252,5,24.0,4.0,20.0,58.0,0.0,24.0,217.0,50,33,17,20.0,11.0,9.0
9905421,7,2,5,6,5,2,2,87,2.0,1.0,1.0,1.0,2.0,0.0,0.0,12,7,5,3.0,3.0,0.0
9411318,8,3,5,7,8,0,0,93,3.0,1.0,2.0,2.0,3.0,0.0,0.0,8,8,0,3.0,3.0,0.0
9707433,10,6,4,9,0,10,23,69,2.0,2.0,0.0,0.0,1.0,1.0,2.0,18,10,8,3.0,1.0,2.0
9503299,8,2,6,12,8,0,0,58,7.0,1.0,6.0,12.0,7.0,0.0,0.0,9,8,1,3.0,2.0,1.0
106205,2,2,0,0,1,1,4,6,1.0,1.0,0.0,0.0,0.0,1.0,2.0,10,2,8,3.0,0.0,3.0
9811239,56,10,46,222,2,54,494,6,18.0,2.0,16.0,51.0,0.0,18.0,209.0,114,56,58,23.0,18.0,5.0
10181,8,4,4,8,1,7,168,34,5.0,3.0,2.0,4.0,0.0,5.0,151.0,50,8,42,38.0,5.0,33.0
1253,26,6,20,77,0,26,299,1,19.0,2.0,17.0,67.0,0.0,19.0,259.0,58,26,32,35.0,17.0,18.0
9708396,35,10,25,68,21,14,22,6,14.0,4.0,10.0,19.0,9.0,5.0,7.0,41,35,6,7.0,6.0,1.0
9702322,61,4,57,344,1,60,392,7,42.0,2.0,40.0,269.0,0.0,42.0,257.0,77,61,16,40.0,32.0,8.0
104101,13,7,6,7,0,13,110,32,6.0,3.0,3.0,3.0,0.0,6.0,23.0,59,13,46,9.0,2.0,7.0
9701342,21,9,12,27,13,8,17,4,4.0,1.0,3.0,4.0,3.0,1.0,2.0,30,21,9,5.0,5.0,0.0
9303309,133,18,115,874,133,0,0,4,55.0,3.0,52.0,489.0,55.0,0.0,0.0,133,133,0,40.0,40.0,0.0
1177,11,4,7,19,0,11,51,21,11.0,4.0,7.0,19.0,0.0,11.0,43.0,22,11,11,13.0,5.0,8.0
9709232,35,8,27,67,4,31,151,21,18.0,4.0,14.0,31.0,1.0,17.0,29.0,46,35,11,20.0,15.0,5.0
9804456,5,2,3,4,0,5,20,7,4.0,1.0,3.0,4.0,0.0,4.0,15.0,30,5,25,3.0,3.0,0.0
9503285,38,8,30,70,12,26,56,7,5.0,4.0,1.0,1.0,5.0,0.0,0.0,47,38,9,4.0,2.0,2.0
9604378,7,2,5,8,1,6,9,7,6.0,1.0,5.0,8.0,6.0,0.0,0.0,11,7,4,4.0,4.0,0.0
9311279,5,2,3,3,3,2,2,223,4.0,2.0,2.0,2.0,4.0,0.0,0.0,6,5,1,4.0,4.0,0.0
9302207,31,6,25,135,16,15,17,15,26.0,3.0,23.0,125.0,18.0,8.0,8.0,33,31,2,7.0,7.0,0.0
9603388,24,6,18,65,4,20,62,15,17.0,3.0,14.0,50.0,2.0,15.0,48.0,41,24,17,12.0,11.0,1.0
9503349,19,5,14,23,19,0,0,98,5.0,1.0,4.0,6.0,5.0,0.0,0.0,20,19,1,4.0,4.0,0.0
9503232,9,6,3,5,9,0,0,76,6.0,5.0,1.0,1.0,6.0,0.0,0.0,9,9,0,4.0,4.0,0.0
9606364,18,9,9,20,5,13,50,12,5.0,3.0,2.0,2.0,1.0,4.0,15.0,40,18,22,8.0,5.0,3.0
9602280,68,11,57,315,11,57,337,19,33.0,1.0,32.0,202.0,0.0,33.0,209.0,102,68,34,20.0,6.0,14.0
9409265,30,1,29,138,7,23,114,19,22.0,1.0,21.0,114.0,5.0,17.0,41.0,42,30,12,16.0,11.0,5.0
9405342,66,24,42,122,28,38,83,10,20.0,6.0,14.0,44.0,4.0,16.0,33.0,75,66,9,11.0,11.0,0.0
9712302,70,9,61,402,1,69,180,24,50.0,1.0,49.0,356.0,1.0,49.0,98.0,77,70,7,42.0,39.0,3.0
9706354,17,11,6,11,1,16,66,57,8.0,7.0,1.0,2.0,0.0,8.0,36.0,27,17,10,12.0,6.0,6.0
9711427,50,5,45,235,0,50,227,16,39.0,3.0,36.0,190.0,0.0,39.0,173.0,61,50,11,25.0,20.0,5.0
9407337,18,7,11,18,12,6,6,16,4.0,1.0,3.0,4.0,4.0,0.0,0.0,19,18,1,4.0,4.0,0.0
9405320,100,15,85,408,100,0,0,16,40.0,3.0,37.0,174.0,40.0,0.0,0.0,100,100,0,13.0,13.0,0.0
9403229,47,13,34,120,28,19,23,44,22.0,5.0,17.0,60.0,16.0,6.0,6.0,50,47,3,10.0,10.0,0.0
9609235,5,3,2,2,0,5,13,62,3.0,1.0,2.0,2.0,2.0,1.0,1.0,11,5,6,4.0,1.0,3.0
9405398,43,8,35,122,43,0,0,30,30.0,4.0,26.0,96.0,30.0,0.0,0.0,43,43,0,15.0,15.0,0.0
9504219,143,11,132,972,41,102,260,8,80.0,3.0,77.0,706.0,12.0,68.0,136.0,152,143,9,50.0,47.0,3.0
9307206,4,2,2,2,4,0,0,190,3.0,1.0,2.0,2.0,3.0,0.0,0.0,4,4,0,3.0,3.0,0.0
9305287,31,12,19,45,27,4,4,190,14.0,6.0,8.0,17.0,11.0,3.0,3.0,32,31,1,9.0,9.0,0.0
9604225,23,6,17,34,2,21,133,6,15.0,5.0,10.0,23.0,1.0,14.0,85.0,36,23,13,9.0,5.0,4.0
9712346,5,2,3,7,0,5,45,7,3.0,1.0,2.0,3.0,0.0,3.0,33.0,23,5,18,2.0,0.0,2.0
9306201,43,13,30,78,43,0,0,183,6.0,3.0,3.0,5.0,6.0,0.0,0.0,43,43,0,4.0,4.0,0.0
9309270,10,6,4,5,7,3,13,85,3.0,2.0,1.0,1.0,1.0,2.0,6.0,15,10,5,5.0,3.0,2.0
9709333,25,9,16,31,6,19,37,6,7.0,3.0,4.0,7.0,3.0,4.0,4.0,33,25,8,6.0,4.0,2.0
9402219,24,5,19,51,24,0,0,87,18.0,3.0,15.0,38.0,18.0,0.0,0.0,24,24,0,14.0,14.0,0.0
9602214,17,6,11,34,4,13,16,8,8.0,2.0,6.0,13.0,2.0,6.0,6.0,20,17,3,8.0,7.0,1.0
9611453,26,2,24,92,0,26,100,8,14.0,1.0,13.0,45.0,0.0,14.0,63.0,36,26,10,21.0,15.0,6.0
106176,11,3,8,19,1,10,48,38,6.0,2.0,4.0,8.0,0.0,6.0,18.0,39,11,28,12.0,7.0,5.0
9601205,58,10,48,178,31,27,81,22,23.0,3.0,20.0,60.0,5.0,18.0,62.0,66,58,8,20.0,15.0,5.0
9409339,1,1,0,0,1,0,0,1429,,,,,,,,1,1,0,,,
9907343,5,1,4,5,1,4,17,45,4.0,1.0,3.0,4.0,0.0,4.0,17.0,12,5,7,1.0,1.0,0.0
9403301,47,9,38,129,18,29,62,22,18.0,4.0,14.0,29.0,7.0,11.0,16.0,57,47,10,11.0,10.0,1.0
9403403,47,6,41,143,11,36,54,22,25.0,1.0,24.0,99.0,6.0,19.0,30.0,49,47,2,18.0,16.0,2.0
9902430,45,3,42,183,5,40,156,22,36.0,1.0,35.0,164.0,1.0,35.0,141.0,53,45,8,28.0,21.0,7.0
9412349,8,3,5,8,8,0,0,331,4.0,2.0,2.0,5.0,4.0,0.0,0.0,8,8,0,4.0,4.0,0.0
9711213,5,2,3,3,0,5,19,22,4.0,1.0,3.0,3.0,0.0,4.0,16.0,17,5,12,8.0,4.0,4.0
6201,13,4,9,16,0,13,19,177,11.0,2.0,9.0,16.0,0.0,11.0,17.0,16,13,3,11.0,9.0,2.0
9709417,17,1,16,79,1,16,104,21,16.0,1.0,15.0,77.0,0.0,16.0,102.0,32,17,15,27.0,15.0,12.0
9711214,4,2,2,3,1,3,5,379,3.0,1.0,2.0,3.0,0.0,3.0,5.0,6,4,2,5.0,3.0,2.0
9305279,25,5,20,55,25,0,0,19,5.0,4.0,1.0,1.0,5.0,0.0,0.0,25,25,0,3.0,3.0,0.0
9712442,18,12,6,10,1,17,150,16,0.0,0.0,0.0,0.0,0.0,0.0,0.0,126,18,108,18.0,1.0,17.0
9901397,29,3,26,82,0,29,261,16,20.0,1.0,19.0,60.0,0.0,20.0,174.0,55,29,26,36.0,18.0,18.0
9911273,28,9,19,49,0,28,360,16,17.0,4.0,13.0,27.0,0.0,17.0,171.0,65,28,37,33.0,11.0,22.0
9907310,9,4,5,8,0,9,50,66,0.0,0.0,0.0,0.0,0.0,0.0,0.0,26,9,17,9.0,0.0,9.0
9601388,33,13,20,40,20,13,14,101,13.0,5.0,8.0,17.0,8.0,5.0,5.0,45,33,12,4.0,4.0,0.0
8208,56,5,51,305,2,54,607,20,50.0,3.0,47.0,289.0,1.0,49.0,593.0,94,56,38,52.0,19.0,33.0
9903503,83,5,78,818,0,83,409,20,74.0,3.0,71.0,794.0,0.0,74.0,383.0,89,83,6,63.0,57.0,6.0
9909296,21,6,15,46,2,19,120,20,13.0,2.0,11.0,42.0,0.0,13.0,100.0,33,21,12,3.0,3.0,0.0
9312302,24,10,14,32,1,23,68,49,13.0,7.0,6.0,8.0,0.0,13.0,26.0,29,24,5,10.0,8.0,2.0
9505321,22,3,19,46,5,17,28,85,10.0,1.0,9.0,21.0,2.0,8.0,8.0,27,22,5,7.0,7.0,0.0
9701288,4,1,3,3,4,0,0,136,4.0,1.0,3.0,3.0,4.0,0.0,0.0,4,4,0,1.0,1.0,0.0
3150,16,4,12,25,0,16,84,20,15.0,3.0,12.0,22.0,0.0,15.0,78.0,28,16,12,2.0,1.0,1.0
10049,1,1,0,0,1,0,0,125,0.0,0.0,0.0,0.0,0.0,0.0,0.0,3,1,2,1.0,0.0,1.0
9903451,79,12,67,381,25,54,91,2,40.0,2.0,38.0,232.0,10.0,30.0,49.0,90,79,11,29.0,27.0,2.0
9812365,17,3,14,30,4,13,13,2,8.0,2.0,6.0,10.0,1.0,7.0,7.0,18,17,1,8.0,7.0,1.0
9211216,19,7,12,32,18,1,1,6,9.0,2.0,7.0,25.0,9.0,0.0,0.0,20,19,1,9.0,9.0,0.0
9406284,4,2,2,2,3,1,4,6,2.0,1.0,1.0,1.0,2.0,0.0,0.0,13,4,9,1.0,1.0,0.0
9707249,35,11,24,78,1,34,183,5,10.0,3.0,7.0,23.0,0.0,10.0,43.0,65,35,30,19.0,10.0,9.0
9711470,9,2,7,13,1,8,65,5,1.0,1.0,0.0,0.0,0.0,1.0,3.0,40,9,31,,,
9406248,45,11,34,181,13,32,80,5,24.0,6.0,18.0,93.0,7.0,17.0,17.0,58,45,13,23.0,22.0,1.0
9406256,42,10,32,73,31,11,19,10,13.0,5.0,8.0,17.0,13.0,0.0,0.0,46,42,4,10.0,10.0,0.0
2285,33,6,27,122,0,33,211,73,32.0,6.0,26.0,120.0,0.0,32.0,205.0,45,33,12,31.0,20.0,11.0
9606387,11,3,8,10,5,6,27,42,8.0,2.0,6.0,8.0,3.0,5.0,15.0,21,11,10,3.0,3.0,0.0
102187,18,5,13,45,0,18,105,73,13.0,2.0,11.0,33.0,0.0,13.0,48.0,39,18,21,18.0,12.0,6.0
9707331,15,4,11,28,0,15,86,158,10.0,2.0,8.0,25.0,0.0,10.0,43.0,32,15,17,18.0,9.0,9.0
9606408,5,3,2,3,1,4,16,5,1.0,1.0,0.0,0.0,1.0,0.0,0.0,13,5,8,3.0,2.0,1.0
9608472,29,5,24,104,11,18,18,92,12.0,3.0,9.0,31.0,6.0,6.0,6.0,32,29,3,10.0,9.0,1.0
9612460,7,7,0,0,3,4,5,23,0.0,0.0,0.0,0.0,0.0,0.0,0.0,22,7,15,5.0,0.0,5.0
9608340,21,14,7,10,1,20,44,60,5.0,3.0,2.0,3.0,0.0,5.0,14.0,35,21,14,10.0,3.0,7.0
9707448,20,4,16,61,0,20,76,19,15.0,3.0,12.0,45.0,0.0,15.0,47.0,32,20,12,9.0,8.0,1.0
9603391,32,24,8,9,3,29,141,26,1.0,1.0,0.0,0.0,0.0,1.0,2.0,172,32,140,15.0,0.0,15.0
9906262,35,3,32,197,1,34,37,70,33.0,1.0,32.0,197.0,0.0,33.0,35.0,38,35,3,33.0,31.0,2.0
9905229,5,3,2,2,3,2,3,0,1.0,1.0,0.0,0.0,0.0,1.0,1.0,19,5,14,3.0,0.0,3.0
9904257,13,5,8,14,2,11,45,0,4.0,1.0,3.0,4.0,1.0,3.0,3.0,24,13,11,4.0,0.0,4.0
9701246,8,5,3,3,5,3,4,103,4.0,3.0,1.0,1.0,3.0,1.0,2.0,12,8,4,2.0,1.0,1.0
9805383,3,3,0,0,0,3,7,18,1.0,1.0,0.0,0.0,0.0,1.0,1.0,10,3,7,4.0,1.0,3.0
9703287,61,4,57,501,0,61,220,36,50.0,4.0,46.0,478.0,1.0,49.0,105.0,88,61,27,48.0,46.0,2.0
4220,2,2,0,0,0,2,2,322,2.0,2.0,0.0,0.0,0.0,2.0,2.0,5,2,3,2.0,1.0,1.0
9803470,6,5,1,2,1,5,12,84,5.0,4.0,1.0,2.0,0.0,5.0,12.0,11,6,5,6.0,3.0,3.0
9409432,8,5,3,3,5,3,3,85,1.0,1.0,0.0,0.0,1.0,0.0,0.0,13,8,5,3.0,2.0,1.0
9603386,15,3,12,35,12,3,7,10,10.0,1.0,9.0,29.0,10.0,0.0,0.0,19,15,4,8.0,8.0,0.0
9912318,8,3,5,8,0,8,21,301,5.0,2.0,3.0,3.0,0.0,5.0,10.0,15,8,7,8.0,5.0,3.0
9802374,38,6,32,73,0,38,129,23,14.0,1.0,13.0,26.0,1.0,13.0,20.0,48,38,10,18.0,15.0,3.0
9601343,33,16,17,37,7,26,50,74,8.0,4.0,4.0,8.0,0.0,8.0,19.0,41,33,8,9.0,5.0,4.0
9404279,11,3,8,15,11,0,0,29,9.0,1.0,8.0,15.0,9.0,0.0,0.0,11,11,0,3.0,3.0,0.0
9505337,8,3,5,8,4,4,7,1,2.0,2.0,0.0,0.0,2.0,0.0,0.0,13,8,5,2.0,2.0,0.0
9508293,12,11,1,1,1,11,77,10,2.0,2.0,0.0,0.0,0.0,2.0,18.0,47,12,35,11.0,3.0,8.0
9903423,4,2,2,2,0,4,23,5,1.0,1.0,0.0,0.0,0.0,1.0,1.0,24,4,20,3.0,0.0,3.0
9803259,13,6,7,8,0,13,146,5,1.0,1.0,0.0,0.0,0.0,1.0,3.0,95,13,82,16.0,2.0,14.0
2279,22,6,16,42,3,19,81,2,11.0,1.0,10.0,33.0,0.0,11.0,51.0,29,22,7,15.0,10.0,5.0
9403381,13,4,9,26,3,10,16,104,6.0,1.0,5.0,9.0,0.0,6.0,11.0,15,13,2,9.0,7.0,2.0
9208238,26,9,17,74,26,0,0,124,15.0,4.0,11.0,57.0,15.0,0.0,0.0,26,26,0,13.0,13.0,0.0
112113,22,5,17,50,0,22,419,18,21.0,4.0,17.0,50.0,0.0,21.0,310.0,73,22,51,43.0,19.0,24.0
9701343,14,6,8,21,2,12,34,41,4.0,2.0,2.0,2.0,0.0,4.0,11.0,28,14,14,9.0,8.0,1.0
102259,24,5,19,115,0,24,236,23,22.0,3.0,19.0,115.0,0.0,22.0,219.0,59,24,35,24.0,15.0,9.0
4210,28,12,16,31,0,28,185,5,4.0,3.0,1.0,1.0,1.0,3.0,3.0,57,28,29,6.0,4.0,2.0
9908427,19,3,16,36,5,14,68,18,12.0,2.0,10.0,21.0,5.0,7.0,45.0,38,19,19,9.0,4.0,5.0
3138,6,2,4,8,2,4,13,18,3.0,2.0,1.0,1.0,0.0,3.0,6.0,13,6,7,1.0,1.0,0.0
9903370,24,5,19,55,5,19,83,5,3.0,3.0,0.0,0.0,0.0,3.0,18.0,44,24,20,17.0,3.0,14.0
9407273,53,13,40,109,11,42,189,10,4.0,2.0,2.0,2.0,0.0,4.0,25.0,76,53,23,14.0,6.0,8.0
9504205,7,2,5,8,7,0,0,18,4.0,2.0,2.0,2.0,4.0,0.0,0.0,7,7,0,,,
9512389,13,8,5,6,3,10,23,10,1.0,1.0,0.0,0.0,0.0,1.0,2.0,21,13,8,2.0,2.0,0.0
9405228,19,10,9,19,14,5,7,147,6.0,3.0,3.0,6.0,3.0,3.0,4.0,21,19,2,5.0,5.0,0.0
4193,9,1,8,17,2,7,12,0,5.0,1.0,4.0,6.0,1.0,4.0,5.0,15,9,6,7.0,6.0,1.0
9162,1,1,0,0,0,1,2,50,0.0,0.0,0.0,0.0,0.0,0.0,0.0,25,1,24,16.0,0.0,16.0
9211281,4,1,3,4,4,0,0,69,4.0,1.0,3.0,4.0,4.0,0.0,0.0,4,4,0,,,
9288,9,3,6,10,1,8,34,118,8.0,3.0,5.0,9.0,1.0,7.0,28.0,17,9,8,12.0,6.0,6.0
9706377,98,1,97,984,1,97,394,11,82.0,1.0,81.0,906.0,1.0,81.0,329.0,107,98,9,65.0,60.0,5.0
7099,39,8,31,97,7,32,156,19,6.0,1.0,5.0,9.0,0.0,6.0,19.0,71,39,32,6.0,0.0,6.0
9702282,18,5,13,40,0,18,56,16,6.0,3.0,3.0,5.0,0.0,6.0,22.0,31,18,13,14.0,6.0,8.0
9810215,19,4,15,30,0,19,139,16,13.0,5.0,8.0,14.0,0.0,13.0,99.0,35,19,16,18.0,8.0,10.0
9412342,7,5,2,3,3,4,8,19,2.0,2.0,0.0,0.0,0.0,2.0,4.0,10,7,3,1.0,1.0,0.0
9910250,25,5,20,39,0,25,193,39,18.0,4.0,14.0,28.0,0.0,18.0,127.0,43,25,18,28.0,14.0,14.0
9302228,14,6,8,16,14,0,0,4,4.0,2.0,2.0,2.0,4.0,0.0,0.0,14,14,0,1.0,1.0,0.0
9307266,90,23,67,187,68,22,24,8,15.0,2.0,13.0,50.0,15.0,0.0,0.0,92,90,2,13.0,13.0,0.0
9604267,26,7,19,43,8,18,23,194,13.0,2.0,11.0,20.0,3.0,10.0,10.0,36,26,10,11.0,10.0,1.0
2077,18,4,14,40,3,15,33,16,15.0,3.0,12.0,35.0,2.0,13.0,24.0,27,18,9,10.0,8.0,2.0
9303308,14,6,8,28,10,4,4,135,7.0,3.0,4.0,12.0,3.0,4.0,4.0,15,14,1,3.0,2.0,1.0
9903406,26,6,20,103,1,25,110,46,20.0,2.0,18.0,96.0,0.0,20.0,83.0,45,26,19,25.0,18.0,7.0
9912408,87,14,73,279,3,84,439,2,30.0,2.0,28.0,149.0,0.0,30.0,129.0,112,87,25,28.0,24.0,4.0
110409,12,7,5,6,1,11,99,11,3.0,3.0,0.0,0.0,0.0,3.0,45.0,84,12,72,14.0,2.0,12.0
12167,33,1,32,197,0,33,467,11,32.0,1.0,31.0,195.0,0.0,32.0,424.0,59,33,26,50.0,31.0,19.0
9904464,11,2,9,18,1,10,86,16,8.0,2.0,6.0,15.0,0.0,8.0,69.0,40,11,29,12.0,7.0,5.0
201274,17,4,13,45,1,16,386,19,16.0,3.0,13.0,44.0,0.0,16.0,374.0,66,17,49,51.0,15.0,36.0
102033,29,7,22,59,5,24,46,19,15.0,3.0,12.0,33.0,0.0,15.0,17.0,45,29,16,4.0,4.0,0.0
9801261,3,3,0,0,2,1,1,244,0.0,0.0,0.0,0.0,0.0,0.0,0.0,4,3,1,1.0,0.0,1.0
107138,13,6,7,12,5,8,68,39,3.0,2.0,1.0,1.0,0.0,3.0,11.0,52,13,39,5.0,2.0,3.0
9910371,7,4,3,5,0,7,48,8,5.0,3.0,2.0,3.0,0.0,5.0,23.0,24,7,17,1.0,0.0,1.0
9209242,4,3,1,1,4,0,0,253,1.0,1.0,0.0,0.0,1.0,0.0,0.0,4,4,0,1.0,1.0,0.0
110067,32,9,23,70,1,31,198,2,13.0,2.0,11.0,51.0,3.0,10.0,10.0,45,32,13,8.0,6.0,2.0
9805382,3,3,0,0,0,3,4,40,0.0,0.0,0.0,0.0,0.0,0.0,0.0,15,3,12,11.0,0.0,11.0
9603249,314,15,299,2706,206,108,133,9,124.0,1.0,123.0,1464.0,124.0,0.0,0.0,319,314,5,52.0,51.0,1.0
9702320,12,5,7,10,4,8,41,26,5.0,2.0,3.0,4.0,1.0,4.0,27.0,29,12,17,7.0,0.0,7.0
9507429,37,8,29,105,33,4,6,131,18.0,3.0,15.0,61.0,18.0,0.0,0.0,39,37,2,13.0,13.0,0.0
12100,60,12,48,214,8,52,220,2,25.0,3.0,22.0,113.0,12.0,13.0,13.0,80,60,20,23.0,22.0,1.0
9810550,7,3,4,7,0,7,37,142,6.0,3.0,3.0,6.0,0.0,6.0,32.0,19,7,12,8.0,4.0,4.0
9909294,4,3,1,1,0,4,22,2,0.0,0.0,0.0,0.0,0.0,0.0,0.0,13,4,9,1.0,1.0,0.0
202023,8,1,7,11,0,8,85,10,8.0,1.0,7.0,11.0,0.0,8.0,56.0,51,8,43,17.0,3.0,14.0
9703320,22,5,17,52,2,20,126,60,5.0,2.0,3.0,7.0,0.0,5.0,34.0,44,22,22,17.0,5.0,12.0
12125,102,5,97,952,48,54,74,37,68.0,2.0,66.0,776.0,38.0,30.0,31.0,108,102,6,51.0,51.0,0.0
9404257,9,4,5,11,4,5,5,99,4.0,1.0,3.0,6.0,4.0,0.0,0.0,10,9,1,5.0,4.0,1.0
5135,4,3,1,1,0,4,13,28,3.0,2.0,1.0,1.0,0.0,3.0,7.0,20,4,16,9.0,0.0,9.0
9508317,26,7,19,49,7,19,22,63,18.0,5.0,13.0,34.0,2.0,16.0,19.0,30,26,4,9.0,8.0,1.0
9606452,4,2,2,2,0,4,13,50,1.0,1.0,0.0,0.0,0.0,1.0,3.0,8,4,4,6.0,2.0,4.0
9608241,7,3,4,8,0,7,44,18,4.0,1.0,3.0,4.0,0.0,4.0,17.0,25,7,18,10.0,6.0,4.0
2055,3,3,0,0,0,3,30,5,0.0,0.0,0.0,0.0,0.0,0.0,0.0,43,3,40,22.0,0.0,22.0
9910416,41,7,34,141,15,26,30,95,19.0,2.0,17.0,55.0,19.0,0.0,0.0,44,41,3,14.0,14.0,0.0
2150,68,16,52,209,3,65,488,3,39.0,7.0,32.0,116.0,0.0,39.0,292.0,112,68,44,17.0,7.0,10.0
203158,5,2,3,4,0,5,45,1,3.0,1.0,2.0,3.0,0.0,3.0,24.0,26,5,21,2.0,0.0,2.0
9144,14,5,9,16,1,13,165,7,8.0,3.0,5.0,11.0,1.0,7.0,68.0,61,14,47,10.0,2.0,8.0
9604228,11,1,10,26,0,11,22,58,1.0,1.0,0.0,0.0,0.0,1.0,2.0,17,11,6,2.0,0.0,2.0
9910220,40,7,33,134,2,38,234,7,25.0,6.0,19.0,78.0,1.0,24.0,144.0,62,40,22,21.0,14.0,7.0
9507419,4,1,3,3,0,4,4,61,,,,,,,,5,4,1,,,
9505420,6,2,4,10,5,1,1,79,4.0,1.0,3.0,4.0,4.0,0.0,0.0,7,6,1,2.0,1.0,1.0
9605363,8,1,7,12,2,6,6,72,3.0,1.0,2.0,2.0,1.0,2.0,2.0,9,8,1,3.0,3.0,0.0
9812257,17,3,14,36,1,16,111,11,14.0,2.0,12.0,32.0,0.0,14.0,97.0,26,17,9,8.0,7.0,1.0
9503394,34,9,25,82,23,11,18,47,15.0,3.0,12.0,53.0,15.0,0.0,0.0,38,34,4,13.0,13.0,0.0
9506378,37,2,35,122,0,37,149,17,29.0,2.0,27.0,99.0,0.0,29.0,137.0,46,37,9,29.0,22.0,7.0
9608388,2,2,0,0,0,2,9,17,,,,,,,,12,2,10,2.0,0.0,2.0
9311282,6,1,5,8,2,4,4,229,5.0,1.0,4.0,6.0,3.0,2.0,2.0,8,6,2,5.0,4.0,1.0
9503202,12,8,4,6,5,7,24,26,2.0,2.0,0.0,0.0,1.0,1.0,7.0,33,12,21,3.0,3.0,0.0
9712486,7,3,4,5,2,5,19,24,4.0,2.0,2.0,3.0,2.0,2.0,8.0,18,7,11,5.0,1.0,4.0
9504334,54,13,41,136,29,25,30,67,9.0,1.0,8.0,27.0,9.0,0.0,0.0,61,54,7,10.0,10.0,0.0
9509432,34,11,23,69,0,34,149,8,11.0,4.0,7.0,11.0,5.0,6.0,6.0,48,34,14,12.0,10.0,2.0
9612287,38,14,24,45,38,0,0,25,11.0,5.0,6.0,12.0,11.0,0.0,0.0,38,38,0,2.0,2.0,0.0
102090,44,8,36,159,0,44,208,37,18.0,1.0,17.0,76.0,18.0,0.0,0.0,74,44,30,23.0,2.0,21.0
105097,9,1,8,24,0,9,68,4,9.0,1.0,8.0,24.0,0.0,9.0,59.0,30,9,21,10.0,5.0,5.0
9712464,40,21,19,38,4,36,219,5,9.0,2.0,7.0,12.0,0.0,9.0,42.0,125,40,85,18.0,5.0,13.0
9801391,42,7,35,248,1,41,391,12,38.0,5.0,33.0,232.0,0.0,38.0,336.0,64,42,22,48.0,34.0,14.0
9503437,27,7,20,31,13,14,23,9,5.0,3.0,2.0,2.0,5.0,0.0,0.0,37,27,10,3.0,3.0,0.0
3297,17,9,8,14,5,12,23,135,4.0,1.0,3.0,5.0,0.0,4.0,8.0,22,17,5,7.0,5.0,2.0
9409427,8,2,6,16,0,8,21,192,4.0,2.0,2.0,4.0,0.0,4.0,13.0,16,8,8,7.0,3.0,4.0
9306289,110,14,96,424,84,26,26,14,39.0,1.0,38.0,185.0,39.0,0.0,0.0,112,110,2,9.0,9.0,0.0
9409289,11,3,8,14,11,0,0,77,4.0,3.0,1.0,1.0,4.0,0.0,0.0,11,11,0,3.0,3.0,0.0
9407347,64,13,51,152,50,14,27,135,17.0,2.0,15.0,46.0,7.0,10.0,20.0,68,64,4,15.0,13.0,2.0
2075,21,7,14,36,0,21,141,24,13.0,3.0,10.0,26.0,0.0,13.0,104.0,42,21,21,14.0,7.0,7.0
9708448,14,5,9,17,2,12,51,24,6.0,1.0,5.0,9.0,3.0,3.0,5.0,31,14,17,3.0,0.0,3.0
9409308,4,4,0,0,4,0,0,374,1.0,1.0,0.0,0.0,1.0,0.0,0.0,5,4,1,2.0,1.0,1.0
9612356,0,0,0,0,0,0,0,236,0.0,0.0,0.0,0.0,0.0,0.0,0.0,11,0,11,1.0,0.0,1.0
9804284,29,3,26,108,0,29,223,9,23.0,2.0,21.0,90.0,0.0,23.0,181.0,50,29,21,27.0,11.0,16.0
105050,3,1,2,3,0,3,3,286,2.0,1.0,1.0,1.0,0.0,2.0,2.0,4,3,1,4.0,3.0,1.0
4251,7,1,6,12,0,7,62,14,5.0,1.0,4.0,9.0,0.0,5.0,55.0,28,7,21,18.0,5.0,13.0
9801281,13,8,5,13,1,12,39,14,3.0,2.0,1.0,1.0,0.0,3.0,7.0,21,13,8,6.0,4.0,2.0
9507354,45,17,28,71,20,25,59,14,8.0,2.0,6.0,12.0,1.0,7.0,30.0,54,45,9,8.0,7.0,1.0
9709496,7,4,3,5,3,4,11,14,1.0,1.0,0.0,0.0,0.0,1.0,2.0,15,7,8,4.0,1.0,3.0
4106,10,2,8,11,3,7,23,14,3.0,1.0,2.0,3.0,0.0,3.0,14.0,24,10,14,4.0,0.0,4.0
9708482,5,4,1,1,3,2,2,337,2.0,2.0,0.0,0.0,0.0,2.0,2.0,7,5,2,4.0,2.0,2.0
9610406,6,2,4,5,2,4,7,44,2.0,1.0,1.0,1.0,0.0,2.0,2.0,11,6,5,3.0,2.0,1.0
9512244,11,5,6,16,1,10,39,77,10.0,5.0,5.0,15.0,0.0,10.0,34.0,20,11,9,8.0,4.0,4.0
9911289,37,16,21,65,4,33,201,11,20.0,4.0,16.0,51.0,0.0,20.0,137.0,56,37,19,6.0,6.0,0.0
9512309,13,4,9,20,3,10,22,16,5.0,1.0,4.0,10.0,5.0,0.0,0.0,17,13,4,5.0,5.0,0.0
9504263,8,6,2,3,0,8,40,17,1.0,1.0,0.0,0.0,0.0,1.0,1.0,17,8,9,7.0,2.0,5.0
9706330,3,2,1,1,2,1,9,16,0.0,0.0,0.0,0.0,0.0,0.0,0.0,20,3,17,4.0,0.0,4.0
9409374,2,1,1,1,0,2,4,16,,,,,,,,4,2,2,,,
9606465,16,6,10,27,16,0,0,105,9.0,1.0,8.0,22.0,9.0,0.0,0.0,16,16,0,9.0,9.0,0.0
9706503,3,3,0,0,3,0,0,286,1.0,1.0,0.0,0.0,1.0,0.0,0.0,3,3,0,1.0,1.0,0.0
9412329,14,6,8,16,2,12,20,12,5.0,2.0,3.0,3.0,0.0,5.0,9.0,18,14,4,4.0,3.0,1.0
9806324,27,5,22,56,1,26,98,8,19.0,2.0,17.0,43.0,1.0,18.0,31.0,38,27,11,17.0,13.0,4.0
9608346,13,3,10,20,7,6,7,132,8.0,1.0,7.0,16.0,6.0,2.0,2.0,15,13,2,8.0,8.0,0.0
9512433,21,5,16,39,1,20,134,8,13.0,3.0,10.0,25.0,0.0,13.0,80.0,31,21,10,5.0,5.0,0.0
9612225,28,10,18,54,4,24,83,15,17.0,4.0,13.0,46.0,0.0,17.0,63.0,42,28,14,5.0,5.0,0.0
9406270,5,4,1,2,1,4,10,15,2.0,2.0,0.0,0.0,2.0,0.0,0.0,9,5,4,2.0,2.0,0.0
9512202,8,2,6,12,0,8,33,15,0.0,0.0,0.0,0.0,0.0,0.0,0.0,17,8,9,5.0,1.0,4.0
9708247,12,4,8,18,11,1,1,255,8.0,2.0,6.0,14.0,8.0,0.0,0.0,14,12,2,7.0,7.0,0.0
9706332,5,3,2,2,0,5,37,5,3.0,2.0,1.0,1.0,0.0,3.0,25.0,35,5,30,17.0,1.0,16.0
3143,8,2,6,10,0,8,13,163,4.0,1.0,3.0,3.0,0.0,4.0,6.0,24,8,16,5.0,4.0,1.0
2106,11,5,6,17,5,6,30,102,6.0,1.0,5.0,13.0,1.0,5.0,6.0,23,11,12,7.0,6.0,1.0
9809297,3,2,1,1,3,0,0,55,0.0,0.0,0.0,0.0,0.0,0.0,0.0,16,3,13,,,
9611301,3,3,0,0,1,2,2,366,0.0,0.0,0.0,0.0,0.0,0.0,0.0,8,3,5,1.0,0.0,1.0
3234,8,5,3,12,0,8,59,83,5.0,2.0,3.0,9.0,0.0,5.0,22.0,32,8,24,11.0,4.0,7.0
9705267,15,7,8,21,5,10,25,52,7.0,2.0,5.0,11.0,4.0,3.0,5.0,31,15,16,6.0,2.0,4.0
9907393,10,4,6,22,7,3,5,10,7.0,2.0,5.0,17.0,7.0,0.0,0.0,13,10,3,4.0,3.0,1.0
9803357,28,8,20,66,0,28,336,15,24.0,5.0,19.0,65.0,0.0,24.0,315.0,60,28,32,42.0,15.0,27.0
207197,2,1,1,1,0,2,12,1,2.0,1.0,1.0,1.0,0.0,2.0,8.0,19,2,17,2.0,0.0,2.0
111086,5,2,3,6,0,5,18,146,5.0,2.0,3.0,6.0,0.0,5.0,18.0,12,5,7,10.0,5.0,5.0
9912545,1,1,0,0,0,1,4,120,0.0,0.0,0.0,0.0,0.0,0.0,0.0,5,1,4,4.0,0.0,4.0
9303287,16,8,8,20,16,0,0,50,2.0,1.0,1.0,1.0,2.0,0.0,0.0,16,16,0,1.0,1.0,0.0
9307336,23,9,14,46,23,0,0,40,21.0,7.0,14.0,45.0,21.0,0.0,0.0,24,23,1,4.0,4.0,0.0
9709349,9,3,6,17,0,9,70,8,8.0,2.0,6.0,17.0,0.0,8.0,52.0,28,9,19,6.0,1.0,5.0
9912301,8,6,2,4,0,8,35,18,3.0,2.0,1.0,2.0,0.0,3.0,15.0,23,8,15,14.0,3.0,11.0
101351,7,5,2,5,1,6,67,60,3.0,2.0,1.0,2.0,0.0,3.0,27.0,52,7,45,20.0,2.0,18.0
9710279,7,3,4,5,2,5,16,10,3.0,1.0,2.0,3.0,3.0,0.0,0.0,16,7,9,3.0,3.0,0.0
9710292,6,6,0,0,4,2,4,123,0.0,0.0,0.0,0.0,0.0,0.0,0.0,22,6,16,5.0,0.0,5.0
9809334,2,1,1,1,0,2,3,123,1.0,1.0,0.0,0.0,0.0,1.0,1.0,10,2,8,3.0,0.0,3.0
9910535,10,4,6,7,2,8,38,15,4.0,1.0,3.0,4.0,0.0,4.0,27.0,22,10,12,5.0,3.0,2.0
9508262,31,9,22,54,2,29,63,85,8.0,1.0,7.0,19.0,2.0,6.0,6.0,41,31,10,11.0,9.0,2.0
9306262,2,2,0,0,2,0,0,170,,,,,,,,2,2,0,,,
9812380,2,1,1,1,0,2,10,14,2.0,1.0,1.0,1.0,0.0,2.0,4.0,7,2,5,4.0,2.0,2.0
9901386,29,19,10,15,3,26,127,23,8.0,4.0,4.0,5.0,1.0,7.0,28.0,48,29,19,13.0,6.0,7.0
9810522,3,3,0,0,2,1,2,163,1.0,1.0,0.0,0.0,1.0,0.0,0.0,5,3,2,,,
103068,17,3,14,52,0,17,42,165,16.0,3.0,13.0,51.0,0.0,16.0,29.0,28,17,11,17.0,15.0,2.0
9612405,6,2,4,6,0,6,22,60,5.0,2.0,3.0,5.0,0.0,5.0,21.0,13,6,7,4.0,3.0,1.0
9909345,2,1,1,1,0,2,3,32,0.0,0.0,0.0,0.0,0.0,0.0,0.0,12,2,10,,,
9608280,18,6,12,26,3,15,76,94,12.0,4.0,8.0,16.0,0.0,12.0,71.0,26,18,8,18.0,11.0,7.0
2193,23,10,13,18,2,21,123,89,8.0,4.0,4.0,6.0,0.0,8.0,52.0,75,23,52,14.0,3.0,11.0
9511371,20,10,10,14,4,16,28,181,14.0,7.0,7.0,11.0,3.0,11.0,12.0,24,20,4,9.0,7.0,2.0
9809489,10,4,6,8,0,10,75,21,6.0,4.0,2.0,3.0,0.0,6.0,25.0,32,10,22,12.0,6.0,6.0
9512267,4,1,3,4,0,4,28,14,4.0,1.0,3.0,4.0,0.0,4.0,22.0,16,4,12,1.0,0.0,1.0
9408395,5,3,2,3,2,3,4,8,,,,,,,,7,5,2,,,
9510443,8,3,5,11,0,8,37,36,8.0,3.0,5.0,11.0,0.0,8.0,29.0,18,8,10,15.0,6.0,9.0
9809525,13,3,10,28,0,13,60,12,10.0,2.0,8.0,18.0,0.0,10.0,29.0,26,13,13,16.0,9.0,7.0
9608264,7,5,2,2,0,7,24,61,0.0,0.0,0.0,0.0,0.0,0.0,0.0,22,7,15,7.0,3.0,4.0
9712520,19,3,16,27,6,13,28,12,1.0,1.0,0.0,0.0,1.0,0.0,0.0,34,19,15,3.0,3.0,0.0
105187,4,4,0,0,0,4,10,169,3.0,3.0,0.0,0.0,0.0,3.0,6.0,12,4,8,7.0,2.0,5.0
7003,10,4,6,10,1,9,53,17,3.0,2.0,1.0,1.0,0.0,3.0,28.0,35,10,25,4.0,4.0,0.0
9907469,18,4,14,33,3,15,78,89,14.0,2.0,12.0,29.0,3.0,11.0,49.0,46,18,28,10.0,4.0,6.0
107188,3,2,1,1,0,3,10,89,2.0,1.0,1.0,1.0,0.0,2.0,4.0,9,3,6,4.0,2.0,2.0
9702310,10,7,3,4,0,10,147,6,5.0,3.0,2.0,3.0,0.0,5.0,116.0,71,10,61,40.0,2.0,38.0
101257,10,3,7,10,0,10,83,30,8.0,2.0,6.0,9.0,0.0,8.0,74.0,28,10,18,14.0,3.0,11.0
105235,3,1,2,3,0,3,12,73,2.0,1.0,1.0,1.0,0.0,2.0,8.0,26,3,23,3.0,1.0,2.0
9608270,27,1,26,157,2,25,27,50,26.0,1.0,25.0,156.0,1.0,25.0,25.0,29,27,2,24.0,23.0,1.0
9801407,5,4,1,1,2,3,6,204,2.0,2.0,0.0,0.0,0.0,2.0,5.0,12,5,7,4.0,1.0,3.0
9309306,3,3,0,0,1,2,2,245,3.0,3.0,0.0,0.0,1.0,2.0,2.0,4,3,1,3.0,2.0,1.0
9709407,6,5,1,2,2,4,14,6,0.0,0.0,0.0,0.0,0.0,0.0,0.0,33,6,27,2.0,1.0,1.0
9312338,12,3,9,20,12,0,0,1,2.0,2.0,0.0,0.0,2.0,0.0,0.0,13,12,1,3.0,3.0,0.0
302225,0,0,0,0,0,0,0,98,,,,,,,,3,0,3,,,
9510276,2,1,1,1,2,0,0,1768,,,,,,,,4,2,2,1.0,0.0,1.0
9806525,3,1,2,2,0,3,5,73,,,,,,,,6,3,3,1.0,1.0,0.0
9804352,31,7,24,60,1,30,148,44,19.0,4.0,15.0,41.0,0.0,19.0,82.0,48,31,17,13.0,9.0,4.0
9701277,14,2,12,26,2,12,115,94,9.0,1.0,8.0,17.0,0.0,9.0,71.0,58,14,44,17.0,4.0,13.0
209166,0,0,0,0,0,0,0,29,0.0,0.0,0.0,0.0,0.0,0.0,0.0,28,0,28,14.0,0.0,14.0
112058,2,2,0,0,0,2,8,17,0.0,0.0,0.0,0.0,0.0,0.0,0.0,31,2,29,4.0,0.0,4.0
9706271,24,5,19,42,0,24,128,29,6.0,2.0,4.0,7.0,0.0,6.0,32.0,50,24,26,12.0,4.0,8.0
9712203,17,3,14,40,13,4,6,9,6.0,1.0,5.0,10.0,6.0,0.0,0.0,19,17,2,8.0,8.0,0.0
9509319,8,4,4,6,2,6,11,26,2.0,1.0,1.0,1.0,2.0,0.0,0.0,14,8,6,5.0,3.0,2.0
9608486,11,5,6,10,6,5,6,97,5.0,1.0,4.0,6.0,5.0,0.0,0.0,15,11,4,3.0,2.0,1.0
9801426,4,4,0,0,3,1,1,431,1.0,1.0,0.0,0.0,1.0,0.0,0.0,5,4,1,1.0,1.0,0.0
9702255,9,6,3,3,2,7,30,15,4.0,1.0,3.0,3.0,4.0,0.0,0.0,19,9,10,2.0,2.0,0.0
8074,11,3,8,15,0,11,28,22,8.0,2.0,6.0,13.0,0.0,8.0,20.0,23,11,12,7.0,5.0,2.0
8113,4,1,3,4,0,4,38,21,4.0,1.0,3.0,4.0,0.0,4.0,38.0,17,4,13,16.0,4.0,12.0
108123,1,1,0,0,1,0,0,50,0.0,0.0,0.0,0.0,0.0,0.0,0.0,10,1,9,1.0,0.0,1.0
9902356,8,5,3,3,0,8,45,200,6.0,4.0,2.0,2.0,0.0,6.0,9.0,25,8,17,7.0,4.0,3.0
9404289,5,2,3,4,5,0,0,148,5.0,2.0,3.0,4.0,5.0,0.0,0.0,6,5,1,3.0,3.0,0.0
9807221,4,2,2,3,0,4,4,287,0.0,0.0,0.0,0.0,0.0,0.0,0.0,7,4,3,1.0,0.0,1.0
3066,5,3,2,3,2,3,15,3,4.0,3.0,1.0,1.0,1.0,3.0,11.0,13,5,8,8.0,2.0,6.0
9707510,33,14,19,71,1,32,196,25,21.0,9.0,12.0,48.0,0.0,21.0,132.0,48,33,15,27.0,16.0,11.0
9609323,21,2,19,54,2,19,89,69,14.0,1.0,13.0,37.0,1.0,13.0,52.0,38,21,17,11.0,6.0,5.0
105089,8,5,3,7,0,8,67,0,3.0,2.0,1.0,1.0,0.0,3.0,5.0,32,8,24,9.0,4.0,5.0
112160,12,7,5,6,1,11,67,0,7.0,3.0,4.0,5.0,0.0,7.0,46.0,29,12,17,14.0,6.0,8.0
108199,30,4,26,91,3,27,64,119,14.0,1.0,13.0,47.0,1.0,13.0,20.0,40,30,10,16.0,14.0,2.0
9401216,4,3,1,1,2,2,4,54,0.0,0.0,0.0,0.0,0.0,0.0,0.0,9,4,5,2.0,0.0,2.0
9607384,9,1,8,17,1,8,15,68,5.0,1.0,4.0,8.0,1.0,4.0,6.0,15,9,6,4.0,3.0,1.0
9605258,5,5,0,0,3,2,3,55,0.0,0.0,0.0,0.0,0.0,0.0,0.0,28,5,23,2.0,0.0,2.0
9511273,4,2,2,3,1,3,3,67,3.0,2.0,1.0,1.0,1.0,2.0,2.0,6,4,2,3.0,2.0,1.0
9911517,7,3,4,11,0,7,25,2,3.0,1.0,2.0,3.0,3.0,0.0,0.0,21,7,14,3.0,3.0,0.0
9802392,5,4,1,1,1,4,4,48,2.0,2.0,0.0,0.0,2.0,0.0,0.0,6,5,1,4.0,3.0,1.0
9305237,10,8,2,3,10,0,0,99,1.0,1.0,0.0,0.0,1.0,0.0,0.0,10,10,0,1.0,1.0,0.0
9406213,8,4,4,8,5,3,3,167,7.0,3.0,4.0,8.0,4.0,3.0,3.0,9,8,1,4.0,4.0,0.0
9603265,11,1,10,21,8,3,9,33,10.0,1.0,9.0,20.0,8.0,2.0,2.0,20,11,9,9.0,8.0,1.0
9401302,8,6,2,2,7,1,1,394,2.0,1.0,1.0,1.0,1.0,1.0,1.0,9,8,1,3.0,2.0,1.0
9605392,20,5,15,48,1,19,65,25,17.0,3.0,14.0,47.0,0.0,17.0,59.0,28,20,8,21.0,15.0,6.0
9807336,33,2,31,104,10,23,44,95,23.0,2.0,21.0,65.0,8.0,15.0,15.0,42,33,9,18.0,17.0,1.0
9605344,3,2,1,1,3,0,0,297,2.0,1.0,1.0,1.0,2.0,0.0,0.0,8,3,5,2.0,2.0,0.0
9401276,19,5,14,49,10,9,15,78,11.0,3.0,8.0,31.0,11.0,0.0,0.0,27,19,8,10.0,10.0,0.0
103278,2,1,1,1,0,2,6,23,0.0,0.0,0.0,0.0,0.0,0.0,0.0,11,2,9,1.0,1.0,0.0
9912278,13,1,12,40,0,13,195,15,13.0,1.0,12.0,40.0,0.0,13.0,182.0,49,13,36,17.0,8.0,9.0
11222,9,3,6,10,1,8,25,19,5.0,1.0,4.0,7.0,2.0,3.0,3.0,20,9,11,3.0,2.0,1.0
9407329,3,3,0,0,0,3,34,176,3.0,3.0,0.0,0.0,0.0,3.0,34.0,20,3,17,17.0,3.0,14.0
7350,22,10,12,29,1,21,54,2,6.0,3.0,3.0,7.0,6.0,0.0,0.0,28,22,6,7.0,5.0,2.0
9701330,36,4,32,106,1,35,118,27,31.0,3.0,28.0,94.0,0.0,31.0,101.0,42,36,6,18.0,14.0,4.0
9903512,11,2,9,24,0,11,53,130,10.0,2.0,8.0,20.0,0.0,10.0,42.0,24,11,13,13.0,10.0,3.0
6011,11,7,4,11,1,10,35,44,4.0,3.0,1.0,1.0,0.0,4.0,12.0,19,11,8,10.0,5.0,5.0
108021,42,1,41,231,2,40,256,37,38.0,1.0,37.0,218.0,0.0,38.0,246.0,53,42,11,41.0,31.0,10.0
112007,3,3,0,0,1,2,8,72,1.0,1.0,0.0,0.0,0.0,1.0,4.0,16,3,13,7.0,1.0,6.0
111215,13,4,9,23,0,13,149,3,9.0,2.0,7.0,15.0,0.0,9.0,93.0,65,13,52,25.0,1.0,24.0
9905316,12,4,8,13,0,12,72,3,5.0,3.0,2.0,2.0,0.0,5.0,23.0,48,12,36,14.0,5.0,9.0
102091,3,3,0,0,0,3,15,4,2.0,2.0,0.0,0.0,0.0,2.0,12.0,24,3,21,16.0,1.0,15.0
204037,8,3,5,7,0,8,74,37,7.0,2.0,5.0,6.0,0.0,7.0,58.0,28,8,20,16.0,4.0,12.0
106275,19,6,13,19,2,17,109,23,3.0,2.0,1.0,1.0,0.0,3.0,29.0,61,19,42,16.0,3.0,13.0
209171,1,1,0,0,0,1,11,47,1.0,1.0,0.0,0.0,0.0,1.0,11.0,15,1,14,13.0,1.0,12.0
106246,15,5,10,16,0,15,74,47,8.0,4.0,4.0,6.0,0.0,8.0,26.0,40,15,25,12.0,6.0,6.0
9610389,10,2,8,17,10,0,0,37,2.0,1.0,1.0,1.0,2.0,0.0,0.0,11,10,1,2.0,2.0,0.0
203027,8,4,4,7,0,8,33,3,3.0,1.0,2.0,3.0,0.0,3.0,3.0,25,8,17,12.0,4.0,8.0
105136,13,9,4,5,1,12,39,37,6.0,3.0,3.0,4.0,0.0,6.0,26.0,27,13,14,9.0,3.0,6.0
9906226,4,3,1,1,0,4,18,5,0.0,0.0,0.0,0.0,0.0,0.0,0.0,28,4,24,7.0,2.0,5.0
9906318,25,6,19,70,4,21,37,65,20.0,4.0,16.0,62.0,3.0,17.0,26.0,33,25,8,16.0,14.0,2.0
205024,7,3,4,6,0,7,152,28,7.0,3.0,4.0,6.0,0.0,7.0,137.0,42,7,35,34.0,7.0,27.0
9807537,5,5,0,0,1,4,21,100,2.0,2.0,0.0,0.0,0.0,2.0,7.0,32,5,27,9.0,0.0,9.0
9403405,3,3,0,0,3,0,0,315,1.0,1.0,0.0,0.0,1.0,0.0,0.0,3,3,0,1.0,1.0,0.0
9409364,7,4,3,5,4,3,6,179,3.0,2.0,1.0,2.0,1.0,2.0,2.0,9,7,2,4.0,3.0,1.0
107317,4,3,1,1,1,3,6,14,1.0,1.0,0.0,0.0,0.0,1.0,2.0,14,4,10,2.0,0.0,2.0
9902411,18,8,10,17,1,17,134,11,10.0,2.0,8.0,14.0,0.0,10.0,92.0,37,18,19,3.0,3.0,0.0
9512374,7,3,4,5,0,7,30,13,3.0,3.0,0.0,0.0,0.0,3.0,11.0,19,7,12,8.0,3.0,5.0
9710425,6,2,4,5,0,6,13,23,0.0,0.0,0.0,0.0,0.0,0.0,0.0,29,6,23,4.0,3.0,1.0
9605314,5,2,3,5,5,0,0,44,5.0,2.0,3.0,5.0,5.0,0.0,0.0,7,5,2,4.0,4.0,0.0
9509322,4,3,1,1,2,2,3,481,3.0,2.0,1.0,1.0,3.0,0.0,0.0,8,4,4,4.0,3.0,1.0
9808354,4,3,1,1,2,2,6,5,1.0,1.0,0.0,0.0,0.0,1.0,1.0,23,4,19,2.0,2.0,0.0
9612477,0,0,0,0,0,0,0,1645,0.0,0.0,0.0,0.0,0.0,0.0,0.0,8,0,8,2.0,0.0,2.0
9808213,10,8,2,2,1,9,28,144,6.0,5.0,1.0,1.0,1.0,5.0,12.0,19,10,9,8.0,4.0,4.0
207123,12,7,5,6,3,9,48,121,1.0,1.0,0.0,0.0,0.0,1.0,5.0,47,12,35,6.0,2.0,4.0
2054,4,1,3,3,0,4,62,102,4.0,1.0,3.0,3.0,0.0,4.0,52.0,36,4,32,17.0,4.0,13.0
9503403,6,6,0,0,6,0,0,111,4.0,4.0,0.0,0.0,4.0,0.0,0.0,6,6,0,4.0,4.0,0.0
9704379,42,12,30,57,21,21,23,9,20.0,6.0,14.0,18.0,3.0,17.0,17.0,47,42,5,15.0,14.0,1.0
103339,5,2,3,3,0,5,11,6,1.0,1.0,0.0,0.0,1.0,0.0,0.0,11,5,6,4.0,1.0,3.0
9805393,2,2,0,0,1,1,4,52,0.0,0.0,0.0,0.0,0.0,0.0,0.0,8,2,6,4.0,1.0,3.0
9709367,9,4,5,10,0,9,29,255,5.0,4.0,1.0,1.0,0.0,5.0,16.0,18,9,9,9.0,4.0,5.0
9907528,6,4,2,2,0,6,29,128,6.0,4.0,2.0,2.0,0.0,6.0,25.0,18,6,12,11.0,6.0,5.0
4056,31,2,29,235,0,31,93,109,31.0,2.0,29.0,235.0,0.0,31.0,87.0,38,31,7,33.0,29.0,4.0
9609520,9,3,6,10,0,9,16,109,6.0,2.0,4.0,6.0,0.0,6.0,12.0,11,9,2,8.0,6.0,2.0
9511364,3,2,1,1,2,1,4,26,2.0,2.0,0.0,0.0,1.0,1.0,3.0,7,3,4,1.0,1.0,0.0
9502371,5,2,3,3,5,0,0,203,5.0,2.0,3.0,3.0,5.0,0.0,0.0,5,5,0,3.0,3.0,0.0
9407294,3,3,0,0,1,2,4,225,1.0,1.0,0.0,0.0,0.0,1.0,1.0,7,3,4,1.0,0.0,1.0
6015,13,5,8,17,8,5,8,283,6.0,1.0,5.0,10.0,3.0,3.0,3.0,17,13,4,5.0,2.0,3.0
9904336,25,5,20,53,1,24,257,50,18.0,3.0,15.0,41.0,1.0,17.0,144.0,71,25,46,22.0,12.0,10.0
9808364,4,1,3,4,0,4,23,19,4.0,1.0,3.0,4.0,0.0,4.0,18.0,12,4,8,12.0,4.0,8.0
9811271,4,4,0,0,0,4,6,36,3.0,3.0,0.0,0.0,3.0,0.0,0.0,10,4,6,1.0,1.0,0.0
9705222,9,6,3,3,1,8,53,7,6.0,4.0,2.0,2.0,0.0,6.0,39.0,29,9,20,16.0,5.0,11.0
9411234,71,14,57,280,3,68,315,53,48.0,5.0,43.0,255.0,1.0,47.0,280.0,81,71,10,46.0,37.0,9.0
9610503,3,2,1,1,0,3,11,61,2.0,2.0,0.0,0.0,0.0,2.0,5.0,8,3,5,5.0,2.0,3.0
9601268,7,6,1,1,6,1,1,205,4.0,4.0,0.0,0.0,4.0,0.0,0.0,8,7,1,3.0,3.0,0.0
9706322,1,1,0,0,0,1,1,238,0.0,0.0,0.0,0.0,0.0,0.0,0.0,11,1,10,2.0,0.0,2.0
9707266,7,4,3,7,4,3,8,77,5.0,3.0,2.0,5.0,2.0,3.0,3.0,17,7,10,3.0,1.0,2.0
8285,3,2,1,1,0,3,17,1,2.0,1.0,1.0,1.0,0.0,2.0,8.0,12,3,9,,,
9712337,2,1,1,1,0,2,4,31,0.0,0.0,0.0,0.0,0.0,0.0,0.0,5,2,3,1.0,0.0,1.0
7148,6,2,4,5,0,6,29,10,3.0,2.0,1.0,1.0,0.0,3.0,4.0,31,6,25,5.0,2.0,3.0
104220,12,2,10,20,10,2,2,0,4.0,1.0,3.0,4.0,4.0,0.0,0.0,13,12,1,5.0,5.0,0.0
3030,8,1,7,13,0,8,51,8,6.0,1.0,5.0,10.0,0.0,6.0,37.0,31,8,23,18.0,5.0,13.0
203047,4,3,1,1,1,3,12,177,3.0,2.0,1.0,1.0,0.0,3.0,11.0,14,4,10,6.0,2.0,4.0
9507259,1,1,0,0,0,1,3,16,1.0,1.0,0.0,0.0,0.0,1.0,3.0,5,1,4,,,
110405,8,3,5,9,3,5,13,202,6.0,1.0,5.0,9.0,2.0,4.0,9.0,16,8,8,7.0,5.0,2.0
9510421,11,4,7,18,0,11,26,124,4.0,2.0,2.0,2.0,1.0,3.0,12.0,17,11,6,6.0,5.0,1.0
9711306,3,2,1,2,2,1,1,243,3.0,2.0,1.0,2.0,3.0,0.0,0.0,5,3,2,2.0,1.0,1.0
9095,5,1,4,5,0,5,17,186,5.0,1.0,4.0,5.0,0.0,5.0,15.0,14,5,9,10.0,5.0,5.0
206150,3,2,1,1,0,3,4,121,2.0,1.0,1.0,1.0,0.0,2.0,2.0,10,3,7,2.0,1.0,1.0
9708243,7,4,3,5,3,4,12,14,6.0,3.0,3.0,5.0,6.0,0.0,0.0,17,7,10,6.0,6.0,0.0
9601320,12,3,9,14,5,7,18,37,4.0,1.0,3.0,4.0,0.0,4.0,13.0,16,12,4,9.0,5.0,4.0
9804263,5,2,3,4,0,5,26,8,2.0,2.0,0.0,0.0,0.0,2.0,6.0,15,5,10,5.0,2.0,3.0
9611208,7,6,1,1,2,5,10,14,2.0,2.0,0.0,0.0,0.0,2.0,2.0,27,7,20,2.0,1.0,1.0
9708436,4,2,2,2,2,2,6,41,3.0,2.0,1.0,1.0,1.0,2.0,4.0,9,4,5,2.0,1.0,1.0
9807289,2,1,1,1,0,2,6,10,1.0,1.0,0.0,0.0,0.0,1.0,2.0,16,2,14,3.0,1.0,2.0
9608282,1,1,0,0,1,0,0,72,0.0,0.0,0.0,0.0,0.0,0.0,0.0,13,1,12,1.0,0.0,1.0
9306301,9,4,5,5,9,0,0,40,2.0,2.0,0.0,0.0,2.0,0.0,0.0,9,9,0,4.0,4.0,0.0
9811301,11,1,10,35,3,8,11,294,10.0,1.0,9.0,34.0,4.0,6.0,6.0,18,11,7,12.0,10.0,2.0
8105,14,6,8,15,0,14,96,50,10.0,5.0,5.0,10.0,0.0,10.0,42.0,36,14,22,19.0,10.0,9.0
7162,9,1,8,22,0,9,61,49,7.0,1.0,6.0,15.0,0.0,7.0,34.0,37,9,28,13.0,7.0,6.0
9810415,8,6,2,5,7,1,1,84,2.0,1.0,1.0,1.0,1.0,1.0,1.0,9,8,1,4.0,3.0,1.0
9905531,2,2,0,0,0,2,6,68,0.0,0.0,0.0,0.0,0.0,0.0,0.0,17,2,15,4.0,0.0,4.0
9710381,4,2,2,2,2,2,5,14,0.0,0.0,0.0,0.0,0.0,0.0,0.0,10,4,6,2.0,1.0,1.0
9298,6,6,0,0,0,6,37,97,1.0,1.0,0.0,0.0,0.0,1.0,2.0,42,6,36,9.0,1.0,8.0
7354,2,2,0,0,0,2,13,2,1.0,1.0,0.0,0.0,0.0,1.0,9.0,21,2,19,9.0,1.0,8.0
9708258,3,1,2,3,0,3,10,17,3.0,1.0,2.0,3.0,1.0,2.0,3.0,22,3,19,2.0,0.0,2.0
9811280,7,5,2,3,0,7,29,56,7.0,5.0,2.0,3.0,0.0,7.0,29.0,23,7,16,10.0,4.0,6.0
9812302,1,1,0,0,0,1,13,56,1.0,1.0,0.0,0.0,0.0,1.0,12.0,20,1,19,14.0,1.0,13.0
107245,2,1,1,1,2,0,0,1558,0.0,0.0,0.0,0.0,0.0,0.0,0.0,3,2,1,,,
106294,2,2,0,0,0,2,16,9,1.0,1.0,0.0,0.0,0.0,1.0,4.0,30,2,28,3.0,0.0,3.0
9609384,31,9,22,80,20,11,13,45,15.0,3.0,12.0,53.0,15.0,0.0,0.0,36,31,5,12.0,12.0,0.0
9406264,5,4,1,2,2,3,5,38,2.0,2.0,0.0,0.0,1.0,1.0,2.0,10,5,5,3.0,2.0,1.0
7187,2,2,0,0,1,1,2,172,1.0,1.0,0.0,0.0,0.0,1.0,2.0,7,2,5,1.0,1.0,0.0
9804380,10,7,3,3,2,8,35,12,0.0,0.0,0.0,0.0,0.0,0.0,0.0,34,10,24,2.0,2.0,0.0
10275,6,6,0,0,3,3,10,15,1.0,1.0,0.0,0.0,0.0,1.0,4.0,45,6,39,23.0,0.0,23.0
9403282,9,5,4,9,2,7,11,25,4.0,3.0,1.0,3.0,4.0,0.0,0.0,11,9,2,4.0,3.0,1.0
9408312,4,4,0,0,3,1,1,394,2.0,2.0,0.0,0.0,1.0,1.0,1.0,9,4,5,4.0,1.0,3.0
201192,3,2,1,1,3,0,0,302,2.0,2.0,0.0,0.0,2.0,0.0,0.0,4,3,1,1.0,1.0,0.0
9503438,1,1,0,0,1,0,0,142,,,,,,,,1,1,0,,,
9407288,9,4,5,7,9,0,0,303,6.0,3.0,3.0,5.0,6.0,0.0,0.0,11,9,2,3.0,3.0,0.0
9712276,16,3,13,40,11,5,9,191,14.0,2.0,12.0,38.0,9.0,5.0,9.0,20,16,4,14.0,12.0,2.0
9609266,9,3,6,10,1,8,39,8,9.0,3.0,6.0,10.0,1.0,8.0,32.0,17,9,8,6.0,3.0,3.0
106337,2,1,1,1,0,2,10,28,2.0,1.0,1.0,1.0,0.0,2.0,6.0,8,2,6,4.0,2.0,2.0
9801328,4,1,3,4,0,4,17,17,4.0,1.0,3.0,4.0,0.0,4.0,16.0,14,4,10,,,
9704400,3,2,1,1,1,2,5,114,1.0,1.0,0.0,0.0,1.0,0.0,0.0,9,3,6,1.0,0.0,1.0
9709327,11,7,4,6,0,11,33,85,4.0,2.0,2.0,2.0,0.0,4.0,12.0,20,11,9,7.0,4.0,3.0
9506225,3,2,1,1,3,0,0,391,2.0,1.0,1.0,1.0,2.0,0.0,0.0,3,3,0,2.0,2.0,0.0
210241,1,1,0,0,0,1,7,73,1.0,1.0,0.0,0.0,0.0,1.0,2.0,12,1,11,3.0,1.0,2.0
4035,8,2,6,11,0,8,49,21,3.0,1.0,2.0,2.0,0.0,3.0,6.0,26,8,18,7.0,0.0,7.0
212005,2,2,0,0,0,2,17,73,1.0,1.0,0.0,0.0,0.0,1.0,4.0,19,2,17,5.0,1.0,4.0
9803494,1,1,0,0,1,0,0,292,0.0,0.0,0.0,0.0,0.0,0.0,0.0,4,1,3,2.0,0.0,2.0
9912337,1,1,0,0,1,0,0,315,1.0,1.0,0.0,0.0,1.0,0.0,0.0,7,1,6,1.0,1.0,0.0
9812382,5,5,0,0,0,5,48,16,1.0,1.0,0.0,0.0,0.0,1.0,13.0,65,5,60,15.0,1.0,14.0
9508212,6,2,4,8,4,2,3,33,0.0,0.0,0.0,0.0,0.0,0.0,0.0,20,6,14,2.0,0.0,2.0
7185,14,6,8,19,3,11,84,50,8.0,1.0,7.0,17.0,0.0,8.0,80.0,32,14,18,23.0,6.0,17.0
9604341,6,2,4,8,6,0,0,50,2.0,1.0,1.0,1.0,2.0,0.0,0.0,6,6,0,5.0,5.0,0.0
210118,0,0,0,0,0,0,0,92,0.0,0.0,0.0,0.0,0.0,0.0,0.0,21,0,21,2.0,0.0,2.0
9809527,6,2,4,5,3,3,6,238,5.0,2.0,3.0,4.0,3.0,2.0,2.0,9,6,3,3.0,3.0,0.0
9908526,12,2,10,28,2,10,12,147,7.0,2.0,5.0,12.0,5.0,2.0,2.0,14,12,2,5.0,4.0,1.0
9805463,3,3,0,0,0,3,8,27,0.0,0.0,0.0,0.0,0.0,0.0,0.0,11,3,8,1.0,0.0,1.0
9809226,2,2,0,0,0,2,9,245,0.0,0.0,0.0,0.0,0.0,0.0,0.0,11,2,9,8.0,1.0,7.0
9902207,5,4,1,1,3,2,2,556,2.0,2.0,0.0,0.0,2.0,0.0,0.0,6,5,1,1.0,1.0,0.0
9812385,8,6,2,2,2,6,29,57,3.0,2.0,1.0,1.0,0.0,3.0,8.0,24,8,16,5.0,2.0,3.0
9604235,5,1,4,4,0,5,13,154,5.0,1.0,4.0,4.0,0.0,5.0,13.0,10,5,5,10.0,5.0,5.0
9802228,2,2,0,0,2,0,0,1118,1.0,1.0,0.0,0.0,1.0,0.0,0.0,6,2,4,1.0,1.0,0.0
9801399,11,2,9,14,1,10,50,22,7.0,2.0,5.0,5.0,0.0,7.0,40.0,21,11,10,13.0,5.0,8.0
112188,3,2,1,1,0,3,18,22,0.0,0.0,0.0,0.0,0.0,0.0,0.0,25,3,22,8.0,0.0,8.0
9809390,4,4,0,0,0,4,12,22,2.0,2.0,0.0,0.0,0.0,2.0,6.0,18,4,14,6.0,1.0,5.0
5322,5,5,0,0,3,2,2,68,0.0,0.0,0.0,0.0,0.0,0.0,0.0,23,5,18,5.0,0.0,5.0
9710267,5,2,3,6,0,5,26,48,4.0,1.0,3.0,6.0,0.0,4.0,18.0,17,5,12,9.0,4.0,5.0
2240,23,12,11,21,3,20,56,1,3.0,2.0,1.0,1.0,0.0,3.0,12.0,43,23,20,7.0,2.0,5.0
9703462,2,2,0,0,1,1,3,17,0.0,0.0,0.0,0.0,0.0,0.0,0.0,61,2,59,22.0,0.0,22.0
9911330,1,1,0,0,1,0,0,277,0.0,0.0,0.0,0.0,0.0,0.0,0.0,4,1,3,,,
9310348,3,2,1,1,3,0,0,75,,,,,,,,6,3,3,,,
9809597,1,1,0,0,0,1,4,70,1.0,1.0,0.0,0.0,0.0,1.0,4.0,5,1,4,,,
203273,6,1,5,10,0,6,32,0,6.0,1.0,5.0,10.0,0.0,6.0,32.0,17,6,11,5.0,4.0,1.0
9906267,14,6,8,13,2,12,69,67,6.0,1.0,5.0,7.0,0.0,6.0,51.0,47,14,33,15.0,5.0,10.0
9808258,8,4,4,5,1,7,22,8,4.0,1.0,3.0,3.0,0.0,4.0,11.0,17,8,9,10.0,4.0,6.0
9512438,1,1,0,0,1,0,0,510,0.0,0.0,0.0,0.0,0.0,0.0,0.0,4,1,3,1.0,0.0,1.0
105229,47,27,20,38,24,23,43,64,12.0,6.0,6.0,7.0,1.0,11.0,24.0,53,47,6,4.0,3.0,1.0
209294,4,4,0,0,0,4,21,3,1.0,1.0,0.0,0.0,0.0,1.0,2.0,90,4,86,12.0,0.0,12.0
206087,6,3,3,5,0,6,39,3,5.0,2.0,3.0,5.0,0.0,5.0,19.0,45,6,39,8.0,3.0,5.0
208162,1,1,0,0,0,1,25,3,0.0,0.0,0.0,0.0,0.0,0.0,0.0,48,1,47,13.0,1.0,12.0
9808378,30,4,26,101,3,27,91,45,15.0,1.0,14.0,53.0,2.0,13.0,25.0,44,30,14,15.0,13.0,2.0
9909338,7,6,1,1,2,5,19,108,4.0,4.0,0.0,0.0,0.0,4.0,15.0,14,7,7,9.0,3.0,6.0
9262,6,5,1,1,0,6,29,35,3.0,3.0,0.0,0.0,0.0,3.0,10.0,23,6,17,7.0,1.0,6.0
9408394,3,1,2,2,0,3,5,19,1.0,1.0,0.0,0.0,0.0,1.0,1.0,5,3,2,1.0,1.0,0.0
9612239,15,1,14,62,6,9,9,112,15.0,1.0,14.0,62.0,6.0,9.0,9.0,17,15,2,15.0,14.0,1.0
212015,1,1,0,0,1,0,0,64,0.0,0.0,0.0,0.0,0.0,0.0,0.0,12,1,11,3.0,0.0,3.0
209116,3,3,0,0,2,1,1,20,1.0,1.0,0.0,0.0,1.0,0.0,0.0,7,3,4,1.0,1.0,0.0
208035,3,2,1,1,0,3,13,48,1.0,1.0,0.0,0.0,0.0,1.0,5.0,33,3,30,16.0,1.0,15.0
9402251,12,2,10,17,12,0,0,212,10.0,2.0,8.0,14.0,10.0,0.0,0.0,12,12,0,6.0,6.0,0.0
9403315,2,2,0,0,0,2,4,358,1.0,1.0,0.0,0.0,0.0,1.0,3.0,10,2,8,6.0,1.0,5.0
9803276,3,2,1,1,3,0,0,59,1.0,1.0,0.0,0.0,1.0,0.0,0.0,6,3,3,2.0,1.0,1.0
110299,2,2,0,0,0,2,8,19,1.0,1.0,0.0,0.0,0.0,1.0,4.0,14,2,12,6.0,1.0,5.0
9702382,0,0,0,0,0,0,0,100,0.0,0.0,0.0,0.0,0.0,0.0,0.0,5,0,5,1.0,0.0,1.0
4206,13,5,8,12,2,11,70,57,4.0,2.0,2.0,3.0,0.0,4.0,23.0,58,13,45,5.0,2.0,3.0
9609388,11,7,4,6,3,8,21,43,4.0,1.0,3.0,4.0,0.0,4.0,17.0,20,11,9,2.0,2.0,0.0
209078,0,0,0,0,0,0,0,22,0.0,0.0,0.0,0.0,0.0,0.0,0.0,9,0,9,6.0,0.0,6.0
110114,6,2,4,5,0,6,55,109,5.0,1.0,4.0,5.0,0.0,5.0,50.0,40,6,34,16.0,5.0,11.0
9602271,15,7,8,16,4,11,19,103,9.0,3.0,6.0,14.0,0.0,9.0,14.0,19,15,4,8.0,6.0,2.0
9504345,4,3,1,1,0,4,27,93,4.0,3.0,1.0,1.0,0.0,4.0,27.0,16,4,12,13.0,4.0,9.0
1032,6,5,1,1,4,2,5,98,0.0,0.0,0.0,0.0,0.0,0.0,0.0,31,6,25,7.0,0.0,7.0
12012,5,4,1,1,0,5,10,125,1.0,1.0,0.0,0.0,0.0,1.0,2.0,28,5,23,10.0,0.0,10.0
105132,4,1,3,5,0,4,24,83,3.0,1.0,2.0,3.0,0.0,3.0,11.0,17,4,13,7.0,3.0,4.0
9802215,1,1,0,0,0,1,2,281,0.0,0.0,0.0,0.0,0.0,0.0,0.0,3,1,2,2.0,0.0,2.0
9611327,1,1,0,0,1,0,0,204,,,,,,,,4,1,3,,,
9205232,6,5,1,2,6,0,0,90,2.0,2.0,0.0,0.0,2.0,0.0,0.0,6,6,0,2.0,2.0,0.0
9801264,4,3,1,1,3,1,1,333,2.0,2.0,0.0,0.0,2.0,0.0,0.0,7,4,3,2.0,2.0,0.0
11188,2,1,1,1,2,0,0,830,2.0,1.0,1.0,1.0,2.0,0.0,0.0,4,2,2,,,
111332,11,4,7,11,1,10,131,12,7.0,1.0,6.0,10.0,0.0,7.0,108.0,68,11,57,26.0,6.0,20.0
208069,8,5,3,3,0,8,99,18,5.0,4.0,1.0,1.0,0.0,5.0,50.0,69,8,61,16.0,4.0,12.0
106311,12,7,5,15,0,12,121,23,8.0,4.0,4.0,11.0,0.0,8.0,82.0,35,12,23,21.0,8.0,13.0
9901446,4,2,2,2,0,4,16,136,4.0,2.0,2.0,2.0,0.0,4.0,16.0,11,4,7,10.0,3.0,7.0
9407213,1,1,0,0,1,0,0,1215,,,,,,,,1,1,0,,,
9602212,1,1,0,0,0,1,1,325,1.0,1.0,0.0,0.0,0.0,1.0,1.0,3,1,2,2.0,1.0,1.0
8179,3,3,0,0,2,1,2,621,0.0,0.0,0.0,0.0,0.0,0.0,0.0,10,3,7,2.0,0.0,2.0
3286,2,2,0,0,0,2,2,41,2.0,2.0,0.0,0.0,0.0,2.0,2.0,9,2,7,4.0,2.0,2.0
3073,13,5,8,12,0,13,143,1,6.0,2.0,4.0,6.0,0.0,6.0,25.0,71,13,58,14.0,8.0,6.0
106329,6,2,4,7,0,6,94,9,6.0,2.0,4.0,7.0,0.0,6.0,93.0,36,6,30,10.0,1.0,9.0
205274,7,4,3,4,1,6,37,62,4.0,1.0,3.0,4.0,0.0,4.0,31.0,25,7,18,13.0,4.0,9.0
209021,1,1,0,0,0,1,3,2,1.0,1.0,0.0,0.0,0.0,1.0,2.0,19,1,18,3.0,0.0,3.0
105182,14,7,7,10,0,14,115,18,1.0,1.0,0.0,0.0,0.0,1.0,15.0,70,14,56,19.0,1.0,18.0
9502292,5,4,1,1,5,0,0,311,2.0,1.0,1.0,1.0,2.0,0.0,0.0,5,5,0,2.0,2.0,0.0
9606421,6,5,1,1,0,6,34,43,4.0,3.0,1.0,1.0,0.0,4.0,26.0,17,6,11,11.0,2.0,9.0
106256,2,2,0,0,0,2,3,68,1.0,1.0,0.0,0.0,0.0,1.0,2.0,5,2,3,,,
11051,1,1,0,0,1,0,0,41,,,,,,,,11,1,10,2.0,0.0,2.0
104143,4,4,0,0,0,4,30,2,2.0,2.0,0.0,0.0,0.0,2.0,9.0,30,4,26,15.0,0.0,15.0
9812309,10,7,3,3,2,8,10,230,7.0,4.0,3.0,3.0,2.0,5.0,5.0,12,10,2,5.0,4.0,1.0
9811258,2,1,1,1,0,2,4,212,2.0,1.0,1.0,1.0,0.0,2.0,4.0,8,2,6,5.0,1.0,4.0
9902298,1,1,0,0,1,0,0,1751,,,,,,,,9,1,8,1.0,0.0,1.0
206072,6,4,2,4,1,5,132,28,4.0,2.0,2.0,4.0,0.0,4.0,91.0,142,6,136,36.0,4.0,32.0
9702351,1,1,0,0,0,1,3,222,1.0,1.0,0.0,0.0,0.0,1.0,3.0,6,1,5,3.0,0.0,3.0
9511348,11,4,7,15,0,11,26,40,10.0,3.0,7.0,15.0,0.0,10.0,25.0,15,11,4,11.0,7.0,4.0
203199,1,1,0,0,0,1,5,13,1.0,1.0,0.0,0.0,0.0,1.0,4.0,8,1,7,5.0,1.0,4.0
9508267,1,1,0,0,1,0,0,281,1.0,1.0,0.0,0.0,1.0,0.0,0.0,1,1,0,1.0,1.0,0.0
9503478,11,3,8,25,8,3,3,134,9.0,2.0,7.0,21.0,9.0,0.0,0.0,12,11,1,9.0,9.0,0.0
9606434,2,2,0,0,0,2,7,10,1.0,1.0,0.0,0.0,0.0,1.0,5.0,31,2,29,8.0,1.0,7.0
9911277,14,8,6,9,9,5,5,126,4.0,1.0,3.0,5.0,0.0,4.0,4.0,18,14,4,5.0,4.0,1.0
9210232,2,2,0,0,2,0,0,1937,1.0,1.0,0.0,0.0,1.0,0.0,0.0,2,2,0,1.0,1.0,0.0
9901261,3,1,2,2,0,3,7,29,2.0,1.0,1.0,1.0,0.0,2.0,6.0,10,3,7,2.0,1.0,1.0
9811306,2,1,1,1,0,2,3,65,0.0,0.0,0.0,0.0,0.0,0.0,0.0,6,2,4,,,
2113,1,1,0,0,1,0,0,9,0.0,0.0,0.0,0.0,0.0,0.0,0.0,28,1,27,10.0,0.0,10.0
202102,4,3,1,1,1,3,13,25,3.0,2.0,1.0,1.0,0.0,3.0,6.0,13,4,9,7.0,3.0,4.0
9711463,7,4,3,3,5,2,2,203,5.0,2.0,3.0,3.0,4.0,1.0,1.0,10,7,3,4.0,4.0,0.0
102172,7,2,5,8,1,6,16,2,3.0,2.0,1.0,1.0,3.0,0.0,0.0,16,7,9,3.0,3.0,0.0
9806233,4,3,1,2,0,4,8,84,3.0,2.0,1.0,1.0,0.0,3.0,6.0,10,4,6,3.0,1.0,2.0
6237,9,5,4,7,0,9,40,65,7.0,3.0,4.0,7.0,0.0,7.0,28.0,30,9,21,12.0,7.0,5.0
109016,1,1,0,0,0,1,2,289,1.0,1.0,0.0,0.0,0.0,1.0,2.0,8,1,7,3.0,1.0,2.0
10259,1,1,0,0,0,1,10,22,1.0,1.0,0.0,0.0,0.0,1.0,10.0,11,1,10,1.0,0.0,1.0
9401333,1,1,0,0,0,1,1,485,1.0,1.0,0.0,0.0,0.0,1.0,1.0,2,1,1,2.0,1.0,1.0
9702428,2,1,1,1,0,2,4,82,2.0,1.0,1.0,1.0,0.0,2.0,4.0,4,2,2,,,
9812334,4,2,2,2,0,4,8,11,3.0,1.0,2.0,2.0,0.0,3.0,3.0,9,4,5,1.0,0.0,1.0
11047,2,2,0,0,0,2,9,16,1.0,1.0,0.0,0.0,0.0,1.0,7.0,10,2,8,3.0,1.0,2.0
9808253,1,1,0,0,1,0,0,145,,,,,,,,3,1,2,,,
9510420,3,2,1,1,1,2,3,19,3.0,2.0,1.0,1.0,2.0,1.0,1.0,5,3,2,5.0,3.0,2.0
9707265,7,4,3,5,3,4,6,123,1.0,1.0,0.0,0.0,0.0,1.0,3.0,10,7,3,4.0,1.0,3.0
9508282,3,2,1,1,0,3,4,13,2.0,1.0,1.0,1.0,2.0,0.0,0.0,11,3,8,2.0,2.0,0.0
204076,5,3,2,2,0,5,42,20,5.0,3.0,2.0,2.0,0.0,5.0,42.0,25,5,20,11.0,4.0,7.0
211264,3,3,0,0,0,3,17,0,2.0,2.0,0.0,0.0,0.0,2.0,13.0,37,3,34,3.0,0.0,3.0
6024,21,10,11,16,6,15,25,64,15.0,4.0,11.0,15.0,2.0,13.0,23.0,25,21,4,10.0,8.0,2.0
302174,0,0,0,0,0,0,0,4,0.0,0.0,0.0,0.0,0.0,0.0,0.0,106,0,106,42.0,0.0,42.0
111231,1,1,0,0,1,0,0,171,0.0,0.0,0.0,0.0,0.0,0.0,0.0,8,1,7,5.0,0.0,5.0
102173,8,6,2,3,1,7,23,12,3.0,3.0,0.0,0.0,2.0,1.0,1.0,25,8,17,4.0,2.0,2.0
209290,7,2,5,8,0,7,51,1,5.0,1.0,4.0,7.0,0.0,5.0,25.0,35,7,28,11.0,5.0,6.0
9412354,10,4,6,9,9,1,1,233,3.0,1.0,2.0,3.0,3.0,0.0,0.0,12,10,2,2.0,2.0,0.0
9408301,5,5,0,0,4,1,1,261,1.0,1.0,0.0,0.0,0.0,1.0,1.0,6,5,1,2.0,1.0,1.0
9907377,9,3,6,7,0,9,18,5,2.0,2.0,0.0,0.0,0.0,2.0,4.0,24,9,15,11.0,1.0,10.0
204079,15,5,10,20,0,15,153,20,15.0,5.0,10.0,20.0,0.0,15.0,151.0,42,15,27,10.0,5.0,5.0
9307302,5,3,2,2,5,0,0,271,3.0,2.0,1.0,1.0,3.0,0.0,0.0,5,5,0,2.0,2.0,0.0
9503283,1,1,0,0,0,1,3,18,,,,,,,,8,1,7,1.0,0.0,1.0
9810369,3,2,1,1,1,2,7,320,1.0,1.0,0.0,0.0,0.0,1.0,3.0,9,3,6,3.0,1.0,2.0
9805323,2,1,1,1,0,2,22,8,2.0,1.0,1.0,1.0,0.0,2.0,22.0,14,2,12,14.0,2.0,12.0
11260,11,3,8,18,3,8,31,89,6.0,1.0,5.0,13.0,5.0,1.0,1.0,27,11,16,9.0,7.0,2.0
110139,2,2,0,0,0,2,3,67,0.0,0.0,0.0,0.0,0.0,0.0,0.0,8,2,6,1.0,0.0,1.0
9410245,3,1,2,3,3,0,0,91,1.0,1.0,0.0,0.0,1.0,0.0,0.0,4,3,1,1.0,0.0,1.0
112219,3,2,1,1,1,2,4,78,1.0,1.0,0.0,0.0,0.0,1.0,3.0,8,3,5,5.0,2.0,3.0
9509223,1,1,0,0,1,0,0,385,1.0,1.0,0.0,0.0,1.0,0.0,0.0,2,1,1,2.0,1.0,1.0
9606459,4,3,1,1,0,4,10,88,2.0,1.0,1.0,1.0,0.0,2.0,2.0,10,4,6,3.0,2.0,1.0
9708496,7,2,5,11,2,5,7,17,6.0,2.0,4.0,9.0,1.0,5.0,5.0,9,7,2,7.0,6.0,1.0
9910403,7,1,6,11,0,7,25,36,7.0,1.0,6.0,11.0,7.0,0.0,0.0,23,7,16,7.0,7.0,0.0
110354,1,1,0,0,0,1,5,58,1.0,1.0,0.0,0.0,0.0,1.0,5.0,37,1,36,10.0,0.0,10.0
111398,2,1,1,1,2,0,0,178,2.0,1.0,1.0,1.0,2.0,0.0,0.0,2,2,0,2.0,2.0,0.0
102099,3,1,2,3,0,3,11,91,3.0,1.0,2.0,3.0,0.0,3.0,6.0,10,3,7,5.0,3.0,2.0
9912384,1,1,0,0,1,0,0,302,1.0,1.0,0.0,0.0,1.0,0.0,0.0,4,1,3,1.0,1.0,0.0
9805345,4,1,3,4,0,4,9,110,4.0,1.0,3.0,4.0,0.0,4.0,4.0,9,4,5,6.0,4.0,2.0
104099,5,4,1,1,0,5,17,27,2.0,2.0,0.0,0.0,0.0,2.0,6.0,32,5,27,5.0,2.0,3.0
9706205,1,1,0,0,0,1,2,105,0.0,0.0,0.0,0.0,0.0,0.0,0.0,7,1,6,2.0,0.0,2.0
202032,3,2,1,1,0,3,25,92,3.0,2.0,1.0,1.0,0.0,3.0,25.0,16,3,13,14.0,3.0,11.0
9811259,13,3,10,29,1,12,68,29,7.0,1.0,6.0,14.0,0.0,7.0,36.0,33,13,20,16.0,8.0,8.0
9307366,4,3,1,1,4,0,0,116,2.0,1.0,1.0,1.0,2.0,0.0,0.0,4,4,0,,,
9505234,3,1,2,2,0,3,14,40,3.0,1.0,2.0,2.0,0.0,3.0,14.0,10,3,7,1.0,0.0,1.0
103095,7,3,4,5,3,4,16,5,0.0,0.0,0.0,0.0,0.0,0.0,0.0,96,7,89,19.0,0.0,19.0
9811474,12,2,10,15,2,10,16,31,6.0,2.0,4.0,5.0,1.0,5.0,9.0,16,12,4,5.0,4.0,1.0
207357,1,1,0,0,1,0,0,1398,,,,,,,,1,1,0,,,
9312241,3,1,2,3,1,2,2,79,2.0,1.0,1.0,1.0,2.0,0.0,0.0,4,3,1,1.0,1.0,0.0
9503245,1,1,0,0,1,0,0,5,0.0,0.0,0.0,0.0,0.0,0.0,0.0,12,1,11,2.0,0.0,2.0
9403258,4,2,2,3,4,0,0,264,3.0,1.0,2.0,3.0,3.0,0.0,0.0,4,4,0,1.0,1.0,0.0
9909380,1,1,0,0,0,1,1,132,0.0,0.0,0.0,0.0,0.0,0.0,0.0,8,1,7,3.0,0.0,3.0
9902478,3,1,2,3,1,2,6,173,3.0,1.0,2.0,3.0,1.0,2.0,3.0,12,3,9,5.0,3.0,2.0
2184,5,2,3,3,3,2,8,30,1.0,1.0,0.0,0.0,0.0,1.0,3.0,15,5,10,4.0,2.0,2.0
101207,2,2,0,0,0,2,5,0,0.0,0.0,0.0,0.0,0.0,0.0,0.0,9,2,7,5.0,2.0,3.0
8115,5,2,3,3,1,4,6,60,2.0,1.0,1.0,1.0,0.0,2.0,4.0,12,5,7,2.0,2.0,0.0
9506464,4,2,2,2,0,4,8,124,3.0,2.0,1.0,1.0,2.0,1.0,1.0,9,4,5,3.0,1.0,2.0
210410,2,2,0,0,0,2,14,2,1.0,1.0,0.0,0.0,0.0,1.0,12.0,25,2,23,18.0,1.0,17.0
212156,2,1,1,1,0,2,13,129,2.0,1.0,1.0,1.0,0.0,2.0,13.0,12,2,10,6.0,2.0,4.0
9708286,2,2,0,0,0,2,2,162,0.0,0.0,0.0,0.0,0.0,0.0,0.0,7,2,5,2.0,0.0,2.0
7072,2,2,0,0,2,0,0,205,2.0,2.0,0.0,0.0,2.0,0.0,0.0,4,2,2,2.0,0.0,2.0
106213,1,1,0,0,0,1,3,26,0.0,0.0,0.0,0.0,0.0,0.0,0.0,25,1,24,11.0,0.0,11.0
111024,2,2,0,0,1,1,3,19,0.0,0.0,0.0,0.0,0.0,0.0,0.0,49,2,47,15.0,0.0,15.0
104044,8,4,4,5,1,7,68,17,5.0,2.0,3.0,3.0,0.0,5.0,54.0,34,8,26,5.0,2.0,3.0
206209,1,1,0,0,0,1,5,22,0.0,0.0,0.0,0.0,0.0,0.0,0.0,18,1,17,3.0,1.0,2.0
110109,2,1,1,1,2,0,0,149,0.0,0.0,0.0,0.0,0.0,0.0,0.0,6,2,4,2.0,0.0,2.0
3157,2,2,0,0,1,1,2,249,1.0,1.0,0.0,0.0,0.0,1.0,2.0,7,2,5,1.0,1.0,0.0
203006,6,1,5,7,0,6,20,146,6.0,1.0,5.0,7.0,0.0,6.0,20.0,10,6,4,10.0,6.0,4.0
9611451,3,2,1,1,0,3,20,61,2.0,1.0,1.0,1.0,0.0,2.0,12.0,46,3,43,13.0,2.0,11.0
9902287,1,1,0,0,0,1,2,173,0.0,0.0,0.0,0.0,0.0,0.0,0.0,10,1,9,4.0,0.0,4.0
107187,5,2,3,4,0,5,64,67,4.0,1.0,3.0,4.0,0.0,4.0,55.0,37,5,32,26.0,4.0,22.0
9605306,2,2,0,0,0,2,9,61,1.0,1.0,0.0,0.0,0.0,1.0,3.0,9,2,7,1.0,0.0,1.0
211178,0,0,0,0,0,0,0,25,0.0,0.0,0.0,0.0,0.0,0.0,0.0,10,0,10,4.0,0.0,4.0
112275,1,1,0,0,0,1,12,11,1.0,1.0,0.0,0.0,0.0,1.0,7.0,31,1,30,8.0,1.0,7.0
9707374,2,2,0,0,0,2,6,67,2.0,2.0,0.0,0.0,1.0,1.0,5.0,20,2,18,3.0,1.0,2.0
9403202,2,2,0,0,2,0,0,703,1.0,1.0,0.0,0.0,1.0,0.0,0.0,2,2,0,1.0,1.0,0.0
209005,2,2,0,0,0,2,8,55,1.0,1.0,0.0,0.0,0.0,1.0,7.0,19,2,17,15.0,1.0,14.0
9909340,1,1,0,0,0,1,2,233,1.0,1.0,0.0,0.0,0.0,1.0,2.0,4,1,3,4.0,1.0,3.0
110319,3,3,0,0,0,3,11,80,0.0,0.0,0.0,0.0,0.0,0.0,0.0,20,3,17,4.0,1.0,3.0
212373,0,0,0,0,0,0,0,1,0.0,0.0,0.0,0.0,0.0,0.0,0.0,40,0,40,25.0,0.0,25.0
3026,1,1,0,0,0,1,2,74,1.0,1.0,0.0,0.0,0.0,1.0,2.0,9,1,8,4.0,1.0,3.0
9805385,3,2,1,1,0,3,6,305,3.0,2.0,1.0,1.0,0.0,3.0,6.0,5,3,2,5.0,3.0,2.0
6302,1,1,0,0,0,1,3,89,0.0,0.0,0.0,0.0,0.0,0.0,0.0,7,1,6,2.0,0.0,2.0
9903346,5,3,2,3,1,4,12,26,0.0,0.0,0.0,0.0,0.0,0.0,0.0,16,5,11,4.0,3.0,1.0
106269,1,1,0,0,0,1,3,51,1.0,1.0,0.0,0.0,0.0,1.0,1.0,4,1,3,1.0,0.0,1.0
9324,6,3,3,7,0,6,129,24,5.0,2.0,3.0,6.0,0.0,5.0,107.0,50,6,44,35.0,5.0,30.0
9512352,3,2,1,1,3,0,0,174,3.0,2.0,1.0,1.0,3.0,0.0,0.0,4,3,1,1.0,1.0,0.0
9603220,3,3,0,0,3,0,0,35,0.0,0.0,0.0,0.0,0.0,0.0,0.0,16,3,13,3.0,0.0,3.0
9809399,1,1,0,0,0,1,6,74,1.0,1.0,0.0,0.0,0.0,1.0,4.0,8,1,7,4.0,1.0,3.0
4221,0,0,0,0,0,0,0,1740,0.0,0.0,0.0,0.0,0.0,0.0,0.0,1,0,1,,,
9509405,7,3,4,5,7,0,0,160,4.0,2.0,2.0,3.0,4.0,0.0,0.0,7,7,0,3.0,3.0,0.0
9302313,7,3,4,10,7,0,0,237,7.0,3.0,4.0,10.0,7.0,0.0,0.0,7,7,0,6.0,6.0,0.0
9603438,1,1,0,0,0,1,5,30,1.0,1.0,0.0,0.0,0.0,1.0,5.0,9,1,8,5.0,1.0,4.0
10207,16,6,10,27,4,12,63,116,12.0,2.0,10.0,27.0,0.0,12.0,49.0,28,16,12,18.0,12.0,6.0
1185,3,3,0,0,2,1,9,142,1.0,1.0,0.0,0.0,0.0,1.0,9.0,14,3,11,8.0,1.0,7.0
9906253,11,3,8,21,3,8,21,63,10.0,2.0,8.0,21.0,4.0,6.0,19.0,18,11,7,8.0,7.0,1.0
10215,2,2,0,0,0,2,9,100,1.0,1.0,0.0,0.0,0.0,1.0,4.0,39,2,37,12.0,1.0,11.0
101219,3,1,2,2,3,0,0,171,3.0,1.0,2.0,2.0,3.0,0.0,0.0,3,3,0,3.0,3.0,0.0
9910558,7,4,3,4,0,7,36,29,2.0,2.0,0.0,0.0,0.0,2.0,14.0,26,7,19,13.0,1.0,12.0
9909341,5,2,3,3,0,5,20,82,3.0,1.0,2.0,2.0,0.0,3.0,14.0,21,5,16,12.0,1.0,11.0
1041,0,0,0,0,0,0,0,875,,,,,,,,3,0,3,,,
9906216,2,1,1,1,0,2,6,209,2.0,1.0,1.0,1.0,0.0,2.0,6.0,6,2,4,4.0,0.0,4.0
209027,3,3,0,0,1,2,2,189,1.0,1.0,0.0,0.0,0.0,1.0,1.0,6,3,3,1.0,1.0,0.0
9707270,9,4,5,9,0,9,33,117,8.0,3.0,5.0,9.0,0.0,8.0,23.0,22,9,13,11.0,7.0,4.0
9511403,2,2,0,0,0,2,5,235,2.0,2.0,0.0,0.0,0.0,2.0,5.0,6,2,4,3.0,1.0,2.0
9711325,4,3,1,1,1,3,8,225,3.0,2.0,1.0,1.0,1.0,2.0,5.0,14,4,10,5.0,1.0,4.0
9302254,3,2,1,1,3,0,0,369,3.0,2.0,1.0,1.0,3.0,0.0,0.0,5,3,2,3.0,3.0,0.0
9805420,3,2,1,1,0,3,9,228,2.0,2.0,0.0,0.0,0.0,2.0,6.0,9,3,6,8.0,3.0,5.0
108165,3,2,1,1,2,1,2,7,,,,,,,,7,3,4,1.0,1.0,0.0
9703423,5,4,1,1,1,4,7,244,3.0,2.0,1.0,1.0,3.0,0.0,0.0,10,5,5,6.0,4.0,2.0
9512400,3,2,1,1,3,0,0,10,0.0,0.0,0.0,0.0,0.0,0.0,0.0,16,3,13,4.0,0.0,4.0
209217,2,2,0,0,0,2,46,3,1.0,1.0,0.0,0.0,0.0,1.0,9.0,38,2,36,10.0,2.0,8.0
2215,1,1,0,0,0,1,2,119,0.0,0.0,0.0,0.0,0.0,0.0,0.0,16,1,15,13.0,0.0,13.0
211352,4,2,2,2,0,4,19,4,1.0,1.0,0.0,0.0,0.0,1.0,4.0,35,4,31,6.0,1.0,5.0
203072,2,2,0,0,0,2,10,29,2.0,2.0,0.0,0.0,0.0,2.0,7.0,26,2,24,9.0,1.0,8.0
110079,0,0,0,0,0,0,0,600,0.0,0.0,0.0,0.0,0.0,0.0,0.0,2,0,2,2.0,0.0,2.0
208205,2,2,0,0,0,2,14,312,2.0,2.0,0.0,0.0,0.0,2.0,7.0,15,2,13,9.0,2.0,7.0
11286,1,1,0,0,1,0,0,292,1.0,1.0,0.0,0.0,1.0,0.0,0.0,9,1,8,3.0,0.0,3.0
6335,3,2,1,1,1,2,5,36,2.0,1.0,1.0,1.0,0.0,2.0,4.0,10,3,7,5.0,2.0,3.0
9804388,7,3,4,6,0,7,40,76,6.0,2.0,4.0,5.0,0.0,6.0,37.0,17,7,10,11.0,5.0,6.0
101171,6,1,5,11,1,5,11,7,5.0,1.0,4.0,8.0,2.0,3.0,3.0,11,6,5,6.0,5.0,1.0
9706452,2,1,1,1,0,2,9,51,2.0,1.0,1.0,1.0,0.0,2.0,7.0,14,2,12,8.0,1.0,7.0
9609356,1,1,0,0,0,1,1,260,0.0,0.0,0.0,0.0,0.0,0.0,0.0,9,1,8,2.0,0.0,2.0
203227,0,0,0,0,0,0,0,247,0.0,0.0,0.0,0.0,0.0,0.0,0.0,2,0,2,1.0,0.0,1.0
9608240,2,1,1,1,0,2,3,49,0.0,0.0,0.0,0.0,0.0,0.0,0.0,5,2,3,2.0,1.0,1.0
208007,4,3,1,1,0,4,27,11,4.0,3.0,1.0,1.0,0.0,4.0,24.0,24,4,20,1.0,1.0,0.0
9707332,4,1,3,4,3,1,1,195,0.0,0.0,0.0,0.0,0.0,0.0,0.0,10,4,6,2.0,2.0,0.0
4177,7,1,6,13,1,6,12,156,6.0,1.0,5.0,10.0,0.0,6.0,12.0,12,7,5,8.0,6.0,2.0
8136,4,2,2,3,0,4,6,31,2.0,1.0,1.0,1.0,0.0,2.0,4.0,10,4,6,2.0,2.0,0.0
9502396,5,3,2,2,1,4,4,232,3.0,2.0,1.0,1.0,1.0,2.0,2.0,6,5,1,2.0,1.0,1.0
9709374,4,3,1,1,2,2,3,272,3.0,2.0,1.0,1.0,3.0,0.0,0.0,6,4,2,3.0,3.0,0.0
11304,2,2,0,0,2,0,0,51,0.0,0.0,0.0,0.0,0.0,0.0,0.0,7,2,5,,,
9711464,1,1,0,0,0,1,3,92,0.0,0.0,0.0,0.0,0.0,0.0,0.0,9,1,8,,,
9805411,2,2,0,0,0,2,6,0,0.0,0.0,0.0,0.0,0.0,0.0,0.0,35,2,33,19.0,0.0,19.0
210325,0,0,0,0,0,0,0,132,0.0,0.0,0.0,0.0,0.0,0.0,0.0,2,0,2,2.0,0.0,2.0
9303250,2,1,1,1,2,0,0,137,2.0,1.0,1.0,1.0,2.0,0.0,0.0,2,2,0,2.0,2.0,0.0
9603263,7,3,4,5,0,7,49,6,5.0,1.0,4.0,5.0,0.0,5.0,41.0,18,7,11,6.0,3.0,3.0
201257,2,1,1,1,0,2,7,89,2.0,1.0,1.0,1.0,0.0,2.0,6.0,8,2,6,7.0,2.0,5.0
112195,1,1,0,0,0,1,3,64,1.0,1.0,0.0,0.0,0.0,1.0,3.0,6,1,5,4.0,1.0,3.0
9907376,2,2,0,0,1,1,1,71,1.0,1.0,0.0,0.0,0.0,1.0,1.0,4,2,2,2.0,1.0,1.0
108083,0,0,0,0,0,0,0,271,0.0,0.0,0.0,0.0,0.0,0.0,0.0,2,0,2,1.0,0.0,1.0
9034,3,3,0,0,0,3,4,185,1.0,1.0,0.0,0.0,0.0,1.0,2.0,6,3,3,3.0,1.0,2.0
9811345,3,3,0,0,0,3,16,115,3.0,3.0,0.0,0.0,0.0,3.0,16.0,20,3,17,10.0,3.0,7.0
9209206,1,1,0,0,0,1,1,770,1.0,1.0,0.0,0.0,1.0,0.0,0.0,2,1,1,1.0,1.0,0.0
9906377,1,1,0,0,0,1,1,269,1.0,1.0,0.0,0.0,1.0,0.0,0.0,2,1,1,1.0,1.0,0.0
111246,4,3,1,2,0,4,7,41,4.0,3.0,1.0,2.0,2.0,2.0,4.0,11,4,7,3.0,3.0,0.0
9203217,4,3,1,1,4,0,0,241,2.0,2.0,0.0,0.0,2.0,0.0,0.0,4,4,0,2.0,2.0,0.0
11240,4,4,0,0,0,4,22,0,0.0,0.0,0.0,0.0,0.0,0.0,0.0,26,4,22,8.0,0.0,8.0
106339,1,1,0,0,0,1,3,0,0.0,0.0,0.0,0.0,0.0,0.0,0.0,13,1,12,2.0,0.0,2.0
5177,2,1,1,1,0,2,7,49,2.0,1.0,1.0,1.0,0.0,2.0,5.0,17,2,15,3.0,0.0,3.0
9710327,6,5,1,1,0,6,44,36,3.0,3.0,0.0,0.0,0.0,3.0,29.0,37,6,31,22.0,1.0,21.0
9211263,1,1,0,0,1,0,0,186,,,,,,,,1,1,0,1.0,1.0,0.0
105266,1,1,0,0,0,1,5,69,0.0,0.0,0.0,0.0,0.0,0.0,0.0,13,1,12,6.0,0.0,6.0
203239,2,2,0,0,0,2,12,28,1.0,1.0,0.0,0.0,0.0,1.0,1.0,19,2,17,3.0,1.0,2.0
103078,3,1,2,3,0,3,7,201,2.0,1.0,1.0,1.0,0.0,2.0,2.0,14,3,11,3.0,2.0,1.0
5198,2,2,0,0,0,2,9,8,2.0,2.0,0.0,0.0,0.0,2.0,6.0,33,2,31,10.0,0.0,10.0
111152,1,1,0,0,0,1,13,21,0.0,0.0,0.0,0.0,0.0,0.0,0.0,28,1,27,6.0,0.0,6.0
105024,1,1,0,0,1,0,0,31,0.0,0.0,0.0,0.0,0.0,0.0,0.0,17,1,16,4.0,0.0,4.0
9609283,4,2,2,2,2,2,7,26,0.0,0.0,0.0,0.0,0.0,0.0,0.0,20,4,16,1.0,1.0,0.0
9908301,3,1,2,2,0,3,14,174,3.0,1.0,2.0,2.0,0.0,3.0,9.0,12,3,9,6.0,3.0,3.0
9509376,0,0,0,0,0,0,0,218,0.0,0.0,0.0,0.0,0.0,0.0,0.0,2,0,2,1.0,0.0,1.0
104160,3,3,0,0,0,3,4,15,1.0,1.0,0.0,0.0,0.0,1.0,2.0,17,3,14,3.0,1.0,2.0
7049,4,2,2,2,0,4,20,59,3.0,1.0,2.0,2.0,0.0,3.0,4.0,13,4,9,3.0,2.0,1.0
2088,4,3,1,1,2,2,4,49,3.0,2.0,1.0,1.0,2.0,1.0,2.0,9,4,5,2.0,1.0,1.0
9903440,5,3,2,3,1,4,11,101,4.0,2.0,2.0,3.0,1.0,3.0,3.0,13,5,8,4.0,3.0,1.0
9709398,0,0,0,0,0,0,0,17,0.0,0.0,0.0,0.0,0.0,0.0,0.0,10,0,10,,,
9504395,4,1,3,3,0,4,7,41,1.0,1.0,0.0,0.0,1.0,0.0,0.0,8,4,4,1.0,0.0,1.0
210180,1,1,0,0,1,0,0,339,1.0,1.0,0.0,0.0,1.0,0.0,0.0,5,1,4,4.0,1.0,3.0
208088,8,3,5,7,0,8,89,7,4.0,1.0,3.0,5.0,0.0,4.0,53.0,31,8,23,16.0,4.0,12.0
9504203,2,2,0,0,2,0,0,224,1.0,1.0,0.0,0.0,1.0,0.0,0.0,2,2,0,1.0,1.0,0.0
9807419,0,0,0,0,0,0,0,291,0.0,0.0,0.0,0.0,0.0,0.0,0.0,4,0,4,1.0,0.0,1.0
1077,1,1,0,0,0,1,2,91,1.0,1.0,0.0,0.0,0.0,1.0,2.0,7,1,6,3.0,1.0,2.0
11108,1,1,0,0,1,0,0,156,1.0,1.0,0.0,0.0,1.0,0.0,0.0,3,1,2,1.0,1.0,0.0
9703253,2,2,0,0,2,0,0,564,1.0,1.0,0.0,0.0,1.0,0.0,0.0,3,2,1,2.0,1.0,1.0
9412280,3,1,2,2,1,2,4,26,2.0,1.0,1.0,1.0,0.0,2.0,4.0,5,3,2,1.0,1.0,0.0
9511279,4,3,1,1,0,4,8,114,2.0,2.0,0.0,0.0,0.0,2.0,2.0,14,4,10,2.0,2.0,0.0
106053,2,2,0,0,0,2,35,12,2.0,2.0,0.0,0.0,0.0,2.0,30.0,38,2,36,8.0,0.0,8.0
9501326,0,0,0,0,0,0,0,97,0.0,0.0,0.0,0.0,0.0,0.0,0.0,1,0,1,,,
4188,1,1,0,0,1,0,0,221,0.0,0.0,0.0,0.0,0.0,0.0,0.0,8,1,7,2.0,0.0,2.0
207008,2,2,0,0,0,2,6,20,1.0,1.0,0.0,0.0,1.0,0.0,0.0,12,2,10,6.0,2.0,4.0
3029,7,6,1,2,0,7,43,15,5.0,4.0,1.0,2.0,0.0,5.0,34.0,48,7,41,8.0,0.0,8.0
105058,2,2,0,0,0,2,12,7,1.0,1.0,0.0,0.0,0.0,1.0,7.0,22,2,20,8.0,1.0,7.0
208046,2,1,1,1,0,2,11,131,2.0,1.0,1.0,1.0,0.0,2.0,9.0,11,2,9,5.0,1.0,4.0
9709479,4,4,0,0,0,4,5,72,3.0,3.0,0.0,0.0,0.0,3.0,4.0,6,4,2,5.0,3.0,2.0
302027,1,1,0,0,1,0,0,46,0.0,0.0,0.0,0.0,0.0,0.0,0.0,14,1,13,3.0,0.0,3.0
9807220,1,1,0,0,0,1,3,17,0.0,0.0,0.0,0.0,0.0,0.0,0.0,19,1,18,3.0,1.0,2.0
9805497,3,3,0,0,1,2,10,4,1.0,1.0,0.0,0.0,1.0,0.0,0.0,27,3,24,1.0,0.0,1.0
9609322,1,1,0,0,0,1,3,180,1.0,1.0,0.0,0.0,0.0,1.0,3.0,9,1,8,5.0,1.0,4.0
105221,2,2,0,0,0,2,7,9,2.0,2.0,0.0,0.0,0.0,2.0,4.0,11,2,9,1.0,0.0,1.0
202249,0,0,0,0,0,0,0,28,0.0,0.0,0.0,0.0,0.0,0.0,0.0,11,0,11,1.0,0.0,1.0
207196,4,3,1,1,0,4,20,106,2.0,2.0,0.0,0.0,0.0,2.0,9.0,23,4,19,9.0,2.0,7.0
9409276,0,0,0,0,0,0,0,281,0.0,0.0,0.0,0.0,0.0,0.0,0.0,2,0,2,1.0,0.0,1.0
211150,0,0,0,0,0,0,0,10,0.0,0.0,0.0,0.0,0.0,0.0,0.0,17,0,17,10.0,0.0,10.0
111434,4,4,0,0,1,3,5,19,0.0,0.0,0.0,0.0,0.0,0.0,0.0,9,4,5,1.0,1.0,0.0
109267,2,2,0,0,1,1,10,38,2.0,2.0,0.0,0.0,1.0,1.0,9.0,20,2,18,13.0,1.0,12.0
101056,1,1,0,0,1,0,0,311,0.0,0.0,0.0,0.0,0.0,0.0,0.0,9,1,8,1.0,0.0,1.0
9407386,0,0,0,0,0,0,0,1390,,,,,,,,1,0,1,1.0,0.0,1.0
107272,1,1,0,0,0,1,1,673,1.0,1.0,0.0,0.0,1.0,0.0,0.0,2,1,1,1.0,1.0,0.0
208181,0,0,0,0,0,0,0,9,0.0,0.0,0.0,0.0,0.0,0.0,0.0,23,0,23,3.0,0.0,3.0
9812220,1,1,0,0,0,1,5,40,1.0,1.0,0.0,0.0,1.0,0.0,0.0,7,1,6,1.0,1.0,0.0
207335,4,2,2,2,0,4,18,11,2.0,1.0,1.0,1.0,2.0,0.0,0.0,10,4,6,2.0,2.0,0.0
105305,3,2,1,1,2,1,5,46,1.0,1.0,0.0,0.0,0.0,1.0,1.0,9,3,6,2.0,2.0,0.0
9507297,0,0,0,0,0,0,0,675,0.0,0.0,0.0,0.0,0.0,0.0,0.0,1,0,1,1.0,0.0,1.0
101156,1,1,0,0,0,1,1,72,1.0,1.0,0.0,0.0,1.0,0.0,0.0,2,1,1,1.0,1.0,0.0
9907258,0,0,0,0,0,0,0,1457,,,,,,,,1,0,1,,,
212035,3,3,0,0,0,3,50,37,2.0,2.0,0.0,0.0,0.0,2.0,41.0,38,3,35,27.0,2.0,25.0
2112,2,2,0,0,0,2,7,39,1.0,1.0,0.0,0.0,0.0,1.0,1.0,8,2,6,3.0,1.0,2.0
211257,1,1,0,0,0,1,26,8,1.0,1.0,0.0,0.0,0.0,1.0,12.0,40,1,39,15.0,1.0,14.0
203235,0,0,0,0,0,0,0,27,0.0,0.0,0.0,0.0,0.0,0.0,0.0,28,0,28,1.0,0.0,1.0
9708471,1,1,0,0,0,1,1,1169,1.0,1.0,0.0,0.0,1.0,0.0,0.0,4,1,3,1.0,1.0,0.0
9115,4,4,0,0,3,1,2,84,1.0,1.0,0.0,0.0,1.0,0.0,0.0,6,4,2,2.0,0.0,2.0
202125,2,1,1,1,0,2,25,11,2.0,1.0,1.0,1.0,0.0,2.0,22.0,37,2,35,14.0,2.0,12.0
204209,0,0,0,0,0,0,0,20,0.0,0.0,0.0,0.0,0.0,0.0,0.0,8,0,8,3.0,0.0,3.0
207226,3,2,1,1,0,3,59,16,2.0,1.0,1.0,1.0,0.0,2.0,30.0,50,3,47,12.0,2.0,10.0
9705215,1,1,0,0,1,0,0,313,1.0,1.0,0.0,0.0,1.0,0.0,0.0,1,1,0,1.0,1.0,0.0
204237,2,1,1,1,0,2,11,83,1.0,1.0,0.0,0.0,0.0,1.0,1.0,11,2,9,3.0,2.0,1.0
109232,5,4,1,1,0,5,24,85,1.0,1.0,0.0,0.0,0.0,1.0,4.0,16,5,11,3.0,1.0,2.0
9310278,1,1,0,0,1,0,0,295,0.0,0.0,0.0,0.0,0.0,0.0,0.0,3,1,2,1.0,0.0,1.0
9412326,5,3,2,4,2,3,4,53,2.0,1.0,1.0,1.0,0.0,2.0,3.0,11,5,6,2.0,0.0,2.0
9407233,0,0,0,0,0,0,0,1401,,,,,,,,1,0,1,1.0,0.0,1.0
302234,1,1,0,0,0,1,1,107,0.0,0.0,0.0,0.0,0.0,0.0,0.0,13,1,12,2.0,0.0,2.0
9409262,1,1,0,0,0,1,3,155,1.0,1.0,0.0,0.0,0.0,1.0,1.0,7,1,6,1.0,0.0,1.0
9808442,2,1,1,1,1,1,3,482,2.0,1.0,1.0,1.0,2.0,0.0,0.0,11,2,9,2.0,2.0,0.0
209259,1,1,0,0,0,1,4,91,1.0,1.0,0.0,0.0,0.0,1.0,3.0,9,1,8,7.0,1.0,6.0
9904400,0,0,0,0,0,0,0,192,0.0,0.0,0.0,0.0,0.0,0.0,0.0,5,0,5,1.0,0.0,1.0
101035,0,0,0,0,0,0,0,0,0.0,0.0,0.0,0.0,0.0,0.0,0.0,58,0,58,4.0,0.0,4.0
203190,0,0,0,0,0,0,0,83,0.0,0.0,0.0,0.0,0.0,0.0,0.0,6,0,6,2.0,0.0,2.0
111355,1,1,0,0,0,1,7,104,1.0,1.0,0.0,0.0,0.0,1.0,2.0,11,1,10,4.0,1.0,3.0
104042,1,1,0,0,0,1,3,623,1.0,1.0,0.0,0.0,0.0,1.0,1.0,4,1,3,1.0,1.0,0.0
9903235,4,2,2,3,4,0,0,375,4.0,2.0,2.0,3.0,4.0,0.0,0.0,4,4,0,4.0,4.0,0.0
9708354,0,0,0,0,0,0,0,1470,,,,,,,,2,0,2,,,
9808464,1,1,0,0,0,1,4,39,1.0,1.0,0.0,0.0,0.0,1.0,3.0,12,1,11,1.0,0.0,1.0
9902253,0,0,0,0,0,0,0,157,0.0,0.0,0.0,0.0,0.0,0.0,0.0,4,0,4,2.0,0.0,2.0
207192,0,0,0,0,0,0,0,85,0.0,0.0,0.0,0.0,0.0,0.0,0.0,16,0,16,6.0,0.0,6.0
210329,0,0,0,0,0,0,0,261,0.0,0.0,0.0,0.0,0.0,0.0,0.0,4,0,4,4.0,0.0,4.0
302101,0,0,0,0,0,0,0,66,0.0,0.0,0.0,0.0,0.0,0.0,0.0,19,0,19,1.0,0.0,1.0
9803206,0,0,0,0,0,0,0,1719,0.0,0.0,0.0,0.0,0.0,0.0,0.0,5,0,5,,,
9405422,1,1,0,0,0,1,1,2054,,,,,,,,3,1,2,,,
209278,0,0,0,0,0,0,0,5,0.0,0.0,0.0,0.0,0.0,0.0,0.0,8,0,8,,,
208018,0,0,0,0,0,0,0,206,0.0,0.0,0.0,0.0,0.0,0.0,0.0,23,0,23,7.0,0.0,7.0
9401353,5,3,2,3,4,1,1,117,4.0,2.0,2.0,3.0,4.0,0.0,0.0,6,5,1,4.0,4.0,0.0
111335,6,1,5,11,0,6,8,221,5.0,1.0,4.0,8.0,0.0,5.0,7.0,10,6,4,6.0,5.0,1.0
4002,0,0,0,0,0,0,0,251,0.0,0.0,0.0,0.0,0.0,0.0,0.0,7,0,7,6.0,0.0,6.0
9709237,1,1,0,0,1,0,0,100,0.0,0.0,0.0,0.0,0.0,0.0,0.0,3,1,2,2.0,0.0,2.0
301014,2,2,0,0,0,2,36,37,2.0,2.0,0.0,0.0,0.0,2.0,33.0,29,2,27,24.0,2.0,22.0
211134,3,2,1,1,2,1,7,82,1.0,1.0,0.0,0.0,0.0,1.0,7.0,14,3,11,9.0,1.0,8.0
7079,1,1,0,0,0,1,1,128,1.0,1.0,0.0,0.0,1.0,0.0,0.0,4,1,3,,,
207046,1,1,0,0,1,0,0,198,1.0,1.0,0.0,0.0,1.0,0.0,0.0,2,1,1,1.0,1.0,0.0
9706405,1,1,0,0,1,0,0,247,1.0,1.0,0.0,0.0,1.0,0.0,0.0,2,1,1,1.0,1.0,0.0
210167,1,1,0,0,1,0,0,940,0.0,0.0,0.0,0.0,0.0,0.0,0.0,3,1,2,1.0,0.0,1.0
211033,0,0,0,0,0,0,0,107,0.0,0.0,0.0,0.0,0.0,0.0,0.0,16,0,16,2.0,0.0,2.0
9710459,0,0,0,0,0,0,0,86,0.0,0.0,0.0,0.0,0.0,0.0,0.0,12,0,12,7.0,0.0,7.0
3235,0,0,0,0,0,0,0,77,,,,,,,,9,0,9,,,
210371,2,2,0,0,0,2,31,27,2.0,2.0,0.0,0.0,0.0,2.0,27.0,27,2,25,18.0,2.0,16.0
9708411,4,2,2,3,2,2,5,78,2.0,1.0,1.0,1.0,0.0,2.0,5.0,9,4,5,4.0,0.0,4.0
9804287,1,1,0,0,0,1,1,241,0.0,0.0,0.0,0.0,0.0,0.0,0.0,8,1,7,2.0,0.0,2.0
9808273,1,1,0,0,0,1,7,8,1.0,1.0,0.0,0.0,0.0,1.0,6.0,10,1,9,7.0,1.0,6.0
109083,0,0,0,0,0,0,0,92,,,,,,,,3,0,3,,,
301045,1,1,0,0,0,1,1,121,1.0,1.0,0.0,0.0,1.0,0.0,0.0,9,1,8,1.0,1.0,0.0
210185,0,0,0,0,0,0,0,807,,,,,,,,1,0,1,1.0,0.0,1.0
101195,0,0,0,0,0,0,0,14,0.0,0.0,0.0,0.0,0.0,0.0,0.0,32,0,32,13.0,0.0,13.0
104250,1,1,0,0,0,1,9,2,1.0,1.0,0.0,0.0,0.0,1.0,9.0,17,1,16,16.0,1.0,15.0
9905233,2,2,0,0,0,2,6,9,1.0,1.0,0.0,0.0,0.0,1.0,4.0,14,2,12,1.0,1.0,0.0
301237,0,0,0,0,0,0,0,2,0.0,0.0,0.0,0.0,0.0,0.0,0.0,11,0,11,2.0,0.0,2.0
3016,1,1,0,0,0,1,1,357,1.0,1.0,0.0,0.0,1.0,0.0,0.0,3,1,2,1.0,1.0,0.0
9910450,3,2,1,2,0,3,5,175,1.0,1.0,0.0,0.0,0.0,1.0,2.0,5,3,2,1.0,1.0,0.0
12374,0,0,0,0,0,0,0,111,0.0,0.0,0.0,0.0,0.0,0.0,0.0,7,0,7,3.0,0.0,3.0
9905460,1,1,0,0,1,0,0,131,0.0,0.0,0.0,0.0,0.0,0.0,0.0,3,1,2,,,
202240,1,1,0,0,0,1,1,76,0.0,0.0,0.0,0.0,0.0,0.0,0.0,10,1,9,1.0,0.0,1.0
201199,2,2,0,0,0,2,12,7,1.0,1.0,0.0,0.0,0.0,1.0,6.0,32,2,30,4.0,0.0,4.0
110099,0,0,0,0,0,0,0,688,0.0,0.0,0.0,0.0,0.0,0.0,0.0,1,0,1,1.0,0.0,1.0
9501363,0,0,0,0,0,0,0,1434,,,,,,,,4,0,4,1.0,0.0,1.0
9404341,4,3,1,1,4,0,0,314,2.0,1.0,1.0,1.0,2.0,0.0,0.0,5,4,1,2.0,2.0,0.0
107049,3,2,1,1,1,2,3,166,3.0,2.0,1.0,1.0,1.0,2.0,3.0,6,3,3,6.0,3.0,3.0
9710552,0,0,0,0,0,0,0,250,0.0,0.0,0.0,0.0,0.0,0.0,0.0,2,0,2,2.0,0.0,2.0
9910356,1,1,0,0,0,1,1,105,1.0,1.0,0.0,0.0,1.0,0.0,0.0,4,1,3,2.0,1.0,1.0
106138,0,0,0,0,0,0,0,33,0.0,0.0,0.0,0.0,0.0,0.0,0.0,16,0,16,4.0,0.0,4.0
110306,1,1,0,0,1,0,0,1797,,,,,,,,6,1,5,1.0,0.0,1.0
9606265,1,1,0,0,0,1,1,135,1.0,1.0,0.0,0.0,0.0,1.0,1.0,6,1,5,3.0,0.0,3.0
205256,0,0,0,0,0,0,0,139,0.0,0.0,0.0,0.0,0.0,0.0,0.0,16,0,16,5.0,0.0,5.0
204056,3,3,0,0,0,3,20,27,3.0,3.0,0.0,0.0,0.0,3.0,16.0,13,3,10,7.0,2.0,5.0
211016,0,0,0,0,0,0,0,207,0.0,0.0,0.0,0.0,0.0,0.0,0.0,5,0,5,2.0,0.0,2.0
302002,1,1,0,0,0,1,7,20,1.0,1.0,0.0,0.0,0.0,1.0,3.0,18,1,17,5.0,1.0,4.0
5048,1,1,0,0,0,1,1,44,0.0,0.0,0.0,0.0,0.0,0.0,0.0,8,1,7,2.0,1.0,1.0
105059,2,2,0,0,1,1,6,2,1.0,1.0,0.0,0.0,0.0,1.0,3.0,17,2,15,7.0,1.0,6.0
9707359,2,1,1,1,0,2,2,102,0.0,0.0,0.0,0.0,0.0,0.0,0.0,8,2,6,2.0,1.0,1.0
209040,3,2,1,1,2,1,2,132,1.0,1.0,0.0,0.0,0.0,1.0,2.0,6,3,3,4.0,1.0,3.0
9409233,0,0,0,0,0,0,0,26,0.0,0.0,0.0,0.0,0.0,0.0,0.0,11,0,11,2.0,0.0,2.0
9808414,2,1,1,1,0,2,4,173,2.0,1.0,1.0,1.0,0.0,2.0,4.0,10,2,8,4.0,2.0,2.0
204301,1,1,0,0,0,1,9,28,1.0,1.0,0.0,0.0,0.0,1.0,4.0,19,1,18,2.0,0.0,2.0
9803437,1,1,0,0,0,1,2,47,0.0,0.0,0.0,0.0,0.0,0.0,0.0,16,1,15,2.0,0.0,2.0
209077,4,4,0,0,0,4,29,165,4.0,4.0,0.0,0.0,0.0,4.0,29.0,24,4,20,19.0,3.0,16.0
105085,2,1,1,1,1,1,3,439,1.0,1.0,0.0,0.0,0.0,1.0,1.0,6,2,4,3.0,2.0,1.0
9712317,0,0,0,0,0,0,0,113,0.0,0.0,0.0,0.0,0.0,0.0,0.0,4,0,4,,,
201190,1,1,0,0,0,1,1,113,1.0,1.0,0.0,0.0,1.0,0.0,0.0,4,1,3,1.0,0.0,1.0
8329,1,1,0,0,1,0,0,696,1.0,1.0,0.0,0.0,1.0,0.0,0.0,1,1,0,1.0,1.0,0.0
9310201,0,0,0,0,0,0,0,1032,0.0,0.0,0.0,0.0,0.0,0.0,0.0,2,0,2,1.0,0.0,1.0
9910368,0,0,0,0,0,0,0,299,0.0,0.0,0.0,0.0,0.0,0.0,0.0,4,0,4,4.0,0.0,4.0
9811320,0,0,0,0,0,0,0,269,0.0,0.0,0.0,0.0,0.0,0.0,0.0,5,0,5,3.0,0.0,3.0
9710504,0,0,0,0,0,0,0,85,0.0,0.0,0.0,0.0,0.0,0.0,0.0,8,0,8,3.0,0.0,3.0
204268,0,0,0,0,0,0,0,39,0.0,0.0,0.0,0.0,0.0,0.0,0.0,17,0,17,1.0,0.0,1.0
10281,2,2,0,0,2,0,0,469,2.0,2.0,0.0,0.0,2.0,0.0,0.0,2,2,0,1.0,1.0,0.0
9905378,2,2,0,0,0,2,8,115,1.0,1.0,0.0,0.0,0.0,1.0,5.0,14,2,12,3.0,0.0,3.0
207069,3,2,1,1,0,3,9,66,3.0,2.0,1.0,1.0,0.0,3.0,9.0,11,3,8,4.0,2.0,2.0
111126,2,2,0,0,2,0,0,21,0.0,0.0,0.0,0.0,0.0,0.0,0.0,21,2,19,6.0,0.0,6.0
212218,0,0,0,0,0,0,0,27,0.0,0.0,0.0,0.0,0.0,0.0,0.0,25,0,25,4.0,0.0,4.0
111429,0,0,0,0,0,0,0,51,,,,,,,,4,0,4,1.0,0.0,1.0
109284,0,0,0,0,0,0,0,34,0.0,0.0,0.0,0.0,0.0,0.0,0.0,9,0,9,,,
202075,0,0,0,0,0,0,0,2,0.0,0.0,0.0,0.0,0.0,0.0,0.0,10,0,10,,,
5206,1,1,0,0,0,1,5,373,1.0,1.0,0.0,0.0,0.0,1.0,3.0,7,1,6,3.0,1.0,2.0
9709313,0,0,0,0,0,0,0,151,0.0,0.0,0.0,0.0,0.0,0.0,0.0,19,0,19,8.0,0.0,8.0
10186,1,1,0,0,1,0,0,448,1.0,1.0,0.0,0.0,1.0,0.0,0.0,2,1,1,1.0,1.0,0.0
9611270,3,2,1,1,2,1,1,159,2.0,2.0,0.0,0.0,1.0,1.0,1.0,5,3,2,3.0,2.0,1.0
9805506,1,1,0,0,1,0,0,1491,,,,,,,,1,1,0,1.0,1.0,0.0
112282,2,1,1,1,2,0,0,38,1.0,1.0,0.0,0.0,1.0,0.0,0.0,5,2,3,,,
9712289,0,0,0,0,0,0,0,148,0.0,0.0,0.0,0.0,0.0,0.0,0.0,3,0,3,1.0,0.0,1.0
101007,2,1,1,1,2,0,0,110,2.0,1.0,1.0,1.0,2.0,0.0,0.0,2,2,0,2.0,2.0,0.0
9505208,0,0,0,0,0,0,0,254,0.0,0.0,0.0,0.0,0.0,0.0,0.0,1,0,1,,,
9909520,2,2,0,0,0,2,6,24,1.0,1.0,0.0,0.0,0.0,1.0,1.0,9,2,7,2.0,1.0,1.0
108266,0,0,0,0,0,0,0,502,0.0,0.0,0.0,0.0,0.0,0.0,0.0,2,0,2,1.0,0.0,1.0
9806247,0,0,0,0,0,0,0,73,0.0,0.0,0.0,0.0,0.0,0.0,0.0,5,0,5,1.0,0.0,1.0
112253,0,0,0,0,0,0,0,21,0.0,0.0,0.0,0.0,0.0,0.0,0.0,13,0,13,3.0,0.0,3.0
10256,0,0,0,0,0,0,0,699,0.0,0.0,0.0,0.0,0.0,0.0,0.0,1,0,1,1.0,0.0,1.0
212290,0,0,0,0,0,0,0,52,0.0,0.0,0.0,0.0,0.0,0.0,0.0,20,0,20,14.0,0.0,14.0
9905256,2,2,0,0,1,1,1,1060,,,,,,,,3,2,1,1.0,1.0,0.0
9807345,0,0,0,0,0,0,0,1210,,,,,,,,2,0,2,1.0,0.0,1.0
112131,3,2,1,1,1,2,12,186,2.0,1.0,1.0,1.0,0.0,2.0,11.0,15,3,12,10.0,2.0,8.0
9912256,1,1,0,0,1,0,0,104,0.0,0.0,0.0,0.0,0.0,0.0,0.0,5,1,4,1.0,1.0,0.0
211042,1,1,0,0,0,1,7,18,1.0,1.0,0.0,0.0,0.0,1.0,1.0,24,1,23,3.0,1.0,2.0
209243,1,1,0,0,1,0,0,625,,,,,,,,1,1,0,1.0,1.0,0.0
9311201,1,1,0,0,1,0,0,401,1.0,1.0,0.0,0.0,1.0,0.0,0.0,4,1,3,1.0,0.0,1.0
201162,0,0,0,0,0,0,0,2,0.0,0.0,0.0,0.0,0.0,0.0,0.0,9,0,9,2.0,0.0,2.0
211413,1,1,0,0,0,1,2,74,0.0,0.0,0.0,0.0,0.0,0.0,0.0,17,1,16,6.0,0.0,6.0
2173,0,0,0,0,0,0,0,1624,0.0,0.0,0.0,0.0,0.0,0.0,0.0,7,0,7,1.0,0.0,1.0
9510265,0,0,0,0,0,0,0,163,0.0,0.0,0.0,0.0,0.0,0.0,0.0,4,0,4,,,
9705262,0,0,0,0,0,0,0,1,0.0,0.0,0.0,0.0,0.0,0.0,0.0,50,0,50,26.0,0.0,26.0
208152,3,2,1,1,0,3,21,131,3.0,2.0,1.0,1.0,0.0,3.0,21.0,30,3,27,15.0,2.0,13.0
112019,0,0,0,0,0,0,0,98,0.0,0.0,0.0,0.0,0.0,0.0,0.0,2,0,2,2.0,0.0,2.0
9907484,0,0,0,0,0,0,0,230,0.0,0.0,0.0,0.0,0.0,0.0,0.0,2,0,2,1.0,0.0,1.0
9602367,0,0,0,0,0,0,0,156,0.0,0.0,0.0,0.0,0.0,0.0,0.0,2,0,2,,,
9509419,0,0,0,0,0,0,0,84,0.0,0.0,0.0,0.0,0.0,0.0,0.0,4,0,4,1.0,0.0,1.0
205292,0,0,0,0,0,0,0,2,0.0,0.0,0.0,0.0,0.0,0.0,0.0,13,0,13,2.0,0.0,2.0
9801319,0,0,0,0,0,0,0,1187,,,,,,,,1,0,1,,,
209327,0,0,0,0,0,0,0,28,,,,,,,,6,0,6,,,
10329,1,1,0,0,0,1,2,184,1.0,1.0,0.0,0.0,1.0,0.0,0.0,3,1,2,,,
9402271,0,0,0,0,0,0,0,881,0.0,0.0,0.0,0.0,0.0,0.0,0.0,4,0,4,,,
9812420,1,1,0,0,1,0,0,14,,,,,,,,9,1,8,1.0,0.0,1.0
9802281,1,1,0,0,1,0,0,199,1.0,1.0,0.0,0.0,1.0,0.0,0.0,2,1,1,,,
211442,0,0,0,0,0,0,0,135,0.0,0.0,0.0,0.0,0.0,0.0,0.0,4,0,4,,,
9306316,0,0,0,0,0,0,0,952,,,,,,,,1,0,1,,,
9711239,0,0,0,0,0,0,0,29,0.0,0.0,0.0,0.0,0.0,0.0,0.0,10,0,10,1.0,0.0,1.0
3310,0,0,0,0,0,0,0,1,0.0,0.0,0.0,0.0,0.0,0.0,0.0,13,0,13,2.0,0.0,2.0
9275,1,1,0,0,0,1,6,31,1.0,1.0,0.0,0.0,0.0,1.0,4.0,8,1,7,6.0,1.0,5.0
210397,0,0,0,0,0,0,0,72,0.0,0.0,0.0,0.0,0.0,0.0,0.0,5,0,5,1.0,0.0,1.0
9609224,0,0,0,0,0,0,0,22,0.0,0.0,0.0,0.0,0.0,0.0,0.0,10,0,10,8.0,0.0,8.0
9808250,2,2,0,0,2,0,0,468,2.0,2.0,0.0,0.0,2.0,0.0,0.0,3,2,1,1.0,1.0,0.0
9908484,0,0,0,0,0,0,0,8,0.0,0.0,0.0,0.0,0.0,0.0,0.0,13,0,13,2.0,0.0,2.0
9511475,0,0,0,0,0,0,0,1881,0.0,0.0,0.0,0.0,0.0,0.0,0.0,5,0,5,5.0,0.0,5.0
205144,0,0,0,0,0,0,0,98,0.0,0.0,0.0,0.0,0.0,0.0,0.0,6,0,6,1.0,0.0,1.0
12239,0,0,0,0,0,0,0,469,0.0,0.0,0.0,0.0,0.0,0.0,0.0,1,0,1,1.0,0.0,1.0
205142,0,0,0,0,0,0,0,37,0.0,0.0,0.0,0.0,0.0,0.0,0.0,25,0,25,,,
9405203,0,0,0,0,0,0,0,93,0.0,0.0,0.0,0.0,0.0,0.0,0.0,3,0,3,1.0,0.0,1.0
9901274,1,1,0,0,0,1,1,406,1.0,1.0,0.0,0.0,0.0,1.0,1.0,2,1,1,1.0,1.0,0.0
105284,3,1,2,2,3,0,0,280,1.0,1.0,0.0,0.0,1.0,0.0,0.0,3,3,0,2.0,2.0,0.0
211128,0,0,0,0,0,0,0,81,0.0,0.0,0.0,0.0,0.0,0.0,0.0,23,0,23,2.0,0.0,2.0
211086,0,0,0,0,0,0,0,20,0.0,0.0,0.0,0.0,0.0,0.0,0.0,19,0,19,11.0,0.0,11.0
205140,0,0,0,0,0,0,0,37,0.0,0.0,0.0,0.0,0.0,0.0,0.0,5,0,5,1.0,0.0,1.0
9810324,0,0,0,0,0,0,0,22,0.0,0.0,0.0,0.0,0.0,0.0,0.0,11,0,11,9.0,0.0,9.0
1186,1,1,0,0,1,0,0,46,1.0,1.0,0.0,0.0,1.0,0.0,0.0,8,1,7,3.0,0.0,3.0
206173,0,0,0,0,0,0,0,64,0.0,0.0,0.0,0.0,0.0,0.0,0.0,3,0,3,2.0,0.0,2.0
1165,0,0,0,0,0,0,0,252,0.0,0.0,0.0,0.0,0.0,0.0,0.0,2,0,2,2.0,0.0,2.0
204045,0,0,0,0,0,0,0,234,0.0,0.0,0.0,0.0,0.0,0.0,0.0,12,0,12,2.0,0.0,2.0
9706458,1,1,0,0,1,0,0,11,0.0,0.0,0.0,0.0,0.0,0.0,0.0,6,1,5,3.0,0.0,3.0
9908472,0,0,0,0,0,0,0,76,0.0,0.0,0.0,0.0,0.0,0.0,0.0,5,0,5,2.0,0.0,2.0
111407,0,0,0,0,0,0,0,98,0.0,0.0,0.0,0.0,0.0,0.0,0.0,5,0,5,3.0,0.0,3.0
302182,0,0,0,0,0,0,0,11,0.0,0.0,0.0,0.0,0.0,0.0,0.0,8,0,8,2.0,0.0,2.0
9804256,0,0,0,0,0,0,0,134,0.0,0.0,0.0,0.0,0.0,0.0,0.0,1,0,1,,,
210111,1,1,0,0,0,1,2,0,1.0,1.0,0.0,0.0,0.0,1.0,2.0,9,1,8,,,
101270,0,0,0,0,0,0,0,137,0.0,0.0,0.0,0.0,0.0,0.0,0.0,5,0,5,2.0,0.0,2.0
9407360,0,0,0,0,0,0,0,135,0.0,0.0,0.0,0.0,0.0,0.0,0.0,3,0,3,2.0,0.0,2.0
207285,0,0,0,0,0,0,0,127,0.0,0.0,0.0,0.0,0.0,0.0,0.0,6,0,6,,,
211449,0,0,0,0,0,0,0,216,0.0,0.0,0.0,0.0,0.0,0.0,0.0,9,0,9,7.0,0.0,7.0
301151,1,1,0,0,0,1,9,23,1.0,1.0,0.0,0.0,0.0,1.0,9.0,23,1,22,16.0,1.0,15.0
205107,0,0,0,0,0,0,0,20,0.0,0.0,0.0,0.0,0.0,0.0,0.0,11,0,11,2.0,0.0,2.0
9801408,0,0,0,0,0,0,0,230,0.0,0.0,0.0,0.0,0.0,0.0,0.0,2,0,2,,,
211396,0,0,0,0,0,0,0,261,0.0,0.0,0.0,0.0,0.0,0.0,0.0,6,0,6,2.0,0.0,2.0
9610241,0,0,0,0,0,0,0,138,0.0,0.0,0.0,0.0,0.0,0.0,0.0,4,0,4,4.0,0.0,4.0
210379,1,1,0,0,1,0,0,7,0.0,0.0,0.0,0.0,0.0,0.0,0.0,10,1,9,1.0,1.0,0.0
206132,0,0,0,0,0,0,0,9,0.0,0.0,0.0,0.0,0.0,0.0,0.0,16,0,16,6.0,0.0,6.0
208111,1,1,0,0,0,1,4,148,1.0,1.0,0.0,0.0,0.0,1.0,4.0,7,1,6,5.0,1.0,4.0
105117,0,0,0,0,0,0,0,33,0.0,0.0,0.0,0.0,0.0,0.0,0.0,10,0,10,7.0,0.0,7.0
212361,1,1,0,0,0,1,4,74,1.0,1.0,0.0,0.0,0.0,1.0,1.0,9,1,8,1.0,0.0,1.0
104196,0,0,0,0,0,0,0,2084,,,,,,,,6,0,6,,,
9908322,0,0,0,0,0,0,0,104,,,,,,,,1,0,1,,,
202067,1,1,0,0,0,1,1,365,0.0,0.0,0.0,0.0,0.0,0.0,0.0,12,1,11,2.0,0.0,2.0
2217,1,1,0,0,0,1,6,212,0.0,0.0,0.0,0.0,0.0,0.0,0.0,9,1,8,1.0,0.0,1.0
9603299,0,0,0,0,0,0,0,40,0.0,0.0,0.0,0.0,0.0,0.0,0.0,15,0,15,1.0,0.0,1.0
210137,1,1,0,0,0,1,10,71,1.0,1.0,0.0,0.0,0.0,1.0,4.0,18,1,17,7.0,0.0,7.0
9412330,0,0,0,0,0,0,0,15,0.0,0.0,0.0,0.0,0.0,0.0,0.0,5,0,5,1.0,0.0,1.0
9612350,0,0,0,0,0,0,0,509,0.0,0.0,0.0,0.0,0.0,0.0,0.0,2,0,2,1.0,0.0,1.0
209283,1,1,0,0,0,1,2,405,1.0,1.0,0.0,0.0,0.0,1.0,2.0,7,1,6,4.0,1.0,3.0
3001,2,1,1,1,0,2,5,147,2.0,1.0,1.0,1.0,0.0,2.0,5.0,13,2,11,8.0,2.0,6.0
201222,0,0,0,0,0,0,0,207,0.0,0.0,0.0,0.0,0.0,0.0,0.0,2,0,2,1.0,0.0,1.0
9402359,0,0,0,0,0,0,0,207,0.0,0.0,0.0,0.0,0.0,0.0,0.0,3,0,3,1.0,0.0,1.0
9207238,2,2,0,0,2,0,0,577,2.0,2.0,0.0,0.0,2.0,0.0,0.0,2,2,0,2.0,2.0,0.0
1127,1,1,0,0,0,1,8,43,1.0,1.0,0.0,0.0,0.0,1.0,2.0,9,1,8,3.0,1.0,2.0
209328,1,1,0,0,0,1,1,328,0.0,0.0,0.0,0.0,0.0,0.0,0.0,9,1,8,4.0,0.0,4.0
11185,0,0,0,0,0,0,0,408,0.0,0.0,0.0,0.0,0.0,0.0,0.0,6,0,6,3.0,0.0,3.0
203249,0,0,0,0,0,0,0,298,0.0,0.0,0.0,0.0,0.0,0.0,0.0,12,0,12,4.0,0.0,4.0
210438,0,0,0,0,0,0,0,170,0.0,0.0,0.0,0.0,0.0,0.0,0.0,12,0,12,5.0,0.0,5.0
9807381,0,0,0,0,0,0,0,30,0.0,0.0,0.0,0.0,0.0,0.0,0.0,10,0,10,4.0,0.0,4.0
9804286,1,1,0,0,0,1,1,188,1.0,1.0,0.0,0.0,0.0,1.0,1.0,3,1,2,1.0,1.0,0.0
103035,1,1,0,0,1,0,0,213,1.0,1.0,0.0,0.0,1.0,0.0,0.0,1,1,0,1.0,1.0,0.0
9610253,0,0,0,0,0,0,0,206,0.0,0.0,0.0,0.0,0.0,0.0,0.0,3,0,3,1.0,0.0,1.0
9503308,0,0,0,0,0,0,0,25,0.0,0.0,0.0,0.0,0.0,0.0,0.0,10,0,10,3.0,0.0,3.0
9812494,0,0,0,0,0,0,0,91,,,,,,,,1,0,1,,,
9409363,0,0,0,0,0,0,0,143,0.0,0.0,0.0,0.0,0.0,0.0,0.0,1,0,1,1.0,0.0,1.0
207062,0,0,0,0,0,0,0,47,0.0,0.0,0.0,0.0,0.0,0.0,0.0,12,0,12,,,
9708385,0,0,0,0,0,0,0,96,0.0,0.0,0.0,0.0,0.0,0.0,0.0,11,0,11,9.0,0.0,9.0
8264,0,0,0,0,0,0,0,50,0.0,0.0,0.0,0.0,0.0,0.0,0.0,14,0,14,4.0,0.0,4.0
9907244,0,0,0,0,0,0,0,131,0.0,0.0,0.0,0.0,0.0,0.0,0.0,7,0,7,2.0,0.0,2.0
110132,0,0,0,0,0,0,0,112,0.0,0.0,0.0,0.0,0.0,0.0,0.0,3,0,3,1.0,0.0,1.0
9403375,1,1,0,0,1,0,0,733,1.0,1.0,0.0,0.0,1.0,0.0,0.0,1,1,0,1.0,1.0,0.0
9711366,0,0,0,0,0,0,0,150,0.0,0.0,0.0,0.0,0.0,0.0,0.0,4,0,4,,,
212177,0,0,0,0,0,0,0,29,0.0,0.0,0.0,0.0,0.0,0.0,0.0,13,0,13,3.0,0.0,3.0
206082,0,0,0,0,0,0,0,50,0.0,0.0,0.0,0.0,0.0,0.0,0.0,16,0,16,3.0,0.0,3.0
9501264,0,0,0,0,0,0,0,96,0.0,0.0,0.0,0.0,0.0,0.0,0.0,3,0,3,1.0,0.0,1.0
103250,0,0,0,0,0,0,0,116,0.0,0.0,0.0,0.0,0.0,0.0,0.0,7,0,7,5.0,0.0,5.0
9705268,0,0,0,0,0,0,0,1834,,,,,,,,3,0,3,,,
9510314,0,0,0,0,0,0,0,459,0.0,0.0,0.0,0.0,0.0,0.0,0.0,2,0,2,1.0,0.0,1.0
302096,0,0,0,0,0,0,0,39,0.0,0.0,0.0,0.0,0.0,0.0,0.0,4,0,4,2.0,0.0,2.0
9805381,0,0,0,0,0,0,0,9,,,,,,,,7,0,7,1.0,0.0,1.0
105122,0,0,0,0,0,0,0,1337,,,,,,,,2,0,2,,,
102109,0,0,0,0,0,0,0,98,0.0,0.0,0.0,0.0,0.0,0.0,0.0,4,0,4,3.0,0.0,3.0
9606446,0,0,0,0,0,0,0,55,,,,,,,,4,0,4,1.0,0.0,1.0
211338,1,1,0,0,0,1,1,3,0.0,0.0,0.0,0.0,0.0,0.0,0.0,13,1,12,2.0,0.0,2.0
9603394,0,0,0,0,0,0,0,160,0.0,0.0,0.0,0.0,0.0,0.0,0.0,2,0,2,,,
210386,0,0,0,0,0,0,0,93,0.0,0.0,0.0,0.0,0.0,0.0,0.0,11,0,11,6.0,0.0,6.0
9802203,0,0,0,0,0,0,0,69,0.0,0.0,0.0,0.0,0.0,0.0,0.0,5,0,5,1.0,0.0,1.0
205175,1,1,0,0,0,1,2,253,1.0,1.0,0.0,0.0,0.0,1.0,2.0,4,1,3,3.0,1.0,2.0
9811452,0,0,0,0,0,0,0,112,0.0,0.0,0.0,0.0,0.0,0.0,0.0,3,0,3,2.0,0.0,2.0
9609519,0,0,0,0,0,0,0,7,0.0,0.0,0.0,0.0,0.0,0.0,0.0,22,0,22,2.0,0.0,2.0
1245,0,0,0,0,0,0,0,1014,0.0,0.0,0.0,0.0,0.0,0.0,0.0,3,0,3,,,
202118,0,0,0,0,0,0,0,375,0.0,0.0,0.0,0.0,0.0,0.0,0.0,7,0,7,5.0,0.0,5.0
9405413,0,0,0,0,0,0,0,1632,,,,,,,,1,0,1,1.0,0.0,1.0
212336,0,0,0,0,0,0,0,29,0.0,0.0,0.0,0.0,0.0,0.0,0.0,8,0,8,,,
11265,0,0,0,0,0,0,0,313,0.0,0.0,0.0,0.0,0.0,0.0,0.0,10,0,10,2.0,0.0,2.0
111460,0,0,0,0,0,0,0,177,,,,,,,,1,0,1,,,
112215,0,0,0,0,0,0,0,447,0.0,0.0,0.0,0.0,0.0,0.0,0.0,2,0,2,2.0,0.0,2.0
9509264,0,0,0,0,0,0,0,44,,,,,,,,2,0,2,,,
9809581,0,0,0,0,0,0,0,68,0.0,0.0,0.0,0.0,0.0,0.0,0.0,2,0,2,1.0,0.0,1.0
6013,0,0,0,0,0,0,0,264,0.0,0.0,0.0,0.0,0.0,0.0,0.0,4,0,4,,,
9608372,0,0,0,0,0,0,0,10,0.0,0.0,0.0,0.0,0.0,0.0,0.0,22,0,22,6.0,0.0,6.0
209237,0,0,0,0,0,0,0,24,0.0,0.0,0.0,0.0,0.0,0.0,0.0,14,0,14,11.0,0.0,11.0
109270,0,0,0,0,0,0,0,23,0.0,0.0,0.0,0.0,0.0,0.0,0.0,12,0,12,2.0,0.0,2.0
9912401,0,0,0,0,0,0,0,126,0.0,0.0,0.0,0.0,0.0,0.0,0.0,2,0,2,1.0,0.0,1.0
212207,0,0,0,0,0,0,0,24,0.0,0.0,0.0,0.0,0.0,0.0,0.0,6,0,6,2.0,0.0,2.0
207187,0,0,0,0,0,0,0,13,0.0,0.0,0.0,0.0,0.0,0.0,0.0,8,0,8,1.0,0.0,1.0
4057,1,1,0,0,0,1,2,54,0.0,0.0,0.0,0.0,0.0,0.0,0.0,16,1,15,13.0,0.0,13.0
210293,0,0,0,0,0,0,0,84,0.0,0.0,0.0,0.0,0.0,0.0,0.0,8,0,8,2.0,0.0,2.0
9309207,0,0,0,0,0,0,0,41,0.0,0.0,0.0,0.0,0.0,0.0,0.0,4,0,4,2.0,0.0,2.0
9901234,0,0,0,0,0,0,0,74,0.0,0.0,0.0,0.0,0.0,0.0,0.0,8,0,8,4.0,0.0,4.0
101330,0,0,0,0,0,0,0,6,0.0,0.0,0.0,0.0,0.0,0.0,0.0,12,0,12,,,
11151,0,0,0,0,0,0,0,277,0.0,0.0,0.0,0.0,0.0,0.0,0.0,2,0,2,1.0,0.0,1.0
9807533,0,0,0,0,0,0,0,77,0.0,0.0,0.0,0.0,0.0,0.0,0.0,5,0,5,1.0,0.0,1.0
9907529,1,1,0,0,1,0,0,742,1.0,1.0,0.0,0.0,1.0,0.0,0.0,1,1,0,1.0,1.0,0.0
210020,0,0,0,0,0,0,0,314,0.0,0.0,0.0,0.0,0.0,0.0,0.0,4,0,4,2.0,0.0,2.0
301161,0,0,0,0,0,0,0,215,0.0,0.0,0.0,0.0,0.0,0.0,0.0,11,0,11,1.0,0.0,1.0
11126,0,0,0,0,0,0,0,89,,,,,,,,2,0,2,,,
302081,0,0,0,0,0,0,0,39,0.0,0.0,0.0,0.0,0.0,0.0,0.0,14,0,14,4.0,0.0,4.0
9409235,0,0,0,0,0,0,0,1201,,,,,,,,3,0,3,,,
9606402,21,3,18,42,4,17,22,100,15.0,2.0,13.0,32.0,3.0,12.0,12.0,26,21,5,15.0,14.0,1.0
9610360,42,7,35,104,2,40,185,13,14.0,2.0,12.0,38.0,1.0,13.0,24.0,73,42,31,8.0,3.0,5.0
2227,7,1,6,10,0,7,58,1,4.0,2.0,2.0,2.0,0.0,4.0,31.0,39,7,32,6.0,3.0,3.0
101190,8,1,7,17,0,8,26,8,,,,,,,,19,8,11,5.0,5.0,0.0
9903456,65,9,56,301,6,59,608,1,45.0,8.0,37.0,201.0,0.0,45.0,509.0,103,65,38,45.0,30.0,15.0
9309203,22,7,15,51,5,17,17,34,5.0,3.0,2.0,2.0,5.0,0.0,0.0,23,22,1,4.0,4.0,0.0
9409437,50,4,46,275,10,40,157,34,28.0,2.0,26.0,170.0,1.0,27.0,116.0,65,50,15,28.0,23.0,5.0
11184,10,5,5,7,8,2,4,1,2.0,1.0,1.0,1.0,2.0,0.0,0.0,14,10,4,2.0,2.0,0.0
9910417,11,5,6,10,3,8,48,1,0.0,0.0,0.0,0.0,0.0,0.0,0.0,52,11,41,6.0,2.0,4.0
9907335,37,6,31,163,0,37,232,34,27.0,3.0,24.0,128.0,0.0,27.0,189.0,51,37,14,35.0,24.0,11.0
9403341,55,11,44,147,55,0,0,1,21.0,1.0,20.0,67.0,21.0,0.0,0.0,55,55,0,7.0,7.0,0.0
9401310,217,63,154,478,195,22,23,20,17.0,4.0,13.0,56.0,17.0,0.0,0.0,219,217,2,11.0,11.0,0.0
9509316,48,10,38,124,1,47,127,114,16.0,2.0,14.0,53.0,1.0,15.0,15.0,64,48,16,18.0,16.0,2.0
9608325,5,2,3,3,3,2,2,25,0.0,0.0,0.0,0.0,0.0,0.0,0.0,18,5,13,2.0,0.0,2.0
9308346,4,3,1,1,3,1,2,229,2.0,1.0,1.0,1.0,2.0,0.0,0.0,7,4,3,2.0,2.0,0.0
201249,10,2,8,19,2,8,11,4,7.0,2.0,5.0,12.0,2.0,5.0,5.0,13,10,3,8.0,7.0,1.0
106219,81,3,78,958,6,75,252,28,67.0,1.0,66.0,884.0,59.0,8.0,8.0,89,81,8,55.0,55.0,0.0
9906252,2,2,0,0,0,2,9,33,1.0,1.0,0.0,0.0,0.0,1.0,2.0,30,2,28,6.0,1.0,5.0
9505433,68,12,56,419,56,12,14,33,45.0,2.0,43.0,336.0,45.0,0.0,0.0,70,68,2,33.0,33.0,0.0
9612329,20,5,15,33,8,12,37,24,4.0,1.0,3.0,4.0,4.0,0.0,0.0,27,20,7,3.0,3.0,0.0
9710372,37,9,28,115,4,33,205,33,25.0,5.0,20.0,85.0,2.0,23.0,111.0,72,37,35,24.0,15.0,9.0
9809306,16,4,12,30,8,8,10,32,5.0,1.0,4.0,4.0,1.0,4.0,4.0,22,16,6,9.0,6.0,3.0
9909352,21,3,18,41,2,19,117,33,15.0,3.0,12.0,30.0,0.0,15.0,87.0,37,21,16,20.0,10.0,10.0
9710312,43,4,39,139,10,33,154,7,18.0,2.0,16.0,51.0,2.0,16.0,77.0,69,43,26,19.0,12.0,7.0
111016,13,5,8,12,3,10,52,2,7.0,3.0,4.0,4.0,0.0,7.0,38.0,24,13,11,4.0,4.0,0.0
9503203,62,8,54,330,42,20,20,26,38.0,1.0,37.0,254.0,25.0,13.0,13.0,64,62,2,23.0,23.0,0.0
9803383,8,5,3,6,1,7,14,26,0.0,0.0,0.0,0.0,0.0,0.0,0.0,16,8,8,1.0,0.0,1.0
9908330,25,6,19,57,1,24,62,26,15.0,4.0,11.0,29.0,0.0,15.0,40.0,34,25,9,6.0,6.0,0.0
9308343,4,3,1,1,4,0,0,35,1.0,1.0,0.0,0.0,1.0,0.0,0.0,5,4,1,1.0,1.0,0.0
9312317,11,7,4,4,11,0,0,399,4.0,2.0,2.0,2.0,4.0,0.0,0.0,11,11,0,3.0,3.0,0.0
9504316,250,31,219,1686,78,172,409,4,75.0,3.0,72.0,776.0,11.0,64.0,176.0,256,250,6,52.0,48.0,4.0
9904380,39,5,34,222,1,38,681,2,33.0,4.0,29.0,207.0,0.0,33.0,644.0,82,39,43,51.0,24.0,27.0
2022,23,7,16,31,2,21,77,26,5.0,1.0,4.0,7.0,0.0,5.0,5.0,44,23,21,9.0,5.0,4.0
110242,11,3,8,18,0,11,86,2,6.0,2.0,4.0,6.0,0.0,6.0,54.0,21,11,10,15.0,6.0,9.0
9704410,24,5,19,47,24,0,0,32,5.0,2.0,3.0,3.0,5.0,0.0,0.0,25,24,1,4.0,4.0,0.0
9310253,43,7,36,111,37,6,6,104,15.0,4.0,11.0,33.0,15.0,0.0,0.0,44,43,1,12.0,12.0,0.0
9304321,36,8,28,85,12,24,35,223,11.0,3.0,8.0,17.0,3.0,8.0,8.0,38,36,2,11.0,10.0,1.0
9209204,14,5,9,17,14,0,0,13,3.0,2.0,1.0,1.0,3.0,0.0,0.0,14,14,0,3.0,3.0,0.0
9302208,97,20,77,270,93,4,4,8,18.0,2.0,16.0,51.0,18.0,0.0,0.0,98,97,1,6.0,6.0,0.0
9603310,77,18,59,184,3,74,445,61,31.0,8.0,23.0,55.0,0.0,31.0,208.0,112,77,35,32.0,21.0,11.0
9307371,50,10,40,231,35,15,15,25,30.0,3.0,27.0,154.0,22.0,8.0,8.0,52,50,2,23.0,22.0,1.0
9502273,24,7,17,33,0,24,66,41,5.0,2.0,3.0,4.0,2.0,3.0,3.0,42,24,18,6.0,5.0,1.0
9407264,6,4,2,8,0,6,33,10,5.0,3.0,2.0,6.0,0.0,5.0,8.0,22,6,16,5.0,4.0,1.0
9308363,57,7,50,260,4,53,100,5,33.0,5.0,28.0,124.0,4.0,29.0,29.0,63,57,6,21.0,20.0,1.0
9402254,56,14,42,110,51,5,5,10,4.0,1.0,3.0,4.0,4.0,0.0,0.0,57,56,1,3.0,3.0,0.0
9504342,102,7,95,748,89,13,15,0,70.0,3.0,67.0,598.0,62.0,8.0,8.0,105,102,3,48.0,48.0,0.0
9806387,234,6,228,2382,88,146,421,3,123.0,3.0,120.0,1538.0,56.0,67.0,105.0,260,234,26,59.0,57.0,2.0
9903308,87,10,77,479,42,45,112,0,56.0,5.0,51.0,359.0,47.0,9.0,9.0,94,87,7,37.0,37.0,0.0
9902460,2,2,0,0,1,1,4,0,0.0,0.0,0.0,0.0,0.0,0.0,0.0,10,2,8,1.0,0.0,1.0
9805266,12,4,8,11,4,8,11,3,1.0,1.0,0.0,0.0,1.0,0.0,0.0,17,12,5,1.0,0.0,1.0
9402291,69,11,58,250,6,63,63,10,12.0,1.0,11.0,43.0,12.0,0.0,0.0,71,69,2,9.0,9.0,0.0
9812475,106,11,95,498,4,102,910,3,61.0,3.0,58.0,365.0,0.0,61.0,662.0,153,106,47,58.0,32.0,26.0
9909249,19,6,13,23,1,18,290,3,12.0,3.0,9.0,17.0,0.0,12.0,214.0,103,19,84,47.0,4.0,43.0
9808254,21,4,17,80,1,20,22,0,17.0,3.0,14.0,77.0,0.0,17.0,19.0,24,21,3,15.0,14.0,1.0
9705270,23,5,18,33,7,16,55,3,7.0,2.0,5.0,7.0,0.0,7.0,32.0,31,23,8,13.0,6.0,7.0
9806534,39,4,35,126,25,14,23,0,13.0,4.0,9.0,22.0,8.0,5.0,9.0,42,39,3,11.0,10.0,1.0
9709483,18,2,16,50,1,17,68,0,8.0,1.0,7.0,16.0,0.0,8.0,30.0,30,18,12,9.0,5.0,4.0
9705392,45,10,35,145,7,38,84,0,16.0,3.0,13.0,46.0,2.0,14.0,16.0,53,45,8,17.0,13.0,4.0
9701362,2,2,0,0,0,2,7,366,0.0,0.0,0.0,0.0,0.0,0.0,0.0,8,2,6,2.0,0.0,2.0
9509327,90,7,83,581,32,58,145,50,55.0,2.0,53.0,455.0,17.0,38.0,62.0,97,90,7,37.0,36.0,1.0
9712328,6,2,4,13,0,6,10,215,3.0,2.0,1.0,2.0,0.0,3.0,3.0,10,6,4,5.0,3.0,2.0
2149,38,7,31,111,5,33,295,0,22.0,3.0,19.0,71.0,0.0,22.0,184.0,71,38,33,24.0,13.0,11.0
9408333,40,4,36,146,18,22,55,81,30.0,2.0,28.0,128.0,10.0,20.0,51.0,46,40,6,18.0,17.0,1.0
9807479,23,2,21,56,3,20,109,81,12.0,1.0,11.0,32.0,3.0,9.0,26.0,54,23,31,13.0,7.0,6.0
9504397,17,10,7,8,4,13,13,51,9.0,5.0,4.0,5.0,1.0,8.0,8.0,18,17,1,3.0,3.0,0.0
9706428,8,5,3,4,0,8,20,181,5.0,3.0,2.0,2.0,0.0,5.0,9.0,21,8,13,5.0,3.0,2.0
9304241,32,4,28,172,32,0,0,46,26.0,2.0,24.0,152.0,26.0,0.0,0.0,32,32,0,17.0,17.0,0.0
9601390,31,9,22,50,17,14,69,63,6.0,4.0,2.0,4.0,1.0,5.0,25.0,42,31,11,16.0,6.0,10.0
9209276,33,8,25,79,33,0,0,50,14.0,1.0,13.0,49.0,14.0,0.0,0.0,33,33,0,12.0,12.0,0.0
9803397,32,7,25,52,5,27,68,42,10.0,1.0,9.0,25.0,1.0,9.0,31.0,40,32,8,14.0,9.0,5.0
9712409,19,9,10,19,8,11,22,0,5.0,4.0,1.0,1.0,1.0,4.0,4.0,22,19,3,6.0,4.0,2.0
9907435,12,3,9,28,1,11,63,0,4.0,1.0,3.0,4.0,0.0,4.0,13.0,28,12,16,19.0,11.0,8.0
9610374,7,3,4,8,6,1,1,81,0.0,0.0,0.0,0.0,0.0,0.0,0.0,17,7,10,3.0,3.0,0.0
9708437,21,12,9,15,0,21,175,36,9.0,4.0,5.0,7.0,0.0,9.0,107.0,69,21,48,34.0,3.0,31.0
9612447,85,6,79,601,10,75,173,12,68.0,3.0,65.0,544.0,9.0,59.0,99.0,98,85,13,50.0,48.0,2.0
9307312,19,2,17,76,6,13,13,36,13.0,1.0,12.0,61.0,2.0,11.0,11.0,20,19,1,5.0,4.0,1.0
9707275,16,4,12,25,0,16,143,36,8.0,5.0,3.0,7.0,0.0,8.0,91.0,42,16,26,22.0,7.0,15.0
103299,18,4,14,47,0,18,127,1,5.0,1.0,4.0,8.0,0.0,5.0,21.0,46,18,28,16.0,8.0,8.0
9701313,59,7,52,317,5,54,195,1,23.0,2.0,21.0,95.0,1.0,22.0,48.0,77,59,18,23.0,19.0,4.0
102165,6,2,4,6,0,6,17,173,6.0,2.0,4.0,6.0,0.0,6.0,15.0,14,6,8,7.0,3.0,4.0
9610357,37,6,31,150,3,34,209,1,29.0,4.0,25.0,117.0,3.0,26.0,168.0,58,37,21,22.0,6.0,16.0
9401256,29,18,11,20,29,0,0,1,6.0,6.0,0.0,0.0,6.0,0.0,0.0,29,29,0,4.0,4.0,0.0
9707336,18,4,14,38,1,17,36,32,4.0,1.0,3.0,5.0,4.0,0.0,0.0,24,18,6,2.0,2.0,0.0
9709484,37,6,31,138,7,30,59,67,18.0,2.0,16.0,47.0,4.0,14.0,31.0,40,37,3,19.0,16.0,3.0
6146,33,2,31,121,0,33,206,34,25.0,2.0,23.0,86.0,0.0,25.0,167.0,48,33,15,20.0,13.0,7.0
9602350,30,7,23,82,24,6,14,2,8.0,2.0,6.0,14.0,8.0,0.0,0.0,39,30,9,3.0,3.0,0.0
9701286,66,4,62,370,0,66,443,5,53.0,4.0,49.0,318.0,0.0,53.0,362.0,90,66,24,25.0,22.0,3.0
9707546,41,7,34,133,0,41,239,23,22.0,2.0,20.0,96.0,1.0,21.0,74.0,73,41,32,25.0,21.0,4.0
9910279,5,3,2,2,0,5,33,63,0.0,0.0,0.0,0.0,0.0,0.0,0.0,57,5,52,11.0,0.0,11.0
9411399,12,5,7,15,0,12,22,33,6.0,2.0,4.0,7.0,0.0,6.0,10.0,17,12,5,5.0,4.0,1.0
9711265,5,3,2,2,0,5,30,1,0.0,0.0,0.0,0.0,0.0,0.0,0.0,40,5,35,11.0,1.0,10.0
9703442,95,24,71,213,14,81,330,7,6.0,1.0,5.0,5.0,1.0,5.0,27.0,143,95,48,9.0,7.0,2.0
107047,3,2,1,1,0,3,4,85,1.0,1.0,0.0,0.0,0.0,1.0,1.0,10,3,7,5.0,0.0,5.0
9812358,79,5,74,396,21,58,187,7,16.0,2.0,14.0,47.0,16.0,0.0,0.0,104,79,25,13.0,13.0,0.0
10229,1,1,0,0,0,1,19,34,1.0,1.0,0.0,0.0,0.0,1.0,19.0,20,1,19,19.0,1.0,18.0
1266,9,2,7,28,1,8,23,1,8.0,2.0,6.0,21.0,0.0,8.0,9.0,18,9,9,11.0,9.0,2.0
9709243,64,10,54,245,13,51,133,29,33.0,7.0,26.0,111.0,0.0,33.0,103.0,73,64,9,28.0,24.0,4.0
9702380,59,4,55,362,1,58,148,7,42.0,2.0,40.0,287.0,0.0,42.0,108.0,65,59,6,36.0,33.0,3.0
108226,3,2,1,1,0,3,21,7,1.0,1.0,0.0,0.0,0.0,1.0,5.0,19,3,16,7.0,1.0,6.0
9206205,97,15,82,327,97,0,0,48,19.0,3.0,16.0,65.0,19.0,0.0,0.0,97,97,0,11.0,11.0,0.0
9307201,166,21,145,901,165,1,1,4,37.0,1.0,36.0,279.0,37.0,0.0,0.0,167,166,1,23.0,23.0,0.0
9310319,79,15,64,293,79,0,0,21,27.0,2.0,25.0,80.0,27.0,0.0,0.0,79,79,0,23.0,23.0,0.0
9709267,12,3,9,19,0,12,47,21,7.0,2.0,5.0,12.0,0.0,7.0,27.0,23,12,11,3.0,2.0,1.0
9707371,20,9,11,16,3,17,78,7,6.0,2.0,4.0,7.0,0.0,6.0,16.0,58,20,38,3.0,3.0,0.0
9510286,53,13,40,145,18,35,135,75,3.0,2.0,1.0,1.0,0.0,3.0,28.0,74,53,21,20.0,6.0,14.0
9608466,21,3,18,46,2,19,62,7,8.0,6.0,2.0,3.0,0.0,8.0,35.0,29,21,8,12.0,7.0,5.0
9410342,43,16,27,72,16,27,69,87,25.0,5.0,20.0,50.0,6.0,19.0,57.0,47,43,4,19.0,15.0,4.0
9303251,71,16,55,294,24,47,92,15,33.0,5.0,28.0,188.0,8.0,25.0,57.0,76,71,5,15.0,14.0,1.0
9708456,165,9,156,1621,44,121,208,32,98.0,4.0,94.0,1148.0,15.0,83.0,148.0,173,165,8,62.0,59.0,3.0
9507365,22,9,13,26,13,9,14,22,6.0,3.0,3.0,3.0,5.0,1.0,1.0,29,22,7,4.0,3.0,1.0
9505250,12,4,8,17,11,1,1,383,8.0,3.0,5.0,12.0,8.0,0.0,0.0,13,12,1,6.0,6.0,0.0
9606415,17,7,10,19,1,16,94,12,6.0,3.0,3.0,4.0,0.0,6.0,37.0,42,17,25,9.0,6.0,3.0
9606378,15,1,14,49,4,11,47,19,5.0,1.0,4.0,7.0,0.0,5.0,27.0,24,15,9,11.0,8.0,3.0
9503236,32,4,28,151,0,32,216,19,26.0,2.0,24.0,139.0,0.0,26.0,135.0,53,32,21,20.0,9.0,11.0
9503358,47,13,34,69,1,46,219,10,8.0,4.0,4.0,4.0,0.0,8.0,44.0,79,47,32,9.0,3.0,6.0
9408298,14,4,10,16,11,3,4,13,2.0,1.0,1.0,1.0,2.0,0.0,0.0,17,14,3,2.0,2.0,0.0
9707264,42,6,36,158,13,29,63,11,28.0,2.0,26.0,126.0,3.0,25.0,46.0,47,42,5,23.0,21.0,2.0
9801322,33,2,31,121,10,23,103,16,20.0,2.0,18.0,88.0,1.0,19.0,91.0,44,33,11,10.0,9.0,1.0
9407359,30,13,17,44,7,23,25,16,19.0,9.0,10.0,26.0,4.0,15.0,15.0,34,30,4,14.0,13.0,1.0
9409446,25,7,18,49,2,23,36,43,12.0,1.0,11.0,37.0,0.0,12.0,20.0,28,25,3,6.0,4.0,2.0
9406266,15,6,9,19,5,10,19,108,7.0,2.0,5.0,10.0,1.0,6.0,9.0,20,15,5,7.0,6.0,1.0
9609295,4,2,2,2,0,4,16,62,1.0,1.0,0.0,0.0,0.0,1.0,5.0,20,4,16,9.0,1.0,8.0
9406233,16,8,8,13,15,1,1,30,11.0,3.0,8.0,13.0,11.0,0.0,0.0,17,16,1,1.0,1.0,0.0
9606470,9,7,2,4,3,6,10,135,4.0,2.0,2.0,3.0,0.0,4.0,5.0,13,9,4,2.0,2.0,0.0
9204202,30,12,18,30,30,0,0,363,8.0,5.0,3.0,7.0,8.0,0.0,0.0,30,30,0,4.0,4.0,0.0
9310327,11,10,1,3,4,7,7,62,7.0,7.0,0.0,0.0,0.0,7.0,7.0,12,11,1,8.0,7.0,1.0
9706265,34,7,27,73,3,31,110,85,23.0,5.0,18.0,40.0,4.0,19.0,66.0,59,34,25,16.0,12.0,4.0
9804416,11,4,7,15,0,11,64,6,7.0,1.0,6.0,13.0,1.0,6.0,13.0,32,11,21,12.0,7.0,5.0
9310285,39,10,29,121,6,33,83,6,28.0,6.0,22.0,96.0,1.0,27.0,69.0,43,39,4,8.0,7.0,1.0
9402210,115,22,93,511,91,24,24,49,47.0,5.0,42.0,301.0,47.0,0.0,0.0,116,115,1,28.0,28.0,0.0
9803236,4,4,0,0,1,3,13,6,1.0,1.0,0.0,0.0,1.0,0.0,0.0,16,4,12,1.0,1.0,0.0
9307217,15,7,8,19,15,0,0,10,2.0,2.0,0.0,0.0,2.0,0.0,0.0,15,15,0,1.0,1.0,0.0
9605317,127,11,116,740,55,72,93,19,45.0,4.0,41.0,218.0,20.0,25.0,33.0,133,127,6,24.0,23.0,1.0
9703278,89,5,84,333,12,77,144,67,26.0,2.0,24.0,110.0,0.0,26.0,42.0,95,89,6,14.0,13.0,1.0
2198,40,16,24,39,7,33,204,45,15.0,4.0,11.0,18.0,0.0,15.0,121.0,84,40,44,28.0,8.0,20.0
9603325,9,3,6,11,4,5,6,205,5.0,1.0,4.0,7.0,5.0,0.0,0.0,11,9,2,5.0,5.0,0.0
9510417,10,3,7,8,5,5,8,270,6.0,1.0,5.0,5.0,4.0,2.0,2.0,14,10,4,4.0,3.0,1.0
9907461,20,5,15,43,2,18,84,45,15.0,3.0,12.0,37.0,0.0,15.0,74.0,29,20,9,18.0,11.0,7.0
9406276,6,5,1,1,2,4,4,38,5.0,5.0,0.0,0.0,5.0,0.0,0.0,9,6,3,2.0,1.0,1.0
9404318,10,2,8,22,1,9,9,22,9.0,2.0,7.0,19.0,1.0,8.0,8.0,11,10,1,9.0,8.0,1.0
9903307,15,10,5,8,7,8,18,22,5.0,3.0,2.0,3.0,1.0,4.0,11.0,24,15,9,8.0,2.0,6.0
9501364,10,4,6,10,2,8,12,88,4.0,3.0,1.0,2.0,0.0,4.0,7.0,12,10,2,6.0,4.0,2.0
9806391,8,3,5,8,0,8,25,88,5.0,2.0,3.0,6.0,0.0,5.0,19.0,18,8,10,12.0,5.0,7.0
9704452,180,23,157,988,37,143,601,21,83.0,6.0,77.0,558.0,6.0,77.0,408.0,200,180,20,53.0,37.0,16.0
9709443,11,2,9,37,0,11,78,21,10.0,1.0,9.0,37.0,0.0,10.0,74.0,22,11,11,21.0,10.0,11.0
9802242,17,6,11,23,0,17,83,42,8.0,2.0,6.0,8.0,0.0,8.0,55.0,31,17,14,20.0,8.0,12.0
9310206,8,3,5,10,3,5,5,94,2.0,1.0,1.0,1.0,2.0,0.0,0.0,9,8,1,2.0,2.0,0.0
9712471,33,2,31,121,6,27,93,19,9.0,2.0,7.0,9.0,0.0,9.0,25.0,45,33,12,10.0,10.0,0.0
9902471,26,6,20,59,4,22,56,80,14.0,4.0,10.0,37.0,3.0,11.0,21.0,41,26,15,14.0,11.0,3.0
9911340,27,5,22,67,3,24,141,19,11.0,2.0,9.0,18.0,0.0,11.0,60.0,49,27,22,8.0,7.0,1.0
9911467,6,4,2,2,0,6,9,334,5.0,4.0,1.0,1.0,0.0,5.0,5.0,12,6,6,5.0,4.0,1.0
9603304,23,7,16,38,6,17,22,39,8.0,2.0,6.0,18.0,1.0,7.0,7.0,27,23,4,4.0,4.0,0.0
9058,25,13,12,26,3,22,283,20,13.0,6.0,7.0,19.0,0.0,13.0,234.0,94,25,69,52.0,5.0,47.0
9905448,32,2,30,192,0,32,216,20,31.0,2.0,29.0,190.0,0.0,31.0,214.0,41,32,9,34.0,26.0,8.0
9909419,26,2,24,131,2,24,468,20,25.0,2.0,23.0,130.0,2.0,23.0,458.0,60,26,34,49.0,20.0,29.0
9312325,18,12,6,9,12,6,7,85,3.0,3.0,0.0,0.0,3.0,0.0,0.0,22,18,4,1.0,1.0,0.0
9506207,38,10,28,92,3,35,101,29,11.0,4.0,7.0,17.0,0.0,11.0,32.0,56,38,18,9.0,8.0,1.0
9701323,14,5,9,19,1,13,33,136,13.0,4.0,9.0,19.0,1.0,12.0,32.0,17,14,3,13.0,10.0,3.0
3199,26,6,20,53,0,26,196,20,23.0,5.0,18.0,45.0,0.0,23.0,177.0,39,26,13,6.0,4.0,2.0
10225,3,2,1,1,0,3,12,20,0.0,0.0,0.0,0.0,0.0,0.0,0.0,16,3,13,3.0,0.0,3.0
4091,16,7,9,15,2,14,71,2,3.0,3.0,0.0,0.0,0.0,3.0,28.0,41,16,25,3.0,1.0,2.0
9902381,24,4,20,51,5,19,61,2,10.0,1.0,9.0,16.0,0.0,10.0,34.0,28,24,4,7.0,6.0,1.0
9211222,18,6,12,32,18,0,0,6,9.0,2.0,7.0,25.0,9.0,0.0,0.0,18,18,0,9.0,9.0,0.0
9406359,63,15,48,214,42,21,28,78,29.0,4.0,25.0,94.0,26.0,3.0,3.0,78,63,15,15.0,15.0,0.0
9708364,24,6,18,50,0,24,105,5,3.0,3.0,0.0,0.0,0.0,3.0,22.0,58,24,34,13.0,8.0,5.0
9712255,2,2,0,0,0,2,4,10,0.0,0.0,0.0,0.0,0.0,0.0,0.0,14,2,12,,,
9504234,55,4,51,259,9,46,198,5,26.0,1.0,25.0,117.0,3.0,23.0,77.0,74,55,19,30.0,25.0,5.0
9409223,5,4,1,1,2,3,3,265,2.0,2.0,0.0,0.0,2.0,0.0,0.0,6,5,1,2.0,2.0,0.0
9908316,16,3,13,42,0,16,108,73,15.0,2.0,13.0,42.0,0.0,15.0,97.0,32,16,16,22.0,12.0,10.0
9606412,18,3,15,31,5,13,35,42,9.0,2.0,7.0,11.0,2.0,7.0,21.0,26,18,8,4.0,4.0,0.0
9410281,62,9,53,200,15,47,187,15,35.0,4.0,31.0,131.0,4.0,31.0,125.0,84,62,22,11.0,7.0,4.0
9708443,4,3,1,2,0,4,23,114,3.0,3.0,0.0,0.0,0.0,3.0,16.0,15,4,11,11.0,3.0,8.0
9607220,16,2,14,26,0,16,71,5,11.0,1.0,10.0,17.0,0.0,11.0,47.0,28,16,12,4.0,4.0,0.0
9609373,4,2,2,2,2,2,5,92,2.0,1.0,1.0,1.0,2.0,0.0,0.0,7,4,3,1.0,1.0,0.0
9701257,22,7,15,31,19,3,4,4,4.0,1.0,3.0,5.0,4.0,0.0,0.0,25,22,3,4.0,4.0,0.0
9803484,9,4,5,7,5,4,5,141,2.0,2.0,0.0,0.0,2.0,0.0,0.0,12,9,3,2.0,2.0,0.0
9708455,21,8,13,23,5,16,26,4,8.0,3.0,5.0,10.0,0.0,8.0,8.0,24,21,3,9.0,8.0,1.0
9607286,41,12,29,56,11,30,140,61,8.0,3.0,5.0,10.0,0.0,8.0,36.0,62,41,21,14.0,7.0,7.0
9309275,2,2,0,0,2,0,0,310,1.0,1.0,0.0,0.0,1.0,0.0,0.0,2,2,0,1.0,1.0,0.0
9905381,78,5,73,522,2,76,545,3,55.0,2.0,53.0,396.0,0.0,55.0,437.0,125,78,47,33.0,12.0,21.0
9904297,24,9,15,26,2,22,99,3,9.0,1.0,8.0,14.0,1.0,8.0,16.0,45,24,21,11.0,7.0,4.0
9704309,3,2,1,1,1,2,4,62,1.0,1.0,0.0,0.0,0.0,1.0,2.0,10,3,7,6.0,0.0,6.0
9403395,9,3,6,9,8,1,1,103,4.0,1.0,3.0,5.0,4.0,0.0,0.0,10,9,1,4.0,4.0,0.0
9703337,99,12,87,508,14,85,438,36,55.0,4.0,51.0,403.0,4.0,51.0,214.0,137,99,38,43.0,39.0,4.0
6179,6,3,3,3,4,2,6,59,2.0,1.0,1.0,1.0,1.0,1.0,4.0,12,6,6,2.0,2.0,0.0
1158,6,5,1,1,1,5,11,227,3.0,2.0,1.0,1.0,0.0,3.0,7.0,13,6,7,6.0,1.0,5.0
9407296,36,13,23,78,6,30,87,6,24.0,9.0,15.0,56.0,2.0,22.0,75.0,43,36,7,18.0,13.0,5.0
9605440,17,2,15,30,4,13,39,10,8.0,1.0,7.0,11.0,3.0,5.0,5.0,32,17,15,5.0,4.0,1.0
9401298,11,6,5,8,5,6,12,251,3.0,3.0,0.0,0.0,3.0,0.0,0.0,18,11,7,3.0,3.0,0.0
9902399,26,5,21,103,10,16,18,23,17.0,3.0,14.0,79.0,11.0,6.0,6.0,29,26,3,12.0,11.0,1.0
9610525,14,5,9,13,2,12,22,1,6.0,4.0,2.0,4.0,0.0,6.0,6.0,23,14,9,8.0,7.0,1.0
9406237,14,6,8,14,14,0,0,129,9.0,4.0,5.0,10.0,9.0,0.0,0.0,14,14,0,4.0,4.0,0.0
9210251,33,17,16,25,33,0,0,10,6.0,6.0,0.0,0.0,6.0,0.0,0.0,33,33,0,5.0,5.0,0.0
9510303,27,12,15,56,4,23,28,55,12.0,3.0,9.0,22.0,2.0,10.0,10.0,35,27,8,3.0,3.0,0.0
9904473,7,5,2,3,0,7,59,12,1.0,1.0,0.0,0.0,0.0,1.0,2.0,43,7,36,11.0,0.0,11.0
9907211,42,9,33,126,5,37,245,10,5.0,4.0,1.0,1.0,0.0,5.0,13.0,72,42,30,11.0,7.0,4.0
3086,39,5,34,110,0,39,395,32,23.0,3.0,20.0,55.0,0.0,23.0,258.0,73,39,34,18.0,11.0,7.0
9509337,28,8,20,36,10,18,51,104,6.0,6.0,0.0,0.0,1.0,5.0,14.0,39,28,11,12.0,6.0,6.0
9209275,9,1,8,22,9,0,0,124,9.0,1.0,8.0,22.0,9.0,0.0,0.0,9,9,0,8.0,8.0,0.0
112117,77,13,64,197,2,75,275,23,25.0,2.0,23.0,72.0,0.0,25.0,116.0,91,77,14,27.0,16.0,11.0
9703260,9,6,3,4,1,8,29,18,0.0,0.0,0.0,0.0,0.0,0.0,0.0,28,9,19,5.0,0.0,5.0
102297,35,7,28,159,7,28,140,23,25.0,4.0,21.0,138.0,0.0,25.0,125.0,48,35,13,12.0,12.0,0.0
6116,13,4,9,22,0,13,156,5,11.0,3.0,8.0,21.0,0.0,11.0,120.0,41,13,28,26.0,11.0,15.0
9910205,87,17,70,268,32,55,214,0,14.0,2.0,12.0,37.0,0.0,14.0,71.0,169,87,82,18.0,13.0,5.0
9210272,35,2,33,106,35,0,0,18,10.0,2.0,8.0,24.0,10.0,0.0,0.0,35,35,0,8.0,8.0,0.0
9911255,35,7,28,76,3,32,198,5,11.0,1.0,10.0,21.0,0.0,11.0,72.0,58,35,23,23.0,8.0,15.0
9512252,87,2,85,760,1,86,327,7,58.0,2.0,56.0,532.0,0.0,58.0,181.0,98,87,11,41.0,37.0,4.0
9504283,5,1,4,9,0,5,12,18,4.0,1.0,3.0,5.0,0.0,4.0,9.0,8,5,3,7.0,4.0,3.0
9606324,36,11,25,66,5,31,504,7,2.0,2.0,0.0,0.0,0.0,2.0,32.0,155,36,119,21.0,0.0,21.0
9209213,41,9,32,119,27,14,14,8,12.0,5.0,7.0,18.0,12.0,0.0,0.0,42,41,1,8.0,8.0,0.0
5259,30,6,24,79,2,28,62,0,14.0,1.0,13.0,39.0,4.0,10.0,17.0,42,30,12,14.0,12.0,2.0
9269,15,13,2,2,3,12,55,0,2.0,2.0,0.0,0.0,1.0,1.0,4.0,43,15,28,4.0,0.0,4.0
9305230,17,5,12,34,17,0,0,41,13.0,1.0,12.0,34.0,13.0,0.0,0.0,18,17,1,12.0,12.0,0.0
101115,7,3,4,6,0,7,35,11,3.0,1.0,2.0,3.0,0.0,3.0,3.0,27,7,20,5.0,3.0,2.0
9905214,91,7,84,673,0,91,953,11,79.0,4.0,75.0,647.0,0.0,79.0,787.0,122,91,31,81.0,65.0,16.0
7142,35,5,30,174,1,34,256,19,31.0,2.0,29.0,170.0,0.0,31.0,240.0,53,35,18,31.0,22.0,9.0
9703302,37,7,30,101,5,32,137,44,24.0,5.0,19.0,68.0,0.0,24.0,100.0,49,37,12,10.0,8.0,2.0
9810286,10,2,8,17,0,10,37,16,3.0,1.0,2.0,2.0,0.0,3.0,5.0,17,10,7,5.0,4.0,1.0
9503484,61,11,50,199,8,53,92,39,36.0,4.0,32.0,146.0,1.0,35.0,61.0,67,61,6,29.0,26.0,3.0
9306271,43,12,31,84,43,0,0,4,8.0,4.0,4.0,6.0,8.0,0.0,0.0,43,43,0,7.0,7.0,0.0
9401259,5,2,3,5,3,2,2,162,4.0,2.0,2.0,4.0,2.0,2.0,2.0,7,5,2,4.0,3.0,1.0
9411338,48,2,46,174,22,26,27,9,18.0,2.0,16.0,61.0,9.0,9.0,9.0,50,48,2,13.0,12.0,1.0
9608305,8,5,3,5,1,7,17,52,3.0,1.0,2.0,2.0,0.0,3.0,3.0,13,8,5,2.0,1.0,1.0
4263,17,4,13,33,1,16,68,17,11.0,2.0,9.0,20.0,1.0,10.0,18.0,31,17,14,7.0,7.0,0.0
9505297,3,2,1,1,1,2,4,44,1.0,1.0,0.0,0.0,0.0,1.0,1.0,6,3,3,2.0,1.0,1.0
9904232,38,2,36,273,0,38,687,2,37.0,2.0,35.0,269.0,0.0,37.0,675.0,76,38,38,49.0,27.0,22.0
3023,2,2,0,0,2,0,0,83,0.0,0.0,0.0,0.0,0.0,0.0,0.0,9,2,7,1.0,0.0,1.0
111390,14,7,7,16,2,12,89,16,6.0,3.0,3.0,6.0,0.0,6.0,61.0,32,14,18,12.0,4.0,8.0
101070,17,2,15,51,0,17,93,11,17.0,2.0,15.0,51.0,0.0,17.0,85.0,26,17,9,21.0,15.0,6.0
9905567,17,6,11,17,3,14,79,16,3.0,1.0,2.0,2.0,0.0,3.0,30.0,40,17,23,11.0,5.0,6.0
205184,2,2,0,0,0,2,25,19,1.0,1.0,0.0,0.0,0.0,1.0,16.0,42,2,40,34.0,1.0,33.0
107173,12,3,9,22,1,11,32,19,8.0,1.0,7.0,19.0,0.0,8.0,22.0,17,12,5,2.0,2.0,0.0
9812529,27,4,23,71,2,25,45,19,7.0,1.0,6.0,15.0,2.0,5.0,6.0,31,27,4,6.0,4.0,2.0
108030,18,7,11,22,0,18,91,19,7.0,6.0,1.0,1.0,0.0,7.0,26.0,33,18,15,6.0,4.0,2.0
9910397,2,2,0,0,0,2,12,16,1.0,1.0,0.0,0.0,0.0,1.0,1.0,28,2,26,5.0,1.0,4.0
9301241,8,3,5,5,6,2,2,85,4.0,1.0,3.0,3.0,4.0,0.0,0.0,9,8,1,1.0,1.0,0.0
110163,34,2,32,223,0,34,256,28,29.0,1.0,28.0,207.0,0.0,29.0,166.0,46,34,12,32.0,25.0,7.0
105336,13,4,9,22,0,13,54,28,10.0,3.0,7.0,19.0,0.0,10.0,46.0,21,13,8,15.0,9.0,6.0
9604317,162,4,158,1234,23,139,142,9,84.0,1.0,83.0,846.0,12.0,72.0,72.0,164,162,2,51.0,50.0,1.0
9802216,6,2,4,4,2,4,12,26,2.0,1.0,1.0,1.0,0.0,2.0,4.0,21,6,15,7.0,0.0,7.0
9509254,16,4,12,27,7,9,16,91,5.0,3.0,2.0,3.0,1.0,4.0,6.0,21,16,5,7.0,6.0,1.0
12141,3,2,1,1,0,3,18,21,0.0,0.0,0.0,0.0,0.0,0.0,0.0,37,3,34,22.0,0.0,22.0
9903472,38,21,17,27,18,20,45,142,2.0,2.0,0.0,0.0,0.0,2.0,9.0,117,38,79,8.0,1.0,7.0
2229,15,3,12,25,0,15,126,2,12.0,3.0,9.0,21.0,1.0,11.0,42.0,29,15,14,14.0,9.0,5.0
204311,9,6,3,3,1,8,22,37,2.0,1.0,1.0,1.0,1.0,1.0,3.0,20,9,11,8.0,2.0,6.0
9703321,14,4,10,16,0,14,27,10,3.0,1.0,2.0,2.0,1.0,2.0,2.0,18,14,4,7.0,5.0,2.0
102301,86,4,82,735,8,78,176,37,64.0,2.0,62.0,638.0,3.0,61.0,80.0,101,86,15,47.0,46.0,1.0
9403340,20,8,12,25,20,0,0,90,16.0,5.0,11.0,24.0,16.0,0.0,0.0,20,20,0,11.0,11.0,0.0
9211214,43,7,36,186,43,0,0,119,26.0,2.0,24.0,117.0,26.0,0.0,0.0,43,43,0,21.0,21.0,0.0
9809556,11,3,8,23,7,4,9,63,7.0,1.0,6.0,19.0,7.0,0.0,0.0,15,11,4,7.0,7.0,0.0
9608215,7,3,4,6,2,5,12,50,1.0,1.0,0.0,0.0,0.0,1.0,2.0,11,7,4,6.0,2.0,4.0
9709292,28,4,24,116,4,24,79,18,18.0,3.0,15.0,86.0,1.0,17.0,53.0,38,28,10,20.0,17.0,3.0
4069,5,3,2,3,0,5,23,86,0.0,0.0,0.0,0.0,0.0,0.0,0.0,26,5,21,6.0,0.0,6.0
9503423,0,0,0,0,0,0,0,2046,0.0,0.0,0.0,0.0,0.0,0.0,0.0,1,0,1,,,
4115,75,16,59,210,5,70,739,12,42.0,8.0,34.0,121.0,0.0,42.0,563.0,133,75,58,40.0,13.0,27.0
204029,9,2,7,12,0,9,135,1,8.0,1.0,7.0,12.0,0.0,8.0,90.0,46,9,37,23.0,7.0,16.0
9156,6,3,3,7,0,6,50,34,6.0,3.0,3.0,7.0,0.0,6.0,50.0,22,6,16,1.0,1.0,0.0
9610243,14,6,8,11,2,12,54,58,2.0,2.0,0.0,0.0,0.0,2.0,9.0,26,14,12,3.0,1.0,2.0
9910257,8,2,6,11,0,8,118,34,4.0,1.0,3.0,6.0,0.0,4.0,54.0,43,8,35,24.0,4.0,20.0
9510341,7,3,4,8,2,5,28,10,1.0,1.0,0.0,0.0,0.0,1.0,5.0,27,7,20,9.0,0.0,9.0
9401288,24,3,21,67,18,6,6,79,19.0,2.0,17.0,55.0,19.0,0.0,0.0,26,24,2,12.0,12.0,0.0
9607280,24,7,17,26,10,14,18,72,11.0,6.0,5.0,5.0,3.0,8.0,9.0,26,24,2,6.0,5.0,1.0
9609350,3,2,1,2,0,3,11,11,,,,,,,,9,3,6,,,
9701236,21,9,12,41,7,14,40,11,13.0,3.0,10.0,32.0,13.0,0.0,0.0,29,21,8,6.0,4.0,2.0
9403361,29,11,18,29,29,0,0,360,8.0,4.0,4.0,5.0,8.0,0.0,0.0,29,29,0,5.0,5.0,0.0
9610294,17,9,8,14,0,17,229,17,15.0,7.0,8.0,14.0,0.0,15.0,207.0,47,17,30,33.0,9.0,24.0
9312316,1,1,0,0,1,0,0,1395,,,,,,,,1,1,0,,,
9708228,13,3,10,21,0,13,51,48,11.0,2.0,9.0,14.0,0.0,11.0,48.0,20,13,7,11.0,4.0,7.0
9801273,5,3,2,2,0,5,16,24,3.0,3.0,0.0,0.0,1.0,2.0,2.0,13,5,8,1.0,1.0,0.0
9609258,8,3,5,7,5,3,4,67,3.0,1.0,2.0,3.0,0.0,3.0,3.0,16,8,8,4.0,3.0,1.0
9510437,11,6,5,14,0,11,23,8,2.0,2.0,0.0,0.0,2.0,0.0,0.0,15,11,4,1.0,1.0,0.0
9701305,12,7,5,9,2,10,36,8,3.0,2.0,1.0,1.0,2.0,1.0,6.0,30,12,18,8.0,1.0,7.0
103151,18,3,15,62,0,18,74,37,15.0,2.0,13.0,49.0,0.0,15.0,23.0,23,18,5,12.0,12.0,0.0
105349,24,11,13,21,2,22,95,4,11.0,5.0,6.0,6.0,0.0,11.0,52.0,51,24,27,8.0,3.0,5.0
9712245,22,11,11,24,1,21,133,12,7.0,3.0,4.0,5.0,0.0,7.0,59.0,48,22,26,22.0,5.0,17.0
9808412,37,8,29,134,2,35,351,12,26.0,1.0,25.0,126.0,0.0,26.0,211.0,88,37,51,35.0,22.0,13.0
9507337,5,4,1,1,4,1,3,155,1.0,1.0,0.0,0.0,0.0,1.0,1.0,8,5,3,1.0,1.0,0.0
5256,16,7,9,27,1,15,51,28,10.0,3.0,7.0,23.0,0.0,10.0,27.0,35,16,19,10.0,1.0,9.0
9501402,7,4,3,3,0,7,19,192,2.0,1.0,1.0,1.0,0.0,2.0,8.0,17,7,10,8.0,2.0,6.0
9308322,10,7,3,3,9,1,1,368,4.0,4.0,0.0,0.0,4.0,0.0,0.0,11,10,1,3.0,3.0,0.0
9504407,33,14,19,36,27,6,7,77,8.0,3.0,5.0,10.0,8.0,0.0,0.0,38,33,5,4.0,4.0,0.0
9703373,14,7,7,18,12,2,2,54,6.0,2.0,4.0,10.0,6.0,0.0,0.0,16,14,2,7.0,7.0,0.0
5020,11,7,4,9,2,9,108,24,3.0,3.0,0.0,0.0,0.0,3.0,41.0,67,11,56,15.0,1.0,14.0
9710451,46,12,34,96,8,38,127,92,13.0,6.0,7.0,14.0,1.0,12.0,31.0,61,46,15,10.0,8.0,2.0
9412362,11,4,7,10,11,0,0,428,8.0,2.0,6.0,9.0,8.0,0.0,0.0,11,11,0,7.0,7.0,0.0
9412381,14,1,13,42,5,9,17,47,13.0,1.0,12.0,41.0,9.0,4.0,5.0,29,14,15,14.0,12.0,2.0
9805342,81,9,72,349,3,78,486,9,56.0,4.0,52.0,282.0,0.0,56.0,381.0,98,81,17,42.0,27.0,15.0
105172,2,1,1,1,0,2,10,286,1.0,1.0,0.0,0.0,0.0,1.0,3.0,9,2,7,6.0,2.0,4.0
5120,6,5,1,2,6,0,0,2113,3.0,2.0,1.0,2.0,3.0,0.0,0.0,6,6,0,,,
9803237,56,17,39,119,6,50,249,14,27.0,5.0,22.0,76.0,0.0,27.0,144.0,96,56,40,26.0,17.0,9.0
9710379,21,5,16,31,4,17,86,14,9.0,2.0,7.0,12.0,0.0,9.0,59.0,34,21,13,14.0,6.0,8.0
9710300,23,8,15,41,0,23,114,27,6.0,4.0,2.0,2.0,0.0,6.0,30.0,37,23,14,20.0,10.0,10.0
9701413,14,2,12,39,0,14,67,14,8.0,1.0,7.0,20.0,0.0,8.0,40.0,31,14,17,15.0,8.0,7.0
9602241,5,3,2,2,5,0,0,337,2.0,1.0,1.0,1.0,2.0,0.0,0.0,7,5,2,4.0,2.0,2.0
9501305,1,1,0,0,0,1,4,114,1.0,1.0,0.0,0.0,0.0,1.0,3.0,11,1,10,2.0,0.0,2.0
9604305,10,4,6,11,4,6,7,77,4.0,2.0,2.0,2.0,1.0,3.0,3.0,12,10,2,4.0,3.0,1.0
8241,21,7,14,29,0,21,127,45,19.0,5.0,14.0,29.0,0.0,19.0,111.0,43,21,22,29.0,14.0,15.0
9904492,4,1,3,6,0,4,10,192,4.0,1.0,3.0,6.0,0.0,4.0,6.0,9,4,5,6.0,4.0,2.0
9504275,5,5,0,0,1,4,12,17,2.0,2.0,0.0,0.0,1.0,1.0,1.0,12,5,7,2.0,1.0,1.0
9706341,5,2,3,4,3,2,14,11,1.0,1.0,0.0,0.0,1.0,0.0,0.0,31,5,26,1.0,0.0,1.0
9607329,5,5,0,0,1,4,26,14,4.0,4.0,0.0,0.0,0.0,4.0,19.0,17,5,12,4.0,1.0,3.0
9607232,2,2,0,0,0,2,10,16,2.0,2.0,0.0,0.0,0.0,2.0,10.0,9,2,7,1.0,0.0,1.0
9707240,8,5,3,3,0,8,26,16,3.0,2.0,1.0,1.0,0.0,3.0,7.0,14,8,6,6.0,3.0,3.0
9602432,13,8,5,5,11,2,2,18,2.0,2.0,0.0,0.0,2.0,0.0,0.0,16,13,3,3.0,3.0,0.0
9809500,9,3,6,8,0,9,83,66,5.0,2.0,3.0,4.0,0.0,5.0,24.0,50,9,41,13.0,3.0,10.0
9704318,5,3,2,2,2,3,3,97,2.0,1.0,1.0,1.0,0.0,2.0,2.0,6,5,1,1.0,0.0,1.0
9602272,30,2,28,107,1,29,132,8,15.0,3.0,12.0,66.0,0.0,15.0,36.0,51,30,21,19.0,16.0,3.0
9208231,30,6,24,64,11,19,19,15,16.0,5.0,11.0,19.0,16.0,0.0,0.0,31,30,1,6.0,6.0,0.0
9406345,43,10,33,167,2,41,100,15,29.0,6.0,23.0,134.0,2.0,27.0,80.0,51,43,8,8.0,4.0,4.0
9404272,9,1,8,16,3,6,8,15,1.0,1.0,0.0,0.0,0.0,1.0,1.0,11,9,2,2.0,1.0,1.0
9204232,10,6,4,6,10,0,0,358,3.0,3.0,0.0,0.0,3.0,0.0,0.0,10,10,0,5.0,5.0,0.0
9707357,3,1,2,2,0,3,12,5,3.0,1.0,2.0,2.0,0.0,3.0,12.0,9,3,6,1.0,0.0,1.0
7110,5,2,3,3,1,4,31,86,3.0,2.0,1.0,1.0,0.0,3.0,13.0,39,5,34,8.0,3.0,5.0
4171,17,5,12,20,0,17,157,3,8.0,6.0,2.0,3.0,0.0,8.0,108.0,75,17,58,35.0,3.0,32.0
3281,5,1,4,6,0,5,47,0,4.0,1.0,3.0,5.0,0.0,4.0,43.0,43,5,38,23.0,3.0,20.0
9312211,2,1,1,1,1,1,1,1773,0.0,0.0,0.0,0.0,0.0,0.0,0.0,4,2,2,,,
206003,17,10,7,9,7,10,16,116,2.0,2.0,0.0,0.0,0.0,2.0,4.0,39,17,22,10.0,1.0,9.0
9705298,4,3,1,1,1,3,4,254,3.0,2.0,1.0,1.0,1.0,2.0,2.0,6,4,2,4.0,3.0,1.0
9407259,5,4,1,1,1,4,7,114,0.0,0.0,0.0,0.0,0.0,0.0,0.0,14,5,9,3.0,1.0,2.0
9803479,58,20,38,86,7,51,461,15,13.0,3.0,10.0,21.0,0.0,13.0,227.0,165,58,107,42.0,8.0,34.0
8090,24,8,16,35,2,22,42,1,6.0,4.0,2.0,3.0,3.0,3.0,6.0,36,24,12,10.0,4.0,6.0
112110,20,3,17,81,8,12,16,146,19.0,3.0,16.0,76.0,8.0,11.0,15.0,25,20,5,19.0,17.0,2.0
9704375,9,5,4,6,1,8,14,70,3.0,2.0,1.0,1.0,0.0,3.0,3.0,19,9,10,5.0,4.0,1.0
9607463,19,6,13,25,1,18,65,37,5.0,2.0,3.0,5.0,0.0,5.0,17.0,37,19,18,11.0,7.0,4.0
9306260,17,8,9,29,17,0,0,40,15.0,6.0,9.0,29.0,15.0,0.0,0.0,17,17,0,6.0,6.0,0.0
9710256,7,2,5,13,0,7,34,8,7.0,2.0,5.0,13.0,0.0,7.0,28.0,17,7,10,1.0,0.0,1.0
9306207,33,19,14,17,30,3,5,10,2.0,1.0,1.0,1.0,2.0,0.0,0.0,38,33,5,3.0,3.0,0.0
104284,46,4,42,222,2,44,271,7,19.0,1.0,18.0,80.0,1.0,18.0,72.0,83,46,37,25.0,21.0,4.0
9712448,5,2,3,3,2,3,8,117,1.0,1.0,0.0,0.0,1.0,0.0,0.0,12,5,7,2.0,2.0,0.0
9507423,1,1,0,0,1,0,0,478,0.0,0.0,0.0,0.0,0.0,0.0,0.0,3,1,2,1.0,0.0,1.0
9403269,12,11,1,1,4,8,9,123,2.0,2.0,0.0,0.0,0.0,2.0,2.0,14,12,2,4.0,4.0,0.0
105311,32,4,28,97,3,29,215,21,20.0,3.0,17.0,64.0,0.0,20.0,154.0,68,32,36,30.0,17.0,13.0
9401339,3,1,2,3,3,0,0,49,,,,,,,,4,3,1,,,
9307223,2,2,0,0,1,1,1,1865,0.0,0.0,0.0,0.0,0.0,0.0,0.0,4,2,2,1.0,0.0,1.0
6232,13,5,8,22,1,12,35,44,10.0,3.0,7.0,16.0,0.0,10.0,28.0,20,13,7,13.0,7.0,6.0
104150,3,2,1,2,0,3,26,56,2.0,1.0,1.0,1.0,0.0,2.0,14.0,32,3,29,5.0,0.0,5.0
9902343,17,4,13,41,3,14,58,30,13.0,2.0,11.0,34.0,2.0,11.0,48.0,33,17,16,16.0,6.0,10.0
5082,6,4,2,3,1,5,8,12,2.0,2.0,0.0,0.0,1.0,1.0,2.0,26,6,20,2.0,2.0,0.0
9705272,2,2,0,0,0,2,14,60,1.0,1.0,0.0,0.0,0.0,1.0,10.0,18,2,16,12.0,1.0,11.0
9909418,24,4,20,89,0,24,338,32,20.0,1.0,19.0,81.0,0.0,20.0,296.0,73,24,49,41.0,18.0,23.0
105025,16,4,12,29,1,15,151,23,5.0,2.0,3.0,5.0,0.0,5.0,46.0,53,16,37,6.0,2.0,4.0
3118,10,5,5,9,0,10,68,13,5.0,2.0,3.0,6.0,0.0,5.0,41.0,44,10,34,16.0,5.0,11.0
9704431,1,1,0,0,1,0,0,149,0.0,0.0,0.0,0.0,0.0,0.0,0.0,5,1,4,1.0,1.0,0.0
9811295,8,3,5,9,2,6,27,112,6.0,2.0,4.0,8.0,0.0,6.0,27.0,17,8,9,12.0,6.0,6.0
9601287,11,7,4,8,5,6,6,14,2.0,1.0,1.0,1.0,2.0,0.0,0.0,13,11,2,1.0,1.0,0.0
9612256,7,1,6,13,1,6,22,130,5.0,1.0,4.0,9.0,0.0,5.0,15.0,11,7,4,9.0,6.0,3.0
9610232,9,4,5,9,2,7,13,36,5.0,1.0,4.0,7.0,0.0,5.0,10.0,13,9,4,4.0,2.0,2.0
4139,30,3,27,107,2,28,75,7,13.0,1.0,12.0,44.0,4.0,9.0,20.0,42,30,12,15.0,15.0,0.0
9802305,7,2,5,11,0,7,18,33,0.0,0.0,0.0,0.0,0.0,0.0,0.0,39,7,32,6.0,0.0,6.0
9801251,23,10,13,20,0,23,172,12,15.0,4.0,11.0,17.0,0.0,15.0,93.0,58,23,35,19.0,11.0,8.0
106147,4,4,0,0,0,4,9,169,4.0,4.0,0.0,0.0,0.0,4.0,8.0,10,4,6,7.0,2.0,5.0
9609371,8,6,2,5,0,8,12,17,3.0,2.0,1.0,2.0,3.0,0.0,0.0,13,8,5,4.0,4.0,0.0
104262,5,2,3,5,0,5,17,67,5.0,2.0,3.0,5.0,0.0,5.0,16.0,18,5,13,3.0,2.0,1.0
9809337,62,19,43,116,9,53,210,89,19.0,4.0,15.0,36.0,0.0,19.0,94.0,78,62,16,20.0,12.0,8.0
9703269,1,1,0,0,0,1,14,6,1.0,1.0,0.0,0.0,0.0,1.0,14.0,30,1,29,16.0,1.0,15.0
9709229,19,10,9,24,7,12,62,102,8.0,4.0,4.0,10.0,1.0,7.0,24.0,39,19,20,12.0,7.0,5.0
110003,1,1,0,0,0,1,1,21,1.0,1.0,0.0,0.0,0.0,1.0,1.0,9,1,8,1.0,0.0,1.0
9401239,4,2,2,2,2,2,2,265,2.0,1.0,1.0,1.0,0.0,2.0,2.0,5,4,1,3.0,2.0,1.0
9801410,8,5,3,5,0,8,48,5,4.0,3.0,1.0,2.0,0.0,4.0,7.0,27,8,19,6.0,4.0,2.0
9305297,3,3,0,0,3,0,0,245,1.0,1.0,0.0,0.0,1.0,0.0,0.0,6,3,3,1.0,0.0,1.0
9705396,2,1,1,1,0,2,5,1583,1.0,1.0,0.0,0.0,0.0,1.0,1.0,7,2,5,4.0,1.0,3.0
9406391,16,6,10,18,16,0,0,453,8.0,1.0,7.0,12.0,8.0,0.0,0.0,17,16,1,7.0,7.0,0.0
1237,2,1,1,1,1,1,1,209,1.0,1.0,0.0,0.0,1.0,0.0,0.0,4,2,2,1.0,1.0,0.0
9510346,19,8,11,18,19,0,0,232,6.0,3.0,3.0,4.0,6.0,0.0,0.0,24,19,5,5.0,4.0,1.0
9303313,22,10,12,24,22,0,0,125,12.0,3.0,9.0,19.0,12.0,0.0,0.0,22,22,0,8.0,8.0,0.0
9805436,7,2,5,7,1,6,34,44,4.0,1.0,3.0,5.0,0.0,4.0,20.0,16,7,9,10.0,3.0,7.0
9507283,13,3,10,17,7,6,10,6,3.0,1.0,2.0,2.0,2.0,1.0,1.0,26,13,13,5.0,4.0,1.0
101227,3,3,0,0,3,0,0,279,1.0,1.0,0.0,0.0,1.0,0.0,0.0,3,3,0,1.0,1.0,0.0
9302295,26,8,18,41,26,0,0,24,10.0,2.0,8.0,14.0,10.0,0.0,0.0,26,26,0,6.0,6.0,0.0
9809483,56,7,49,179,3,53,196,9,22.0,4.0,18.0,54.0,0.0,22.0,103.0,75,56,19,21.0,19.0,2.0
9802224,8,5,3,4,0,8,27,85,2.0,2.0,0.0,0.0,0.0,2.0,7.0,19,8,11,9.0,3.0,6.0
9509392,9,7,2,4,6,3,11,26,1.0,1.0,0.0,0.0,0.0,1.0,8.0,24,9,15,10.0,1.0,9.0
9712355,3,2,1,1,0,3,5,244,2.0,2.0,0.0,0.0,0.0,2.0,4.0,9,3,6,1.0,1.0,0.0
9810477,2,2,0,0,1,1,1,504,2.0,2.0,0.0,0.0,1.0,1.0,1.0,4,2,2,2.0,1.0,1.0
9504278,11,4,7,8,9,2,2,15,4.0,1.0,3.0,3.0,4.0,0.0,0.0,13,11,2,1.0,1.0,0.0
9025,4,2,2,3,1,3,8,88,3.0,1.0,2.0,3.0,0.0,3.0,6.0,8,4,4,1.0,0.0,1.0
8328,3,2,1,1,0,3,42,21,3.0,2.0,1.0,1.0,0.0,3.0,42.0,37,3,34,28.0,3.0,25.0
108130,1,1,0,0,1,0,0,1259,0.0,0.0,0.0,0.0,0.0,0.0,0.0,3,1,2,1.0,0.0,1.0
9906204,6,5,1,1,4,2,6,57,3.0,2.0,1.0,1.0,3.0,0.0,0.0,17,6,11,2.0,1.0,1.0
9703439,8,2,6,10,2,6,7,1,7.0,1.0,6.0,10.0,4.0,3.0,3.0,13,8,5,2.0,1.0,1.0
9802376,5,5,0,0,2,3,3,287,2.0,2.0,0.0,0.0,2.0,0.0,0.0,6,5,1,2.0,2.0,0.0
11058,3,2,1,1,0,3,8,3,1.0,1.0,0.0,0.0,0.0,1.0,1.0,9,3,6,1.0,1.0,0.0
9709251,6,4,2,2,6,0,0,499,3.0,2.0,1.0,1.0,3.0,0.0,0.0,6,6,0,1.0,1.0,0.0
9712501,4,3,1,2,1,3,15,69,1.0,1.0,0.0,0.0,0.0,1.0,3.0,13,4,9,6.0,2.0,4.0
106283,3,3,0,0,0,3,5,0,0.0,0.0,0.0,0.0,0.0,0.0,0.0,14,3,11,1.0,0.0,1.0
112310,15,2,13,37,0,15,119,0,6.0,2.0,4.0,8.0,0.0,6.0,45.0,52,15,37,21.0,6.0,15.0
111150,61,20,41,136,7,54,331,0,21.0,8.0,13.0,41.0,0.0,21.0,166.0,116,61,55,23.0,11.0,12.0
106017,10,8,2,2,4,6,13,51,4.0,4.0,0.0,0.0,0.0,4.0,4.0,19,10,9,5.0,3.0,2.0
9610362,14,3,11,14,0,14,47,68,5.0,1.0,4.0,5.0,1.0,4.0,8.0,24,14,10,7.0,3.0,4.0
106097,11,2,9,17,4,7,24,37,5.0,1.0,4.0,7.0,1.0,4.0,12.0,24,11,13,3.0,0.0,3.0
9701267,2,1,1,1,0,2,4,67,1.0,1.0,0.0,0.0,0.0,1.0,2.0,5,2,3,3.0,1.0,2.0
9604442,22,6,16,25,8,14,25,27,3.0,2.0,1.0,2.0,0.0,3.0,5.0,30,22,8,5.0,5.0,0.0
9504392,1,1,0,0,1,0,0,58,0.0,0.0,0.0,0.0,0.0,0.0,0.0,13,1,12,3.0,0.0,3.0
9412245,10,2,8,12,1,9,9,190,2.0,1.0,1.0,1.0,0.0,2.0,2.0,14,10,4,6.0,5.0,1.0
9408204,11,5,6,9,11,0,0,167,9.0,3.0,6.0,9.0,9.0,0.0,0.0,11,11,0,6.0,6.0,0.0
9701406,7,2,5,11,0,7,36,33,6.0,1.0,5.0,9.0,0.0,6.0,30.0,21,7,14,12.0,6.0,6.0
9803251,11,5,6,15,0,11,47,13,7.0,4.0,3.0,10.0,0.0,7.0,37.0,26,11,15,17.0,6.0,11.0
9606216,8,3,5,10,4,4,14,25,3.0,1.0,2.0,3.0,3.0,0.0,0.0,20,8,12,2.0,2.0,0.0
9903220,34,9,25,92,0,34,112,95,22.0,4.0,18.0,63.0,1.0,21.0,66.0,47,34,13,23.0,18.0,5.0
9508304,3,3,0,0,0,3,5,6,2.0,2.0,0.0,0.0,0.0,2.0,2.0,13,3,10,1.0,0.0,1.0
9507311,16,5,11,14,6,10,20,183,4.0,2.0,2.0,2.0,1.0,3.0,6.0,25,16,9,6.0,3.0,3.0
105281,5,4,1,1,0,5,44,2,2.0,1.0,1.0,1.0,0.0,2.0,8.0,40,5,35,3.0,2.0,1.0
2239,7,2,5,11,2,5,35,15,6.0,1.0,5.0,11.0,1.0,5.0,29.0,18,7,11,4.0,1.0,3.0
102143,12,7,5,11,10,2,3,19,1.0,1.0,0.0,0.0,1.0,0.0,0.0,18,12,6,2.0,0.0,2.0
9408274,1,1,0,0,1,0,0,176,,,,,,,,1,1,0,,,
107307,4,4,0,0,0,4,33,2,2.0,2.0,0.0,0.0,0.0,2.0,11.0,33,4,29,10.0,0.0,10.0
9711485,88,9,79,395,1,87,356,27,76.0,8.0,68.0,363.0,1.0,75.0,316.0,106,88,18,29.0,27.0,2.0
9907420,12,2,10,21,0,12,69,130,10.0,1.0,9.0,18.0,0.0,10.0,47.0,31,12,19,13.0,9.0,4.0
5194,8,3,5,12,0,8,24,19,2.0,1.0,1.0,1.0,2.0,0.0,0.0,14,8,6,5.0,3.0,2.0
9905290,6,3,3,3,3,3,7,255,2.0,2.0,0.0,0.0,2.0,0.0,0.0,14,6,8,2.0,2.0,0.0
203136,3,2,1,1,0,3,8,129,1.0,1.0,0.0,0.0,0.0,1.0,3.0,13,3,10,2.0,1.0,1.0
201022,2,1,1,1,0,2,11,0,0.0,0.0,0.0,0.0,0.0,0.0,0.0,36,2,34,1.0,0.0,1.0
9906486,13,2,11,38,1,12,81,46,10.0,1.0,9.0,35.0,1.0,9.0,36.0,55,13,42,7.0,0.0,7.0
9607288,2,2,0,0,1,1,8,43,0.0,0.0,0.0,0.0,0.0,0.0,0.0,13,2,11,1.0,0.0,1.0
204062,6,4,2,3,0,6,29,37,1.0,1.0,0.0,0.0,0.0,1.0,4.0,26,6,20,6.0,1.0,5.0
110227,5,3,2,6,0,5,27,4,0.0,0.0,0.0,0.0,0.0,0.0,0.0,15,5,10,6.0,4.0,2.0
2072,33,6,27,131,11,22,63,47,25.0,3.0,22.0,121.0,10.0,15.0,42.0,47,33,14,28.0,23.0,5.0
111379,7,4,3,3,0,7,58,47,3.0,2.0,1.0,1.0,0.0,3.0,16.0,27,7,20,9.0,3.0,6.0
9911314,3,2,1,1,0,3,15,3,2.0,1.0,1.0,1.0,0.0,2.0,3.0,19,3,16,4.0,1.0,3.0
9906383,24,5,19,77,2,22,177,56,12.0,5.0,7.0,16.0,0.0,12.0,99.0,61,24,37,24.0,5.0,19.0
107313,13,4,9,33,0,13,22,3,9.0,1.0,8.0,27.0,0.0,9.0,9.0,22,13,9,11.0,10.0,1.0
9912436,19,11,8,9,2,17,66,62,6.0,5.0,1.0,1.0,0.0,6.0,20.0,55,19,36,15.0,7.0,8.0
9910514,4,1,3,4,4,0,0,65,1.0,1.0,0.0,0.0,1.0,0.0,0.0,5,4,1,2.0,1.0,1.0
205122,3,1,2,2,0,3,40,28,3.0,1.0,2.0,2.0,0.0,3.0,39.0,22,3,19,21.0,3.0,18.0
9405273,27,3,24,103,10,17,17,100,23.0,3.0,20.0,94.0,7.0,16.0,16.0,29,27,2,20.0,19.0,1.0
9503304,3,2,1,1,1,2,4,274,2.0,1.0,1.0,1.0,0.0,2.0,4.0,6,3,3,4.0,1.0,3.0
9209274,8,6,2,3,8,0,0,124,1.0,1.0,0.0,0.0,1.0,0.0,0.0,8,8,0,4.0,4.0,0.0
9511253,2,2,0,0,1,1,1,190,1.0,1.0,0.0,0.0,0.0,1.0,1.0,5,2,3,3.0,0.0,3.0
7261,11,4,7,10,0,11,90,11,8.0,2.0,6.0,8.0,0.0,8.0,66.0,41,11,30,5.0,0.0,5.0
9602394,3,2,1,1,0,3,9,13,1.0,1.0,0.0,0.0,1.0,0.0,0.0,15,3,12,4.0,0.0,4.0
9404232,5,2,3,3,0,5,5,63,3.0,1.0,2.0,2.0,0.0,3.0,3.0,7,5,2,2.0,1.0,1.0
9707360,4,2,2,2,0,4,18,44,4.0,2.0,2.0,2.0,1.0,3.0,4.0,11,4,7,1.0,1.0,0.0
9410306,1,1,0,0,1,0,0,481,1.0,1.0,0.0,0.0,1.0,0.0,0.0,1,1,0,1.0,1.0,0.0
3309,7,4,3,5,0,7,36,32,6.0,3.0,3.0,5.0,0.0,6.0,32.0,32,7,25,1.0,0.0,1.0
9601334,7,3,4,7,4,3,5,14,6.0,3.0,3.0,6.0,6.0,0.0,0.0,12,7,5,3.0,3.0,0.0
9710395,3,3,0,0,0,3,5,62,0.0,0.0,0.0,0.0,0.0,0.0,0.0,18,3,15,11.0,0.0,11.0
1146,4,1,3,5,3,1,1,101,0.0,0.0,0.0,0.0,0.0,0.0,0.0,20,4,16,4.0,0.0,4.0
9407266,29,5,24,56,28,1,1,105,18.0,2.0,16.0,40.0,18.0,0.0,0.0,30,29,1,8.0,8.0,0.0
9707216,1,1,0,0,1,0,0,877,1.0,1.0,0.0,0.0,1.0,0.0,0.0,1,1,0,,,
9507367,5,3,2,2,0,5,9,17,2.0,1.0,1.0,1.0,0.0,2.0,2.0,22,5,17,2.0,0.0,2.0
9405289,1,1,0,0,1,0,0,1963,,,,,,,,4,1,3,,,
9807280,1,1,0,0,0,1,1,1,0.0,0.0,0.0,0.0,0.0,0.0,0.0,18,1,17,2.0,0.0,2.0
9711454,5,2,3,3,2,3,15,255,2.0,2.0,0.0,0.0,1.0,1.0,6.0,17,5,12,9.0,2.0,7.0
111080,3,3,0,0,1,2,4,15,0.0,0.0,0.0,0.0,0.0,0.0,0.0,43,3,40,2.0,0.0,2.0
5316,34,2,32,235,0,34,116,109,32.0,2.0,30.0,229.0,0.0,32.0,114.0,40,34,6,35.0,30.0,5.0
9612335,7,2,5,8,1,6,25,114,2.0,2.0,0.0,0.0,0.0,2.0,13.0,18,7,11,11.0,5.0,6.0
9601222,4,3,1,1,0,4,19,26,0.0,0.0,0.0,0.0,0.0,0.0,0.0,53,4,49,15.0,0.0,15.0
8251,1,1,0,0,1,0,0,12,0.0,0.0,0.0,0.0,0.0,0.0,0.0,13,1,12,10.0,0.0,10.0
9609418,10,5,5,5,3,7,16,33,6.0,3.0,3.0,3.0,0.0,6.0,12.0,18,10,8,2.0,2.0,0.0
12044,3,2,1,1,2,1,1,2117,0.0,0.0,0.0,0.0,0.0,0.0,0.0,8,3,5,,,
9909465,4,3,1,1,0,4,55,0,2.0,1.0,1.0,1.0,0.0,2.0,39.0,55,4,51,36.0,1.0,35.0
9901314,14,6,8,18,2,12,51,44,6.0,3.0,3.0,5.0,1.0,5.0,21.0,28,14,14,7.0,5.0,2.0
9503401,11,2,9,14,7,4,9,36,7.0,1.0,6.0,8.0,5.0,2.0,4.0,14,11,3,6.0,6.0,0.0
101078,4,4,0,0,1,3,5,197,2.0,2.0,0.0,0.0,0.0,2.0,4.0,16,4,12,7.0,2.0,5.0
9603449,25,13,12,22,3,22,110,53,12.0,5.0,7.0,12.0,0.0,12.0,92.0,44,25,19,20.0,9.0,11.0
9708254,13,5,8,11,5,8,68,18,0.0,0.0,0.0,0.0,0.0,0.0,0.0,77,13,64,7.0,0.0,7.0
9709318,12,8,4,5,5,7,14,5,1.0,1.0,0.0,0.0,1.0,0.0,0.0,32,12,20,3.0,0.0,3.0
9706359,2,2,0,0,0,2,2,238,1.0,1.0,0.0,0.0,0.0,1.0,1.0,7,2,5,2.0,1.0,1.0
9702236,3,2,1,1,2,1,1,279,1.0,1.0,0.0,0.0,1.0,0.0,0.0,8,3,5,2.0,0.0,2.0
9810381,7,3,4,5,0,7,34,1,1.0,1.0,0.0,0.0,0.0,1.0,2.0,18,7,11,1.0,0.0,1.0
9908268,10,2,8,21,1,9,17,34,9.0,2.0,7.0,18.0,1.0,8.0,16.0,13,10,3,1.0,1.0,0.0
9808423,7,3,4,6,2,5,13,5,0.0,0.0,0.0,0.0,0.0,0.0,0.0,21,7,14,7.0,0.0,7.0
207179,1,1,0,0,0,1,7,29,1.0,1.0,0.0,0.0,0.0,1.0,4.0,33,1,32,9.0,0.0,9.0
9912410,6,3,3,7,0,6,27,8,3.0,3.0,0.0,0.0,0.0,3.0,11.0,19,6,13,9.0,3.0,6.0
11339,3,3,0,0,0,3,6,224,1.0,1.0,0.0,0.0,0.0,1.0,2.0,18,3,15,5.0,1.0,4.0
10151,8,2,6,8,1,7,52,18,4.0,3.0,1.0,1.0,1.0,3.0,15.0,28,8,20,10.0,3.0,7.0
8161,4,3,1,1,2,2,11,57,1.0,1.0,0.0,0.0,0.0,1.0,9.0,16,4,12,8.0,1.0,7.0
9604280,16,3,13,35,16,0,0,222,13.0,1.0,12.0,34.0,13.0,0.0,0.0,16,16,0,10.0,10.0,0.0
204006,4,1,3,4,0,4,12,282,4.0,1.0,3.0,4.0,0.0,4.0,12.0,8,4,4,8.0,4.0,4.0
102039,2,2,0,0,0,2,6,186,2.0,2.0,0.0,0.0,0.0,2.0,6.0,7,2,5,6.0,2.0,4.0
9309307,8,7,1,1,8,0,0,241,2.0,2.0,0.0,0.0,2.0,0.0,0.0,8,8,0,2.0,2.0,0.0
9709261,8,4,4,6,3,5,18,135,0.0,0.0,0.0,0.0,0.0,0.0,0.0,21,8,13,8.0,0.0,8.0
9509407,3,1,2,3,0,3,7,5,2.0,1.0,1.0,1.0,2.0,0.0,0.0,6,3,3,2.0,2.0,0.0
9903410,4,2,2,2,0,4,20,8,2.0,1.0,1.0,1.0,0.0,2.0,5.0,17,4,13,5.0,2.0,3.0
9507292,1,1,0,0,1,0,0,391,0.0,0.0,0.0,0.0,0.0,0.0,0.0,2,1,1,1.0,0.0,1.0
9712215,6,2,4,6,2,4,6,314,4.0,1.0,3.0,4.0,0.0,4.0,4.0,9,6,3,5.0,4.0,1.0
9808350,1,1,0,0,1,0,0,12,0.0,0.0,0.0,0.0,0.0,0.0,0.0,24,1,23,5.0,0.0,5.0
9611233,1,1,0,0,0,1,1,14,1.0,1.0,0.0,0.0,0.0,1.0,1.0,6,1,5,1.0,0.0,1.0
9308341,5,4,1,1,4,1,1,40,1.0,1.0,0.0,0.0,1.0,0.0,0.0,6,5,1,3.0,3.0,0.0
9910393,8,1,7,20,0,8,19,294,8.0,1.0,7.0,20.0,0.0,8.0,16.0,12,8,4,11.0,8.0,3.0
2021,4,2,2,2,0,4,35,46,2.0,1.0,1.0,1.0,0.0,2.0,15.0,16,4,12,7.0,0.0,7.0
9811475,3,3,0,0,0,3,19,6,2.0,2.0,0.0,0.0,0.0,2.0,16.0,18,3,15,3.0,0.0,3.0
9811276,9,7,2,2,3,6,16,59,1.0,1.0,0.0,0.0,0.0,1.0,2.0,24,9,15,3.0,1.0,2.0
6292,5,5,0,0,1,4,10,14,1.0,1.0,0.0,0.0,0.0,1.0,4.0,28,5,23,10.0,1.0,9.0
9710410,6,3,3,3,1,5,15,68,2.0,2.0,0.0,0.0,0.0,2.0,5.0,26,6,20,5.0,0.0,5.0
9805490,2,1,1,1,1,1,4,97,2.0,1.0,1.0,1.0,1.0,1.0,3.0,10,2,8,3.0,0.0,3.0
9711473,9,4,5,7,3,6,20,12,0.0,0.0,0.0,0.0,0.0,0.0,0.0,30,9,21,5.0,0.0,5.0
9507404,0,0,0,0,0,0,0,198,0.0,0.0,0.0,0.0,0.0,0.0,0.0,4,0,4,3.0,0.0,3.0
9903251,10,4,6,13,0,10,31,56,8.0,3.0,5.0,11.0,0.0,8.0,28.0,19,10,9,3.0,1.0,2.0
9812303,4,2,2,2,0,4,30,56,4.0,2.0,2.0,2.0,0.0,4.0,27.0,16,4,12,11.0,3.0,8.0
108002,20,2,18,53,0,20,160,37,14.0,1.0,13.0,40.0,0.0,14.0,108.0,52,20,32,23.0,14.0,9.0
9906423,20,10,10,15,5,15,22,9,13.0,8.0,5.0,6.0,1.0,12.0,19.0,22,20,2,12.0,11.0,1.0
1174,20,10,10,30,0,20,138,32,8.0,3.0,5.0,15.0,0.0,8.0,76.0,46,20,26,5.0,0.0,5.0
9411304,6,3,3,4,2,4,4,38,4.0,2.0,2.0,2.0,2.0,2.0,2.0,9,6,3,5.0,4.0,1.0
9911420,3,3,0,0,1,2,3,64,1.0,1.0,0.0,0.0,0.0,1.0,1.0,16,3,13,2.0,1.0,1.0
9807373,6,4,2,2,0,6,27,12,2.0,2.0,0.0,0.0,0.0,2.0,7.0,29,6,23,12.0,2.0,10.0
9707415,4,2,2,2,0,4,24,15,2.0,1.0,1.0,1.0,0.0,2.0,17.0,42,4,38,20.0,1.0,19.0
9411363,2,2,0,0,1,1,5,25,1.0,1.0,0.0,0.0,0.0,1.0,3.0,9,2,7,3.0,1.0,2.0
9511241,1,1,0,0,0,1,3,183,1.0,1.0,0.0,0.0,0.0,1.0,3.0,6,1,5,3.0,1.0,2.0
206076,3,2,1,2,0,3,21,8,1.0,1.0,0.0,0.0,0.0,1.0,12.0,27,3,24,5.0,2.0,3.0
9504318,6,4,2,2,5,1,1,142,2.0,2.0,0.0,0.0,1.0,1.0,1.0,8,6,2,3.0,2.0,1.0
9407289,21,4,17,40,16,5,6,70,8.0,3.0,5.0,8.0,5.0,3.0,3.0,25,21,4,4.0,4.0,0.0
9712436,2,1,1,1,0,2,4,191,1.0,1.0,0.0,0.0,0.0,1.0,3.0,6,2,4,4.0,1.0,3.0
9609274,2,2,0,0,0,2,7,150,1.0,1.0,0.0,0.0,0.0,1.0,4.0,11,2,9,7.0,1.0,6.0
9502268,8,6,2,4,8,0,0,28,4.0,2.0,2.0,4.0,4.0,0.0,0.0,8,8,0,3.0,3.0,0.0
9902338,5,1,4,6,0,5,49,17,5.0,1.0,4.0,6.0,0.0,5.0,49.0,19,5,14,1.0,1.0,0.0
9707427,1,1,0,0,0,1,3,297,0.0,0.0,0.0,0.0,0.0,0.0,0.0,5,1,4,2.0,0.0,2.0
9710298,6,4,2,2,1,5,12,85,5.0,4.0,1.0,1.0,1.0,4.0,11.0,11,6,5,7.0,3.0,4.0
9605442,5,3,2,2,4,1,1,391,3.0,2.0,1.0,1.0,2.0,1.0,1.0,6,5,1,3.0,2.0,1.0
211147,5,4,1,1,0,5,16,73,3.0,2.0,1.0,1.0,0.0,3.0,6.0,19,5,14,6.0,2.0,4.0
5162,8,4,4,9,0,8,51,73,7.0,3.0,4.0,9.0,0.0,7.0,50.0,17,8,9,15.0,6.0,9.0
9304256,9,5,4,5,4,5,5,15,2.0,2.0,0.0,0.0,2.0,0.0,0.0,10,9,1,1.0,1.0,0.0
9404275,3,2,1,1,3,0,0,274,1.0,1.0,0.0,0.0,1.0,0.0,0.0,3,3,0,1.0,1.0,0.0
9812442,5,3,2,2,5,0,0,272,4.0,2.0,2.0,2.0,4.0,0.0,0.0,5,5,0,3.0,3.0,0.0
9810441,8,3,5,12,0,8,75,67,6.0,3.0,3.0,7.0,0.0,6.0,57.0,36,8,28,19.0,5.0,14.0
9510412,3,1,2,3,0,3,20,61,1.0,1.0,0.0,0.0,0.0,1.0,7.0,35,3,32,1.0,0.0,1.0
7186,9,4,5,7,0,9,29,50,7.0,2.0,5.0,7.0,0.0,7.0,24.0,14,9,5,3.0,3.0,0.0
9604400,3,3,0,0,0,3,5,0,1.0,1.0,0.0,0.0,1.0,0.0,0.0,12,3,9,2.0,1.0,1.0
203159,8,3,5,9,0,8,46,95,1.0,1.0,0.0,0.0,0.0,1.0,4.0,30,8,22,5.0,2.0,3.0
9811508,3,2,1,1,0,3,6,238,2.0,1.0,1.0,1.0,0.0,2.0,3.0,10,3,7,3.0,2.0,1.0
9909253,5,4,1,2,4,1,1,130,1.0,1.0,0.0,0.0,1.0,0.0,0.0,6,5,1,1.0,1.0,0.0
9809233,1,1,0,0,0,1,2,187,1.0,1.0,0.0,0.0,0.0,1.0,2.0,3,1,2,2.0,1.0,1.0
9809333,4,4,0,0,0,4,9,182,1.0,1.0,0.0,0.0,0.0,1.0,4.0,15,4,11,2.0,2.0,0.0
9512222,0,0,0,0,0,0,0,652,0.0,0.0,0.0,0.0,0.0,0.0,0.0,4,0,4,1.0,0.0,1.0
9901376,23,4,19,63,4,19,72,127,16.0,2.0,14.0,49.0,3.0,13.0,32.0,41,23,18,18.0,15.0,3.0
9304213,1,1,0,0,1,0,0,93,0.0,0.0,0.0,0.0,0.0,0.0,0.0,3,1,2,1.0,1.0,0.0
9511327,11,2,9,9,3,8,41,10,6.0,1.0,5.0,5.0,1.0,5.0,25.0,24,11,13,11.0,4.0,7.0
9804239,13,9,4,4,0,13,49,22,7.0,7.0,0.0,0.0,0.0,7.0,28.0,21,13,8,11.0,4.0,7.0
204334,4,2,2,4,0,4,24,22,3.0,1.0,2.0,3.0,0.0,3.0,18.0,17,4,13,12.0,4.0,8.0
9809461,1,1,0,0,0,1,8,40,1.0,1.0,0.0,0.0,0.0,1.0,7.0,10,1,9,,,
6300,4,4,0,0,0,4,17,43,1.0,1.0,0.0,0.0,0.0,1.0,4.0,30,4,26,2.0,1.0,1.0
9803265,6,2,4,7,1,5,13,48,5.0,1.0,4.0,7.0,0.0,5.0,12.0,15,6,9,4.0,1.0,3.0
4143,19,10,9,14,1,18,70,9,9.0,3.0,6.0,10.0,0.0,9.0,37.0,32,19,13,15.0,10.0,5.0
9908522,3,2,1,1,0,3,12,9,3.0,2.0,1.0,1.0,0.0,3.0,6.0,8,3,5,5.0,3.0,2.0
103023,15,11,4,6,4,11,63,28,9.0,7.0,2.0,2.0,0.0,9.0,46.0,50,15,35,15.0,8.0,7.0
9706335,2,2,0,0,0,2,5,141,1.0,1.0,0.0,0.0,0.0,1.0,2.0,8,2,6,2.0,1.0,1.0
9810352,1,1,0,0,0,1,3,70,1.0,1.0,0.0,0.0,0.0,1.0,2.0,11,1,10,,,
204008,7,2,5,6,3,4,5,0,2.0,1.0,1.0,1.0,1.0,1.0,1.0,10,7,3,3.0,2.0,1.0
9906358,10,6,4,6,0,10,22,8,5.0,3.0,2.0,3.0,0.0,5.0,13.0,23,10,13,12.0,3.0,9.0
9809450,5,3,2,2,0,5,17,8,2.0,1.0,1.0,1.0,0.0,2.0,4.0,11,5,6,7.0,2.0,5.0
9411280,4,4,0,0,0,4,12,26,4.0,4.0,0.0,0.0,0.0,4.0,11.0,9,4,5,6.0,2.0,4.0
105234,8,2,6,8,6,2,3,51,5.0,1.0,4.0,4.0,5.0,0.0,0.0,10,8,2,4.0,4.0,0.0
209333,1,1,0,0,0,1,2,3,0.0,0.0,0.0,0.0,0.0,0.0,0.0,22,1,21,3.0,0.0,3.0
207110,9,6,3,4,0,9,94,3,7.0,4.0,3.0,4.0,0.0,7.0,47.0,38,9,29,9.0,3.0,6.0
5061,1,1,0,0,0,1,1,503,0.0,0.0,0.0,0.0,0.0,0.0,0.0,8,1,7,5.0,0.0,5.0
9809300,6,1,5,8,1,5,9,51,2.0,2.0,0.0,0.0,1.0,1.0,1.0,10,6,4,7.0,5.0,2.0
9304231,1,1,0,0,1,0,0,1845,,,,,,,,1,1,0,,,
9502255,14,1,13,28,3,11,42,35,6.0,1.0,5.0,9.0,0.0,6.0,21.0,22,14,8,8.0,6.0,2.0
9809430,3,1,2,3,0,3,5,189,3.0,1.0,2.0,3.0,0.0,3.0,5.0,5,3,2,5.0,3.0,2.0
9904409,10,3,7,18,0,10,44,112,10.0,3.0,7.0,18.0,0.0,10.0,41.0,20,10,10,18.0,10.0,8.0
212071,2,2,0,0,1,1,2,1,0.0,0.0,0.0,0.0,0.0,0.0,0.0,24,2,22,6.0,0.0,6.0
209181,1,1,0,0,0,1,2,64,1.0,1.0,0.0,0.0,1.0,0.0,0.0,15,1,14,2.0,0.0,2.0
208171,2,2,0,0,0,2,11,33,1.0,1.0,0.0,0.0,0.0,1.0,4.0,22,2,20,3.0,1.0,2.0
9803416,5,3,2,2,0,5,19,212,4.0,3.0,1.0,1.0,0.0,4.0,7.0,12,5,7,5.0,3.0,2.0
9310368,3,2,1,1,2,1,2,358,2.0,1.0,1.0,1.0,2.0,0.0,0.0,10,3,7,2.0,2.0,0.0
9912434,23,13,10,16,9,14,26,65,13.0,5.0,8.0,14.0,2.0,11.0,15.0,29,23,6,13.0,10.0,3.0
9410354,8,4,4,5,7,1,1,542,3.0,3.0,0.0,0.0,3.0,0.0,0.0,9,8,1,2.0,2.0,0.0
9702412,16,4,12,23,3,13,51,12,11.0,1.0,10.0,18.0,0.0,11.0,42.0,29,16,13,1.0,1.0,0.0
9038,18,5,13,34,3,15,37,57,10.0,1.0,9.0,23.0,0.0,10.0,11.0,32,18,14,11.0,10.0,1.0
9803467,5,2,3,6,4,1,2,101,4.0,1.0,3.0,6.0,4.0,0.0,0.0,8,5,3,4.0,4.0,0.0
2192,6,2,4,9,6,0,0,205,4.0,1.0,3.0,6.0,4.0,0.0,0.0,6,6,0,4.0,4.0,0.0
11080,1,1,0,0,0,1,2,241,0.0,0.0,0.0,0.0,0.0,0.0,0.0,6,1,5,5.0,0.0,5.0
9507335,9,2,7,18,3,6,6,103,8.0,1.0,7.0,18.0,2.0,6.0,6.0,10,9,1,6.0,5.0,1.0
9301225,15,6,9,17,15,0,0,93,11.0,5.0,6.0,9.0,11.0,0.0,0.0,15,15,0,8.0,8.0,0.0
9509278,9,2,7,14,0,9,37,35,7.0,1.0,6.0,13.0,0.0,7.0,23.0,17,9,8,11.0,7.0,4.0
105189,1,1,0,0,0,1,12,21,0.0,0.0,0.0,0.0,0.0,0.0,0.0,25,1,24,2.0,0.0,2.0
9808218,5,3,2,4,0,5,17,83,5.0,3.0,2.0,4.0,0.0,5.0,14.0,12,5,7,7.0,4.0,3.0
9707441,3,3,0,0,0,3,11,9,1.0,1.0,0.0,0.0,0.0,1.0,4.0,24,3,21,3.0,0.0,3.0
9705379,1,1,0,0,1,0,0,141,,,,,,,,2,1,1,,,
201088,1,1,0,0,0,1,8,11,0.0,0.0,0.0,0.0,0.0,0.0,0.0,27,1,26,1.0,0.0,1.0
9509307,3,3,0,0,3,0,0,643,2.0,2.0,0.0,0.0,2.0,0.0,0.0,3,3,0,2.0,2.0,0.0
110045,6,3,3,4,0,6,40,2,3.0,2.0,1.0,1.0,0.0,3.0,9.0,23,6,17,8.0,4.0,4.0
203182,4,3,1,1,0,4,34,12,3.0,2.0,1.0,1.0,0.0,3.0,27.0,50,4,46,12.0,3.0,9.0
105260,15,5,10,20,0,15,133,7,2.0,2.0,0.0,0.0,0.0,2.0,27.0,61,15,46,10.0,4.0,6.0
108250,6,2,4,6,2,4,199,23,4.0,1.0,3.0,5.0,0.0,4.0,96.0,94,6,88,43.0,4.0,39.0
9810473,5,4,1,1,0,5,30,136,4.0,3.0,1.0,1.0,0.0,4.0,28.0,27,5,22,15.0,4.0,11.0
111304,0,0,0,0,0,0,0,1341,0.0,0.0,0.0,0.0,0.0,0.0,0.0,2,0,2,,,
9606278,3,2,1,1,3,0,0,325,3.0,2.0,1.0,1.0,3.0,0.0,0.0,7,3,4,2.0,2.0,0.0
102320,8,6,2,3,0,8,14,82,4.0,2.0,2.0,3.0,1.0,3.0,6.0,23,8,15,3.0,3.0,0.0
9710443,1,1,0,0,1,0,0,252,0.0,0.0,0.0,0.0,0.0,0.0,0.0,4,1,3,1.0,0.0,1.0
9806282,14,7,7,7,1,13,50,48,3.0,3.0,0.0,0.0,0.0,3.0,12.0,34,14,20,14.0,2.0,12.0
109139,4,3,1,1,0,4,25,9,3.0,3.0,0.0,0.0,0.0,3.0,23.0,24,4,20,10.0,2.0,8.0
207219,2,1,1,1,0,2,12,62,2.0,1.0,1.0,1.0,0.0,2.0,11.0,17,2,15,13.0,2.0,11.0
206071,16,5,11,33,3,13,80,2,12.0,3.0,9.0,29.0,0.0,12.0,40.0,42,16,26,18.0,10.0,8.0
112278,23,5,18,38,0,23,215,18,14.0,2.0,12.0,30.0,0.0,14.0,138.0,49,23,26,27.0,13.0,14.0
9609499,1,1,0,0,0,1,1,156,1.0,1.0,0.0,0.0,0.0,1.0,1.0,3,1,2,1.0,1.0,0.0
9708404,2,2,0,0,1,1,1,2023,1.0,1.0,0.0,0.0,1.0,0.0,0.0,11,2,9,1.0,1.0,0.0
107222,6,3,3,5,0,6,77,68,6.0,3.0,3.0,5.0,0.0,6.0,52.0,31,6,25,17.0,5.0,12.0
12014,5,2,3,6,0,5,27,66,4.0,2.0,2.0,4.0,0.0,4.0,9.0,16,5,11,1.0,0.0,1.0
9912344,7,6,1,1,1,6,23,2,2.0,2.0,0.0,0.0,0.0,2.0,3.0,14,7,7,2.0,2.0,0.0
112312,2,2,0,0,0,2,4,23,0.0,0.0,0.0,0.0,0.0,0.0,0.0,133,2,131,34.0,0.0,34.0
9907361,3,2,1,1,1,2,3,212,2.0,1.0,1.0,1.0,1.0,1.0,2.0,10,3,7,4.0,0.0,4.0
9902347,3,3,0,0,1,2,4,403,0.0,0.0,0.0,0.0,0.0,0.0,0.0,20,3,17,2.0,0.0,2.0
207254,2,1,1,1,0,2,17,28,2.0,1.0,1.0,1.0,0.0,2.0,6.0,15,2,13,3.0,0.0,3.0
9610520,2,1,1,1,0,2,4,222,2.0,1.0,1.0,1.0,0.0,2.0,4.0,5,2,3,3.0,1.0,2.0
9905374,7,5,2,2,0,7,48,40,3.0,2.0,1.0,1.0,0.0,3.0,33.0,55,7,48,17.0,1.0,16.0
9512275,3,3,0,0,0,3,10,53,1.0,1.0,0.0,0.0,0.0,1.0,1.0,14,3,11,3.0,0.0,3.0
9511459,2,2,0,0,0,2,2,281,2.0,2.0,0.0,0.0,0.0,2.0,2.0,6,2,4,1.0,0.0,1.0
9509431,4,3,1,1,2,2,5,134,1.0,1.0,0.0,0.0,1.0,0.0,0.0,8,4,4,2.0,1.0,1.0
9703289,6,5,1,1,0,6,24,10,5.0,5.0,0.0,0.0,0.0,5.0,15.0,28,6,22,10.0,3.0,7.0
9603239,10,6,4,5,1,9,21,6,6.0,5.0,1.0,1.0,6.0,0.0,0.0,21,10,11,8.0,5.0,3.0
9903546,3,2,1,1,3,0,0,25,0.0,0.0,0.0,0.0,0.0,0.0,0.0,23,3,20,4.0,0.0,4.0
9505431,2,2,0,0,0,2,2,251,1.0,1.0,0.0,0.0,0.0,1.0,1.0,3,2,1,3.0,2.0,1.0
9712240,9,4,5,7,7,2,2,139,4.0,3.0,1.0,1.0,4.0,0.0,0.0,10,9,1,4.0,4.0,0.0
9807274,1,1,0,0,0,1,2,232,0.0,0.0,0.0,0.0,0.0,0.0,0.0,4,1,3,1.0,0.0,1.0
11221,5,1,4,6,0,5,21,25,5.0,1.0,4.0,6.0,4.0,1.0,1.0,15,5,10,10.0,5.0,5.0
9712370,4,2,2,2,4,0,0,188,3.0,1.0,2.0,2.0,3.0,0.0,0.0,5,4,1,3.0,3.0,0.0
108006,2,2,0,0,0,2,7,158,0.0,0.0,0.0,0.0,0.0,0.0,0.0,12,2,10,2.0,1.0,1.0
9808225,12,4,8,14,2,10,34,84,10.0,2.0,8.0,13.0,0.0,10.0,34.0,22,12,10,11.0,5.0,6.0
201005,6,4,2,4,0,6,12,65,4.0,3.0,1.0,2.0,0.0,4.0,8.0,14,6,8,2.0,0.0,2.0
9601301,3,3,0,0,1,2,7,8,0.0,0.0,0.0,0.0,0.0,0.0,0.0,23,3,20,2.0,0.0,2.0
9407333,1,1,0,0,0,1,1,317,1.0,1.0,0.0,0.0,0.0,1.0,1.0,5,1,4,3.0,1.0,2.0
9603248,11,4,7,13,8,3,3,160,9.0,4.0,5.0,10.0,7.0,2.0,2.0,12,11,1,4.0,3.0,1.0
9706328,3,2,1,1,1,2,9,82,2.0,1.0,1.0,1.0,0.0,2.0,9.0,14,3,11,9.0,1.0,8.0
9912395,2,1,1,1,0,2,11,44,2.0,1.0,1.0,1.0,0.0,2.0,6.0,13,2,11,6.0,2.0,4.0
9511370,1,1,0,0,0,1,1,127,,,,,,,,5,1,4,,,
4236,6,3,3,4,0,6,18,236,4.0,2.0,2.0,2.0,0.0,4.0,15.0,14,6,8,9.0,4.0,5.0
9505286,2,1,1,1,2,0,0,44,,,,,,,,3,2,1,,,
9707513,8,2,6,6,0,8,19,123,5.0,3.0,2.0,2.0,0.0,5.0,11.0,22,8,14,8.0,4.0,4.0
9407216,7,4,3,6,7,0,0,326,5.0,3.0,2.0,3.0,5.0,0.0,0.0,7,7,0,2.0,2.0,0.0
208085,1,1,0,0,0,1,11,20,1.0,1.0,0.0,0.0,0.0,1.0,10.0,15,1,14,6.0,1.0,5.0
211266,4,4,0,0,0,4,55,0,3.0,3.0,0.0,0.0,0.0,3.0,42.0,24,4,20,20.0,3.0,17.0
9334,1,1,0,0,1,0,0,122,1.0,1.0,0.0,0.0,1.0,0.0,0.0,3,1,2,1.0,1.0,0.0
2191,3,2,1,1,0,3,62,4,2.0,1.0,1.0,1.0,0.0,2.0,35.0,40,3,37,21.0,2.0,19.0
112172,6,6,0,0,1,5,42,5,3.0,3.0,0.0,0.0,0.0,3.0,35.0,31,6,25,21.0,3.0,18.0
103308,7,1,6,12,0,7,82,2,6.0,1.0,5.0,10.0,0.0,6.0,59.0,31,7,24,18.0,7.0,11.0
210183,3,2,1,1,0,3,11,7,1.0,1.0,0.0,0.0,0.0,1.0,4.0,36,3,33,13.0,0.0,13.0
9601299,4,3,1,2,0,4,6,233,1.0,1.0,0.0,0.0,0.0,1.0,1.0,7,4,3,4.0,2.0,2.0
9605455,5,2,3,3,4,1,1,449,1.0,1.0,0.0,0.0,0.0,1.0,1.0,6,5,1,3.0,3.0,0.0
9507384,3,2,1,2,2,1,8,75,1.0,1.0,0.0,0.0,0.0,1.0,1.0,13,3,10,3.0,1.0,2.0
204275,8,5,3,4,0,8,41,20,6.0,4.0,2.0,3.0,0.0,6.0,37.0,21,8,13,6.0,3.0,3.0
9312289,2,2,0,0,2,0,0,271,1.0,1.0,0.0,0.0,1.0,0.0,0.0,2,2,0,1.0,1.0,0.0
9704232,8,5,3,5,0,8,27,69,6.0,4.0,2.0,4.0,0.0,6.0,21.0,21,8,13,8.0,4.0,4.0
9504428,3,3,0,0,1,2,3,78,1.0,1.0,0.0,0.0,0.0,1.0,2.0,8,3,5,2.0,1.0,1.0
9403207,1,1,0,0,0,1,1,186,1.0,1.0,0.0,0.0,1.0,0.0,0.0,7,1,6,2.0,1.0,1.0
101031,7,4,3,5,2,5,24,8,0.0,0.0,0.0,0.0,0.0,0.0,0.0,30,7,23,4.0,1.0,3.0
111166,4,1,3,4,0,4,29,6,4.0,1.0,3.0,4.0,0.0,4.0,28.0,23,4,19,6.0,3.0,3.0
9412251,5,3,2,3,5,0,0,91,3.0,3.0,0.0,0.0,3.0,0.0,0.0,5,5,0,2.0,2.0,0.0
201015,1,1,0,0,0,1,5,78,0.0,0.0,0.0,0.0,0.0,0.0,0.0,13,1,12,4.0,1.0,3.0
9504350,4,4,0,0,4,0,0,385,3.0,3.0,0.0,0.0,3.0,0.0,0.0,4,4,0,3.0,3.0,0.0
201159,2,2,0,0,1,1,4,51,1.0,1.0,0.0,0.0,1.0,0.0,0.0,14,2,12,3.0,1.0,2.0
9410394,3,1,2,3,3,0,0,236,3.0,1.0,2.0,3.0,3.0,0.0,0.0,4,3,1,1.0,0.0,1.0
9812484,3,2,1,1,0,3,6,109,3.0,2.0,1.0,1.0,0.0,3.0,6.0,11,3,8,6.0,3.0,3.0
202228,2,1,1,1,0,2,11,58,2.0,1.0,1.0,1.0,0.0,2.0,7.0,17,2,15,7.0,2.0,5.0
112265,4,3,1,1,2,2,5,106,0.0,0.0,0.0,0.0,0.0,0.0,0.0,20,4,16,3.0,0.0,3.0
9610491,1,1,0,0,0,1,1,962,1.0,1.0,0.0,0.0,1.0,0.0,0.0,2,1,1,,,
9809208,1,1,0,0,1,0,0,242,0.0,0.0,0.0,0.0,0.0,0.0,0.0,7,1,6,3.0,0.0,3.0
9810392,10,4,6,9,8,2,2,110,6.0,2.0,4.0,7.0,6.0,0.0,0.0,12,10,2,6.0,6.0,0.0
106218,1,1,0,0,0,1,4,27,,,,,,,,5,1,4,,,
9410241,2,2,0,0,2,0,0,447,1.0,1.0,0.0,0.0,1.0,0.0,0.0,2,2,0,1.0,1.0,0.0
207278,4,3,1,1,1,3,4,92,1.0,1.0,0.0,0.0,1.0,0.0,0.0,11,4,7,2.0,0.0,2.0
9611235,1,1,0,0,0,1,1,59,0.0,0.0,0.0,0.0,0.0,0.0,0.0,7,1,6,1.0,1.0,0.0
9506445,15,6,9,19,7,8,11,52,12.0,4.0,8.0,17.0,7.0,5.0,5.0,18,15,3,4.0,4.0,0.0
9611263,1,1,0,0,0,1,4,40,1.0,1.0,0.0,0.0,0.0,1.0,4.0,6,1,5,2.0,0.0,2.0
104292,3,2,1,1,1,2,8,55,1.0,1.0,0.0,0.0,0.0,1.0,6.0,19,3,16,2.0,1.0,1.0
9903420,7,4,3,3,3,4,11,31,2.0,1.0,1.0,1.0,0.0,2.0,7.0,29,7,22,5.0,3.0,2.0
202204,6,2,4,5,0,6,75,32,4.0,2.0,2.0,2.0,0.0,4.0,37.0,46,6,40,9.0,3.0,6.0
9312267,11,5,6,8,11,0,0,186,5.0,1.0,4.0,5.0,5.0,0.0,0.0,11,11,0,4.0,4.0,0.0
9601331,2,2,0,0,0,2,2,61,0.0,0.0,0.0,0.0,0.0,0.0,0.0,18,2,16,10.0,0.0,10.0
9507254,2,2,0,0,2,0,0,264,1.0,1.0,0.0,0.0,1.0,0.0,0.0,2,2,0,,,
9708225,0,0,0,0,0,0,0,2080,0.0,0.0,0.0,0.0,0.0,0.0,0.0,5,0,5,4.0,0.0,4.0
3239,7,3,4,7,2,5,17,256,4.0,1.0,3.0,6.0,0.0,4.0,16.0,12,7,5,8.0,4.0,4.0
5305,2,1,1,1,2,0,0,30,0.0,0.0,0.0,0.0,0.0,0.0,0.0,19,2,17,10.0,0.0,10.0
112104,8,3,5,9,0,8,28,0,4.0,2.0,2.0,3.0,0.0,4.0,11.0,20,8,12,10.0,6.0,4.0
9912394,4,4,0,0,2,2,4,18,3.0,3.0,0.0,0.0,3.0,0.0,0.0,7,4,3,2.0,1.0,1.0
202154,3,2,1,1,0,3,45,7,2.0,1.0,1.0,1.0,0.0,2.0,25.0,47,3,44,14.0,2.0,12.0
207056,9,7,2,4,0,9,71,2,2.0,2.0,0.0,0.0,0.0,2.0,23.0,46,9,37,7.0,1.0,6.0
110056,6,2,4,6,1,5,12,129,5.0,2.0,3.0,5.0,0.0,5.0,9.0,18,6,12,7.0,4.0,3.0
9904445,2,2,0,0,0,2,7,23,0.0,0.0,0.0,0.0,0.0,0.0,0.0,16,2,14,1.0,1.0,0.0
202221,1,1,0,0,1,0,0,335,1.0,1.0,0.0,0.0,1.0,0.0,0.0,5,1,4,2.0,1.0,1.0
9812325,4,2,2,2,2,2,19,12,3.0,1.0,2.0,2.0,3.0,0.0,0.0,30,4,26,3.0,1.0,2.0
9705375,1,1,0,0,0,1,1,505,1.0,1.0,0.0,0.0,0.0,1.0,1.0,4,1,3,1.0,0.0,1.0
112050,5,1,4,5,5,0,0,17,1.0,1.0,0.0,0.0,1.0,0.0,0.0,6,5,1,4.0,4.0,0.0
1164,5,4,1,1,0,5,12,22,3.0,2.0,1.0,1.0,1.0,2.0,3.0,15,5,10,2.0,1.0,1.0
207300,6,4,2,5,0,6,57,108,6.0,4.0,2.0,5.0,0.0,6.0,56.0,20,6,14,13.0,5.0,8.0
202140,4,2,2,2,3,1,1,249,2.0,1.0,1.0,1.0,2.0,0.0,0.0,7,4,3,3.0,3.0,0.0
204142,8,2,6,12,0,8,38,146,8.0,2.0,6.0,12.0,0.0,8.0,38.0,23,8,15,15.0,7.0,8.0
9609334,2,1,1,1,0,2,6,35,2.0,1.0,1.0,1.0,0.0,2.0,6.0,10,2,8,4.0,1.0,3.0
9805439,6,6,0,0,1,5,16,7,1.0,1.0,0.0,0.0,0.0,1.0,2.0,22,6,16,3.0,1.0,2.0
9911311,12,1,11,34,0,12,82,8,7.0,1.0,6.0,15.0,0.0,7.0,38.0,24,12,12,15.0,8.0,7.0
11205,4,2,2,3,0,4,16,163,2.0,2.0,0.0,0.0,0.0,2.0,8.0,14,4,10,7.0,2.0,5.0
11131,0,0,0,0,0,0,0,138,0.0,0.0,0.0,0.0,0.0,0.0,0.0,6,0,6,1.0,0.0,1.0
11100,1,1,0,0,0,1,3,236,,,,,,,,7,1,6,3.0,1.0,2.0
9708492,0,0,0,0,0,0,0,87,0.0,0.0,0.0,0.0,0.0,0.0,0.0,7,0,7,,,
9408320,4,2,2,2,1,3,3,75,,,,,,,,5,4,1,2.0,1.0,1.0
208106,2,1,1,1,1,1,1,23,0.0,0.0,0.0,0.0,0.0,0.0,0.0,5,2,3,2.0,0.0,2.0
9810403,3,3,0,0,1,2,2,233,2.0,2.0,0.0,0.0,0.0,2.0,2.0,4,3,1,2.0,1.0,1.0
206036,1,1,0,0,0,1,5,25,1.0,1.0,0.0,0.0,0.0,1.0,2.0,10,1,9,7.0,1.0,6.0
102168,7,4,3,4,0,7,29,7,1.0,1.0,0.0,0.0,0.0,1.0,2.0,24,7,17,3.0,0.0,3.0
9903366,1,1,0,0,0,1,13,1,0.0,0.0,0.0,0.0,0.0,0.0,0.0,20,1,19,2.0,1.0,1.0
9808386,5,3,2,2,0,5,22,299,2.0,1.0,1.0,1.0,0.0,2.0,7.0,19,5,14,10.0,3.0,7.0
9702388,4,4,0,0,1,3,3,271,3.0,3.0,0.0,0.0,1.0,2.0,2.0,5,4,1,3.0,2.0,1.0
9910404,4,2,2,3,3,1,3,1,0.0,0.0,0.0,0.0,0.0,0.0,0.0,57,4,53,3.0,3.0,0.0
12025,2,1,1,1,2,0,0,80,0.0,0.0,0.0,0.0,0.0,0.0,0.0,12,2,10,3.0,0.0,3.0
10159,9,5,4,10,0,9,65,24,1.0,1.0,0.0,0.0,0.0,1.0,3.0,30,9,21,6.0,1.0,5.0
109222,3,1,2,3,0,3,4,308,3.0,1.0,2.0,3.0,0.0,3.0,3.0,10,3,7,4.0,3.0,1.0
9606225,2,1,1,1,0,2,2,435,2.0,1.0,1.0,1.0,0.0,2.0,2.0,6,2,4,3.0,1.0,2.0
9810375,1,1,0,0,0,1,3,74,1.0,1.0,0.0,0.0,0.0,1.0,1.0,4,1,3,2.0,0.0,2.0
9509364,2,2,0,0,1,1,1,319,1.0,1.0,0.0,0.0,0.0,1.0,1.0,4,2,2,2.0,1.0,1.0
9612435,11,6,5,7,0,11,37,105,8.0,4.0,4.0,5.0,1.0,7.0,14.0,21,11,10,8.0,3.0,5.0
9312225,7,6,1,1,5,2,2,346,3.0,3.0,0.0,0.0,3.0,0.0,0.0,12,7,5,3.0,3.0,0.0
9606262,1,1,0,0,0,1,5,30,1.0,1.0,0.0,0.0,0.0,1.0,5.0,15,1,14,5.0,1.0,4.0
9411416,2,2,0,0,1,1,1,116,1.0,1.0,0.0,0.0,0.0,1.0,1.0,4,2,2,,,
2098,4,3,1,1,0,4,6,171,4.0,3.0,1.0,1.0,0.0,4.0,5.0,9,4,5,4.0,3.0,1.0
2024,16,9,7,11,4,12,29,63,10.0,6.0,4.0,5.0,0.0,10.0,22.0,28,16,12,4.0,3.0,1.0
9907321,1,1,0,0,0,1,4,100,1.0,1.0,0.0,0.0,0.0,1.0,1.0,11,1,10,1.0,1.0,0.0
112227,1,1,0,0,0,1,4,171,1.0,1.0,0.0,0.0,0.0,1.0,4.0,11,1,10,9.0,1.0,8.0
103150,4,1,3,3,1,3,6,72,2.0,1.0,1.0,1.0,0.0,2.0,3.0,9,4,5,4.0,2.0,2.0
9904285,8,2,6,10,0,8,32,82,8.0,2.0,6.0,10.0,0.0,8.0,28.0,13,8,5,11.0,7.0,4.0
109279,2,2,0,0,0,2,6,102,2.0,2.0,0.0,0.0,0.0,2.0,6.0,10,2,8,5.0,2.0,3.0
112319,0,0,0,0,0,0,0,0,0.0,0.0,0.0,0.0,0.0,0.0,0.0,13,0,13,1.0,0.0,1.0
12016,2,2,0,0,0,2,3,189,2.0,2.0,0.0,0.0,0.0,2.0,2.0,4,2,2,2.0,1.0,1.0
9710231,1,1,0,0,1,0,0,156,0.0,0.0,0.0,0.0,0.0,0.0,0.0,7,1,6,5.0,0.0,5.0
9507330,5,3,2,2,5,0,0,82,1.0,1.0,0.0,0.0,1.0,0.0,0.0,5,5,0,1.0,1.0,0.0
101043,3,3,0,0,0,3,24,2,2.0,2.0,0.0,0.0,0.0,2.0,13.0,26,3,23,17.0,2.0,15.0
210242,0,0,0,0,0,0,0,28,0.0,0.0,0.0,0.0,0.0,0.0,0.0,12,0,12,,,
9801245,6,3,3,5,1,5,9,228,4.0,2.0,2.0,2.0,0.0,4.0,7.0,8,6,2,7.0,5.0,2.0
9911518,2,2,0,0,0,2,24,6,2.0,2.0,0.0,0.0,0.0,2.0,12.0,20,2,18,8.0,2.0,6.0
9804454,11,5,6,9,11,0,0,442,5.0,2.0,3.0,4.0,5.0,0.0,0.0,11,11,0,5.0,5.0,0.0
204212,0,0,0,0,0,0,0,299,0.0,0.0,0.0,0.0,0.0,0.0,0.0,17,0,17,5.0,0.0,5.0
9510407,10,3,7,17,0,10,44,63,8.0,2.0,6.0,15.0,0.0,8.0,32.0,20,10,10,14.0,8.0,6.0
4122,3,3,0,0,0,3,8,119,2.0,2.0,0.0,0.0,0.0,2.0,6.0,15,3,12,11.0,1.0,10.0
211080,5,5,0,0,0,5,39,66,2.0,2.0,0.0,0.0,0.0,2.0,23.0,29,5,24,18.0,2.0,16.0
9811506,1,1,0,0,0,1,2,1,0.0,0.0,0.0,0.0,0.0,0.0,0.0,47,1,46,16.0,0.0,16.0
9602408,2,2,0,0,2,0,0,600,1.0,1.0,0.0,0.0,1.0,0.0,0.0,2,2,0,1.0,1.0,0.0
201045,1,1,0,0,0,1,10,32,1.0,1.0,0.0,0.0,0.0,1.0,10.0,23,1,22,2.0,0.0,2.0
8307,1,1,0,0,0,1,2,292,1.0,1.0,0.0,0.0,0.0,1.0,2.0,7,1,6,5.0,1.0,4.0
8037,3,2,1,1,0,3,15,2,0.0,0.0,0.0,0.0,0.0,0.0,0.0,18,3,15,1.0,1.0,0.0
9805499,5,2,3,3,0,5,28,76,4.0,2.0,2.0,2.0,0.0,4.0,21.0,15,5,10,9.0,2.0,7.0
12003,5,2,3,5,3,2,2,58,3.0,1.0,2.0,2.0,1.0,2.0,2.0,9,5,4,4.0,3.0,1.0
9710532,1,1,0,0,0,1,1,668,0.0,0.0,0.0,0.0,0.0,0.0,0.0,3,1,2,1.0,0.0,1.0
9611216,1,1,0,0,0,1,4,14,,,,,,,,5,1,4,1.0,0.0,1.0
9909323,1,1,0,0,1,0,0,247,1.0,1.0,0.0,0.0,1.0,0.0,0.0,1,1,0,1.0,1.0,0.0
9611288,4,4,0,0,1,3,27,53,2.0,2.0,0.0,0.0,0.0,2.0,22.0,20,4,16,14.0,1.0,13.0
209269,6,3,3,4,0,6,96,11,6.0,3.0,3.0,4.0,0.0,6.0,96.0,56,6,50,31.0,5.0,26.0
9708323,3,2,1,1,0,3,15,195,0.0,0.0,0.0,0.0,0.0,0.0,0.0,11,3,8,5.0,0.0,5.0
11165,6,2,4,7,0,6,17,156,5.0,2.0,3.0,5.0,0.0,5.0,13.0,13,6,7,8.0,5.0,3.0
9265,10,5,5,10,0,10,29,31,6.0,2.0,4.0,7.0,0.0,6.0,15.0,19,10,9,6.0,4.0,2.0
3123,10,3,7,12,0,10,119,8,5.0,2.0,3.0,6.0,0.0,5.0,56.0,51,10,41,18.0,3.0,15.0
9710548,1,1,0,0,1,0,0,272,1.0,1.0,0.0,0.0,1.0,0.0,0.0,5,1,4,2.0,0.0,2.0
9806238,2,2,0,0,0,2,4,40,1.0,1.0,0.0,0.0,1.0,0.0,0.0,5,2,3,,,
9311212,4,2,2,3,3,1,1,320,1.0,1.0,0.0,0.0,0.0,1.0,1.0,9,4,5,3.0,3.0,0.0
9808342,7,4,3,3,2,5,7,242,3.0,3.0,0.0,0.0,2.0,1.0,1.0,14,7,7,4.0,1.0,3.0
205156,6,4,2,2,1,5,8,132,6.0,4.0,2.0,2.0,1.0,5.0,8.0,9,6,3,8.0,6.0,2.0
9605332,7,3,4,4,6,1,1,137,3.0,1.0,2.0,2.0,3.0,0.0,0.0,8,7,1,5.0,4.0,1.0
9709400,2,2,0,0,0,2,11,17,1.0,1.0,0.0,0.0,0.0,1.0,6.0,16,2,14,1.0,0.0,1.0
204139,3,2,1,1,1,2,12,31,1.0,1.0,0.0,0.0,0.0,1.0,8.0,19,3,16,7.0,2.0,5.0
9705247,1,1,0,0,1,0,0,140,0.0,0.0,0.0,0.0,0.0,0.0,0.0,4,1,3,2.0,0.0,2.0
301279,0,0,0,0,0,0,0,53,0.0,0.0,0.0,0.0,0.0,0.0,0.0,23,0,23,23.0,0.0,23.0
9608267,2,2,0,0,2,0,0,271,2.0,2.0,0.0,0.0,2.0,0.0,0.0,2,2,0,1.0,1.0,0.0
9702303,1,1,0,0,0,1,2,13,1.0,1.0,0.0,0.0,0.0,1.0,1.0,11,1,10,2.0,1.0,1.0
209049,0,0,0,0,0,0,0,74,0.0,0.0,0.0,0.0,0.0,0.0,0.0,14,0,14,11.0,0.0,11.0
9510217,3,3,0,0,3,0,0,35,0.0,0.0,0.0,0.0,0.0,0.0,0.0,4,3,1,,,
9405315,0,0,0,0,0,0,0,131,,,,,,,,2,0,2,,,
9807507,2,2,0,0,0,2,6,1,0.0,0.0,0.0,0.0,0.0,0.0,0.0,8,2,6,1.0,1.0,0.0
12094,2,2,0,0,0,2,11,30,1.0,1.0,0.0,0.0,0.0,1.0,8.0,17,2,15,8.0,1.0,7.0
211375,1,1,0,0,0,1,6,0,0.0,0.0,0.0,0.0,0.0,0.0,0.0,11,1,10,6.0,0.0,6.0
207224,5,3,2,2,0,5,38,127,3.0,1.0,2.0,2.0,0.0,3.0,20.0,23,5,18,13.0,3.0,10.0
9910259,8,2,6,14,2,6,12,49,8.0,2.0,6.0,14.0,2.0,6.0,12.0,15,8,7,3.0,1.0,2.0
9511332,2,2,0,0,0,2,3,302,1.0,1.0,0.0,0.0,0.0,1.0,1.0,4,2,2,1.0,1.0,0.0
9707295,2,2,0,0,1,1,1,53,0.0,0.0,0.0,0.0,0.0,0.0,0.0,11,2,9,2.0,0.0,2.0
9304203,6,3,3,3,6,0,0,206,3.0,2.0,1.0,1.0,3.0,0.0,0.0,7,6,1,4.0,4.0,0.0
1007,2,2,0,0,2,0,0,105,,,,,,,,5,2,3,,,
112055,2,1,1,1,0,2,4,29,1.0,1.0,0.0,0.0,0.0,1.0,1.0,5,2,3,2.0,1.0,1.0
9911265,4,2,2,3,2,2,2,8,2.0,2.0,0.0,0.0,2.0,0.0,0.0,7,4,3,2.0,1.0,1.0
205271,3,2,1,1,0,3,27,21,3.0,2.0,1.0,1.0,0.0,3.0,24.0,36,3,33,14.0,3.0,11.0
8076,8,7,1,1,0,8,24,89,7.0,6.0,1.0,1.0,1.0,6.0,6.0,18,8,10,5.0,4.0,1.0
206126,1,1,0,0,0,1,5,139,1.0,1.0,0.0,0.0,0.0,1.0,3.0,8,1,7,2.0,1.0,1.0
9906299,8,4,4,6,5,3,3,236,5.0,2.0,3.0,4.0,2.0,3.0,3.0,12,8,4,6.0,4.0,2.0
209158,11,8,3,3,0,11,65,37,5.0,3.0,2.0,2.0,0.0,5.0,38.0,43,11,32,14.0,4.0,10.0
9807343,3,3,0,0,3,0,0,350,2.0,2.0,0.0,0.0,2.0,0.0,0.0,3,3,0,1.0,1.0,0.0
9712452,4,2,2,2,1,3,18,110,3.0,1.0,2.0,2.0,0.0,3.0,15.0,17,4,13,12.0,3.0,9.0
9405369,2,1,1,1,0,2,2,323,2.0,1.0,1.0,1.0,1.0,1.0,1.0,4,2,2,3.0,2.0,1.0
9912378,4,4,0,0,1,3,13,101,3.0,3.0,0.0,0.0,0.0,3.0,12.0,21,4,17,6.0,0.0,6.0
11146,11,4,7,8,2,9,19,89,2.0,2.0,0.0,0.0,2.0,0.0,0.0,23,11,12,5.0,5.0,0.0
9705412,6,2,4,8,2,4,13,41,2.0,2.0,0.0,0.0,0.0,2.0,10.0,14,6,8,2.0,2.0,0.0
211171,1,1,0,0,1,0,0,25,0.0,0.0,0.0,0.0,0.0,0.0,0.0,6,1,5,4.0,0.0,4.0
209006,4,2,2,2,0,4,84,7,3.0,1.0,2.0,2.0,0.0,3.0,65.0,51,4,47,24.0,3.0,21.0
9908494,0,0,0,0,0,0,0,89,0.0,0.0,0.0,0.0,0.0,0.0,0.0,4,0,4,1.0,0.0,1.0
9608395,1,1,0,0,0,1,1,291,1.0,1.0,0.0,0.0,1.0,0.0,0.0,10,1,9,4.0,0.0,4.0
9711206,7,3,4,8,2,5,9,91,6.0,2.0,4.0,8.0,1.0,5.0,9.0,10,7,3,4.0,4.0,0.0
9702217,0,0,0,0,0,0,0,21,0.0,0.0,0.0,0.0,0.0,0.0,0.0,33,0,33,5.0,0.0,5.0
9510423,1,1,0,0,1,0,0,564,1.0,1.0,0.0,0.0,1.0,0.0,0.0,1,1,0,1.0,1.0,0.0
9811359,1,1,0,0,1,0,0,208,1.0,1.0,0.0,0.0,1.0,0.0,0.0,7,1,6,1.0,0.0,1.0
9709414,0,0,0,0,0,0,0,1127,0.0,0.0,0.0,0.0,0.0,0.0,0.0,1,0,1,1.0,0.0,1.0
12156,4,3,1,1,0,4,33,12,0.0,0.0,0.0,0.0,0.0,0.0,0.0,80,4,76,15.0,1.0,14.0
101175,2,1,1,1,2,0,0,8,0.0,0.0,0.0,0.0,0.0,0.0,0.0,9,2,7,1.0,1.0,0.0
11068,1,1,0,0,0,1,1,50,1.0,1.0,0.0,0.0,0.0,1.0,1.0,5,1,4,1.0,0.0,1.0
210078,4,4,0,0,0,4,26,20,3.0,3.0,0.0,0.0,0.0,3.0,25.0,26,4,22,7.0,3.0,4.0
9901313,1,1,0,0,0,1,8,11,1.0,1.0,0.0,0.0,0.0,1.0,6.0,9,1,8,1.0,0.0,1.0
9403372,1,1,0,0,1,0,0,179,0.0,0.0,0.0,0.0,0.0,0.0,0.0,7,1,6,2.0,0.0,2.0
6177,3,3,0,0,0,3,16,15,1.0,1.0,0.0,0.0,0.0,1.0,9.0,34,3,31,4.0,1.0,3.0
9804289,1,1,0,0,1,0,0,156,0.0,0.0,0.0,0.0,0.0,0.0,0.0,4,1,3,1.0,0.0,1.0
211228,4,3,1,1,0,4,31,46,2.0,1.0,1.0,1.0,0.0,2.0,21.0,30,4,26,4.0,1.0,3.0
9801335,2,1,1,1,1,1,5,17,,,,,,,,11,2,9,2.0,2.0,0.0
9809422,2,1,1,1,0,2,5,69,1.0,1.0,0.0,0.0,0.0,1.0,3.0,6,2,4,1.0,1.0,0.0
9807342,3,3,0,0,1,2,2,180,3.0,3.0,0.0,0.0,1.0,2.0,2.0,5,3,2,5.0,3.0,2.0
111040,3,2,1,1,1,2,2,72,1.0,1.0,0.0,0.0,1.0,0.0,0.0,11,3,8,3.0,1.0,2.0
110101,1,1,0,0,0,1,1,65,1.0,1.0,0.0,0.0,0.0,1.0,1.0,7,1,6,2.0,1.0,1.0
209281,1,1,0,0,0,1,2,106,0.0,0.0,0.0,0.0,0.0,0.0,0.0,8,1,7,5.0,0.0,5.0
207138,0,0,0,0,0,0,0,53,0.0,0.0,0.0,0.0,0.0,0.0,0.0,16,0,16,14.0,0.0,14.0
111270,0,0,0,0,0,0,0,260,0.0,0.0,0.0,0.0,0.0,0.0,0.0,12,0,12,7.0,0.0,7.0
9510400,0,0,0,0,0,0,0,24,0.0,0.0,0.0,0.0,0.0,0.0,0.0,8,0,8,1.0,0.0,1.0
302173,3,2,1,1,0,3,5,50,1.0,1.0,0.0,0.0,0.0,1.0,1.0,18,3,15,4.0,2.0,2.0
105014,6,6,0,0,0,6,105,23,4.0,4.0,0.0,0.0,0.0,4.0,87.0,69,6,63,32.0,1.0,31.0
201014,2,2,0,0,1,1,18,18,1.0,1.0,0.0,0.0,0.0,1.0,9.0,21,2,19,9.0,1.0,8.0
9501401,1,1,0,0,1,0,0,134,0.0,0.0,0.0,0.0,0.0,0.0,0.0,7,1,6,2.0,0.0,2.0
112080,2,2,0,0,0,2,4,505,1.0,1.0,0.0,0.0,0.0,1.0,2.0,8,2,6,3.0,1.0,2.0
9206249,5,5,0,0,5,0,0,407,4.0,4.0,0.0,0.0,4.0,0.0,0.0,5,5,0,3.0,3.0,0.0
208265,2,2,0,0,0,2,9,11,1.0,1.0,0.0,0.0,0.0,1.0,1.0,8,2,6,2.0,1.0,1.0
8130,0,0,0,0,0,0,0,47,0.0,0.0,0.0,0.0,0.0,0.0,0.0,5,0,5,1.0,0.0,1.0
9505290,1,1,0,0,1,0,0,675,1.0,1.0,0.0,0.0,1.0,0.0,0.0,1,1,0,1.0,1.0,0.0
10173,0,0,0,0,0,0,0,20,,,,,,,,14,0,14,,,
9812218,0,0,0,0,0,0,0,98,,,,,,,,1,0,1,,,
9406331,3,2,1,1,2,1,1,163,2.0,1.0,1.0,1.0,1.0,1.0,1.0,5,3,2,,,
8154,2,1,1,1,1,1,1,150,0.0,0.0,0.0,0.0,0.0,0.0,0.0,10,2,8,2.0,0.0,2.0
104213,4,2,2,2,0,4,49,8,3.0,2.0,1.0,1.0,0.0,3.0,31.0,39,4,35,15.0,3.0,12.0
107093,1,1,0,0,0,1,3,27,0.0,0.0,0.0,0.0,0.0,0.0,0.0,15,1,14,2.0,1.0,1.0
9607387,1,1,0,0,0,1,5,6,0.0,0.0,0.0,0.0,0.0,0.0,0.0,11,1,10,4.0,0.0,4.0
205181,2,2,0,0,1,1,1,186,0.0,0.0,0.0,0.0,0.0,0.0,0.0,9,2,7,1.0,0.0,1.0
203184,5,2,3,5,0,5,22,11,4.0,1.0,3.0,5.0,0.0,4.0,4.0,24,5,19,3.0,1.0,2.0
110197,1,1,0,0,0,1,6,20,0.0,0.0,0.0,0.0,0.0,0.0,0.0,20,1,19,3.0,1.0,2.0
11302,1,1,0,0,1,0,0,754,0.0,0.0,0.0,0.0,0.0,0.0,0.0,5,1,4,2.0,0.0,2.0
9712241,0,0,0,0,0,0,0,340,0.0,0.0,0.0,0.0,0.0,0.0,0.0,3,0,3,2.0,0.0,2.0
9303209,2,1,1,1,2,0,0,320,2.0,1.0,1.0,1.0,2.0,0.0,0.0,2,2,0,2.0,2.0,0.0
110316,1,1,0,0,0,1,16,7,1.0,1.0,0.0,0.0,0.0,1.0,8.0,28,1,27,9.0,1.0,8.0
9407210,0,0,0,0,0,0,0,596,0.0,0.0,0.0,0.0,0.0,0.0,0.0,1,0,1,1.0,0.0,1.0
9303298,1,1,0,0,1,0,0,1464,,,,,,,,1,1,0,1.0,1.0,0.0
212253,0,0,0,0,0,0,0,65,,,,,,,,3,0,3,,,
212199,3,2,1,1,0,3,60,28,3.0,2.0,1.0,1.0,0.0,3.0,49.0,63,3,60,32.0,3.0,29.0
208270,0,0,0,0,0,0,0,3,0.0,0.0,0.0,0.0,0.0,0.0,0.0,15,0,15,5.0,0.0,5.0
3283,0,0,0,0,0,0,0,482,0.0,0.0,0.0,0.0,0.0,0.0,0.0,7,0,7,3.0,0.0,3.0
7027,2,2,0,0,0,2,3,91,2.0,2.0,0.0,0.0,0.0,2.0,3.0,4,2,2,4.0,2.0,2.0
9708494,0,0,0,0,0,0,0,61,0.0,0.0,0.0,0.0,0.0,0.0,0.0,10,0,10,7.0,0.0,7.0
3036,1,1,0,0,0,1,3,0,0.0,0.0,0.0,0.0,0.0,0.0,0.0,19,1,18,5.0,0.0,5.0
104102,2,2,0,0,1,1,2,83,1.0,1.0,0.0,0.0,0.0,1.0,1.0,7,2,5,2.0,1.0,1.0
209036,0,0,0,0,0,0,0,2,0.0,0.0,0.0,0.0,0.0,0.0,0.0,30,0,30,16.0,0.0,16.0
9903539,3,2,1,1,2,1,3,96,3.0,2.0,1.0,1.0,2.0,1.0,2.0,9,3,6,5.0,1.0,4.0
9909573,1,1,0,0,0,1,1,375,1.0,1.0,0.0,0.0,0.0,1.0,1.0,3,1,2,2.0,1.0,1.0
9709422,2,2,0,0,1,1,1,328,1.0,1.0,0.0,0.0,0.0,1.0,1.0,5,2,3,2.0,1.0,1.0
9605278,2,2,0,0,2,0,0,145,0.0,0.0,0.0,0.0,0.0,0.0,0.0,4,2,2,2.0,1.0,1.0
210237,0,0,0,0,0,0,0,9,0.0,0.0,0.0,0.0,0.0,0.0,0.0,11,0,11,7.0,0.0,7.0
205263,2,2,0,0,0,2,8,1,1.0,1.0,0.0,0.0,0.0,1.0,5.0,23,2,21,8.0,1.0,7.0
208184,2,2,0,0,0,2,6,261,2.0,2.0,0.0,0.0,0.0,2.0,6.0,6,2,4,6.0,2.0,4.0
107247,1,1,0,0,0,1,5,66,0.0,0.0,0.0,0.0,0.0,0.0,0.0,38,1,37,3.0,0.0,3.0
9510354,0,0,0,0,0,0,0,1595,,,,,,,,1,0,1,1.0,0.0,1.0
6113,1,1,0,0,0,1,1,133,1.0,1.0,0.0,0.0,0.0,1.0,1.0,4,1,3,2.0,1.0,1.0
9409359,0,0,0,0,0,0,0,6,,,,,,,,5,0,5,1.0,0.0,1.0
105101,3,2,1,1,0,3,17,206,3.0,2.0,1.0,1.0,0.0,3.0,13.0,25,3,22,9.0,3.0,6.0
301235,0,0,0,0,0,0,0,79,0.0,0.0,0.0,0.0,0.0,0.0,0.0,6,0,6,1.0,0.0,1.0
112118,6,1,5,9,0,6,12,221,5.0,1.0,4.0,6.0,0.0,5.0,9.0,10,6,4,7.0,5.0,2.0
2295,3,3,0,0,0,3,20,251,2.0,2.0,0.0,0.0,0.0,2.0,2.0,11,3,8,8.0,2.0,6.0
9512416,0,0,0,0,0,0,0,18,0.0,0.0,0.0,0.0,0.0,0.0,0.0,13,0,13,1.0,0.0,1.0
9043,3,2,1,1,2,1,6,128,0.0,0.0,0.0,0.0,0.0,0.0,0.0,11,3,8,1.0,0.0,1.0
212341,2,1,1,1,0,2,11,73,2.0,1.0,1.0,1.0,0.0,2.0,2.0,20,2,18,1.0,0.0,1.0
301090,0,0,0,0,0,0,0,71,0.0,0.0,0.0,0.0,0.0,0.0,0.0,8,0,8,4.0,0.0,4.0
5282,2,2,0,0,1,1,3,198,1.0,1.0,0.0,0.0,0.0,1.0,3.0,10,2,8,5.0,1.0,4.0
9510234,1,1,0,0,0,1,4,436,1.0,1.0,0.0,0.0,0.0,1.0,1.0,5,1,4,2.0,1.0,1.0
9909233,2,2,0,0,1,1,5,26,2.0,2.0,0.0,0.0,2.0,0.0,0.0,32,2,30,2.0,1.0,1.0
9410370,2,2,0,0,0,2,5,90,2.0,2.0,0.0,0.0,0.0,2.0,4.0,10,2,8,4.0,1.0,3.0
210233,1,1,0,0,0,1,2,85,1.0,1.0,0.0,0.0,0.0,1.0,1.0,10,1,9,6.0,1.0,5.0
10154,1,1,0,0,0,1,13,20,1.0,1.0,0.0,0.0,0.0,1.0,11.0,21,1,20,2.0,0.0,2.0
106129,0,0,0,0,0,0,0,2,0.0,0.0,0.0,0.0,0.0,0.0,0.0,23,0,23,12.0,0.0,12.0
301122,0,0,0,0,0,0,0,177,0.0,0.0,0.0,0.0,0.0,0.0,0.0,3,0,3,1.0,0.0,1.0
9507260,2,2,0,0,1,1,1,255,0.0,0.0,0.0,0.0,0.0,0.0,0.0,3,2,1,1.0,0.0,1.0
211049,0,0,0,0,0,0,0,20,0.0,0.0,0.0,0.0,0.0,0.0,0.0,16,0,16,1.0,0.0,1.0
211460,0,0,0,0,0,0,0,31,0.0,0.0,0.0,0.0,0.0,0.0,0.0,13,0,13,4.0,0.0,4.0
206251,0,0,0,0,0,0,0,23,0.0,0.0,0.0,0.0,0.0,0.0,0.0,33,0,33,5.0,0.0,5.0
111365,0,0,0,0,0,0,0,42,0.0,0.0,0.0,0.0,0.0,0.0,0.0,9,0,9,5.0,0.0,5.0
206153,0,0,0,0,0,0,0,1391,,,,,,,,1,0,1,1.0,0.0,1.0
9910302,0,0,0,0,0,0,0,50,0.0,0.0,0.0,0.0,0.0,0.0,0.0,4,0,4,2.0,0.0,2.0
9905288,1,1,0,0,1,0,0,9,0.0,0.0,0.0,0.0,0.0,0.0,0.0,6,1,5,3.0,0.0,3.0
209358,1,1,0,0,0,1,1,73,0.0,0.0,0.0,0.0,0.0,0.0,0.0,10,1,9,1.0,0.0,1.0
9811210,1,1,0,0,0,1,1,150,1.0,1.0,0.0,0.0,1.0,0.0,0.0,5,1,4,1.0,0.0,1.0
9409217,1,1,0,0,1,0,0,399,0.0,0.0,0.0,0.0,0.0,0.0,0.0,3,1,2,3.0,1.0,2.0
9904204,1,1,0,0,0,1,3,111,1.0,1.0,0.0,0.0,0.0,1.0,2.0,6,1,5,3.0,1.0,2.0
301051,0,0,0,0,0,0,0,62,0.0,0.0,0.0,0.0,0.0,0.0,0.0,12,0,12,7.0,0.0,7.0
101319,5,2,3,3,1,4,15,76,3.0,2.0,1.0,1.0,1.0,2.0,5.0,14,5,9,7.0,3.0,4.0
9902387,0,0,0,0,0,0,0,322,0.0,0.0,0.0,0.0,0.0,0.0,0.0,1,0,1,1.0,0.0,1.0
9908441,1,1,0,0,1,0,0,688,1.0,1.0,0.0,0.0,1.0,0.0,0.0,1,1,0,1.0,1.0,0.0
112292,1,1,0,0,0,1,4,226,1.0,1.0,0.0,0.0,0.0,1.0,2.0,7,1,6,3.0,1.0,2.0
9411322,1,1,0,0,1,0,0,218,1.0,1.0,0.0,0.0,1.0,0.0,0.0,1,1,0,1.0,1.0,0.0
9812243,6,4,2,2,3,3,3,166,2.0,2.0,0.0,0.0,2.0,0.0,0.0,9,6,3,1.0,1.0,0.0
204356,0,0,0,0,0,0,0,179,0.0,0.0,0.0,0.0,0.0,0.0,0.0,2,0,2,1.0,0.0,1.0
9811512,1,1,0,0,1,0,0,427,1.0,1.0,0.0,0.0,1.0,0.0,0.0,3,1,2,1.0,0.0,1.0
106137,1,1,0,0,0,1,3,33,1.0,1.0,0.0,0.0,0.0,1.0,1.0,6,1,5,5.0,1.0,4.0
103029,2,2,0,0,0,2,8,107,1.0,1.0,0.0,0.0,0.0,1.0,3.0,18,2,16,4.0,1.0,3.0
9211236,0,0,0,0,0,0,0,164,,,,,,,,1,0,1,,,
9707486,1,1,0,0,0,1,3,36,0.0,0.0,0.0,0.0,0.0,0.0,0.0,11,1,10,1.0,0.0,1.0
9409389,1,1,0,0,0,1,1,245,1.0,1.0,0.0,0.0,1.0,0.0,0.0,3,1,2,1.0,0.0,1.0
9807338,2,2,0,0,0,2,3,207,1.0,1.0,0.0,0.0,0.0,1.0,1.0,6,2,4,3.0,1.0,2.0
302187,0,0,0,0,0,0,0,83,0.0,0.0,0.0,0.0,0.0,0.0,0.0,11,0,11,3.0,0.0,3.0
10055,1,1,0,0,0,1,4,44,1.0,1.0,0.0,0.0,0.0,1.0,4.0,7,1,6,2.0,1.0,1.0
301114,0,0,0,0,0,0,0,25,0.0,0.0,0.0,0.0,0.0,0.0,0.0,8,0,8,5.0,0.0,5.0
9910475,1,1,0,0,1,0,0,105,0.0,0.0,0.0,0.0,0.0,0.0,0.0,6,1,5,1.0,1.0,0.0
9305263,1,1,0,0,1,0,0,108,,,,,,,,1,1,0,,,
9908277,1,1,0,0,0,1,1,1,0.0,0.0,0.0,0.0,0.0,0.0,0.0,13,1,12,2.0,0.0,2.0
9510458,0,0,0,0,0,0,0,5,0.0,0.0,0.0,0.0,0.0,0.0,0.0,17,0,17,9.0,0.0,9.0
302036,0,0,0,0,0,0,0,28,0.0,0.0,0.0,0.0,0.0,0.0,0.0,30,0,30,16.0,0.0,16.0
8332,0,0,0,0,0,0,0,1877,,,,,,,,2,0,2,,,
206223,3,1,2,2,0,3,19,165,3.0,1.0,2.0,2.0,0.0,3.0,19.0,21,3,18,16.0,2.0,14.0
211162,1,1,0,0,0,1,3,14,0.0,0.0,0.0,0.0,0.0,0.0,0.0,10,1,9,2.0,0.0,2.0
105241,0,0,0,0,0,0,0,44,0.0,0.0,0.0,0.0,0.0,0.0,0.0,6,0,6,3.0,0.0,3.0
212081,0,0,0,0,0,0,0,14,,,,,,,,9,0,9,2.0,0.0,2.0
211164,0,0,0,0,0,0,0,62,0.0,0.0,0.0,0.0,0.0,0.0,0.0,14,0,14,13.0,0.0,13.0
9912269,0,0,0,0,0,0,0,107,0.0,0.0,0.0,0.0,0.0,0.0,0.0,4,0,4,1.0,0.0,1.0
102250,1,1,0,0,0,1,4,100,1.0,1.0,0.0,0.0,0.0,1.0,4.0,10,1,9,7.0,1.0,6.0
9310370,1,1,0,0,1,0,0,269,1.0,1.0,0.0,0.0,1.0,0.0,0.0,1,1,0,1.0,1.0,0.0
212093,2,2,0,0,0,2,8,82,2.0,2.0,0.0,0.0,0.0,2.0,8.0,10,2,8,2.0,0.0,2.0
109271,1,1,0,0,0,1,1,39,0.0,0.0,0.0,0.0,0.0,0.0,0.0,4,1,3,2.0,0.0,2.0
101079,0,0,0,0,0,0,0,4,0.0,0.0,0.0,0.0,0.0,0.0,0.0,9,0,9,6.0,0.0,6.0
9811400,2,1,1,1,0,2,7,115,1.0,1.0,0.0,0.0,0.0,1.0,4.0,14,2,12,3.0,1.0,2.0
9802255,0,0,0,0,0,0,0,520,0.0,0.0,0.0,0.0,0.0,0.0,0.0,1,0,1,1.0,0.0,1.0
9506373,0,0,0,0,0,0,0,258,0.0,0.0,0.0,0.0,0.0,0.0,0.0,8,0,8,,,
201017,2,1,1,1,0,2,4,232,1.0,1.0,0.0,0.0,0.0,1.0,1.0,21,2,19,2.0,0.0,2.0
106131,1,1,0,0,0,1,23,29,1.0,1.0,0.0,0.0,0.0,1.0,13.0,27,1,26,14.0,1.0,13.0
1183,0,0,0,0,0,0,0,83,0.0,0.0,0.0,0.0,0.0,0.0,0.0,30,0,30,2.0,0.0,2.0
109039,0,0,0,0,0,0,0,17,0.0,0.0,0.0,0.0,0.0,0.0,0.0,10,0,10,2.0,0.0,2.0
1184,2,1,1,1,0,2,8,147,2.0,1.0,1.0,1.0,0.0,2.0,8.0,9,2,7,7.0,2.0,5.0
112173,0,0,0,0,0,0,0,98,,,,,,,,5,0,5,,,
9409397,0,0,0,0,0,0,0,29,,,,,,,,4,0,4,1.0,0.0,1.0
9705313,1,1,0,0,0,1,1,159,0.0,0.0,0.0,0.0,0.0,0.0,0.0,3,1,2,2.0,0.0,2.0
206224,0,0,0,0,0,0,0,126,0.0,0.0,0.0,0.0,0.0,0.0,0.0,4,0,4,3.0,0.0,3.0
112029,1,1,0,0,0,1,13,20,1.0,1.0,0.0,0.0,0.0,1.0,12.0,16,1,15,2.0,0.0,2.0
8175,0,0,0,0,0,0,0,8,0.0,0.0,0.0,0.0,0.0,0.0,0.0,8,0,8,,,
105232,1,1,0,0,0,1,2,110,1.0,1.0,0.0,0.0,0.0,1.0,1.0,4,1,3,2.0,1.0,1.0
111388,1,1,0,0,0,1,2,72,1.0,1.0,0.0,0.0,0.0,1.0,2.0,7,1,6,2.0,0.0,2.0
110408,0,0,0,0,0,0,0,31,0.0,0.0,0.0,0.0,0.0,0.0,0.0,6,0,6,1.0,0.0,1.0
207270,0,0,0,0,0,0,0,26,0.0,0.0,0.0,0.0,0.0,0.0,0.0,10,0,10,2.0,0.0,2.0
3314,0,0,0,0,0,0,0,121,0.0,0.0,0.0,0.0,0.0,0.0,0.0,8,0,8,6.0,0.0,6.0
9810428,3,3,0,0,2,1,4,21,3.0,3.0,0.0,0.0,2.0,1.0,2.0,16,3,13,4.0,2.0,2.0
10120,1,1,0,0,1,0,0,699,1.0,1.0,0.0,0.0,1.0,0.0,0.0,1,1,0,1.0,1.0,0.0
12267,3,1,2,3,0,3,18,83,3.0,1.0,2.0,3.0,0.0,3.0,9.0,19,3,16,7.0,3.0,4.0
9907302,0,0,0,0,0,0,0,227,0.0,0.0,0.0,0.0,0.0,0.0,0.0,7,0,7,7.0,0.0,7.0
6298,0,0,0,0,0,0,0,6,0.0,0.0,0.0,0.0,0.0,0.0,0.0,22,0,22,9.0,0.0,9.0
204230,1,1,0,0,0,1,4,186,1.0,1.0,0.0,0.0,0.0,1.0,4.0,15,1,14,10.0,1.0,9.0
9604324,0,0,0,0,0,0,0,54,0.0,0.0,0.0,0.0,0.0,0.0,0.0,7,0,7,1.0,0.0,1.0
9611379,0,0,0,0,0,0,0,139,0.0,0.0,0.0,0.0,0.0,0.0,0.0,3,0,3,2.0,0.0,2.0
107285,0,0,0,0,0,0,0,29,0.0,0.0,0.0,0.0,0.0,0.0,0.0,16,0,16,10.0,0.0,10.0
104202,0,0,0,0,0,0,0,6,0.0,0.0,0.0,0.0,0.0,0.0,0.0,19,0,19,7.0,0.0,7.0
9308285,0,0,0,0,0,0,0,29,0.0,0.0,0.0,0.0,0.0,0.0,0.0,4,0,4,,,
206154,2,2,0,0,0,2,15,74,1.0,1.0,0.0,0.0,0.0,1.0,5.0,16,2,14,7.0,1.0,6.0
211196,0,0,0,0,0,0,0,109,0.0,0.0,0.0,0.0,0.0,0.0,0.0,32,0,32,29.0,0.0,29.0
209023,0,0,0,0,0,0,0,348,0.0,0.0,0.0,0.0,0.0,0.0,0.0,7,0,7,2.0,0.0,2.0
9804342,0,0,0,0,0,0,0,820,,,,,,,,1,0,1,,,
102239,1,1,0,0,0,1,4,125,0.0,0.0,0.0,0.0,0.0,0.0,0.0,7,1,6,5.0,0.0,5.0
11362,3,3,0,0,0,3,5,98,3.0,3.0,0.0,0.0,0.0,3.0,5.0,5,3,2,5.0,3.0,2.0
9812291,1,1,0,0,0,1,1,230,1.0,1.0,0.0,0.0,1.0,0.0,0.0,3,1,2,1.0,1.0,0.0
209227,0,0,0,0,0,0,0,149,0.0,0.0,0.0,0.0,0.0,0.0,0.0,3,0,3,1.0,0.0,1.0
9912536,0,0,0,0,0,0,0,43,0.0,0.0,0.0,0.0,0.0,0.0,0.0,6,0,6,2.0,0.0,2.0
108012,1,1,0,0,0,1,11,2,1.0,1.0,0.0,0.0,0.0,1.0,6.0,13,1,12,2.0,1.0,1.0
202180,0,0,0,0,0,0,0,38,0.0,0.0,0.0,0.0,0.0,0.0,0.0,7,0,7,3.0,0.0,3.0
9501412,0,0,0,0,0,0,0,110,0.0,0.0,0.0,0.0,0.0,0.0,0.0,1,0,1,1.0,0.0,1.0
212201,0,0,0,0,0,0,0,88,0.0,0.0,0.0,0.0,0.0,0.0,0.0,7,0,7,2.0,0.0,2.0
9802318,0,0,0,0,0,0,0,451,0.0,0.0,0.0,0.0,0.0,0.0,0.0,3,0,3,3.0,0.0,3.0
9910337,0,0,0,0,0,0,0,22,0.0,0.0,0.0,0.0,0.0,0.0,0.0,13,0,13,10.0,0.0,10.0
9228,0,0,0,0,0,0,0,9,0.0,0.0,0.0,0.0,0.0,0.0,0.0,63,0,63,14.0,0.0,14.0
9402344,0,0,0,0,0,0,0,295,0.0,0.0,0.0,0.0,0.0,0.0,0.0,1,0,1,1.0,0.0,1.0
212314,0,0,0,0,0,0,0,110,0.0,0.0,0.0,0.0,0.0,0.0,0.0,3,0,3,,,
5092,1,1,0,0,0,1,1,27,1.0,1.0,0.0,0.0,1.0,0.0,0.0,9,1,8,1.0,1.0,0.0
208068,1,1,0,0,0,1,6,33,0.0,0.0,0.0,0.0,0.0,0.0,0.0,66,1,65,8.0,0.0,8.0
9707495,3,2,1,1,0,3,10,31,3.0,2.0,1.0,1.0,0.0,3.0,6.0,11,3,8,6.0,3.0,3.0
4080,2,2,0,0,2,0,0,532,1.0,1.0,0.0,0.0,1.0,0.0,0.0,2,2,0,2.0,2.0,0.0
105135,0,0,0,0,0,0,0,140,0.0,0.0,0.0,0.0,0.0,0.0,0.0,5,0,5,2.0,0.0,2.0
210412,0,0,0,0,0,0,0,11,0.0,0.0,0.0,0.0,0.0,0.0,0.0,43,0,43,29.0,0.0,29.0
9811293,1,1,0,0,0,1,2,1250,1.0,1.0,0.0,0.0,0.0,1.0,2.0,4,1,3,2.0,1.0,1.0
9811244,0,0,0,0,0,0,0,1072,,,,,,,,3,0,3,,,
9807217,0,0,0,0,0,0,0,27,0.0,0.0,0.0,0.0,0.0,0.0,0.0,5,0,5,2.0,0.0,2.0
302244,0,0,0,0,0,0,0,169,0.0,0.0,0.0,0.0,0.0,0.0,0.0,9,0,9,2.0,0.0,2.0
9906355,0,0,0,0,0,0,0,17,0.0,0.0,0.0,0.0,0.0,0.0,0.0,24,0,24,1.0,0.0,1.0
210292,0,0,0,0,0,0,0,1808,,,,,,,,4,0,4,,,
102054,1,1,0,0,1,0,0,365,1.0,1.0,0.0,0.0,1.0,0.0,0.0,3,1,2,1.0,1.0,0.0
106249,2,2,0,0,0,2,3,280,0.0,0.0,0.0,0.0,0.0,0.0,0.0,4,2,2,2.0,1.0,1.0
205225,1,1,0,0,0,1,2,18,0.0,0.0,0.0,0.0,0.0,0.0,0.0,43,1,42,4.0,0.0,4.0
205095,1,1,0,0,0,1,3,20,1.0,1.0,0.0,0.0,0.0,1.0,2.0,16,1,15,3.0,0.0,3.0
9502354,0,0,0,0,0,0,0,38,0.0,0.0,0.0,0.0,0.0,0.0,0.0,6,0,6,1.0,0.0,1.0
10182,1,1,0,0,0,1,2,9,0.0,0.0,0.0,0.0,0.0,0.0,0.0,12,1,11,7.0,0.0,7.0
102154,0,0,0,0,0,0,0,77,0.0,0.0,0.0,0.0,0.0,0.0,0.0,5,0,5,,,
9605205,2,2,0,0,0,2,2,71,1.0,1.0,0.0,0.0,0.0,1.0,1.0,4,2,2,3.0,1.0,2.0
212006,0,0,0,0,0,0,0,1753,0.0,0.0,0.0,0.0,0.0,0.0,0.0,4,0,4,,,
104188,0,0,0,0,0,0,0,156,0.0,0.0,0.0,0.0,0.0,0.0,0.0,5,0,5,2.0,0.0,2.0
9903317,1,1,0,0,0,1,6,56,1.0,1.0,0.0,0.0,0.0,1.0,4.0,7,1,6,4.0,1.0,3.0
9607262,0,0,0,0,0,0,0,105,0.0,0.0,0.0,0.0,0.0,0.0,0.0,3,0,3,1.0,0.0,1.0
204323,1,1,0,0,0,1,2,68,1.0,1.0,0.0,0.0,0.0,1.0,1.0,14,1,13,11.0,0.0,11.0
9905322,0,0,0,0,0,0,0,718,0.0,0.0,0.0,0.0,0.0,0.0,0.0,1,0,1,1.0,0.0,1.0
9508328,0,0,0,0,0,0,0,113,0.0,0.0,0.0,0.0,0.0,0.0,0.0,4,0,4,,,
9805285,0,0,0,0,0,0,0,900,0.0,0.0,0.0,0.0,0.0,0.0,0.0,2,0,2,1.0,0.0,1.0
9602402,0,0,0,0,0,0,0,122,0.0,0.0,0.0,0.0,0.0,0.0,0.0,3,0,3,1.0,0.0,1.0
9603254,0,0,0,0,0,0,0,117,0.0,0.0,0.0,0.0,0.0,0.0,0.0,1,0,1,1.0,0.0,1.0
9604293,0,0,0,0,0,0,0,848,0.0,0.0,0.0,0.0,0.0,0.0,0.0,3,0,3,1.0,0.0,1.0
12349,2,1,1,1,0,2,6,216,2.0,1.0,1.0,1.0,0.0,2.0,6.0,7,2,5,6.0,2.0,4.0
9510331,0,0,0,0,0,0,0,194,0.0,0.0,0.0,0.0,0.0,0.0,0.0,4,0,4,4.0,0.0,4.0
201021,0,0,0,0,0,0,0,70,0.0,0.0,0.0,0.0,0.0,0.0,0.0,7,0,7,,,
9706327,0,0,0,0,0,0,0,40,0.0,0.0,0.0,0.0,0.0,0.0,0.0,6,0,6,,,
211381,0,0,0,0,0,0,0,7,0.0,0.0,0.0,0.0,0.0,0.0,0.0,18,0,18,6.0,0.0,6.0
9910217,0,0,0,0,0,0,0,76,,,,,,,,1,0,1,,,
302071,0,0,0,0,0,0,0,65,0.0,0.0,0.0,0.0,0.0,0.0,0.0,5,0,5,3.0,0.0,3.0
209003,0,0,0,0,0,0,0,2,0.0,0.0,0.0,0.0,0.0,0.0,0.0,32,0,32,2.0,0.0,2.0
5192,1,1,0,0,0,1,1,91,0.0,0.0,0.0,0.0,0.0,0.0,0.0,4,1,3,2.0,0.0,2.0
111191,0,0,0,0,0,0,0,87,0.0,0.0,0.0,0.0,0.0,0.0,0.0,6,0,6,5.0,0.0,5.0
9908250,0,0,0,0,0,0,0,168,0.0,0.0,0.0,0.0,0.0,0.0,0.0,3,0,3,3.0,0.0,3.0
9703229,0,0,0,0,0,0,0,1821,0.0,0.0,0.0,0.0,0.0,0.0,0.0,2,0,2,2.0,0.0,2.0
9901452,0,0,0,0,0,0,0,42,,,,,,,,6,0,6,1.0,0.0,1.0
9905438,2,1,1,1,1,1,2,365,1.0,1.0,0.0,0.0,1.0,0.0,0.0,6,2,4,2.0,1.0,1.0
204104,0,0,0,0,0,0,0,2,0.0,0.0,0.0,0.0,0.0,0.0,0.0,30,0,30,1.0,0.0,1.0
9707315,1,1,0,0,0,1,4,17,1.0,1.0,0.0,0.0,0.0,1.0,4.0,16,1,15,4.0,1.0,3.0
9903434,1,1,0,0,0,1,1,556,0.0,0.0,0.0,0.0,0.0,0.0,0.0,3,1,2,3.0,1.0,2.0
9910340,0,0,0,0,0,0,0,0,0.0,0.0,0.0,0.0,0.0,0.0,0.0,35,0,35,22.0,0.0,22.0
9405221,1,1,0,0,1,0,0,509,1.0,1.0,0.0,0.0,1.0,0.0,0.0,1,1,0,1.0,1.0,0.0
210432,0,0,0,0,0,0,0,21,0.0,0.0,0.0,0.0,0.0,0.0,0.0,8,0,8,,,
3060,1,1,0,0,0,1,2,147,1.0,1.0,0.0,0.0,0.0,1.0,2.0,5,1,4,3.0,1.0,2.0
301129,0,0,0,0,0,0,0,113,0.0,0.0,0.0,0.0,0.0,0.0,0.0,12,0,12,9.0,0.0,9.0
9907232,0,0,0,0,0,0,0,167,0.0,0.0,0.0,0.0,0.0,0.0,0.0,6,0,6,1.0,0.0,1.0
301021,0,0,0,0,0,0,0,16,0.0,0.0,0.0,0.0,0.0,0.0,0.0,13,0,13,2.0,0.0,2.0
209206,0,0,0,0,0,0,0,106,,,,,,,,2,0,2,,,
210129,1,1,0,0,1,0,0,185,1.0,1.0,0.0,0.0,1.0,0.0,0.0,1,1,0,1.0,1.0,0.0
110172,0,0,0,0,0,0,0,201,0.0,0.0,0.0,0.0,0.0,0.0,0.0,8,0,8,8.0,0.0,8.0
9910381,0,0,0,0,0,0,0,9,0.0,0.0,0.0,0.0,0.0,0.0,0.0,5,0,5,1.0,0.0,1.0
9609223,0,0,0,0,0,0,0,22,0.0,0.0,0.0,0.0,0.0,0.0,0.0,11,0,11,4.0,0.0,4.0
9711381,0,0,0,0,0,0,0,120,0.0,0.0,0.0,0.0,0.0,0.0,0.0,4,0,4,,,
104093,0,0,0,0,0,0,0,57,0.0,0.0,0.0,0.0,0.0,0.0,0.0,12,0,12,7.0,0.0,7.0
103196,0,0,0,0,0,0,0,1,0.0,0.0,0.0,0.0,0.0,0.0,0.0,9,0,9,1.0,0.0,1.0
9907405,0,0,0,0,0,0,0,69,0.0,0.0,0.0,0.0,0.0,0.0,0.0,5,0,5,4.0,0.0,4.0
9911501,0,0,0,0,0,0,0,281,0.0,0.0,0.0,0.0,0.0,0.0,0.0,7,0,7,4.0,0.0,4.0
103006,0,0,0,0,0,0,0,92,0.0,0.0,0.0,0.0,0.0,0.0,0.0,6,0,6,2.0,0.0,2.0
9508410,0,0,0,0,0,0,0,101,0.0,0.0,0.0,0.0,0.0,0.0,0.0,3,0,3,2.0,0.0,2.0
106150,0,0,0,0,0,0,0,1736,,,,,,,,1,0,1,,,
11101,0,0,0,0,0,0,0,2125,0.0,0.0,0.0,0.0,0.0,0.0,0.0,3,0,3,,,
9708462,0,0,0,0,0,0,0,134,0.0,0.0,0.0,0.0,0.0,0.0,0.0,8,0,8,2.0,0.0,2.0
212055,0,0,0,0,0,0,0,732,0.0,0.0,0.0,0.0,0.0,0.0,0.0,3,0,3,1.0,0.0,1.0
9511202,0,0,0,0,0,0,0,270,0.0,0.0,0.0,0.0,0.0,0.0,0.0,1,0,1,1.0,0.0,1.0
9402230,0,0,0,0,0,0,0,1441,0.0,0.0,0.0,0.0,0.0,0.0,0.0,1,0,1,,,
105106,0,0,0,0,0,0,0,86,0.0,0.0,0.0,0.0,0.0,0.0,0.0,41,0,41,7.0,0.0,7.0
9303245,0,0,0,0,0,0,0,207,0.0,0.0,0.0,0.0,0.0,0.0,0.0,1,0,1,1.0,0.0,1.0
212155,0,0,0,0,0,0,0,184,0.0,0.0,0.0,0.0,0.0,0.0,0.0,10,0,10,3.0,0.0,3.0
9801231,0,0,0,0,0,0,0,27,0.0,0.0,0.0,0.0,0.0,0.0,0.0,38,0,38,11.0,0.0,11.0
207206,0,0,0,0,0,0,0,45,0.0,0.0,0.0,0.0,0.0,0.0,0.0,24,0,24,14.0,0.0,14.0
211102,0,0,0,0,0,0,0,5,0.0,0.0,0.0,0.0,0.0,0.0,0.0,12,0,12,1.0,0.0,1.0
10076,0,0,0,0,0,0,0,775,0.0,0.0,0.0,0.0,0.0,0.0,0.0,3,0,3,1.0,0.0,1.0
210220,0,0,0,0,0,0,0,247,0.0,0.0,0.0,0.0,0.0,0.0,0.0,2,0,2,1.0,0.0,1.0
9907374,0,0,0,0,0,0,0,27,,,,,,,,7,0,7,1.0,0.0,1.0
2185,0,0,0,0,0,0,0,142,0.0,0.0,0.0,0.0,0.0,0.0,0.0,3,0,3,3.0,0.0,3.0
9310356,0,0,0,0,0,0,0,6,0.0,0.0,0.0,0.0,0.0,0.0,0.0,13,0,13,2.0,0.0,2.0
301193,0,0,0,0,0,0,0,52,0.0,0.0,0.0,0.0,0.0,0.0,0.0,11,0,11,10.0,0.0,10.0
9907288,0,0,0,0,0,0,0,468,0.0,0.0,0.0,0.0,0.0,0.0,0.0,1,0,1,1.0,0.0,1.0
9710260,0,0,0,0,0,0,0,22,0.0,0.0,0.0,0.0,0.0,0.0,0.0,5,0,5,2.0,0.0,2.0
101120,0,0,0,0,0,0,0,15,0.0,0.0,0.0,0.0,0.0,0.0,0.0,20,0,20,3.0,0.0,3.0
210001,1,1,0,0,0,1,1,4,0.0,0.0,0.0,0.0,0.0,0.0,0.0,13,1,12,8.0,0.0,8.0
209012,0,0,0,0,0,0,0,465,0.0,0.0,0.0,0.0,0.0,0.0,0.0,2,0,2,2.0,0.0,2.0
12248,0,0,0,0,0,0,0,356,0.0,0.0,0.0,0.0,0.0,0.0,0.0,4,0,4,1.0,0.0,1.0
108019,0,0,0,0,0,0,0,47,0.0,0.0,0.0,0.0,0.0,0.0,0.0,8,0,8,1.0,0.0,1.0
9905449,0,0,0,0,0,0,0,216,0.0,0.0,0.0,0.0,0.0,0.0,0.0,1,0,1,1.0,0.0,1.0
107260,0,0,0,0,0,0,0,51,0.0,0.0,0.0,0.0,0.0,0.0,0.0,8,0,8,4.0,0.0,4.0
210105,0,0,0,0,0,0,0,45,0.0,0.0,0.0,0.0,0.0,0.0,0.0,7,0,7,1.0,0.0,1.0
210152,0,0,0,0,0,0,0,1539,,,,,,,,1,0,1,,,
210147,0,0,0,0,0,0,0,461,0.0,0.0,0.0,0.0,0.0,0.0,0.0,6,0,6,2.0,0.0,2.0
9706333,0,0,0,0,0,0,0,168,0.0,0.0,0.0,0.0,0.0,0.0,0.0,2,0,2,2.0,0.0,2.0
9607235,0,0,0,0,0,0,0,6,0.0,0.0,0.0,0.0,0.0,0.0,0.0,24,0,24,7.0,0.0,7.0
9308305,0,0,0,0,0,0,0,214,0.0,0.0,0.0,0.0,0.0,0.0,0.0,1,0,1,1.0,0.0,1.0
210079,0,0,0,0,0,0,0,83,0.0,0.0,0.0,0.0,0.0,0.0,0.0,12,0,12,2.0,0.0,2.0
6126,0,0,0,0,0,0,0,97,0.0,0.0,0.0,0.0,0.0,0.0,0.0,4,0,4,3.0,0.0,3.0
9308207,0,0,0,0,0,0,0,1578,0.0,0.0,0.0,0.0,0.0,0.0,0.0,2,0,2,,,
211365,0,0,0,0,0,0,0,28,0.0,0.0,0.0,0.0,0.0,0.0,0.0,8,0,8,2.0,0.0,2.0
1187,0,0,0,0,0,0,0,138,0.0,0.0,0.0,0.0,0.0,0.0,0.0,3,0,3,1.0,0.0,1.0
301010,0,0,0,0,0,0,0,186,0.0,0.0,0.0,0.0,0.0,0.0,0.0,26,0,26,10.0,0.0,10.0
9411291,0,0,0,0,0,0,0,170,0.0,0.0,0.0,0.0,0.0,0.0,0.0,5,0,5,2.0,0.0,2.0
212217,0,0,0,0,0,0,0,285,0.0,0.0,0.0,0.0,0.0,0.0,0.0,2,0,2,2.0,0.0,2.0
5201,0,0,0,0,0,0,0,57,0.0,0.0,0.0,0.0,0.0,0.0,0.0,7,0,7,5.0,0.0,5.0
210413,0,0,0,0,0,0,0,6,0.0,0.0,0.0,0.0,0.0,0.0,0.0,17,0,17,6.0,0.0,6.0
9512209,0,0,0,0,0,0,0,401,0.0,0.0,0.0,0.0,0.0,0.0,0.0,14,0,14,4.0,0.0,4.0
301070,0,0,0,0,0,0,0,62,0.0,0.0,0.0,0.0,0.0,0.0,0.0,9,0,9,7.0,0.0,7.0
105316,0,0,0,0,0,0,0,108,0.0,0.0,0.0,0.0,0.0,0.0,0.0,7,0,7,2.0,0.0,2.0
9908512,0,0,0,0,0,0,0,1590,0.0,0.0,0.0,0.0,0.0,0.0,0.0,3,0,3,1.0,0.0,1.0
212407,0,0,0,0,0,0,0,74,0.0,0.0,0.0,0.0,0.0,0.0,0.0,10,0,10,1.0,0.0,1.0
5291,0,0,0,0,0,0,0,743,0.0,0.0,0.0,0.0,0.0,0.0,0.0,2,0,2,1.0,0.0,1.0
110135,1,1,0,0,0,1,3,54,0.0,0.0,0.0,0.0,0.0,0.0,0.0,33,1,32,11.0,0.0,11.0
209033,0,0,0,0,0,0,0,878,,,,,,,,3,0,3,1.0,0.0,1.0
301091,0,0,0,0,0,0,0,17,0.0,0.0,0.0,0.0,0.0,0.0,0.0,9,0,9,1.0,0.0,1.0
211250,0,0,0,0,0,0,0,165,0.0,0.0,0.0,0.0,0.0,0.0,0.0,16,0,16,4.0,0.0,4.0
212214,0,0,0,0,0,0,0,5,0.0,0.0,0.0,0.0,0.0,0.0,0.0,19,0,19,5.0,0.0,5.0
9607354,20,6,14,34,0,20,45,100,16.0,5.0,11.0,27.0,0.0,16.0,39.0,23,20,3,18.0,15.0,3.0
9605245,19,1,18,46,3,16,16,31,16.0,1.0,15.0,40.0,3.0,13.0,13.0,20,19,1,13.0,12.0,1.0
3323,31,8,23,113,1,30,363,1,22.0,5.0,17.0,73.0,0.0,22.0,291.0,67,31,36,41.0,16.0,25.0
102012,7,3,4,9,0,7,62,1,6.0,2.0,4.0,9.0,0.0,6.0,45.0,36,7,29,12.0,2.0,10.0
9903535,102,19,83,431,18,84,433,1,28.0,3.0,25.0,132.0,19.0,9.0,14.0,154,102,52,24.0,23.0,1.0
9309236,12,5,7,12,4,8,8,7,2.0,2.0,0.0,0.0,2.0,0.0,0.0,14,12,2,3.0,3.0,0.0
9409440,115,10,105,557,5,110,390,6,52.0,5.0,47.0,247.0,0.0,52.0,229.0,129,115,14,32.0,22.0,10.0
11269,9,6,3,5,5,4,8,196,1.0,1.0,0.0,0.0,1.0,0.0,0.0,16,9,7,3.0,1.0,2.0
10071,1,1,0,0,1,0,0,849,,,,,,,,1,1,0,,,
9908395,39,9,30,128,5,34,400,34,24.0,3.0,21.0,100.0,2.0,22.0,258.0,100,39,61,43.0,19.0,24.0
9407406,17,5,12,23,17,0,0,1,13.0,2.0,11.0,22.0,13.0,0.0,0.0,17,17,0,3.0,3.0,0.0
9403233,23,7,16,45,4,19,31,34,1.0,1.0,0.0,0.0,0.0,1.0,1.0,25,23,2,8.0,6.0,2.0
9602234,51,8,43,219,30,21,26,4,17.0,3.0,14.0,56.0,17.0,0.0,0.0,53,51,2,21.0,20.0,1.0
9407389,165,14,151,915,43,122,188,4,45.0,2.0,43.0,358.0,3.0,42.0,61.0,170,165,5,34.0,32.0,2.0
9312318,57,12,45,155,50,7,7,39,29.0,3.0,26.0,90.0,29.0,0.0,0.0,58,57,1,19.0,19.0,0.0
202205,14,3,11,25,0,14,77,4,7.0,3.0,4.0,9.0,0.0,7.0,24.0,34,14,20,8.0,6.0,2.0
106295,79,3,76,888,0,79,240,28,67.0,2.0,65.0,825.0,2.0,65.0,65.0,84,79,5,55.0,54.0,1.0
9909414,3,3,0,0,2,1,1,24,1.0,1.0,0.0,0.0,1.0,0.0,0.0,15,3,12,1.0,1.0,0.0
9507237,54,8,46,175,39,15,32,30,17.0,4.0,13.0,36.0,7.0,10.0,26.0,59,54,5,10.0,7.0,3.0
9612402,29,3,26,103,1,28,124,26,18.0,2.0,16.0,70.0,1.0,17.0,44.0,45,29,16,18.0,15.0,3.0
9710447,24,7,17,72,10,14,25,4,13.0,3.0,10.0,37.0,1.0,12.0,19.0,29,24,5,14.0,12.0,2.0
9809451,35,6,29,110,3,32,56,80,23.0,3.0,20.0,84.0,1.0,22.0,31.0,41,35,6,17.0,15.0,2.0
9909538,16,3,13,37,3,13,78,4,3.0,1.0,2.0,3.0,0.0,3.0,20.0,36,16,20,11.0,5.0,6.0
9710335,152,16,136,811,34,118,758,7,57.0,3.0,54.0,373.0,1.0,56.0,519.0,181,152,29,53.0,38.0,15.0
111297,1,1,0,0,0,1,12,26,1.0,1.0,0.0,0.0,0.0,1.0,10.0,30,1,29,15.0,1.0,14.0
9504399,9,3,6,11,2,7,31,26,3.0,2.0,1.0,1.0,0.0,3.0,8.0,26,9,17,5.0,2.0,3.0
9803466,305,4,301,3747,54,251,371,2,139.0,1.0,138.0,2339.0,7.0,132.0,213.0,308,305,3,53.0,51.0,2.0
9910303,3,3,0,0,0,3,13,5,2.0,2.0,0.0,0.0,0.0,2.0,2.0,28,3,25,5.0,2.0,3.0
9309228,19,9,10,15,19,0,0,35,4.0,3.0,1.0,1.0,4.0,0.0,0.0,19,19,0,3.0,3.0,0.0
9409401,7,1,6,8,3,4,5,71,4.0,1.0,3.0,4.0,1.0,3.0,4.0,9,7,2,2.0,2.0,0.0
9505326,86,15,71,302,7,79,460,69,37.0,6.0,31.0,140.0,0.0,37.0,210.0,132,86,46,28.0,19.0,9.0
9905396,2,2,0,0,0,2,3,36,0.0,0.0,0.0,0.0,0.0,0.0,0.0,8,2,6,2.0,0.0,2.0
2178,66,9,57,218,1,65,404,2,29.0,1.0,28.0,128.0,0.0,29.0,134.0,91,66,25,28.0,23.0,5.0
110320,22,11,11,26,3,19,87,4,3.0,2.0,1.0,1.0,0.0,3.0,9.0,39,22,17,3.0,0.0,3.0
9708310,29,4,25,66,2,27,114,35,19.0,3.0,16.0,44.0,2.0,17.0,70.0,50,29,21,9.0,3.0,6.0
9311350,23,9,14,29,8,15,15,40,3.0,3.0,0.0,0.0,3.0,0.0,0.0,25,23,2,5.0,5.0,0.0
9307295,27,8,19,100,5,22,51,63,16.0,5.0,11.0,43.0,1.0,15.0,35.0,30,27,3,20.0,17.0,3.0
9301295,29,8,21,40,16,13,15,116,6.0,3.0,3.0,5.0,1.0,5.0,5.0,31,29,2,6.0,5.0,1.0
9302240,87,18,69,181,87,0,0,14,12.0,3.0,9.0,24.0,12.0,0.0,0.0,87,87,0,5.0,5.0,0.0
9604344,7,2,5,6,5,2,2,134,3.0,1.0,2.0,2.0,3.0,0.0,0.0,9,7,2,2.0,2.0,0.0
9310229,17,10,7,9,17,0,0,25,5.0,5.0,0.0,0.0,5.0,0.0,0.0,17,17,0,5.0,5.0,0.0
9503204,63,12,51,174,44,19,26,48,21.0,6.0,15.0,48.0,15.0,6.0,6.0,77,63,14,10.0,10.0,0.0
9408308,15,6,9,16,1,14,19,26,1.0,1.0,0.0,0.0,0.0,1.0,5.0,29,15,14,5.0,1.0,4.0
9411256,19,11,8,16,13,6,12,318,9.0,6.0,3.0,6.0,9.0,0.0,0.0,29,19,10,6.0,5.0,1.0
9406417,41,10,31,68,14,27,39,10,10.0,2.0,8.0,14.0,2.0,8.0,15.0,44,41,3,2.0,2.0,0.0
9505359,152,9,143,1025,84,68,91,0,50.0,3.0,47.0,258.0,42.0,8.0,8.0,160,152,8,22.0,20.0,2.0
9806440,66,2,64,478,31,35,65,3,45.0,1.0,44.0,381.0,31.0,14.0,14.0,76,66,10,35.0,34.0,1.0
9903408,32,11,21,55,3,29,61,3,20.0,5.0,15.0,47.0,0.0,20.0,46.0,46,32,14,9.0,8.0,1.0
9505275,105,12,93,635,9,96,214,0,64.0,4.0,60.0,472.0,1.0,63.0,133.0,117,105,12,45.0,43.0,2.0
9503417,37,1,36,118,32,5,5,0,18.0,1.0,17.0,60.0,13.0,5.0,5.0,38,37,1,5.0,5.0,0.0
9507376,11,6,5,7,1,10,36,3,1.0,1.0,0.0,0.0,0.0,1.0,7.0,26,11,15,6.0,1.0,5.0
9812538,102,24,78,282,6,96,610,3,39.0,3.0,36.0,151.0,0.0,39.0,280.0,177,102,75,35.0,20.0,15.0
9909318,19,8,11,19,1,18,117,12,13.0,2.0,11.0,18.0,0.0,13.0,95.0,49,19,30,12.0,8.0,4.0
9808277,22,5,17,60,3,19,26,3,15.0,2.0,13.0,45.0,15.0,0.0,0.0,27,22,5,6.0,4.0,2.0
9712239,14,3,11,20,0,14,98,3,5.0,3.0,2.0,3.0,0.0,5.0,33.0,46,14,32,20.0,4.0,16.0
9807305,97,10,87,468,27,70,286,0,14.0,4.0,10.0,35.0,1.0,13.0,69.0,117,97,20,9.0,6.0,3.0
9803244,21,2,19,62,2,19,85,0,8.0,1.0,7.0,18.0,0.0,8.0,23.0,37,21,16,11.0,5.0,6.0
9710491,25,7,18,39,18,7,7,0,12.0,4.0,8.0,19.0,11.0,1.0,1.0,27,25,2,3.0,2.0,1.0
9702298,14,5,9,13,4,10,39,0,5.0,1.0,4.0,5.0,0.0,5.0,11.0,30,14,16,7.0,4.0,3.0
9610229,89,10,79,546,7,82,253,50,52.0,4.0,48.0,382.0,1.0,51.0,146.0,104,89,15,35.0,32.0,3.0
9802387,26,5,21,62,5,21,29,82,20.0,2.0,18.0,41.0,2.0,18.0,23.0,29,26,3,15.0,13.0,2.0
9810467,18,7,11,25,5,13,26,0,3.0,1.0,2.0,2.0,0.0,3.0,6.0,29,18,11,4.0,3.0,1.0
9601337,34,6,28,68,6,28,44,81,20.0,2.0,18.0,41.0,3.0,17.0,21.0,44,34,10,9.0,8.0,1.0
9808321,5,2,3,5,1,4,16,81,2.0,1.0,1.0,1.0,0.0,2.0,8.0,25,5,20,2.0,0.0,2.0
9508276,42,12,30,78,12,30,46,51,25.0,5.0,20.0,59.0,10.0,15.0,15.0,45,42,3,13.0,12.0,1.0
9712381,4,4,0,0,2,2,9,36,0.0,0.0,0.0,0.0,0.0,0.0,0.0,27,4,23,5.0,0.0,5.0
9305290,29,5,24,115,29,0,0,46,18.0,1.0,17.0,66.0,18.0,0.0,0.0,29,29,0,14.0,14.0,0.0
9603328,46,6,40,234,11,35,103,32,21.0,2.0,19.0,147.0,21.0,0.0,0.0,59,46,13,21.0,21.0,0.0
9305321,26,7,19,65,26,0,0,71,8.0,1.0,7.0,21.0,8.0,0.0,0.0,26,26,0,3.0,3.0,0.0
9804309,30,6,24,57,11,19,43,71,15.0,3.0,12.0,29.0,5.0,10.0,10.0,37,30,7,13.0,12.0,1.0
9805298,2,2,0,0,2,0,0,39,0.0,0.0,0.0,0.0,0.0,0.0,0.0,6,2,4,,,
9612332,32,3,29,146,23,9,12,0,13.0,1.0,12.0,41.0,13.0,0.0,0.0,38,32,6,11.0,11.0,0.0
9610419,10,8,2,3,1,9,29,10,3.0,2.0,1.0,2.0,0.0,3.0,3.0,27,10,17,4.0,3.0,1.0
9410285,7,5,2,2,1,6,20,10,0.0,0.0,0.0,0.0,0.0,0.0,0.0,45,7,38,5.0,0.0,5.0
9702430,15,4,11,21,1,14,48,3,11.0,4.0,7.0,13.0,0.0,11.0,40.0,23,15,8,14.0,10.0,4.0
9403288,19,1,18,80,8,11,11,36,16.0,1.0,15.0,64.0,7.0,9.0,9.0,20,19,1,5.0,4.0,1.0
9707355,21,4,17,40,0,21,165,36,17.0,4.0,13.0,31.0,0.0,17.0,135.0,36,21,15,22.0,13.0,9.0
104090,14,8,6,9,0,14,55,1,12.0,7.0,5.0,7.0,0.0,12.0,36.0,23,14,9,12.0,7.0,5.0
9712398,63,11,52,243,5,58,248,1,20.0,3.0,17.0,60.0,0.0,20.0,63.0,87,63,24,20.0,14.0,6.0
103086,8,4,4,5,0,8,53,2,1.0,1.0,0.0,0.0,0.0,1.0,10.0,29,8,21,10.0,5.0,5.0
9612446,96,12,84,575,6,90,725,1,51.0,4.0,47.0,398.0,1.0,50.0,480.0,155,96,59,36.0,4.0,32.0
9401278,17,6,11,20,8,9,9,129,5.0,2.0,3.0,5.0,5.0,0.0,0.0,19,17,2,5.0,5.0,0.0
9810512,63,21,42,145,17,46,265,23,18.0,1.0,17.0,70.0,3.0,15.0,60.0,88,63,25,18.0,8.0,10.0
9711402,41,8,33,109,3,38,147,34,14.0,2.0,12.0,33.0,0.0,14.0,50.0,58,41,17,11.0,8.0,3.0
7196,25,9,16,62,3,22,186,34,20.0,5.0,15.0,55.0,0.0,20.0,172.0,43,25,18,22.0,10.0,12.0
9603238,115,8,107,805,17,98,127,5,62.0,3.0,59.0,526.0,3.0,59.0,81.0,122,115,7,34.0,33.0,1.0
9701341,44,3,41,192,0,44,432,5,36.0,1.0,35.0,178.0,0.0,36.0,386.0,61,44,17,47.0,31.0,16.0
9708264,20,8,12,14,0,20,106,5,8.0,3.0,5.0,5.0,1.0,7.0,61.0,43,20,23,4.0,2.0,2.0
9912319,17,5,12,29,0,17,83,1,5.0,3.0,2.0,2.0,0.0,5.0,5.0,32,17,15,5.0,4.0,1.0
9412203,20,6,14,26,8,12,18,93,5.0,1.0,4.0,5.0,5.0,0.0,0.0,27,20,7,4.0,4.0,0.0
9711322,17,5,12,20,1,16,80,157,3.0,3.0,0.0,0.0,0.0,3.0,5.0,39,17,22,5.0,3.0,2.0
9802345,8,4,4,7,1,7,33,58,4.0,2.0,2.0,4.0,0.0,4.0,15.0,23,8,15,11.0,4.0,7.0
107257,10,2,8,13,1,9,23,1,3.0,2.0,1.0,1.0,2.0,1.0,1.0,21,10,11,3.0,2.0,1.0
9903305,24,8,16,37,0,24,282,6,14.0,6.0,8.0,17.0,0.0,14.0,134.0,54,24,30,17.0,10.0,7.0
102289,7,4,3,4,1,6,20,34,3.0,3.0,0.0,0.0,2.0,1.0,1.0,12,7,5,5.0,3.0,2.0
9244,15,2,13,37,0,15,57,1,12.0,1.0,11.0,28.0,0.0,12.0,48.0,30,15,15,14.0,9.0,5.0
9803328,20,6,14,31,8,12,45,1,2.0,1.0,1.0,1.0,2.0,0.0,0.0,26,20,6,2.0,2.0,0.0
9703349,95,9,86,603,0,95,715,7,64.0,4.0,60.0,428.0,0.0,64.0,515.0,114,95,19,54.0,42.0,12.0
9608478,20,4,16,44,20,0,0,299,9.0,3.0,6.0,12.0,9.0,0.0,0.0,20,20,0,9.0,9.0,0.0
9301272,8,6,2,4,8,0,0,63,2.0,2.0,0.0,0.0,2.0,0.0,0.0,8,8,0,1.0,1.0,0.0
9311366,60,9,51,261,53,7,7,4,20.0,2.0,18.0,89.0,20.0,0.0,0.0,61,60,1,2.0,2.0,0.0
9401308,95,11,84,363,29,66,68,40,52.0,5.0,47.0,213.0,4.0,48.0,48.0,97,95,2,30.0,29.0,1.0
6107,0,0,0,0,0,0,0,7,0.0,0.0,0.0,0.0,0.0,0.0,0.0,16,0,16,2.0,0.0,2.0
9708447,8,4,4,6,3,5,17,7,3.0,1.0,2.0,3.0,0.0,3.0,9.0,16,8,8,4.0,3.0,1.0
9511212,3,2,1,1,1,2,2,173,0.0,0.0,0.0,0.0,0.0,0.0,0.0,4,3,1,2.0,2.0,0.0
9709507,26,6,20,42,4,22,180,7,9.0,1.0,8.0,13.0,0.0,9.0,105.0,70,26,44,21.0,5.0,16.0
9507377,18,8,10,25,3,15,30,55,7.0,2.0,5.0,10.0,2.0,5.0,5.0,26,18,8,2.0,2.0,0.0
9304267,37,8,29,157,17,20,27,15,30.0,6.0,24.0,136.0,13.0,17.0,22.0,40,37,3,9.0,9.0,0.0
9207227,25,7,18,71,25,0,0,15,16.0,3.0,13.0,58.0,16.0,0.0,0.0,25,25,0,11.0,11.0,0.0
9508332,15,6,9,10,4,11,30,30,4.0,1.0,3.0,3.0,0.0,4.0,8.0,21,15,6,2.0,2.0,0.0
9507293,7,5,2,2,7,0,0,382,6.0,5.0,1.0,1.0,6.0,0.0,0.0,7,7,0,3.0,3.0,0.0
9609460,49,2,47,311,12,37,76,19,26.0,1.0,25.0,147.0,26.0,0.0,0.0,54,49,5,28.0,25.0,3.0
9602277,109,8,101,529,60,49,79,19,28.0,2.0,26.0,150.0,9.0,19.0,35.0,111,109,2,21.0,20.0,1.0
9504431,23,7,16,37,4,19,71,25,10.0,3.0,7.0,14.0,0.0,10.0,44.0,40,23,17,12.0,7.0,5.0
9311213,23,2,21,87,21,2,6,19,6.0,5.0,1.0,1.0,6.0,0.0,0.0,26,23,3,15.0,14.0,1.0
9512327,40,5,35,126,27,13,14,24,12.0,2.0,10.0,22.0,5.0,7.0,7.0,42,40,2,6.0,6.0,0.0
9707362,23,4,19,66,2,21,24,127,20.0,3.0,17.0,62.0,0.0,20.0,20.0,25,23,2,16.0,15.0,1.0
9502308,38,7,31,93,34,4,4,16,11.0,2.0,9.0,25.0,11.0,0.0,0.0,39,38,1,3.0,3.0,0.0
9408383,17,6,11,23,5,12,12,150,12.0,5.0,7.0,12.0,2.0,10.0,10.0,18,17,1,3.0,3.0,0.0
9508386,64,16,48,177,33,31,44,47,21.0,2.0,19.0,72.0,21.0,0.0,0.0,71,64,7,18.0,18.0,0.0
9410244,13,5,8,18,13,0,0,80,7.0,1.0,6.0,16.0,7.0,0.0,0.0,13,13,0,7.0,7.0,0.0
9610493,13,7,6,10,4,9,20,62,3.0,2.0,1.0,1.0,0.0,3.0,9.0,23,13,10,3.0,3.0,0.0
9411332,20,4,16,38,1,19,46,30,17.0,2.0,15.0,34.0,0.0,17.0,41.0,23,20,3,13.0,10.0,3.0
9705217,9,9,0,0,2,7,20,17,0.0,0.0,0.0,0.0,0.0,0.0,0.0,49,9,40,3.0,0.0,3.0
9301252,10,7,3,8,6,4,4,86,3.0,2.0,1.0,1.0,0.0,3.0,3.0,11,10,1,3.0,2.0,1.0
9406395,7,5,2,3,1,6,19,86,4.0,3.0,1.0,1.0,0.0,4.0,13.0,12,7,5,7.0,3.0,4.0
9904398,5,3,2,2,0,5,19,6,4.0,2.0,2.0,2.0,1.0,3.0,13.0,24,5,19,4.0,1.0,3.0
9805297,14,4,10,22,2,12,37,6,5.0,1.0,4.0,5.0,0.0,5.0,6.0,24,14,10,9.0,5.0,4.0
9312306,38,11,27,61,9,29,51,6,20.0,7.0,13.0,29.0,0.0,20.0,37.0,41,38,3,4.0,4.0,0.0
9403328,3,3,0,0,3,0,0,267,1.0,1.0,0.0,0.0,1.0,0.0,0.0,3,3,0,1.0,1.0,0.0
9804401,9,4,5,8,1,8,39,8,1.0,1.0,0.0,0.0,1.0,0.0,0.0,21,9,12,4.0,1.0,3.0
9308304,23,8,15,29,21,2,2,260,4.0,1.0,3.0,3.0,4.0,0.0,0.0,24,23,1,4.0,4.0,0.0
9609301,14,3,11,18,2,12,35,8,7.0,1.0,6.0,10.0,0.0,7.0,14.0,27,14,13,9.0,7.0,2.0
9703284,89,22,67,207,10,79,163,67,23.0,3.0,20.0,75.0,2.0,21.0,41.0,96,89,7,15.0,15.0,0.0
3326,26,5,21,81,1,25,111,22,20.0,2.0,18.0,72.0,0.0,20.0,71.0,47,26,21,17.0,15.0,2.0
9604398,32,3,29,105,9,23,93,22,26.0,2.0,24.0,91.0,8.0,18.0,50.0,49,32,17,16.0,13.0,3.0
9605213,28,4,24,70,9,19,35,45,23.0,3.0,20.0,55.0,7.0,16.0,26.0,32,28,4,19.0,17.0,2.0
9910353,2,2,0,0,2,0,0,22,0.0,0.0,0.0,0.0,0.0,0.0,0.0,10,2,8,6.0,0.0,6.0
9406285,48,13,35,137,2,46,121,22,26.0,4.0,22.0,104.0,2.0,24.0,63.0,53,48,5,21.0,17.0,4.0
9405240,30,8,22,61,13,17,17,22,14.0,4.0,10.0,28.0,5.0,9.0,9.0,31,30,1,4.0,4.0,0.0
9903389,53,8,45,173,10,43,326,22,32.0,3.0,29.0,128.0,0.0,32.0,266.0,78,53,25,33.0,18.0,15.0
9503328,32,10,22,46,13,19,39,88,5.0,4.0,1.0,1.0,0.0,5.0,9.0,41,32,9,8.0,3.0,5.0
9809440,7,1,6,13,2,5,8,88,6.0,1.0,5.0,10.0,1.0,5.0,7.0,10,7,3,8.0,6.0,2.0
9709449,18,6,12,22,4,14,56,22,9.0,3.0,6.0,11.0,0.0,9.0,46.0,37,18,19,3.0,2.0,1.0
9710301,20,10,10,15,11,9,10,137,7.0,1.0,6.0,9.0,7.0,0.0,0.0,24,20,4,6.0,6.0,0.0
9804429,22,2,20,43,1,21,111,21,15.0,2.0,13.0,30.0,0.0,15.0,88.0,33,22,11,19.0,10.0,9.0
9401294,26,5,21,102,15,11,11,19,19.0,2.0,17.0,92.0,9.0,10.0,10.0,27,26,1,3.0,3.0,0.0
9712494,19,3,16,25,4,15,61,39,3.0,3.0,0.0,0.0,0.0,3.0,17.0,34,19,15,5.0,2.0,3.0
9902483,29,3,26,100,3,26,121,19,23.0,3.0,20.0,79.0,2.0,21.0,77.0,43,29,14,14.0,11.0,3.0
9911342,19,6,13,29,0,19,69,19,13.0,5.0,8.0,16.0,0.0,13.0,44.0,32,19,13,18.0,10.0,8.0
9912484,5,3,2,3,1,4,12,66,2.0,1.0,1.0,1.0,0.0,2.0,3.0,12,5,7,3.0,0.0,3.0
9604388,92,5,87,483,26,66,225,8,39.0,1.0,38.0,213.0,1.0,38.0,140.0,102,92,10,15.0,13.0,2.0
9357,15,9,6,12,0,15,171,20,11.0,5.0,6.0,12.0,0.0,11.0,161.0,58,15,43,43.0,8.0,35.0
9905523,63,1,62,533,0,63,452,20,58.0,1.0,57.0,513.0,0.0,58.0,425.0,82,63,19,54.0,43.0,11.0
9909574,63,3,60,482,1,62,655,20,60.0,3.0,57.0,475.0,1.0,59.0,635.0,84,63,21,64.0,45.0,19.0
9401303,18,6,12,16,10,8,16,29,6.0,2.0,4.0,7.0,5.0,1.0,1.0,24,18,6,5.0,5.0,0.0
9506332,18,2,16,36,0,18,36,29,9.0,1.0,8.0,18.0,0.0,9.0,9.0,28,18,10,10.0,9.0,1.0
9704228,30,6,24,72,22,8,10,8,14.0,3.0,11.0,33.0,14.0,0.0,0.0,33,30,3,9.0,9.0,0.0
5040,7,2,5,7,0,7,22,20,1.0,1.0,0.0,0.0,1.0,0.0,0.0,15,7,8,7.0,4.0,3.0
12013,7,1,6,11,0,7,46,20,4.0,1.0,3.0,6.0,0.0,4.0,8.0,20,7,13,5.0,2.0,3.0
5084,16,6,10,16,8,8,12,25,0.0,0.0,0.0,0.0,0.0,0.0,0.0,45,16,29,4.0,4.0,0.0
9903319,19,4,15,45,0,19,76,2,12.0,3.0,9.0,17.0,0.0,12.0,48.0,27,19,8,7.0,6.0,1.0
9908363,50,10,40,167,50,0,0,85,13.0,4.0,9.0,50.0,13.0,0.0,0.0,50,50,0,8.0,8.0,0.0
9407336,27,4,23,68,23,4,4,161,15.0,1.0,14.0,48.0,15.0,0.0,0.0,29,27,2,11.0,11.0,0.0
9710473,38,7,31,135,5,33,152,18,8.0,1.0,7.0,17.0,0.0,8.0,25.0,77,38,39,12.0,8.0,4.0
9801445,45,11,34,173,9,36,122,18,24.0,2.0,22.0,104.0,3.0,21.0,51.0,60,45,15,15.0,14.0,1.0
9505245,45,9,36,186,1,44,218,5,27.0,4.0,23.0,105.0,0.0,27.0,107.0,68,45,23,33.0,25.0,8.0
9411281,3,2,1,1,2,1,1,75,2.0,1.0,1.0,1.0,2.0,0.0,0.0,5,3,2,1.0,1.0,0.0
9603324,22,8,14,38,1,21,77,99,9.0,4.0,5.0,16.0,0.0,9.0,38.0,38,22,16,12.0,6.0,6.0
9608336,16,2,14,20,1,15,54,42,8.0,3.0,5.0,6.0,0.0,8.0,28.0,27,16,11,9.0,5.0,4.0
9802335,3,3,0,0,0,3,8,15,0.0,0.0,0.0,0.0,0.0,0.0,0.0,19,3,16,3.0,0.0,3.0
9303316,8,5,3,8,8,0,0,35,1.0,1.0,0.0,0.0,1.0,0.0,0.0,8,8,0,4.0,4.0,0.0
9607234,11,5,6,8,1,10,40,5,0.0,0.0,0.0,0.0,0.0,0.0,0.0,23,11,12,2.0,2.0,0.0
9610490,66,19,47,138,33,33,67,92,16.0,3.0,13.0,35.0,4.0,12.0,25.0,74,66,8,10.0,8.0,2.0
9811256,24,6,18,48,5,19,54,4,8.0,1.0,7.0,19.0,7.0,1.0,2.0,41,24,17,9.0,8.0,1.0
9306324,11,2,9,23,11,0,0,23,2.0,1.0,1.0,1.0,2.0,0.0,0.0,11,11,0,2.0,2.0,0.0
9708481,33,2,31,116,18,15,23,95,22.0,1.0,21.0,90.0,10.0,12.0,12.0,38,33,5,15.0,15.0,0.0
9609477,4,3,1,1,1,3,10,23,0.0,0.0,0.0,0.0,0.0,0.0,0.0,19,4,15,7.0,0.0,7.0
9409225,19,10,9,28,15,4,4,63,9.0,3.0,6.0,14.0,9.0,0.0,0.0,21,19,2,5.0,5.0,0.0
9906281,53,2,51,324,1,52,277,3,41.0,2.0,39.0,260.0,0.0,41.0,237.0,68,53,15,14.0,14.0,0.0
9904382,34,7,27,92,1,33,425,3,24.0,5.0,19.0,67.0,0.0,24.0,339.0,98,34,64,44.0,10.0,34.0
9705463,17,2,15,39,17,0,0,191,10.0,1.0,9.0,25.0,10.0,0.0,0.0,17,17,0,9.0,9.0,0.0
102139,2,1,1,1,2,0,0,41,0.0,0.0,0.0,0.0,0.0,0.0,0.0,11,2,9,1.0,0.0,1.0
9703379,35,3,32,178,2,33,122,36,32.0,2.0,30.0,175.0,0.0,32.0,115.0,41,35,6,28.0,24.0,4.0
8053,7,5,2,3,3,4,10,227,2.0,1.0,1.0,1.0,0.0,2.0,6.0,17,7,10,8.0,0.0,8.0
1312,55,19,36,94,24,31,216,24,16.0,1.0,15.0,43.0,0.0,16.0,118.0,105,55,50,20.0,10.0,10.0
9408376,73,13,60,160,50,23,36,192,9.0,2.0,7.0,17.0,0.0,9.0,16.0,80,73,7,11.0,8.0,3.0
11145,0,0,0,0,0,0,0,301,0.0,0.0,0.0,0.0,0.0,0.0,0.0,11,0,11,1.0,0.0,1.0
2049,29,4,25,105,2,27,111,2,22.0,3.0,19.0,80.0,0.0,22.0,94.0,34,29,5,20.0,17.0,3.0
302003,47,10,37,122,47,0,0,8,13.0,3.0,10.0,34.0,13.0,0.0,0.0,47,47,0,6.0,6.0,0.0
9306292,37,9,28,59,21,16,25,1,4.0,2.0,2.0,3.0,2.0,2.0,2.0,40,37,3,2.0,1.0,1.0
9310380,8,2,6,15,8,0,0,1,1.0,1.0,0.0,0.0,1.0,0.0,0.0,8,8,0,1.0,1.0,0.0
9501408,0,0,0,0,0,0,0,182,0.0,0.0,0.0,0.0,0.0,0.0,0.0,3,0,3,3.0,0.0,3.0
9511218,13,6,7,13,0,13,37,5,3.0,1.0,2.0,3.0,3.0,0.0,0.0,17,13,4,1.0,1.0,0.0
9705394,2,2,0,0,2,0,0,164,0.0,0.0,0.0,0.0,0.0,0.0,0.0,6,2,4,1.0,0.0,1.0
9911245,56,12,44,140,2,54,493,7,24.0,6.0,18.0,74.0,0.0,24.0,282.0,111,56,55,40.0,18.0,22.0
8276,12,5,7,15,3,9,87,3,0.0,0.0,0.0,0.0,0.0,0.0,0.0,74,12,62,20.0,0.0,20.0
9806216,3,2,1,1,0,3,13,20,1.0,1.0,0.0,0.0,0.0,1.0,1.0,9,3,6,1.0,1.0,0.0
9301242,18,3,15,80,18,0,0,124,16.0,1.0,15.0,80.0,16.0,0.0,0.0,18,18,0,15.0,15.0,0.0
202110,16,9,7,12,2,14,309,18,11.0,6.0,5.0,9.0,0.0,11.0,188.0,76,16,60,35.0,11.0,24.0
9704349,9,3,6,9,1,8,83,5,4.0,2.0,2.0,2.0,0.0,4.0,27.0,70,9,61,4.0,2.0,2.0
102304,19,6,13,65,1,18,192,23,16.0,3.0,13.0,65.0,0.0,16.0,186.0,45,19,26,19.0,9.0,10.0
7202,15,9,6,11,1,14,62,18,10.0,5.0,5.0,9.0,0.0,10.0,33.0,40,15,25,4.0,0.0,4.0
1019,54,5,49,314,1,53,317,18,40.0,4.0,36.0,235.0,1.0,39.0,245.0,83,54,29,22.0,17.0,5.0
9307208,73,12,61,339,16,57,94,18,32.0,3.0,29.0,185.0,8.0,24.0,41.0,79,73,6,4.0,4.0,0.0
9912494,10,3,7,22,0,10,86,5,4.0,2.0,2.0,4.0,0.0,4.0,22.0,43,10,33,2.0,0.0,2.0
9712257,37,7,30,85,3,34,192,10,3.0,2.0,1.0,1.0,0.0,3.0,7.0,63,37,26,6.0,4.0,2.0
9504322,4,3,1,1,3,1,1,395,2.0,2.0,0.0,0.0,2.0,0.0,0.0,5,4,1,2.0,2.0,0.0
9708214,19,6,13,25,0,19,125,7,7.0,3.0,4.0,8.0,0.0,7.0,73.0,40,19,21,20.0,4.0,16.0
9210255,20,10,10,18,20,0,0,8,6.0,3.0,3.0,6.0,6.0,0.0,0.0,20,20,0,4.0,4.0,0.0
9339,9,6,3,3,1,8,37,119,3.0,3.0,0.0,0.0,0.0,3.0,20.0,31,9,22,15.0,2.0,13.0
9806441,23,6,17,67,2,21,69,50,17.0,3.0,14.0,55.0,1.0,16.0,57.0,33,23,10,19.0,14.0,5.0
9507276,5,3,2,3,5,0,0,162,3.0,1.0,2.0,3.0,3.0,0.0,0.0,7,5,2,3.0,3.0,0.0
101133,11,4,7,10,2,9,63,11,9.0,3.0,6.0,9.0,0.0,9.0,63.0,23,11,12,7.0,4.0,3.0
1268,54,5,49,337,0,54,185,11,49.0,3.0,46.0,327.0,0.0,49.0,141.0,65,54,11,48.0,44.0,4.0
7289,33,2,31,134,5,28,104,19,25.0,2.0,23.0,103.0,7.0,18.0,50.0,47,33,14,18.0,13.0,5.0
9703401,15,7,8,24,1,14,16,4,8.0,1.0,7.0,22.0,0.0,8.0,8.0,18,15,3,2.0,2.0,0.0
9811519,7,4,3,5,0,7,38,16,2.0,1.0,1.0,1.0,0.0,2.0,10.0,18,7,11,5.0,2.0,3.0
9511405,23,6,17,72,8,15,17,44,12.0,2.0,10.0,29.0,12.0,0.0,0.0,26,23,3,7.0,6.0,1.0
9405301,13,5,8,11,5,8,13,94,4.0,3.0,1.0,2.0,0.0,4.0,8.0,16,13,3,2.0,2.0,0.0
9404244,19,9,10,20,4,15,18,94,6.0,4.0,2.0,2.0,1.0,5.0,5.0,22,19,3,8.0,7.0,1.0
9511272,28,9,19,42,23,5,6,9,12.0,4.0,8.0,25.0,12.0,0.0,0.0,31,28,3,8.0,8.0,0.0
9508359,94,19,75,372,81,13,14,83,33.0,4.0,29.0,158.0,33.0,0.0,0.0,99,94,5,24.0,24.0,0.0
8283,13,3,10,28,3,10,30,16,11.0,2.0,9.0,22.0,3.0,8.0,12.0,20,13,7,7.0,6.0,1.0
9708452,10,4,6,11,1,9,44,39,8.0,2.0,6.0,11.0,0.0,8.0,34.0,23,10,13,15.0,7.0,8.0
9905242,67,8,59,275,1,66,429,21,25.0,2.0,23.0,94.0,0.0,25.0,137.0,101,67,34,20.0,12.0,8.0
6097,36,11,25,61,2,34,300,2,11.0,5.0,6.0,8.0,0.0,11.0,86.0,70,36,34,17.0,7.0,10.0
9604262,7,3,4,4,4,3,3,138,3.0,3.0,0.0,0.0,1.0,2.0,2.0,11,7,4,3.0,2.0,1.0
101320,3,3,0,0,0,3,13,44,1.0,1.0,0.0,0.0,0.0,1.0,7.0,15,3,12,6.0,1.0,5.0
9908220,7,1,6,10,0,7,39,44,6.0,1.0,5.0,9.0,0.0,6.0,18.0,19,7,12,10.0,6.0,4.0
209107,8,4,4,6,1,7,18,19,2.0,2.0,0.0,0.0,0.0,2.0,8.0,25,8,17,10.0,1.0,9.0
111255,8,2,6,12,0,8,33,19,7.0,1.0,6.0,12.0,0.0,7.0,32.0,19,8,11,2.0,1.0,1.0
9907471,25,6,19,42,0,25,68,19,5.0,2.0,3.0,6.0,0.0,5.0,9.0,32,25,7,6.0,3.0,3.0
108033,11,10,1,1,1,10,73,19,2.0,1.0,1.0,1.0,0.0,2.0,16.0,43,11,32,18.0,2.0,16.0
9911437,2,1,1,1,2,0,0,30,0.0,0.0,0.0,0.0,0.0,0.0,0.0,25,2,23,1.0,0.0,1.0
204228,10,3,7,22,1,9,156,28,9.0,2.0,7.0,22.0,0.0,9.0,141.0,34,10,24,28.0,9.0,19.0
110382,28,1,27,190,0,28,282,28,27.0,1.0,26.0,186.0,0.0,27.0,177.0,47,28,19,33.0,25.0,8.0
111112,14,3,11,32,1,13,93,28,8.0,2.0,6.0,17.0,0.0,8.0,64.0,32,14,18,19.0,8.0,11.0
9706344,83,5,78,491,7,76,230,9,64.0,1.0,63.0,428.0,4.0,60.0,177.0,95,83,12,35.0,28.0,7.0
9803219,28,17,11,17,10,18,88,26,10.0,4.0,6.0,10.0,0.0,10.0,36.0,59,28,31,3.0,3.0,0.0
9509418,12,8,4,6,7,5,5,91,6.0,5.0,1.0,1.0,6.0,0.0,0.0,15,12,3,4.0,3.0,1.0
12378,23,7,16,24,1,22,103,2,10.0,4.0,6.0,9.0,0.0,10.0,49.0,41,23,18,14.0,6.0,8.0
9903475,43,3,40,366,0,43,663,2,41.0,2.0,39.0,365.0,0.0,41.0,651.0,71,43,28,54.0,35.0,19.0
3306,14,9,5,8,0,14,175,2,8.0,6.0,2.0,2.0,0.0,8.0,135.0,82,14,68,49.0,2.0,47.0
205071,7,4,3,4,0,7,56,10,7.0,4.0,3.0,4.0,0.0,7.0,47.0,33,7,26,16.0,2.0,14.0
9705206,16,1,15,39,0,16,48,10,8.0,1.0,7.0,15.0,2.0,6.0,14.0,27,16,11,13.0,8.0,5.0
102323,55,9,46,309,0,55,282,37,42.0,4.0,38.0,278.0,0.0,42.0,137.0,93,55,38,38.0,34.0,4.0
9610354,16,6,10,28,2,14,39,90,9.0,3.0,6.0,21.0,0.0,9.0,31.0,25,16,9,15.0,9.0,6.0
9211328,24,3,21,89,24,0,0,119,18.0,2.0,16.0,73.0,18.0,0.0,0.0,24,24,0,18.0,18.0,0.0
9907203,12,2,10,34,2,10,28,63,9.0,1.0,8.0,26.0,0.0,9.0,27.0,23,12,11,13.0,9.0,4.0
9207231,2,1,1,1,2,0,0,825,,,,,,,,2,2,0,,,
9709350,10,3,7,14,3,7,24,119,6.0,2.0,4.0,7.0,0.0,6.0,20.0,16,10,6,11.0,5.0,6.0
5313,22,13,9,21,4,18,81,32,3.0,3.0,0.0,0.0,1.0,2.0,3.0,39,22,17,5.0,4.0,1.0
9019,0,0,0,0,0,0,0,20,,,,,,,,5,0,5,2.0,0.0,2.0
5080,31,5,26,86,0,31,435,12,13.0,3.0,10.0,26.0,0.0,13.0,251.0,84,31,53,25.0,8.0,17.0
9706261,23,2,21,90,0,23,126,1,18.0,2.0,16.0,65.0,0.0,18.0,98.0,36,23,13,10.0,6.0,4.0
9284,2,2,0,0,1,1,31,34,1.0,1.0,0.0,0.0,0.0,1.0,24.0,37,2,35,25.0,1.0,24.0
9610244,32,6,26,75,3,29,97,58,15.0,2.0,13.0,31.0,1.0,14.0,48.0,43,32,11,17.0,12.0,5.0
9911206,21,8,13,20,2,19,128,29,3.0,2.0,1.0,1.0,0.0,3.0,30.0,78,21,57,15.0,3.0,12.0
9309286,18,9,9,14,18,0,0,61,4.0,3.0,1.0,2.0,4.0,0.0,0.0,18,18,0,3.0,3.0,0.0
9503260,20,6,14,27,0,20,42,79,15.0,4.0,11.0,21.0,0.0,15.0,22.0,44,20,24,10.0,9.0,1.0
9609250,11,2,9,18,2,9,20,72,6.0,1.0,5.0,6.0,0.0,6.0,13.0,17,11,6,7.0,3.0,4.0
9701229,80,6,74,466,8,72,367,11,64.0,3.0,61.0,443.0,0.0,64.0,331.0,89,80,9,48.0,43.0,5.0
9503226,25,10,15,22,14,11,16,16,8.0,2.0,6.0,10.0,8.0,0.0,0.0,37,25,12,8.0,8.0,0.0
9404322,10,5,5,6,0,10,10,360,4.0,4.0,0.0,0.0,0.0,4.0,4.0,11,10,1,4.0,3.0,1.0
9601317,19,13,6,7,8,11,20,44,3.0,2.0,1.0,1.0,0.0,3.0,7.0,41,19,22,3.0,2.0,1.0
9312322,5,5,0,0,3,2,2,211,4.0,4.0,0.0,0.0,3.0,1.0,1.0,8,5,3,2.0,1.0,1.0
9809253,11,3,8,15,3,8,17,12,0.0,0.0,0.0,0.0,0.0,0.0,0.0,29,11,18,6.0,0.0,6.0
9701242,9,4,5,6,0,9,20,17,1.0,1.0,0.0,0.0,0.0,1.0,1.0,15,9,6,4.0,1.0,3.0
9610351,1,1,0,0,1,0,0,292,0.0,0.0,0.0,0.0,0.0,0.0,0.0,8,1,7,3.0,0.0,3.0
9606392,15,3,12,14,2,13,86,8,4.0,3.0,1.0,1.0,0.0,4.0,9.0,33,15,18,11.0,6.0,5.0
9407287,112,32,80,266,46,66,145,14,13.0,4.0,9.0,18.0,1.0,12.0,25.0,125,112,13,12.0,9.0,3.0
7265,10,7,3,3,2,8,11,305,1.0,1.0,0.0,0.0,1.0,0.0,0.0,17,10,7,4.0,3.0,1.0
9807565,65,22,43,117,54,11,23,4,8.0,5.0,3.0,4.0,4.0,4.0,8.0,74,65,9,9.0,9.0,0.0
9612421,31,5,26,75,9,22,117,6,4.0,2.0,2.0,4.0,1.0,3.0,7.0,54,31,23,9.0,3.0,6.0
9812463,24,9,15,42,1,23,202,12,19.0,6.0,13.0,38.0,0.0,19.0,173.0,54,24,30,32.0,15.0,17.0
9308226,30,16,14,29,21,9,16,29,6.0,5.0,1.0,1.0,0.0,6.0,10.0,34,30,4,7.0,7.0,0.0
6158,8,7,1,1,8,0,0,72,2.0,1.0,1.0,1.0,2.0,0.0,0.0,8,8,0,2.0,2.0,0.0
9503234,20,9,11,24,3,17,37,192,3.0,1.0,2.0,2.0,0.0,3.0,10.0,42,20,22,10.0,2.0,8.0
9806255,29,8,21,48,5,24,66,101,19.0,6.0,13.0,32.0,3.0,16.0,38.0,43,29,14,12.0,8.0,4.0
9508244,2,2,0,0,1,1,1,936,0.0,0.0,0.0,0.0,0.0,0.0,0.0,3,2,1,,,
9905294,6,3,3,3,0,6,19,54,2.0,2.0,0.0,0.0,2.0,0.0,0.0,15,6,9,3.0,3.0,0.0
9810496,28,3,25,107,1,27,157,24,22.0,1.0,21.0,99.0,0.0,22.0,119.0,39,28,11,26.0,20.0,6.0
9609419,40,5,35,162,12,28,68,92,25.0,3.0,22.0,106.0,6.0,19.0,36.0,52,40,12,25.0,22.0,3.0
9602286,1,1,0,0,0,1,1,16,0.0,0.0,0.0,0.0,0.0,0.0,0.0,27,1,26,3.0,0.0,3.0
9506355,4,4,0,0,1,3,6,47,2.0,2.0,0.0,0.0,1.0,1.0,1.0,15,4,11,2.0,2.0,0.0
9807212,9,7,2,3,5,4,11,9,0.0,0.0,0.0,0.0,0.0,0.0,0.0,30,9,21,3.0,3.0,0.0
106100,1,1,0,0,0,1,6,286,0.0,0.0,0.0,0.0,0.0,0.0,0.0,8,1,7,7.0,1.0,6.0
9412255,17,3,14,40,10,7,10,14,8.0,2.0,6.0,11.0,2.0,6.0,7.0,22,17,5,5.0,4.0,1.0
9510418,9,4,5,7,2,7,13,14,2.0,1.0,1.0,1.0,0.0,2.0,7.0,15,9,6,7.0,1.0,6.0
9808248,28,7,21,58,0,28,198,14,17.0,4.0,13.0,38.0,0.0,17.0,126.0,47,28,19,28.0,11.0,17.0
9710465,18,7,11,21,2,16,109,27,9.0,3.0,6.0,9.0,0.0,9.0,37.0,36,18,18,10.0,5.0,5.0
9903411,9,4,5,10,0,9,82,14,7.0,3.0,4.0,9.0,0.0,7.0,70.0,26,9,17,16.0,6.0,10.0
9604217,15,3,12,40,1,14,79,13,14.0,3.0,11.0,38.0,0.0,14.0,79.0,24,15,9,19.0,12.0,7.0
9310367,8,7,1,1,7,1,1,109,2.0,2.0,0.0,0.0,1.0,1.0,1.0,9,8,1,3.0,3.0,0.0
9605417,9,1,8,16,3,6,8,77,4.0,1.0,3.0,5.0,0.0,4.0,6.0,16,9,7,6.0,5.0,1.0
105062,3,2,1,1,0,3,4,45,3.0,2.0,1.0,1.0,0.0,3.0,4.0,8,3,5,,,
9601380,3,3,0,0,0,3,7,17,0.0,0.0,0.0,0.0,0.0,0.0,0.0,10,3,7,1.0,1.0,0.0
9507398,36,5,31,79,0,36,158,17,26.0,4.0,22.0,64.0,0.0,26.0,131.0,45,36,9,10.0,7.0,3.0
9709509,16,4,12,37,3,13,70,66,11.0,2.0,9.0,31.0,0.0,11.0,42.0,35,16,19,19.0,11.0,8.0
9608310,15,4,11,22,8,7,49,16,5.0,2.0,3.0,3.0,0.0,5.0,35.0,27,15,12,12.0,3.0,9.0
9607256,13,2,11,16,0,13,27,194,8.0,1.0,7.0,7.0,0.0,8.0,13.0,17,13,4,11.0,9.0,2.0
9707247,1,1,0,0,0,1,2,549,0.0,0.0,0.0,0.0,0.0,0.0,0.0,5,1,4,1.0,0.0,1.0
9811257,8,4,4,9,0,8,30,5,3.0,2.0,1.0,1.0,0.0,3.0,12.0,31,8,23,1.0,0.0,1.0
9810368,3,2,1,1,3,0,0,794,1.0,1.0,0.0,0.0,1.0,0.0,0.0,4,3,1,1.0,1.0,0.0
9707393,23,9,14,46,6,17,37,97,11.0,5.0,6.0,11.0,1.0,10.0,26.0,27,23,4,12.0,8.0,4.0
9609368,10,6,4,5,0,10,80,8,6.0,3.0,3.0,4.0,0.0,6.0,48.0,25,10,15,3.0,2.0,1.0
9211303,30,9,21,50,16,14,14,112,18.0,6.0,12.0,29.0,18.0,0.0,0.0,32,30,2,11.0,11.0,0.0
9406387,6,2,4,8,6,0,0,15,,,,,,,,6,6,0,,,
9411293,13,2,11,24,11,2,4,274,2.0,1.0,1.0,1.0,0.0,2.0,4.0,15,13,2,4.0,2.0,2.0
9406292,5,3,2,3,5,0,0,238,2.0,1.0,1.0,1.0,2.0,0.0,0.0,5,5,0,2.0,2.0,0.0
9708325,4,2,2,2,0,4,19,5,2.0,1.0,1.0,1.0,0.0,2.0,8.0,28,4,24,1.0,1.0,0.0
9902340,11,8,3,3,10,1,1,131,2.0,1.0,1.0,1.0,2.0,0.0,0.0,12,11,1,2.0,1.0,1.0
6229,28,8,20,53,1,27,157,3,19.0,5.0,14.0,34.0,0.0,19.0,125.0,55,28,27,7.0,7.0,0.0
4048,15,6,9,22,1,14,64,0,7.0,2.0,5.0,14.0,0.0,7.0,36.0,54,15,39,14.0,5.0,9.0
9905246,9,8,1,1,0,9,89,0,4.0,3.0,1.0,1.0,0.0,4.0,50.0,56,9,47,27.0,2.0,25.0
9207260,2,2,0,0,2,0,0,201,,,,,,,,2,2,0,,,
9706551,12,3,9,17,1,11,18,52,6.0,3.0,3.0,5.0,1.0,5.0,5.0,20,12,8,5.0,5.0,0.0
9604212,5,5,0,0,5,0,0,152,1.0,1.0,0.0,0.0,1.0,0.0,0.0,5,5,0,1.0,1.0,0.0
9806519,39,4,35,162,0,39,359,15,30.0,3.0,27.0,127.0,0.0,30.0,299.0,62,39,23,32.0,13.0,19.0
110159,4,4,0,0,1,3,8,1,0.0,0.0,0.0,0.0,0.0,0.0,0.0,21,4,17,3.0,1.0,2.0
112233,16,2,14,52,1,15,57,146,15.0,2.0,13.0,48.0,1.0,14.0,52.0,27,16,11,21.0,15.0,6.0
9806450,6,4,2,4,1,5,10,120,5.0,3.0,2.0,4.0,0.0,5.0,10.0,8,6,2,6.0,4.0,2.0
9701373,10,3,7,16,9,1,1,137,4.0,2.0,2.0,3.0,4.0,0.0,0.0,15,10,5,5.0,5.0,0.0
9903236,3,2,1,1,0,3,13,145,2.0,1.0,1.0,1.0,0.0,2.0,6.0,16,3,13,5.0,2.0,3.0
9802381,51,7,44,267,1,50,357,8,42.0,4.0,38.0,240.0,0.0,42.0,328.0,66,51,15,48.0,35.0,13.0
9912302,5,5,0,0,0,5,33,4,2.0,2.0,0.0,0.0,0.0,2.0,24.0,60,5,55,18.0,2.0,16.0
108037,47,5,42,176,2,45,280,7,19.0,1.0,18.0,68.0,1.0,18.0,51.0,76,47,29,26.0,21.0,5.0
108159,8,6,2,3,2,6,21,123,0.0,0.0,0.0,0.0,0.0,0.0,0.0,52,8,44,11.0,0.0,11.0
9712429,19,4,15,74,1,18,48,21,18.0,3.0,15.0,74.0,3.0,15.0,32.0,27,19,8,16.0,15.0,1.0
9206229,8,3,5,12,8,0,0,96,3.0,1.0,2.0,3.0,3.0,0.0,0.0,8,8,0,3.0,3.0,0.0
106113,6,1,5,9,0,6,19,21,6.0,1.0,5.0,9.0,0.0,6.0,13.0,13,6,7,10.0,6.0,4.0
9409348,14,3,11,36,1,13,13,49,9.0,1.0,8.0,25.0,0.0,9.0,9.0,16,14,2,11.0,10.0,1.0
9308276,55,9,46,184,48,7,7,35,28.0,2.0,26.0,101.0,22.0,6.0,6.0,56,55,1,13.0,13.0,0.0
9003,7,4,3,7,0,7,29,44,5.0,4.0,1.0,4.0,0.0,5.0,20.0,15,7,8,8.0,3.0,5.0
9212284,59,8,51,267,0,59,59,56,50.0,7.0,43.0,208.0,0.0,50.0,50.0,60,59,1,33.0,32.0,1.0
9904385,3,3,0,0,2,1,7,30,0.0,0.0,0.0,0.0,0.0,0.0,0.0,14,3,11,6.0,0.0,6.0
11332,17,2,15,48,1,16,50,165,16.0,2.0,14.0,46.0,1.0,15.0,21.0,23,17,6,15.0,13.0,2.0
9803274,17,4,13,69,1,16,41,60,11.0,3.0,8.0,35.0,1.0,10.0,19.0,23,17,6,12.0,10.0,2.0
9909433,3,2,1,1,1,2,17,32,2.0,1.0,1.0,1.0,0.0,2.0,15.0,39,3,36,6.0,0.0,6.0
107007,8,5,3,3,2,6,102,0,6.0,4.0,2.0,2.0,0.0,6.0,101.0,47,8,39,37.0,5.0,32.0
5297,43,9,34,98,10,33,133,13,24.0,2.0,22.0,66.0,1.0,23.0,107.0,67,43,24,15.0,3.0,12.0
9709409,2,2,0,0,1,1,2,46,0.0,0.0,0.0,0.0,0.0,0.0,0.0,16,2,14,1.0,0.0,1.0
9209238,17,6,11,41,17,0,0,131,13.0,3.0,10.0,38.0,13.0,0.0,0.0,17,17,0,10.0,10.0,0.0
9601350,10,5,5,11,8,2,3,140,5.0,3.0,2.0,4.0,5.0,0.0,0.0,12,10,2,5.0,5.0,0.0
9304227,8,5,3,3,8,0,0,192,1.0,1.0,0.0,0.0,1.0,0.0,0.0,8,8,0,4.0,4.0,0.0
9706454,12,4,8,15,1,11,115,36,8.0,3.0,5.0,11.0,0.0,8.0,101.0,32,12,20,22.0,8.0,14.0
103166,4,4,0,0,0,4,35,34,0.0,0.0,0.0,0.0,0.0,0.0,0.0,58,4,54,22.0,0.0,22.0
9805205,5,5,0,0,3,2,2,782,1.0,1.0,0.0,0.0,1.0,0.0,0.0,9,5,4,1.0,1.0,0.0
9801348,12,3,9,13,12,0,0,12,10.0,2.0,8.0,12.0,10.0,0.0,0.0,17,12,5,,,
109089,1,1,0,0,1,0,0,196,0.0,0.0,0.0,0.0,0.0,0.0,0.0,17,1,16,2.0,0.0,2.0
9701353,27,8,19,47,2,25,30,17,9.0,1.0,8.0,23.0,9.0,0.0,0.0,37,27,10,9.0,9.0,0.0
108135,16,6,10,13,1,15,68,24,2.0,1.0,1.0,1.0,0.0,2.0,9.0,44,16,28,4.0,3.0,1.0
9911297,10,5,5,8,1,9,42,89,6.0,3.0,3.0,4.0,0.0,6.0,31.0,26,10,16,13.0,4.0,9.0
9409382,7,1,6,13,7,0,0,6,,,,,,,,7,7,0,4.0,4.0,0.0
9806475,8,3,5,7,0,8,53,30,6.0,2.0,4.0,6.0,0.0,6.0,37.0,25,8,17,15.0,4.0,11.0
9911302,39,12,27,69,1,38,165,21,17.0,2.0,15.0,27.0,1.0,16.0,36.0,65,39,26,16.0,10.0,6.0
9509323,2,1,1,1,0,2,2,81,2.0,1.0,1.0,1.0,0.0,2.0,2.0,7,2,5,2.0,0.0,2.0
9802212,1,1,0,0,1,0,0,41,0.0,0.0,0.0,0.0,0.0,0.0,0.0,12,1,11,3.0,0.0,3.0
9410331,8,2,6,15,5,3,3,5,7.0,2.0,5.0,14.0,7.0,0.0,0.0,9,8,1,7.0,7.0,0.0
10067,4,4,0,0,2,2,7,5,0.0,0.0,0.0,0.0,0.0,0.0,0.0,41,4,37,30.0,0.0,30.0
9503278,20,2,18,53,0,20,39,1,12.0,1.0,11.0,39.0,0.0,12.0,12.0,25,20,5,1.0,1.0,0.0
2278,5,3,2,3,2,3,7,16,3.0,3.0,0.0,0.0,1.0,2.0,2.0,9,5,4,5.0,3.0,2.0
9512326,10,4,6,20,1,9,22,113,7.0,1.0,6.0,17.0,0.0,7.0,19.0,14,10,4,10.0,7.0,3.0
7295,0,0,0,0,0,0,0,43,0.0,0.0,0.0,0.0,0.0,0.0,0.0,12,0,12,5.0,0.0,5.0
9806437,29,12,17,36,2,27,155,44,16.0,5.0,11.0,26.0,1.0,15.0,83.0,53,29,24,14.0,8.0,6.0
9509414,14,5,9,11,5,9,11,100,2.0,2.0,0.0,0.0,0.0,2.0,2.0,18,14,4,4.0,2.0,2.0
108205,7,6,1,1,0,7,47,29,3.0,2.0,1.0,1.0,0.0,3.0,22.0,48,7,41,16.0,2.0,14.0
9304304,1,1,0,0,1,0,0,1274,,,,,,,,1,1,0,,,
9903421,17,5,12,31,1,16,64,29,11.0,3.0,8.0,21.0,0.0,11.0,46.0,25,17,8,15.0,8.0,7.0
9803227,28,14,14,41,2,26,132,29,9.0,5.0,4.0,7.0,0.0,9.0,62.0,63,28,35,11.0,4.0,7.0
9512239,27,10,17,42,2,25,45,61,8.0,1.0,7.0,12.0,1.0,7.0,7.0,38,27,11,5.0,4.0,1.0
9901332,13,2,11,32,12,1,1,244,11.0,2.0,9.0,27.0,10.0,1.0,1.0,14,13,1,9.0,9.0,0.0
9806511,3,2,1,1,3,0,0,504,2.0,1.0,1.0,1.0,2.0,0.0,0.0,3,3,0,2.0,2.0,0.0
9702403,17,5,12,22,6,11,21,40,5.0,1.0,4.0,4.0,0.0,5.0,7.0,29,17,12,6.0,3.0,3.0
9215,7,4,3,5,0,7,24,22,3.0,1.0,2.0,3.0,0.0,3.0,7.0,17,7,10,3.0,2.0,1.0
111001,1,1,0,0,0,1,1,319,0.0,0.0,0.0,0.0,0.0,0.0,0.0,6,1,5,1.0,1.0,0.0
109157,1,1,0,0,1,0,0,1343,0.0,0.0,0.0,0.0,0.0,0.0,0.0,6,1,5,1.0,1.0,0.0
9406250,7,4,3,5,0,7,13,155,5.0,2.0,3.0,5.0,0.0,5.0,9.0,11,7,4,6.0,4.0,2.0
9712244,10,4,6,11,0,10,89,1,8.0,3.0,5.0,10.0,0.0,8.0,71.0,39,10,29,18.0,4.0,14.0
9712347,10,8,2,3,5,5,5,126,4.0,4.0,0.0,0.0,3.0,1.0,1.0,15,10,5,3.0,3.0,0.0
11104,9,4,5,8,0,9,72,46,4.0,2.0,2.0,2.0,0.0,4.0,34.0,35,9,26,7.0,4.0,3.0
9712228,39,8,31,89,14,25,64,25,9.0,2.0,7.0,20.0,3.0,6.0,7.0,51,39,12,7.0,6.0,1.0
9905216,4,2,2,2,0,4,19,69,1.0,1.0,0.0,0.0,0.0,1.0,3.0,17,4,13,11.0,2.0,9.0
109075,2,1,1,1,0,2,2,2128,,,,,,,,5,2,3,2.0,2.0,0.0
201089,9,4,5,7,0,9,32,0,5.0,2.0,3.0,5.0,0.0,5.0,12.0,25,9,16,10.0,3.0,7.0
112216,17,10,7,10,3,14,55,0,4.0,3.0,1.0,2.0,0.0,4.0,16.0,40,17,23,2.0,2.0,0.0
204234,1,1,0,0,0,1,5,20,1.0,1.0,0.0,0.0,1.0,0.0,0.0,8,1,7,,,
9701384,41,7,34,228,5,36,145,68,34.0,4.0,30.0,206.0,5.0,29.0,102.0,55,41,14,33.0,28.0,5.0
9802260,0,0,0,0,0,0,0,978,,,,,,,,4,0,4,2.0,0.0,2.0
9812497,5,4,1,1,0,5,27,67,1.0,1.0,0.0,0.0,0.0,1.0,1.0,17,5,12,5.0,2.0,3.0
9605368,7,4,3,3,5,2,5,55,0.0,0.0,0.0,0.0,0.0,0.0,0.0,11,7,4,3.0,0.0,3.0
9302303,17,4,13,26,17,0,0,169,5.0,3.0,2.0,3.0,5.0,0.0,0.0,17,17,0,4.0,4.0,0.0
9501378,3,3,0,0,1,2,2,10,0.0,0.0,0.0,0.0,0.0,0.0,0.0,11,3,8,1.0,1.0,0.0
9410363,2,1,1,1,2,0,0,167,2.0,1.0,1.0,1.0,2.0,0.0,0.0,3,2,1,2.0,2.0,0.0
9511306,3,3,0,0,3,0,0,1704,0.0,0.0,0.0,0.0,0.0,0.0,0.0,6,3,3,,,
9402220,3,2,1,1,3,0,0,2086,,,,,,,,3,3,0,,,
9606244,4,3,1,2,0,4,27,25,4.0,3.0,1.0,2.0,0.0,4.0,24.0,17,4,13,13.0,3.0,10.0
9910445,2,1,1,1,0,2,18,95,2.0,1.0,1.0,1.0,0.0,2.0,17.0,18,2,16,9.0,1.0,8.0
6184,11,5,6,9,3,8,25,16,5.0,1.0,4.0,7.0,1.0,4.0,9.0,21,11,10,6.0,4.0,2.0
9508268,16,6,10,23,11,5,11,53,5.0,1.0,4.0,5.0,5.0,0.0,0.0,26,16,10,3.0,0.0,3.0
107177,5,5,0,0,0,5,8,263,2.0,2.0,0.0,0.0,0.0,2.0,2.0,8,5,3,3.0,2.0,1.0
2273,3,1,2,3,0,3,49,15,3.0,1.0,2.0,3.0,0.0,3.0,45.0,25,3,22,4.0,0.0,4.0
102207,8,3,5,7,0,8,38,19,4.0,2.0,2.0,3.0,0.0,4.0,8.0,22,8,14,4.0,2.0,2.0
9902226,17,10,7,10,8,9,45,23,3.0,2.0,1.0,1.0,0.0,3.0,11.0,32,17,15,8.0,3.0,5.0
6256,3,3,0,0,0,3,20,2,2.0,2.0,0.0,0.0,1.0,1.0,1.0,15,3,12,1.0,1.0,0.0
9812522,25,4,21,50,1,24,82,27,24.0,4.0,20.0,48.0,1.0,23.0,80.0,33,25,8,10.0,7.0,3.0
9909539,10,1,9,13,0,10,61,130,9.0,2.0,7.0,11.0,0.0,9.0,50.0,26,10,16,14.0,9.0,5.0
110036,3,2,1,1,2,1,5,43,1.0,1.0,0.0,0.0,0.0,1.0,1.0,13,3,10,3.0,1.0,2.0
106286,6,3,3,5,0,6,22,3,0.0,0.0,0.0,0.0,0.0,0.0,0.0,43,6,37,1.0,0.0,1.0
206088,6,3,3,4,1,5,14,129,2.0,1.0,1.0,1.0,0.0,2.0,8.0,13,6,7,5.0,2.0,3.0
201128,11,7,4,7,0,11,94,2,6.0,5.0,1.0,1.0,0.0,6.0,24.0,38,11,27,18.0,5.0,13.0
9907314,15,2,13,31,2,13,42,3,9.0,1.0,8.0,16.0,0.0,9.0,19.0,27,15,12,14.0,9.0,5.0
9803294,1,1,0,0,0,1,3,61,0.0,0.0,0.0,0.0,0.0,0.0,0.0,14,1,13,2.0,0.0,2.0
108139,35,7,28,122,1,34,323,37,31.0,5.0,26.0,115.0,0.0,31.0,282.0,55,35,20,39.0,27.0,12.0
201233,12,3,9,19,12,0,0,95,3.0,1.0,2.0,3.0,3.0,0.0,0.0,12,12,0,4.0,4.0,0.0
6005,19,3,16,71,0,19,57,47,18.0,2.0,16.0,71.0,0.0,18.0,47.0,27,19,8,24.0,18.0,6.0
9805496,31,14,17,28,16,15,21,216,7.0,3.0,4.0,5.0,4.0,3.0,6.0,36,31,5,6.0,5.0,1.0
3102,2,2,0,0,1,1,1,42,0.0,0.0,0.0,0.0,0.0,0.0,0.0,18,2,16,1.0,0.0,1.0
111319,3,1,2,2,0,3,28,3,1.0,1.0,0.0,0.0,0.0,1.0,14.0,23,3,20,7.0,3.0,4.0
110266,10,5,5,8,1,9,40,37,3.0,1.0,2.0,3.0,0.0,3.0,13.0,27,10,17,10.0,3.0,7.0
9212241,3,3,0,0,3,0,0,1388,,,,,,,,3,3,0,,,
9911261,5,5,0,0,5,0,0,68,0.0,0.0,0.0,0.0,0.0,0.0,0.0,20,5,15,2.0,1.0,1.0
205168,4,1,3,5,0,4,41,28,4.0,1.0,3.0,5.0,0.0,4.0,33.0,15,4,11,13.0,4.0,9.0
9503279,7,2,5,10,7,0,0,100,5.0,1.0,4.0,9.0,5.0,0.0,0.0,7,7,0,2.0,2.0,0.0
9710514,4,2,2,3,3,1,2,83,2.0,1.0,1.0,1.0,2.0,0.0,0.0,12,4,8,3.0,2.0,1.0
9512414,3,3,0,0,1,2,4,179,1.0,1.0,0.0,0.0,1.0,0.0,0.0,6,3,3,2.0,1.0,1.0
9405421,10,6,4,4,4,6,12,190,5.0,3.0,2.0,2.0,0.0,5.0,10.0,14,10,4,9.0,5.0,4.0
101099,10,4,6,11,1,9,98,11,6.0,2.0,4.0,8.0,0.0,6.0,77.0,54,10,44,25.0,6.0,19.0
9609261,4,4,0,0,2,2,3,67,2.0,2.0,0.0,0.0,2.0,0.0,0.0,6,4,2,1.0,1.0,0.0
9502307,9,3,6,8,0,9,28,25,4.0,3.0,1.0,1.0,1.0,3.0,5.0,21,9,12,8.0,4.0,4.0
9603284,7,3,4,7,7,0,0,44,5.0,3.0,2.0,3.0,5.0,0.0,0.0,7,7,0,4.0,4.0,0.0
9509226,8,5,3,3,2,6,13,72,3.0,1.0,2.0,2.0,0.0,3.0,8.0,13,8,5,7.0,3.0,4.0
5118,13,6,7,17,0,13,170,32,7.0,3.0,4.0,11.0,0.0,7.0,113.0,54,13,41,30.0,7.0,23.0
9401335,8,4,4,5,8,0,0,598,4.0,1.0,3.0,4.0,4.0,0.0,0.0,8,8,0,4.0,4.0,0.0
9404355,9,3,6,13,0,9,22,62,7.0,2.0,5.0,11.0,0.0,7.0,17.0,15,9,6,6.0,4.0,2.0
10310,4,4,0,0,3,1,1,275,0.0,0.0,0.0,0.0,0.0,0.0,0.0,7,4,3,2.0,2.0,0.0
9408365,7,5,2,7,0,7,22,102,6.0,4.0,2.0,7.0,0.0,6.0,20.0,11,7,4,9.0,5.0,4.0
9806207,7,3,4,5,6,1,2,112,3.0,1.0,2.0,3.0,2.0,1.0,1.0,10,7,3,3.0,3.0,0.0
9603315,3,1,2,2,0,3,4,236,0.0,0.0,0.0,0.0,0.0,0.0,0.0,22,3,19,1.0,0.0,1.0
9809279,5,5,0,0,0,5,39,6,2.0,2.0,0.0,0.0,0.0,2.0,21.0,27,5,22,2.0,2.0,0.0
9212233,2,2,0,0,2,0,0,632,1.0,1.0,0.0,0.0,1.0,0.0,0.0,3,2,1,1.0,1.0,0.0
9611354,5,1,4,8,1,4,12,25,5.0,1.0,4.0,8.0,1.0,4.0,11.0,9,5,4,8.0,5.0,3.0
9606372,5,3,2,3,4,1,3,128,5.0,3.0,2.0,3.0,5.0,0.0,0.0,13,5,8,4.0,4.0,0.0
6077,30,3,27,179,0,30,139,109,28.0,2.0,26.0,176.0,0.0,28.0,135.0,38,30,8,33.0,26.0,7.0
9708351,8,4,4,6,1,7,19,109,5.0,2.0,3.0,4.0,0.0,5.0,14.0,20,8,12,8.0,5.0,3.0
9603225,2,2,0,0,0,2,10,61,1.0,1.0,0.0,0.0,0.0,1.0,3.0,14,2,12,3.0,0.0,3.0
9804282,36,3,33,166,17,19,58,12,17.0,3.0,14.0,63.0,17.0,0.0,0.0,46,36,10,19.0,19.0,0.0
9610416,3,1,2,2,0,3,4,41,0.0,0.0,0.0,0.0,0.0,0.0,0.0,16,3,13,9.0,0.0,9.0
12075,48,6,42,161,1,47,63,0,24.0,2.0,22.0,85.0,1.0,23.0,31.0,51,48,3,17.0,16.0,1.0
9910336,6,5,1,1,4,2,11,0,1.0,1.0,0.0,0.0,0.0,1.0,8.0,15,6,9,2.0,2.0,0.0
9811365,7,4,3,5,0,7,19,19,5.0,2.0,3.0,5.0,0.0,5.0,16.0,15,7,8,8.0,4.0,4.0
9506334,2,1,1,1,0,2,9,36,1.0,1.0,0.0,0.0,0.0,1.0,3.0,10,2,8,2.0,0.0,2.0
9906359,13,5,8,9,6,7,12,197,7.0,3.0,4.0,4.0,0.0,7.0,12.0,16,13,3,8.0,5.0,3.0
9605289,6,3,3,5,3,3,4,335,3.0,3.0,0.0,0.0,1.0,2.0,2.0,8,6,2,2.0,1.0,1.0
9708312,2,2,0,0,1,1,5,61,0.0,0.0,0.0,0.0,0.0,0.0,0.0,14,2,12,6.0,0.0,6.0
9704450,7,3,4,5,1,6,28,5,4.0,2.0,2.0,2.0,4.0,0.0,0.0,23,7,16,3.0,3.0,0.0
9706469,7,3,4,8,4,3,3,33,1.0,1.0,0.0,0.0,1.0,0.0,0.0,22,7,15,6.0,0.0,6.0
9707320,7,4,3,5,2,5,6,77,4.0,2.0,2.0,4.0,4.0,0.0,0.0,14,7,7,5.0,4.0,1.0
9908340,4,2,2,2,0,4,107,1,2.0,1.0,1.0,1.0,0.0,2.0,84.0,62,4,58,28.0,1.0,27.0
9905404,15,11,4,4,1,14,40,1,5.0,5.0,0.0,0.0,2.0,3.0,3.0,24,15,9,4.0,3.0,1.0
9902201,13,5,8,12,1,12,75,5,3.0,1.0,2.0,2.0,0.0,3.0,19.0,50,13,37,8.0,4.0,4.0
105154,6,2,4,6,1,5,35,29,6.0,2.0,4.0,6.0,1.0,5.0,28.0,20,6,14,10.0,4.0,6.0
3031,3,2,1,2,0,3,12,8,1.0,1.0,0.0,0.0,0.0,1.0,6.0,15,3,12,9.0,1.0,8.0
110043,2,2,0,0,0,2,4,177,2.0,2.0,0.0,0.0,0.0,2.0,4.0,4,2,2,1.0,1.0,0.0
9612451,30,12,18,72,5,25,47,18,14.0,4.0,10.0,40.0,1.0,13.0,27.0,37,30,7,12.0,11.0,1.0
11035,4,2,2,2,4,0,0,178,0.0,0.0,0.0,0.0,0.0,0.0,0.0,12,4,8,2.0,0.0,2.0
9612252,22,1,21,97,0,22,183,53,21.0,1.0,20.0,93.0,0.0,21.0,173.0,37,22,15,31.0,19.0,12.0
102206,11,3,8,21,2,9,11,282,9.0,2.0,7.0,17.0,0.0,9.0,9.0,16,11,5,8.0,7.0,1.0
9809312,13,7,6,11,6,7,12,186,9.0,4.0,5.0,10.0,3.0,6.0,6.0,20,13,7,9.0,8.0,1.0
9403294,5,1,4,4,3,2,2,25,2.0,1.0,1.0,1.0,1.0,1.0,1.0,6,5,1,3.0,2.0,1.0
9712273,12,6,6,8,4,8,44,14,3.0,2.0,1.0,1.0,0.0,3.0,18.0,31,12,19,6.0,6.0,0.0
9510277,11,1,10,29,1,10,22,37,10.0,1.0,9.0,26.0,1.0,9.0,18.0,14,11,3,11.0,9.0,2.0
9910389,2,1,1,1,0,2,7,8,0.0,0.0,0.0,0.0,0.0,0.0,0.0,22,2,20,4.0,0.0,4.0
9503326,2,2,0,0,2,0,0,391,2.0,2.0,0.0,0.0,2.0,0.0,0.0,2,2,0,2.0,2.0,0.0
9803450,10,7,3,4,1,9,16,56,3.0,2.0,1.0,2.0,0.0,3.0,3.0,16,10,6,5.0,3.0,2.0
9602209,2,1,1,1,2,0,0,256,2.0,1.0,1.0,1.0,2.0,0.0,0.0,4,2,2,2.0,2.0,0.0
9305202,3,3,0,0,3,0,0,392,2.0,2.0,0.0,0.0,2.0,0.0,0.0,3,3,0,1.0,1.0,0.0
9308355,4,3,1,1,0,4,7,40,,,,,,,,6,4,2,3.0,3.0,0.0
9910425,8,2,6,15,0,8,19,294,8.0,2.0,6.0,15.0,0.0,8.0,17.0,12,8,4,10.0,7.0,3.0
4227,12,1,11,44,0,12,82,46,12.0,1.0,11.0,44.0,0.0,12.0,72.0,38,12,26,23.0,12.0,11.0
2237,10,4,6,11,0,10,49,24,7.0,2.0,5.0,10.0,0.0,7.0,40.0,19,10,9,3.0,2.0,1.0
111377,5,4,1,1,1,4,26,14,2.0,1.0,1.0,1.0,0.0,2.0,14.0,56,5,51,5.0,1.0,4.0
9907569,5,5,0,0,0,5,25,14,3.0,3.0,0.0,0.0,0.0,3.0,12.0,17,5,12,7.0,2.0,5.0
9711373,8,2,6,11,0,8,29,150,3.0,1.0,2.0,2.0,0.0,3.0,8.0,18,8,10,6.0,2.0,4.0
9708458,1,1,0,0,0,1,1,97,1.0,1.0,0.0,0.0,0.0,1.0,1.0,4,1,3,1.0,0.0,1.0
9904233,17,9,8,10,2,15,86,12,2.0,2.0,0.0,0.0,0.0,2.0,10.0,46,17,29,5.0,2.0,3.0
9404216,7,3,4,6,3,4,4,198,4.0,2.0,2.0,3.0,4.0,0.0,0.0,8,7,1,5.0,5.0,0.0
9909302,5,1,4,4,0,5,35,56,5.0,1.0,4.0,4.0,0.0,5.0,35.0,13,5,8,13.0,5.0,8.0
9904309,2,1,1,1,0,2,4,56,,,,,,,,4,2,2,1.0,0.0,1.0
6051,7,5,2,2,1,6,22,41,2.0,1.0,1.0,1.0,0.0,2.0,12.0,35,7,28,9.0,2.0,7.0
9912340,3,3,0,0,1,2,32,9,2.0,2.0,0.0,0.0,1.0,1.0,14.0,80,3,77,13.0,1.0,12.0
4148,12,4,8,20,0,12,58,32,8.0,4.0,4.0,11.0,0.0,8.0,51.0,27,12,15,5.0,5.0,0.0
9604367,6,6,0,0,2,4,22,38,1.0,1.0,0.0,0.0,0.0,1.0,2.0,18,6,12,2.0,1.0,1.0
9310270,7,3,4,6,7,0,0,100,3.0,1.0,2.0,2.0,3.0,0.0,0.0,7,7,0,2.0,2.0,0.0
9809493,7,4,3,3,0,7,18,12,2.0,1.0,1.0,1.0,0.0,2.0,5.0,14,7,7,2.0,0.0,2.0
103142,0,0,0,0,0,0,0,84,0.0,0.0,0.0,0.0,0.0,0.0,0.0,6,0,6,1.0,0.0,1.0
209069,1,1,0,0,1,0,0,518,0.0,0.0,0.0,0.0,0.0,0.0,0.0,2,1,1,1.0,0.0,1.0
9404240,6,4,2,2,6,0,0,183,3.0,2.0,1.0,1.0,3.0,0.0,0.0,6,6,0,3.0,3.0,0.0
208073,5,5,0,0,0,5,51,8,2.0,2.0,0.0,0.0,0.0,2.0,27.0,56,5,51,34.0,2.0,32.0
9505444,3,3,0,0,3,0,0,434,1.0,1.0,0.0,0.0,1.0,0.0,0.0,3,3,0,1.0,1.0,0.0
9507310,6,3,3,3,2,4,6,303,2.0,1.0,1.0,1.0,0.0,2.0,2.0,13,6,7,4.0,2.0,2.0
9802436,6,2,4,6,0,6,19,191,6.0,2.0,4.0,6.0,0.0,6.0,11.0,12,6,6,9.0,6.0,3.0
108270,0,0,0,0,0,0,0,1114,,,,,,,,1,0,1,,,
9805419,9,6,3,7,1,8,20,28,4.0,3.0,1.0,1.0,1.0,3.0,6.0,23,9,14,5.0,1.0,4.0
9911332,9,3,6,13,1,8,53,17,6.0,2.0,4.0,8.0,0.0,6.0,43.0,21,9,12,9.0,4.0,5.0
9712325,14,1,13,43,0,14,52,49,12.0,1.0,11.0,37.0,2.0,10.0,30.0,27,14,13,9.0,9.0,0.0
7344,4,2,2,2,2,2,15,29,2.0,1.0,1.0,1.0,0.0,2.0,13.0,29,4,25,7.0,0.0,7.0
9611410,1,1,0,0,0,1,1,391,1.0,1.0,0.0,0.0,0.0,1.0,1.0,4,1,3,3.0,1.0,2.0
1296,7,3,4,7,0,7,31,3,1.0,1.0,0.0,0.0,0.0,1.0,10.0,45,7,38,5.0,0.0,5.0
7269,10,1,9,29,7,3,14,2,8.0,1.0,7.0,26.0,8.0,0.0,0.0,18,10,8,8.0,8.0,0.0
9308290,7,6,1,1,4,3,3,237,4.0,3.0,1.0,1.0,1.0,3.0,3.0,8,7,1,4.0,3.0,1.0
9412246,3,1,2,3,3,0,0,274,2.0,1.0,1.0,1.0,2.0,0.0,0.0,4,3,1,2.0,2.0,0.0
9703331,2,1,1,1,2,0,0,1195,,,,,,,,3,2,1,,,
9804298,18,1,17,83,1,17,95,67,17.0,1.0,16.0,77.0,1.0,16.0,86.0,34,18,16,22.0,15.0,7.0
9409332,4,4,0,0,4,0,0,280,3.0,3.0,0.0,0.0,3.0,0.0,0.0,4,4,0,2.0,2.0,0.0
8138,7,5,2,3,1,6,15,50,3.0,3.0,0.0,0.0,0.0,3.0,3.0,14,7,7,2.0,0.0,2.0
9608354,2,2,0,0,0,2,10,50,1.0,1.0,0.0,0.0,0.0,1.0,4.0,7,2,5,3.0,1.0,2.0
207351,2,2,0,0,0,2,11,71,1.0,1.0,0.0,0.0,0.0,1.0,7.0,29,2,27,3.0,0.0,3.0
9703295,2,2,0,0,0,2,2,34,2.0,2.0,0.0,0.0,2.0,0.0,0.0,21,2,19,2.0,0.0,2.0
9909442,5,2,3,5,0,5,12,147,4.0,2.0,2.0,2.0,0.0,4.0,6.0,8,5,3,3.0,2.0,1.0
9612407,0,0,0,0,0,0,0,488,0.0,0.0,0.0,0.0,0.0,0.0,0.0,2,0,2,2.0,0.0,2.0
9706417,20,6,14,36,5,15,89,7,12.0,2.0,10.0,26.0,0.0,12.0,58.0,44,20,24,20.0,9.0,11.0
9506202,1,1,0,0,0,1,1,652,1.0,1.0,0.0,0.0,1.0,0.0,0.0,4,1,3,1.0,1.0,0.0
9605208,1,1,0,0,1,0,0,57,0.0,0.0,0.0,0.0,0.0,0.0,0.0,11,1,10,5.0,0.0,5.0
9810210,0,0,0,0,0,0,0,48,0.0,0.0,0.0,0.0,0.0,0.0,0.0,3,0,3,2.0,0.0,2.0
9603282,5,5,0,0,0,5,14,10,2.0,2.0,0.0,0.0,0.0,2.0,5.0,51,5,46,13.0,0.0,13.0
9810393,13,5,8,13,3,10,30,15,2.0,2.0,0.0,0.0,2.0,0.0,0.0,36,13,23,3.0,1.0,2.0
208272,2,1,1,1,0,2,26,131,1.0,1.0,0.0,0.0,0.0,1.0,10.0,31,2,29,11.0,1.0,10.0
9811346,7,5,2,3,0,7,28,40,6.0,4.0,2.0,3.0,0.0,6.0,27.0,14,7,7,11.0,4.0,7.0
9408325,2,1,1,1,1,1,1,39,0.0,0.0,0.0,0.0,0.0,0.0,0.0,6,2,4,1.0,0.0,1.0
4190,15,4,11,26,0,15,72,48,10.0,1.0,9.0,21.0,0.0,10.0,41.0,42,15,27,15.0,8.0,7.0
6310,5,5,0,0,1,4,14,360,3.0,3.0,0.0,0.0,0.0,3.0,6.0,14,5,9,1.0,1.0,0.0
9911486,1,1,0,0,0,1,1,9,0.0,0.0,0.0,0.0,0.0,0.0,0.0,14,1,13,1.0,0.0,1.0
201273,17,2,15,24,1,16,73,28,14.0,2.0,12.0,18.0,0.0,14.0,63.0,30,17,13,20.0,10.0,10.0
9708328,5,4,1,1,0,5,12,141,2.0,2.0,0.0,0.0,0.0,2.0,4.0,9,5,4,4.0,3.0,1.0
9811241,2,1,1,1,0,2,2,119,,,,,,,,3,2,1,1.0,1.0,0.0
204138,3,1,2,2,3,0,0,77,0.0,0.0,0.0,0.0,0.0,0.0,0.0,10,3,7,4.0,0.0,4.0
5155,4,3,1,1,2,2,7,67,2.0,1.0,1.0,1.0,0.0,2.0,7.0,9,4,5,,,
3020,16,1,15,51,0,16,51,201,15.0,1.0,14.0,46.0,1.0,14.0,42.0,28,16,12,18.0,14.0,4.0
9312360,10,6,4,10,7,3,4,330,4.0,2.0,2.0,3.0,4.0,0.0,0.0,14,10,4,4.0,4.0,0.0
204180,3,2,1,1,0,3,22,51,3.0,2.0,1.0,1.0,0.0,3.0,14.0,21,3,18,12.0,2.0,10.0
210155,4,2,2,2,0,4,40,3,2.0,1.0,1.0,1.0,0.0,2.0,24.0,79,4,75,19.0,2.0,17.0
207260,4,3,1,1,0,4,11,28,1.0,1.0,0.0,0.0,1.0,0.0,0.0,16,4,12,2.0,0.0,2.0
112246,2,1,1,1,0,2,21,56,1.0,1.0,0.0,0.0,0.0,1.0,6.0,19,2,17,7.0,1.0,6.0
9811242,4,4,0,0,2,2,2,77,1.0,1.0,0.0,0.0,1.0,0.0,0.0,9,4,5,4.0,1.0,3.0
9604297,2,1,1,1,2,0,0,480,1.0,1.0,0.0,0.0,1.0,0.0,0.0,3,2,1,2.0,1.0,1.0
9711429,17,3,14,34,2,15,86,35,12.0,2.0,10.0,23.0,0.0,12.0,72.0,42,17,25,13.0,4.0,9.0
9801414,7,2,5,14,1,6,8,189,7.0,2.0,5.0,14.0,1.0,6.0,8.0,9,7,2,9.0,7.0,2.0
9707502,7,4,3,4,1,6,22,112,2.0,2.0,0.0,0.0,0.0,2.0,9.0,21,7,14,8.0,2.0,6.0
103121,13,3,10,21,0,13,99,1,6.0,2.0,4.0,5.0,0.0,6.0,53.0,42,13,29,6.0,5.0,1.0
201305,5,2,3,3,1,4,19,29,2.0,1.0,1.0,1.0,0.0,2.0,7.0,18,5,13,4.0,1.0,3.0
206133,2,2,0,0,1,1,8,1,0.0,0.0,0.0,0.0,0.0,0.0,0.0,30,2,28,6.0,0.0,6.0
9506407,19,10,9,18,16,3,6,121,6.0,2.0,4.0,8.0,6.0,0.0,0.0,22,19,3,3.0,3.0,0.0
9303217,1,1,0,0,0,1,1,1547,1.0,1.0,0.0,0.0,0.0,1.0,1.0,3,1,2,,,
9311344,21,6,15,48,21,0,0,65,14.0,2.0,12.0,40.0,14.0,0.0,0.0,21,21,0,10.0,10.0,0.0
102116,4,2,2,3,0,4,53,4,2.0,1.0,1.0,1.0,0.0,2.0,29.0,37,4,33,24.0,2.0,22.0
9709365,6,6,0,0,2,4,43,12,2.0,2.0,0.0,0.0,1.0,1.0,7.0,47,6,41,7.0,1.0,6.0
10297,20,6,14,34,3,17,46,9,14.0,2.0,12.0,29.0,2.0,12.0,28.0,46,20,26,11.0,9.0,2.0
9811218,4,2,2,3,3,1,1,39,3.0,2.0,1.0,1.0,3.0,0.0,0.0,8,4,4,1.0,0.0,1.0
9074,2,1,1,1,0,2,10,205,1.0,1.0,0.0,0.0,0.0,1.0,3.0,10,2,8,4.0,1.0,3.0
108274,10,6,4,5,0,10,44,109,1.0,1.0,0.0,0.0,0.0,1.0,6.0,48,10,38,14.0,1.0,13.0
9905498,5,4,1,1,2,3,4,33,4.0,4.0,0.0,0.0,1.0,3.0,3.0,16,5,11,2.0,0.0,2.0
9512271,4,2,2,2,1,3,3,63,3.0,1.0,2.0,2.0,0.0,3.0,3.0,6,4,2,4.0,3.0,1.0
9605257,7,7,0,0,1,6,13,26,1.0,1.0,0.0,0.0,1.0,0.0,0.0,25,7,18,4.0,2.0,2.0
9801307,19,4,15,30,0,19,84,40,13.0,2.0,11.0,21.0,0.0,13.0,50.0,36,19,17,8.0,7.0,1.0
9902446,6,4,2,3,0,6,24,83,3.0,1.0,2.0,3.0,0.0,3.0,8.0,16,6,10,6.0,3.0,3.0
9402207,6,3,3,4,2,4,4,96,3.0,2.0,1.0,1.0,3.0,0.0,0.0,8,6,2,2.0,2.0,0.0
9707496,8,3,5,5,0,8,52,25,8.0,3.0,5.0,5.0,0.0,8.0,52.0,26,8,18,17.0,6.0,11.0
4237,15,5,10,10,0,15,18,11,4.0,3.0,1.0,1.0,0.0,4.0,4.0,20,15,5,6.0,4.0,2.0
204132,2,2,0,0,0,2,13,20,2.0,2.0,0.0,0.0,0.0,2.0,13.0,28,2,26,21.0,0.0,21.0
7351,2,2,0,0,0,2,31,21,2.0,2.0,0.0,0.0,0.0,2.0,30.0,30,2,28,23.0,2.0,21.0
206030,4,2,2,2,0,4,35,12,3.0,2.0,1.0,1.0,0.0,3.0,31.0,43,4,39,20.0,2.0,18.0
110270,3,3,0,0,1,2,29,5,0.0,0.0,0.0,0.0,0.0,0.0,0.0,50,3,47,16.0,0.0,16.0
110332,6,2,4,6,0,6,42,23,3.0,1.0,2.0,3.0,0.0,3.0,3.0,44,6,38,4.0,0.0,4.0
9902286,3,1,2,2,0,3,15,9,3.0,1.0,2.0,2.0,0.0,3.0,15.0,15,3,12,3.0,2.0,1.0
9903398,1,1,0,0,1,0,0,97,,,,,,,,3,1,2,1.0,0.0,1.0
9402357,4,4,0,0,4,0,0,362,1.0,1.0,0.0,0.0,1.0,0.0,0.0,4,4,0,1.0,1.0,0.0
107147,9,4,5,7,1,8,86,4,6.0,2.0,4.0,6.0,0.0,6.0,81.0,35,9,26,9.0,2.0,7.0
9503407,1,1,0,0,1,0,0,252,1.0,1.0,0.0,0.0,1.0,0.0,0.0,1,1,0,1.0,1.0,0.0
9903348,5,3,2,2,0,5,26,26,0.0,0.0,0.0,0.0,0.0,0.0,0.0,31,5,26,6.0,4.0,2.0
110062,9,2,7,15,0,9,115,9,9.0,2.0,7.0,15.0,0.0,9.0,109.0,50,9,41,24.0,2.0,22.0
205229,0,0,0,0,0,0,0,654,0.0,0.0,0.0,0.0,0.0,0.0,0.0,1,0,1,1.0,0.0,1.0
204342,24,5,19,66,1,23,80,2,12.0,1.0,11.0,44.0,0.0,12.0,41.0,37,24,13,19.0,12.0,7.0
112353,1,1,0,0,0,1,7,12,0.0,0.0,0.0,0.0,0.0,0.0,0.0,30,1,29,5.0,0.0,5.0
204204,1,1,0,0,0,1,8,24,1.0,1.0,0.0,0.0,0.0,1.0,3.0,10,1,9,3.0,1.0,2.0
9406247,0,0,0,0,0,0,0,96,0.0,0.0,0.0,0.0,0.0,0.0,0.0,6,0,6,1.0,0.0,1.0
111188,4,1,3,3,0,4,66,68,4.0,1.0,3.0,3.0,0.0,4.0,52.0,37,4,33,26.0,4.0,22.0
102133,1,1,0,0,0,1,4,77,0.0,0.0,0.0,0.0,0.0,0.0,0.0,20,1,19,4.0,0.0,4.0
1061,3,2,1,1,0,3,16,2,1.0,1.0,0.0,0.0,0.0,1.0,1.0,11,3,8,1.0,1.0,0.0
201251,5,4,1,1,0,5,13,5,0.0,0.0,0.0,0.0,0.0,0.0,0.0,36,5,31,6.0,2.0,4.0
9405206,2,1,1,1,1,1,1,35,0.0,0.0,0.0,0.0,0.0,0.0,0.0,9,2,7,2.0,1.0,1.0
9904228,2,2,0,0,0,2,9,33,1.0,1.0,0.0,0.0,0.0,1.0,2.0,11,2,9,4.0,0.0,4.0
209337,7,4,3,6,0,7,99,28,7.0,4.0,3.0,6.0,0.0,7.0,83.0,32,7,25,27.0,6.0,21.0
9103,2,2,0,0,1,1,2,85,0.0,0.0,0.0,0.0,0.0,0.0,0.0,17,2,15,6.0,0.0,6.0
9610379,6,3,3,4,4,2,2,40,1.0,1.0,0.0,0.0,1.0,0.0,0.0,8,6,2,1.0,0.0,1.0
9811411,9,5,4,5,2,7,12,13,4.0,1.0,3.0,4.0,4.0,0.0,0.0,14,9,5,4.0,4.0,0.0
9209216,1,1,0,0,1,0,0,323,1.0,1.0,0.0,0.0,1.0,0.0,0.0,1,1,0,1.0,1.0,0.0
9406378,13,5,8,19,1,12,25,134,7.0,2.0,5.0,11.0,0.0,7.0,14.0,17,13,4,8.0,6.0,2.0
9705449,4,1,3,6,0,4,35,10,1.0,1.0,0.0,0.0,0.0,1.0,5.0,26,4,22,5.0,1.0,4.0
9612306,2,2,0,0,1,1,1,203,0.0,0.0,0.0,0.0,0.0,0.0,0.0,5,2,3,1.0,1.0,0.0
9311313,8,3,5,5,2,6,6,25,1.0,1.0,0.0,0.0,1.0,0.0,0.0,9,8,1,5.0,4.0,1.0
9705261,10,3,7,9,3,7,12,49,6.0,2.0,4.0,5.0,1.0,5.0,5.0,18,10,8,3.0,2.0,1.0
9804443,1,1,0,0,0,1,5,11,1.0,1.0,0.0,0.0,0.0,1.0,1.0,23,1,22,2.0,0.0,2.0
9810474,5,2,3,4,0,5,32,9,3.0,1.0,2.0,2.0,0.0,3.0,18.0,15,5,10,11.0,5.0,6.0
110047,5,2,3,5,0,5,11,25,4.0,1.0,3.0,4.0,1.0,3.0,3.0,9,5,4,6.0,4.0,2.0
9806422,1,1,0,0,0,1,1,88,0.0,0.0,0.0,0.0,0.0,0.0,0.0,7,1,6,2.0,0.0,2.0
211163,1,1,0,0,0,1,5,50,0.0,0.0,0.0,0.0,0.0,0.0,0.0,25,1,24,4.0,0.0,4.0
9509245,3,3,0,0,1,2,4,59,0.0,0.0,0.0,0.0,0.0,0.0,0.0,9,3,6,2.0,1.0,1.0
9311216,9,3,6,8,9,0,0,65,3.0,1.0,2.0,3.0,3.0,0.0,0.0,9,9,0,3.0,3.0,0.0
9709281,1,1,0,0,0,1,1,151,0.0,0.0,0.0,0.0,0.0,0.0,0.0,12,1,11,6.0,0.0,6.0
9412331,1,1,0,0,0,1,1,317,1.0,1.0,0.0,0.0,0.0,1.0,1.0,3,1,2,3.0,1.0,2.0
9304212,5,4,1,1,5,0,0,160,4.0,3.0,1.0,1.0,4.0,0.0,0.0,5,5,0,1.0,1.0,0.0
9707268,7,2,5,9,1,6,12,82,6.0,1.0,5.0,9.0,0.0,6.0,9.0,11,7,4,2.0,1.0,1.0
9902349,0,0,0,0,0,0,0,316,0.0,0.0,0.0,0.0,0.0,0.0,0.0,4,0,4,1.0,0.0,1.0
9607229,4,3,1,1,0,4,10,43,0.0,0.0,0.0,0.0,0.0,0.0,0.0,17,4,13,5.0,1.0,4.0
6296,3,2,1,1,2,1,1,145,0.0,0.0,0.0,0.0,0.0,0.0,0.0,15,3,12,6.0,0.0,6.0
9507217,1,1,0,0,0,1,1,452,0.0,0.0,0.0,0.0,0.0,0.0,0.0,3,1,2,1.0,0.0,1.0
9708320,5,2,3,5,0,5,8,131,1.0,1.0,0.0,0.0,0.0,1.0,1.0,11,5,6,3.0,3.0,0.0
210132,1,1,0,0,0,1,5,8,0.0,0.0,0.0,0.0,0.0,0.0,0.0,10,1,9,3.0,1.0,2.0
210284,4,1,3,4,0,4,22,20,0.0,0.0,0.0,0.0,0.0,0.0,0.0,20,4,16,5.0,0.0,5.0
211414,2,2,0,0,0,2,9,0,1.0,1.0,0.0,0.0,0.0,1.0,6.0,18,2,16,3.0,0.0,3.0
1027,5,5,0,0,3,2,4,122,1.0,1.0,0.0,0.0,0.0,1.0,3.0,11,5,6,6.0,1.0,5.0
10081,7,4,3,4,0,7,40,5,2.0,2.0,0.0,0.0,0.0,2.0,19.0,23,7,16,2.0,1.0,1.0
7307,2,2,0,0,0,2,14,4,1.0,1.0,0.0,0.0,0.0,1.0,8.0,31,2,29,15.0,0.0,15.0
106077,8,3,5,10,0,8,72,2,6.0,2.0,4.0,8.0,0.0,6.0,51.0,23,8,15,16.0,6.0,10.0
5141,3,2,1,1,0,3,13,78,3.0,2.0,1.0,1.0,0.0,3.0,11.0,23,3,20,5.0,2.0,3.0
8141,9,3,6,12,2,7,24,48,7.0,3.0,4.0,8.0,2.0,5.0,5.0,35,9,26,10.0,7.0,3.0
9612324,5,4,1,1,2,3,3,449,0.0,0.0,0.0,0.0,0.0,0.0,0.0,12,5,7,3.0,2.0,1.0
9902291,5,3,2,3,3,2,7,5,3.0,1.0,2.0,3.0,3.0,0.0,0.0,15,5,10,2.0,0.0,2.0
9810529,13,5,8,10,1,12,38,20,6.0,2.0,4.0,5.0,1.0,5.0,5.0,20,13,7,7.0,5.0,2.0
204340,1,1,0,0,0,1,2,64,1.0,1.0,0.0,0.0,0.0,1.0,2.0,13,1,12,2.0,0.0,2.0
9709262,5,4,1,1,0,5,30,69,3.0,3.0,0.0,0.0,0.0,3.0,23.0,29,5,24,13.0,2.0,11.0
9508382,2,2,0,0,1,1,2,78,1.0,1.0,0.0,0.0,1.0,0.0,0.0,5,2,3,1.0,1.0,0.0
106174,3,3,0,0,0,3,17,2,2.0,2.0,0.0,0.0,0.0,2.0,13.0,16,3,13,9.0,0.0,9.0
104005,3,2,1,1,1,2,11,59,2.0,1.0,1.0,1.0,0.0,2.0,11.0,12,3,9,1.0,0.0,1.0
202175,1,1,0,0,0,1,4,6,1.0,1.0,0.0,0.0,0.0,1.0,4.0,17,1,16,3.0,1.0,2.0
9506385,8,4,4,6,8,0,0,91,5.0,2.0,3.0,5.0,5.0,0.0,0.0,8,8,0,5.0,5.0,0.0
9606343,3,2,1,1,0,3,6,7,0.0,0.0,0.0,0.0,0.0,0.0,0.0,14,3,11,5.0,3.0,2.0
208240,1,1,0,0,0,1,19,5,1.0,1.0,0.0,0.0,0.0,1.0,17.0,59,1,58,27.0,1.0,26.0
205039,4,3,1,1,0,4,43,6,2.0,1.0,1.0,1.0,0.0,2.0,31.0,31,4,27,8.0,1.0,7.0
9906291,2,2,0,0,0,2,11,17,1.0,1.0,0.0,0.0,0.0,1.0,10.0,20,2,18,2.0,1.0,1.0
9712310,5,4,1,1,2,3,3,105,3.0,2.0,1.0,1.0,0.0,3.0,3.0,9,5,4,1.0,1.0,0.0
203044,1,1,0,0,0,1,3,58,1.0,1.0,0.0,0.0,0.0,1.0,3.0,8,1,7,2.0,0.0,2.0
205130,2,1,1,1,0,2,6,178,2.0,1.0,1.0,1.0,0.0,2.0,6.0,5,2,3,5.0,2.0,3.0
9307255,0,0,0,0,0,0,0,93,,,,,,,,1,0,1,,,
9305255,1,1,0,0,1,0,0,867,1.0,1.0,0.0,0.0,1.0,0.0,0.0,2,1,1,1.0,1.0,0.0
9812440,22,5,17,48,0,22,222,53,16.0,3.0,13.0,41.0,0.0,16.0,196.0,42,22,20,33.0,14.0,19.0
108213,11,2,9,16,0,11,77,27,10.0,2.0,8.0,14.0,0.0,10.0,56.0,26,11,15,14.0,5.0,9.0
9607479,3,2,1,1,0,3,9,57,2.0,1.0,1.0,1.0,0.0,2.0,6.0,14,3,11,5.0,0.0,5.0
7017,2,2,0,0,1,1,17,34,1.0,1.0,0.0,0.0,0.0,1.0,17.0,32,2,30,25.0,1.0,24.0
9805319,8,6,2,2,2,6,20,31,4.0,4.0,0.0,0.0,0.0,4.0,15.0,25,8,17,7.0,1.0,6.0
9611242,3,3,0,0,0,3,6,52,2.0,2.0,0.0,0.0,0.0,2.0,5.0,14,3,11,3.0,0.0,3.0
9510223,6,5,1,1,3,3,7,40,2.0,1.0,1.0,1.0,0.0,2.0,5.0,13,6,7,2.0,1.0,1.0
3101,1,1,0,0,0,1,4,3,0.0,0.0,0.0,0.0,0.0,0.0,0.0,43,1,42,20.0,0.0,20.0
9904346,3,2,1,1,0,3,13,31,3.0,2.0,1.0,1.0,0.0,3.0,12.0,14,3,11,5.0,2.0,3.0
211333,1,1,0,0,0,1,7,32,0.0,0.0,0.0,0.0,0.0,0.0,0.0,16,1,15,5.0,0.0,5.0
9406226,2,1,1,1,0,2,6,79,1.0,1.0,0.0,0.0,0.0,1.0,2.0,11,2,9,3.0,0.0,3.0
3179,9,3,6,17,0,9,81,8,8.0,2.0,6.0,17.0,0.0,8.0,68.0,31,9,22,19.0,5.0,14.0
10014,0,0,0,0,0,0,0,189,0.0,0.0,0.0,0.0,0.0,0.0,0.0,6,0,6,1.0,0.0,1.0
9712232,6,4,2,2,0,6,15,31,6.0,4.0,2.0,2.0,0.0,6.0,12.0,10,6,4,2.0,2.0,0.0
9505246,6,6,0,0,4,2,5,74,2.0,2.0,0.0,0.0,2.0,0.0,0.0,16,6,10,2.0,2.0,0.0
7046,2,2,0,0,0,2,3,102,0.0,0.0,0.0,0.0,0.0,0.0,0.0,51,2,49,24.0,0.0,24.0
204305,3,2,1,1,0,3,8,159,1.0,1.0,0.0,0.0,0.0,1.0,4.0,20,3,17,5.0,1.0,4.0
12331,1,1,0,0,0,1,8,27,1.0,1.0,0.0,0.0,0.0,1.0,5.0,19,1,18,,,
5033,3,1,2,3,3,0,0,87,,,,,,,,6,3,3,,,
9610382,4,3,1,1,2,2,10,26,0.0,0.0,0.0,0.0,0.0,0.0,0.0,18,4,14,4.0,1.0,3.0
203211,2,1,1,1,2,0,0,201,0.0,0.0,0.0,0.0,0.0,0.0,0.0,12,2,10,,,
9805282,7,3,4,9,0,7,38,158,5.0,1.0,4.0,9.0,0.0,5.0,30.0,21,7,14,19.0,5.0,14.0
6226,3,2,1,1,2,1,1,335,2.0,1.0,1.0,1.0,2.0,0.0,0.0,4,3,1,2.0,2.0,0.0
103084,5,2,3,3,0,5,39,23,4.0,1.0,3.0,3.0,0.0,4.0,36.0,27,5,22,9.0,1.0,8.0
102336,4,2,2,2,0,4,31,17,4.0,2.0,2.0,2.0,0.0,4.0,21.0,23,4,19,12.0,4.0,8.0
9707480,9,1,8,21,0,9,48,17,8.0,1.0,7.0,20.0,0.0,8.0,43.0,23,9,14,6.0,5.0,1.0
111113,2,1,1,1,0,2,10,22,1.0,1.0,0.0,0.0,0.0,1.0,4.0,14,2,12,3.0,2.0,1.0
210209,3,2,1,1,0,3,25,108,1.0,1.0,0.0,0.0,0.0,1.0,12.0,22,3,19,10.0,1.0,9.0
204289,2,2,0,0,0,2,2,249,1.0,1.0,0.0,0.0,0.0,1.0,1.0,4,2,2,3.0,2.0,1.0
205206,1,1,0,0,0,1,2,146,1.0,1.0,0.0,0.0,0.0,1.0,2.0,4,1,3,,,
9609297,9,6,3,3,1,8,38,26,4.0,2.0,2.0,2.0,0.0,4.0,27.0,24,9,15,11.0,4.0,7.0
9708397,5,2,3,5,5,0,0,0,1.0,1.0,0.0,0.0,1.0,0.0,0.0,8,5,3,1.0,1.0,0.0
110153,10,5,5,6,4,6,22,13,3.0,1.0,2.0,2.0,0.0,3.0,12.0,24,10,14,8.0,3.0,5.0
8063,1,1,0,0,0,1,3,163,1.0,1.0,0.0,0.0,0.0,1.0,3.0,14,1,13,4.0,1.0,3.0
9912245,10,5,5,6,10,0,0,202,3.0,2.0,1.0,1.0,3.0,0.0,0.0,12,10,2,2.0,2.0,0.0
11398,4,2,2,2,0,4,7,309,2.0,1.0,1.0,1.0,0.0,2.0,4.0,9,4,5,4.0,2.0,2.0
102108,1,1,0,0,0,1,3,34,,,,,,,,4,1,3,,,
9407357,1,1,0,0,1,0,0,1848,1.0,1.0,0.0,0.0,1.0,0.0,0.0,1,1,0,1.0,1.0,0.0
208251,8,6,2,2,1,7,34,23,3.0,2.0,1.0,1.0,0.0,3.0,16.0,30,8,22,17.0,0.0,17.0
9710405,1,1,0,0,1,0,0,233,1.0,1.0,0.0,0.0,1.0,0.0,0.0,3,1,2,2.0,1.0,1.0
1168,3,3,0,0,1,2,3,21,,,,,,,,7,3,4,,,
112174,5,2,3,5,0,5,39,1,5.0,2.0,3.0,5.0,0.0,5.0,37.0,21,5,16,2.0,1.0,1.0
9908306,2,2,0,0,0,2,12,1,1.0,1.0,0.0,0.0,0.0,1.0,5.0,37,2,35,24.0,0.0,24.0
9611390,1,1,0,0,1,0,0,52,0.0,0.0,0.0,0.0,0.0,0.0,0.0,8,1,7,2.0,0.0,2.0
9803472,4,2,2,3,0,4,12,40,0.0,0.0,0.0,0.0,0.0,0.0,0.0,10,4,6,3.0,1.0,2.0
206306,8,6,2,3,0,8,70,9,8.0,6.0,2.0,3.0,0.0,8.0,70.0,34,8,26,7.0,4.0,3.0
102038,3,2,1,1,0,3,3,51,2.0,1.0,1.0,1.0,2.0,0.0,0.0,4,3,1,1.0,1.0,0.0
104169,1,1,0,0,0,1,9,24,1.0,1.0,0.0,0.0,0.0,1.0,8.0,11,1,10,,,
4062,6,3,3,6,0,6,9,308,4.0,1.0,3.0,6.0,4.0,0.0,0.0,13,6,7,6.0,4.0,2.0
9603243,1,1,0,0,0,1,1,190,1.0,1.0,0.0,0.0,0.0,1.0,1.0,5,1,4,2.0,0.0,2.0
9408330,4,3,1,1,2,2,3,74,2.0,1.0,1.0,1.0,2.0,0.0,0.0,6,4,2,2.0,2.0,0.0
9609338,0,0,0,0,0,0,0,17,0.0,0.0,0.0,0.0,0.0,0.0,0.0,13,0,13,,,
9804361,5,3,2,2,1,4,9,105,5.0,3.0,2.0,2.0,1.0,4.0,6.0,11,5,6,5.0,4.0,1.0
9302296,3,1,2,3,0,3,4,124,3.0,1.0,2.0,3.0,3.0,0.0,0.0,5,3,2,1.0,1.0,0.0
9709265,3,3,0,0,1,2,2,160,1.0,1.0,0.0,0.0,0.0,1.0,1.0,5,3,2,2.0,1.0,1.0
9503480,2,1,1,1,2,0,0,116,1.0,1.0,0.0,0.0,1.0,0.0,0.0,2,2,0,1.0,1.0,0.0
9905427,15,6,9,22,5,10,22,171,12.0,4.0,8.0,21.0,8.0,4.0,4.0,22,15,7,9.0,8.0,1.0
3077,3,2,1,1,0,3,4,63,3.0,2.0,1.0,1.0,0.0,3.0,3.0,7,3,4,1.0,1.0,0.0
9504414,4,2,2,3,4,0,0,113,2.0,1.0,1.0,1.0,2.0,0.0,0.0,4,4,0,3.0,3.0,0.0
209365,1,1,0,0,0,1,1,17,0.0,0.0,0.0,0.0,0.0,0.0,0.0,9,1,8,1.0,0.0,1.0
107302,4,4,0,0,0,4,10,72,2.0,2.0,0.0,0.0,0.0,2.0,3.0,13,4,9,4.0,1.0,3.0
9509261,8,2,6,14,3,5,5,82,7.0,1.0,6.0,14.0,2.0,5.0,5.0,9,8,1,2.0,2.0,0.0
9905452,9,4,5,7,9,0,0,102,6.0,3.0,3.0,5.0,6.0,0.0,0.0,9,9,0,5.0,5.0,0.0
9902311,1,1,0,0,0,1,2,169,0.0,0.0,0.0,0.0,0.0,0.0,0.0,18,1,17,7.0,0.0,7.0
1149,8,6,2,2,4,4,5,309,2.0,2.0,0.0,0.0,0.0,2.0,2.0,18,8,10,5.0,3.0,2.0
9611210,9,6,3,5,4,5,11,54,4.0,1.0,3.0,5.0,4.0,0.0,0.0,19,9,10,5.0,4.0,1.0
9606315,2,2,0,0,0,2,6,82,2.0,2.0,0.0,0.0,0.0,2.0,5.0,8,2,6,1.0,0.0,1.0
105186,1,1,0,0,0,1,11,2,1.0,1.0,0.0,0.0,0.0,1.0,7.0,15,1,14,12.0,1.0,11.0
9501302,0,0,0,0,0,0,0,295,0.0,0.0,0.0,0.0,0.0,0.0,0.0,3,0,3,1.0,0.0,1.0
9511281,1,1,0,0,0,1,6,134,1.0,1.0,0.0,0.0,0.0,1.0,5.0,11,1,10,9.0,1.0,8.0
9607295,1,1,0,0,0,1,4,531,0.0,0.0,0.0,0.0,0.0,0.0,0.0,11,1,10,2.0,1.0,1.0
9908467,6,2,4,5,2,4,9,80,4.0,1.0,3.0,4.0,1.0,3.0,6.0,13,6,7,4.0,2.0,2.0
9812326,14,9,5,8,12,2,2,120,4.0,2.0,2.0,2.0,4.0,0.0,0.0,18,14,4,2.0,2.0,0.0
9312247,5,3,2,3,5,0,0,91,3.0,1.0,2.0,3.0,3.0,0.0,0.0,5,5,0,3.0,3.0,0.0
8303,2,2,0,0,0,2,6,0,0.0,0.0,0.0,0.0,0.0,0.0,0.0,32,2,30,1.0,0.0,1.0
205153,6,2,4,6,0,6,21,66,6.0,2.0,4.0,6.0,0.0,6.0,21.0,12,6,6,10.0,5.0,5.0
210196,0,0,0,0,0,0,0,63,,,,,,,,8,0,8,1.0,0.0,1.0
9605255,1,1,0,0,1,0,0,600,1.0,1.0,0.0,0.0,1.0,0.0,0.0,7,1,6,1.0,1.0,0.0
205075,1,1,0,0,0,1,1,46,0.0,0.0,0.0,0.0,0.0,0.0,0.0,22,1,21,1.0,0.0,1.0
210117,0,0,0,0,0,0,0,278,0.0,0.0,0.0,0.0,0.0,0.0,0.0,12,0,12,7.0,0.0,7.0
8082,2,2,0,0,1,1,1,190,1.0,1.0,0.0,0.0,0.0,1.0,1.0,3,2,1,2.0,1.0,1.0
9809571,4,1,3,4,0,4,19,76,4.0,1.0,3.0,4.0,0.0,4.0,19.0,11,4,7,11.0,4.0,7.0
202120,2,2,0,0,0,2,10,7,1.0,1.0,0.0,0.0,0.0,1.0,2.0,24,2,22,14.0,0.0,14.0
105218,0,0,0,0,0,0,0,147,0.0,0.0,0.0,0.0,0.0,0.0,0.0,2,0,2,1.0,0.0,1.0
9611348,2,1,1,1,1,1,1,117,,,,,,,,4,2,2,1.0,0.0,1.0
9910284,7,6,1,1,4,3,5,247,5.0,4.0,1.0,1.0,2.0,3.0,5.0,12,7,5,4.0,1.0,3.0
9905502,2,2,0,0,0,2,7,90,1.0,1.0,0.0,0.0,0.0,1.0,6.0,9,2,7,3.0,0.0,3.0
210332,5,4,1,1,0,5,61,11,4.0,3.0,1.0,1.0,0.0,4.0,57.0,36,5,31,25.0,3.0,22.0
9191,0,0,0,0,0,0,0,197,0.0,0.0,0.0,0.0,0.0,0.0,0.0,5,0,5,4.0,0.0,4.0
103162,4,2,2,3,0,4,14,156,3.0,2.0,1.0,2.0,0.0,3.0,10.0,10,4,6,7.0,3.0,4.0
8246,4,2,2,3,0,4,24,31,4.0,2.0,2.0,3.0,0.0,4.0,23.0,16,4,12,12.0,2.0,10.0
6089,2,1,1,1,0,2,2,8,2.0,1.0,1.0,1.0,0.0,2.0,2.0,7,2,5,1.0,0.0,1.0
9510279,3,3,0,0,0,3,14,10,3.0,3.0,0.0,0.0,0.0,3.0,9.0,12,3,9,4.0,1.0,3.0
9512382,1,1,0,0,0,1,3,196,1.0,1.0,0.0,0.0,0.0,1.0,3.0,5,1,4,2.0,1.0,1.0
9903409,3,3,0,0,2,1,1,306,1.0,1.0,0.0,0.0,1.0,0.0,0.0,5,3,2,1.0,1.0,0.0
12356,1,1,0,0,1,0,0,98,0.0,0.0,0.0,0.0,0.0,0.0,0.0,10,1,9,7.0,0.0,7.0
207217,1,1,0,0,0,1,1,132,1.0,1.0,0.0,0.0,0.0,1.0,1.0,6,1,5,4.0,1.0,3.0
101052,0,0,0,0,0,0,0,112,0.0,0.0,0.0,0.0,0.0,0.0,0.0,6,0,6,3.0,0.0,3.0
206115,2,2,0,0,0,2,12,62,1.0,1.0,0.0,0.0,0.0,1.0,6.0,11,2,9,7.0,1.0,6.0
8114,12,5,7,18,4,8,40,71,6.0,2.0,4.0,9.0,0.0,6.0,37.0,25,12,13,16.0,4.0,12.0
9912333,1,1,0,0,0,1,1,170,0.0,0.0,0.0,0.0,0.0,0.0,0.0,18,1,17,5.0,0.0,5.0
111082,10,2,8,20,1,9,60,53,8.0,2.0,6.0,15.0,0.0,8.0,56.0,19,10,9,16.0,8.0,8.0
206305,2,1,1,1,1,1,8,9,1.0,1.0,0.0,0.0,0.0,1.0,3.0,13,2,11,4.0,1.0,3.0
112116,0,0,0,0,0,0,0,84,0.0,0.0,0.0,0.0,0.0,0.0,0.0,14,0,14,6.0,0.0,6.0
207165,2,2,0,0,0,2,14,74,2.0,2.0,0.0,0.0,0.0,2.0,14.0,18,2,16,7.0,0.0,7.0
205243,0,0,0,0,0,0,0,215,0.0,0.0,0.0,0.0,0.0,0.0,0.0,7,0,7,2.0,0.0,2.0
207320,0,0,0,0,0,0,0,380,0.0,0.0,0.0,0.0,0.0,0.0,0.0,6,0,6,3.0,0.0,3.0
9804293,6,4,2,2,0,6,21,1,5.0,4.0,1.0,1.0,0.0,5.0,6.0,18,6,12,4.0,3.0,1.0
9208216,3,2,1,1,3,0,0,241,2.0,1.0,1.0,1.0,2.0,0.0,0.0,3,3,0,,,
212116,6,3,3,3,2,4,7,119,2.0,1.0,1.0,1.0,0.0,2.0,3.0,13,6,7,6.0,0.0,6.0
102221,12,4,8,15,0,12,39,127,10.0,2.0,8.0,15.0,0.0,10.0,35.0,22,12,10,14.0,8.0,6.0
9811207,1,1,0,0,1,0,0,227,,,,,,,,4,1,3,1.0,1.0,0.0
9503405,1,1,0,0,1,0,0,480,1.0,1.0,0.0,0.0,1.0,0.0,0.0,1,1,0,1.0,1.0,0.0
206296,0,0,0,0,0,0,0,353,0.0,0.0,0.0,0.0,0.0,0.0,0.0,4,0,4,3.0,0.0,3.0
9406355,1,1,0,0,1,0,0,96,,,,,,,,4,1,3,,,
207336,0,0,0,0,0,0,0,9,0.0,0.0,0.0,0.0,0.0,0.0,0.0,17,0,17,2.0,0.0,2.0
202268,2,1,1,1,0,2,4,201,1.0,1.0,0.0,0.0,0.0,1.0,2.0,7,2,5,3.0,1.0,2.0
9907262,1,1,0,0,0,1,1,153,1.0,1.0,0.0,0.0,0.0,1.0,1.0,2,1,1,2.0,1.0,1.0
9408355,2,2,0,0,2,0,0,576,1.0,1.0,0.0,0.0,1.0,0.0,0.0,2,2,0,1.0,1.0,0.0
9116,4,4,0,0,0,4,22,31,3.0,3.0,0.0,0.0,0.0,3.0,6.0,18,4,14,5.0,3.0,2.0
9403368,9,3,6,7,9,0,0,139,9.0,3.0,6.0,7.0,9.0,0.0,0.0,13,9,4,6.0,6.0,0.0
9602321,1,1,0,0,0,1,1,202,1.0,1.0,0.0,0.0,1.0,0.0,0.0,3,1,2,1.0,1.0,0.0
202257,13,2,11,24,0,13,99,37,3.0,3.0,0.0,0.0,0.0,3.0,31.0,43,13,30,7.0,5.0,2.0
9811485,4,2,2,3,2,2,11,15,2.0,1.0,1.0,1.0,2.0,0.0,0.0,11,4,7,2.0,2.0,0.0
9304268,1,1,0,0,1,0,0,939,1.0,1.0,0.0,0.0,1.0,0.0,0.0,1,1,0,1.0,1.0,0.0
9401343,3,2,1,1,3,0,0,323,3.0,2.0,1.0,1.0,3.0,0.0,0.0,3,3,0,3.0,3.0,0.0
1064,8,2,6,20,0,8,12,23,7.0,1.0,6.0,20.0,0.0,7.0,11.0,15,8,7,7.0,6.0,1.0
109145,0,0,0,0,0,0,0,3,0.0,0.0,0.0,0.0,0.0,0.0,0.0,10,0,10,6.0,0.0,6.0
9277,0,0,0,0,0,0,0,18,,,,,,,,6,0,6,1.0,0.0,1.0
211328,1,1,0,0,1,0,0,339,0.0,0.0,0.0,0.0,0.0,0.0,0.0,16,1,15,5.0,0.0,5.0
112182,3,2,1,1,0,3,26,92,1.0,1.0,0.0,0.0,0.0,1.0,5.0,28,3,25,14.0,2.0,12.0
9910369,1,1,0,0,0,1,1,233,1.0,1.0,0.0,0.0,0.0,1.0,1.0,7,1,6,2.0,1.0,1.0
9610484,2,2,0,0,0,2,4,291,1.0,1.0,0.0,0.0,1.0,0.0,0.0,10,2,8,3.0,2.0,1.0
9911498,3,1,2,2,0,3,11,91,3.0,1.0,2.0,2.0,0.0,3.0,11.0,8,3,5,3.0,2.0,1.0
111306,0,0,0,0,0,0,0,130,0.0,0.0,0.0,0.0,0.0,0.0,0.0,15,0,15,1.0,0.0,1.0
8212,2,2,0,0,1,1,2,197,1.0,1.0,0.0,0.0,0.0,1.0,2.0,9,2,7,1.0,1.0,0.0
9809580,1,1,0,0,1,0,0,7,1.0,1.0,0.0,0.0,1.0,0.0,0.0,9,1,8,1.0,1.0,0.0
209357,2,2,0,0,0,2,7,25,2.0,2.0,0.0,0.0,0.0,2.0,7.0,10,2,8,1.0,1.0,0.0
9912217,4,4,0,0,1,3,8,12,3.0,3.0,0.0,0.0,1.0,2.0,3.0,14,4,10,2.0,1.0,1.0
102151,1,1,0,0,0,1,1,1156,,,,,,,,4,1,3,2.0,1.0,1.0
9906447,2,2,0,0,2,0,0,221,1.0,1.0,0.0,0.0,1.0,0.0,0.0,2,2,0,1.0,1.0,0.0
210106,2,2,0,0,0,2,25,20,2.0,2.0,0.0,0.0,0.0,2.0,25.0,43,2,41,26.0,0.0,26.0
9806269,2,2,0,0,0,2,3,266,2.0,2.0,0.0,0.0,0.0,2.0,3.0,6,2,4,4.0,1.0,3.0
9702366,2,2,0,0,1,1,1,6,0.0,0.0,0.0,0.0,0.0,0.0,0.0,15,2,13,2.0,0.0,2.0
107072,4,2,2,3,1,3,18,131,3.0,1.0,2.0,3.0,0.0,3.0,13.0,15,4,11,5.0,2.0,3.0
9909405,6,5,1,2,0,6,17,316,5.0,4.0,1.0,2.0,0.0,5.0,10.0,20,6,14,6.0,3.0,3.0
209098,3,3,0,0,1,2,3,46,,,,,,,,5,3,2,3.0,2.0,1.0
212040,1,1,0,0,1,0,0,1810,,,,,,,,2,1,1,,,
9901292,3,3,0,0,0,3,8,2,0.0,0.0,0.0,0.0,0.0,0.0,0.0,25,3,22,3.0,0.0,3.0
9808264,5,4,1,1,3,2,4,180,4.0,3.0,1.0,1.0,2.0,2.0,2.0,11,5,6,2.0,2.0,0.0
6242,0,0,0,0,0,0,0,1902,0.0,0.0,0.0,0.0,0.0,0.0,0.0,3,0,3,,,
9903551,1,1,0,0,1,0,0,31,1.0,1.0,0.0,0.0,1.0,0.0,0.0,5,1,4,1.0,1.0,0.0
2013,0,0,0,0,0,0,0,128,0.0,0.0,0.0,0.0,0.0,0.0,0.0,3,0,3,1.0,0.0,1.0
9711278,2,2,0,0,0,2,2,58,0.0,0.0,0.0,0.0,0.0,0.0,0.0,3,2,1,1.0,0.0,1.0
106178,3,3,0,0,0,3,21,260,3.0,3.0,0.0,0.0,0.0,3.0,9.0,20,3,17,7.0,3.0,4.0
9909287,0,0,0,0,0,0,0,97,,,,,,,,3,0,3,,,
209368,3,2,1,1,1,2,2,0,0.0,0.0,0.0,0.0,0.0,0.0,0.0,14,3,11,2.0,2.0,0.0
9401250,1,1,0,0,1,0,0,1285,,,,,,,,1,1,0,,,
9611457,0,0,0,0,0,0,0,12,0.0,0.0,0.0,0.0,0.0,0.0,0.0,9,0,9,,,
9303323,2,2,0,0,2,0,0,1082,2.0,2.0,0.0,0.0,2.0,0.0,0.0,2,2,0,2.0,2.0,0.0
202069,4,1,3,3,0,4,23,31,2.0,1.0,1.0,1.0,0.0,2.0,6.0,22,4,18,10.0,2.0,8.0
1316,0,0,0,0,0,0,0,111,0.0,0.0,0.0,0.0,0.0,0.0,0.0,5,0,5,5.0,0.0,5.0
209074,4,2,2,2,0,4,60,11,3.0,2.0,1.0,1.0,0.0,3.0,48.0,60,4,56,38.0,2.0,36.0
9905218,4,3,1,1,0,4,16,47,3.0,2.0,1.0,1.0,0.0,3.0,8.0,17,4,13,9.0,3.0,6.0
211390,1,1,0,0,0,1,4,19,1.0,1.0,0.0,0.0,0.0,1.0,4.0,5,1,4,5.0,1.0,4.0
9706278,5,2,3,4,4,1,3,311,5.0,2.0,3.0,4.0,4.0,1.0,1.0,8,5,3,5.0,4.0,1.0
9610539,0,0,0,0,0,0,0,134,0.0,0.0,0.0,0.0,0.0,0.0,0.0,3,0,3,3.0,0.0,3.0
9712374,0,0,0,0,0,0,0,627,0.0,0.0,0.0,0.0,0.0,0.0,0.0,7,0,7,1.0,0.0,1.0
101126,2,2,0,0,2,0,0,105,0.0,0.0,0.0,0.0,0.0,0.0,0.0,14,2,12,3.0,0.0,3.0
110398,1,1,0,0,0,1,5,24,0.0,0.0,0.0,0.0,0.0,0.0,0.0,39,1,38,21.0,0.0,21.0
108078,2,2,0,0,0,2,9,27,0.0,0.0,0.0,0.0,0.0,0.0,0.0,39,2,37,9.0,0.0,9.0
210364,0,0,0,0,0,0,0,616,0.0,0.0,0.0,0.0,0.0,0.0,0.0,5,0,5,1.0,0.0,1.0
109049,2,1,1,1,1,1,1,70,2.0,1.0,1.0,1.0,1.0,1.0,1.0,5,2,3,1.0,1.0,0.0
204285,5,3,2,2,0,5,33,65,2.0,2.0,0.0,0.0,0.0,2.0,8.0,18,5,13,8.0,2.0,6.0
9807362,6,3,3,4,2,4,28,20,1.0,1.0,0.0,0.0,0.0,1.0,2.0,20,6,14,3.0,2.0,1.0
104082,2,1,1,1,0,2,7,14,1.0,1.0,0.0,0.0,0.0,1.0,3.0,13,2,11,4.0,1.0,3.0
9602278,1,1,0,0,1,0,0,340,1.0,1.0,0.0,0.0,1.0,0.0,0.0,2,1,1,,,
9402242,1,1,0,0,1,0,0,320,1.0,1.0,0.0,0.0,1.0,0.0,0.0,1,1,0,1.0,1.0,0.0
9609456,0,0,0,0,0,0,0,279,0.0,0.0,0.0,0.0,0.0,0.0,0.0,3,0,3,1.0,0.0,1.0
4026,2,2,0,0,2,0,0,24,,,,,,,,7,2,5,,,
9805256,1,1,0,0,0,1,3,132,1.0,1.0,0.0,0.0,0.0,1.0,3.0,7,1,6,3.0,1.0,2.0
9908419,0,0,0,0,0,0,0,256,0.0,0.0,0.0,0.0,0.0,0.0,0.0,6,0,6,3.0,0.0,3.0
209214,3,2,1,1,0,3,46,2,2.0,1.0,1.0,1.0,0.0,2.0,16.0,28,3,25,11.0,2.0,9.0
9405266,0,0,0,0,0,0,0,134,,,,,,,,1,0,1,,,
212379,0,0,0,0,0,0,0,18,0.0,0.0,0.0,0.0,0.0,0.0,0.0,21,0,21,11.0,0.0,11.0
107259,3,2,1,2,0,3,14,91,3.0,2.0,1.0,2.0,0.0,3.0,10.0,10,3,7,9.0,3.0,6.0
107041,0,0,0,0,0,0,0,1514,0.0,0.0,0.0,0.0,0.0,0.0,0.0,4,0,4,1.0,0.0,1.0
9707444,1,1,0,0,0,1,2,306,0.0,0.0,0.0,0.0,0.0,0.0,0.0,6,1,5,1.0,1.0,0.0
9708260,3,2,1,1,3,0,0,228,1.0,1.0,0.0,0.0,1.0,0.0,0.0,7,3,4,3.0,0.0,3.0
12213,5,1,4,5,0,5,37,2,2.0,1.0,1.0,1.0,0.0,2.0,10.0,18,5,13,4.0,4.0,0.0
9803355,4,2,2,3,0,4,8,96,1.0,1.0,0.0,0.0,0.0,1.0,3.0,12,4,8,7.0,1.0,6.0
204164,2,1,1,1,2,0,0,55,0.0,0.0,0.0,0.0,0.0,0.0,0.0,41,2,39,18.0,0.0,18.0
9812373,1,1,0,0,0,1,1,157,0.0,0.0,0.0,0.0,0.0,0.0,0.0,12,1,11,5.0,0.0,5.0
9902300,3,1,2,3,3,0,0,145,3.0,1.0,2.0,3.0,3.0,0.0,0.0,3,3,0,3.0,3.0,0.0
9409234,0,0,0,0,0,0,0,196,0.0,0.0,0.0,0.0,0.0,0.0,0.0,8,0,8,3.0,0.0,3.0
3282,1,1,0,0,0,1,1,20,1.0,1.0,0.0,0.0,1.0,0.0,0.0,14,1,13,2.0,1.0,1.0
8054,0,0,0,0,0,0,0,97,0.0,0.0,0.0,0.0,0.0,0.0,0.0,9,0,9,5.0,0.0,5.0
212085,1,1,0,0,0,1,4,14,0.0,0.0,0.0,0.0,0.0,0.0,0.0,32,1,31,15.0,0.0,15.0
9332,0,0,0,0,0,0,0,49,,,,,,,,2,0,2,2.0,0.0,2.0
9403298,5,4,1,2,0,5,13,96,3.0,2.0,1.0,2.0,0.0,3.0,7.0,11,5,6,8.0,4.0,4.0
9903367,4,3,1,1,1,3,17,113,3.0,2.0,1.0,1.0,0.0,3.0,16.0,17,4,13,12.0,2.0,10.0
202104,2,2,0,0,1,1,2,206,0.0,0.0,0.0,0.0,0.0,0.0,0.0,5,2,3,3.0,1.0,2.0
101327,1,1,0,0,1,0,0,79,1.0,1.0,0.0,0.0,1.0,0.0,0.0,8,1,7,2.0,0.0,2.0
112212,6,2,4,5,0,6,15,221,4.0,2.0,2.0,2.0,0.0,4.0,11.0,10,6,4,7.0,4.0,3.0
9905533,0,0,0,0,0,0,0,11,0.0,0.0,0.0,0.0,0.0,0.0,0.0,61,0,61,14.0,0.0,14.0
9812479,8,2,6,19,3,5,5,66,7.0,1.0,6.0,19.0,7.0,0.0,0.0,14,8,6,7.0,7.0,0.0
204041,3,2,1,1,1,2,5,5,0.0,0.0,0.0,0.0,0.0,0.0,0.0,23,3,20,2.0,0.0,2.0
212375,2,1,1,1,0,2,8,3,2.0,1.0,1.0,1.0,2.0,0.0,0.0,16,2,14,3.0,0.0,3.0
9803325,1,1,0,0,0,1,2,328,1.0,1.0,0.0,0.0,0.0,1.0,2.0,11,1,10,4.0,1.0,3.0
101072,1,1,0,0,1,0,0,118,0.0,0.0,0.0,0.0,0.0,0.0,0.0,11,1,10,8.0,0.0,8.0
9504381,2,1,1,1,2,0,0,436,2.0,1.0,1.0,1.0,2.0,0.0,0.0,3,2,1,2.0,2.0,0.0
103135,4,2,2,2,0,4,6,86,0.0,0.0,0.0,0.0,0.0,0.0,0.0,28,4,24,9.0,0.0,9.0
9502303,2,2,0,0,1,1,1,228,2.0,2.0,0.0,0.0,1.0,1.0,1.0,5,2,3,3.0,1.0,2.0
9506315,1,1,0,0,0,1,2,1317,,,,,,,,3,1,2,2.0,1.0,1.0
1234,4,3,1,1,0,4,24,20,1.0,1.0,0.0,0.0,1.0,0.0,0.0,14,4,10,3.0,3.0,0.0
103291,1,1,0,0,0,1,8,11,1.0,1.0,0.0,0.0,0.0,1.0,8.0,10,1,9,,,
9712521,0,0,0,0,0,0,0,91,0.0,0.0,0.0,0.0,0.0,0.0,0.0,5,0,5,2.0,0.0,2.0
211225,0,0,0,0,0,0,0,475,0.0,0.0,0.0,0.0,0.0,0.0,0.0,4,0,4,2.0,0.0,2.0
5254,1,1,0,0,0,1,5,17,1.0,1.0,0.0,0.0,0.0,1.0,5.0,15,1,14,1.0,0.0,1.0
209046,4,3,1,1,2,2,3,52,0.0,0.0,0.0,0.0,0.0,0.0,0.0,15,4,11,1.0,0.0,1.0
103333,2,1,1,1,0,2,5,261,2.0,1.0,1.0,1.0,0.0,2.0,4.0,5,2,3,4.0,2.0,2.0
9906473,1,1,0,0,0,1,7,7,1.0,1.0,0.0,0.0,0.0,1.0,6.0,22,1,21,9.0,1.0,8.0
9706202,0,0,0,0,0,0,0,1355,,,,,,,,3,0,3,,,
3009,1,1,0,0,0,1,21,94,1.0,1.0,0.0,0.0,0.0,1.0,19.0,22,1,21,20.0,1.0,19.0
9905514,1,1,0,0,1,0,0,9,,,,,,,,10,1,9,1.0,0.0,1.0
9901294,0,0,0,0,0,0,0,370,0.0,0.0,0.0,0.0,0.0,0.0,0.0,3,0,3,2.0,0.0,2.0
9906541,2,2,0,0,0,2,6,150,0.0,0.0,0.0,0.0,0.0,0.0,0.0,16,2,14,2.0,1.0,1.0
9907354,2,1,1,1,1,1,3,429,2.0,1.0,1.0,1.0,2.0,0.0,0.0,5,2,3,2.0,2.0,0.0
9906214,1,1,0,0,0,1,1,97,0.0,0.0,0.0,0.0,0.0,0.0,0.0,3,1,2,2.0,0.0,2.0
208212,2,2,0,0,0,2,2,62,1.0,1.0,0.0,0.0,1.0,0.0,0.0,14,2,12,1.0,1.0,0.0
9810318,0,0,0,0,0,0,0,22,0.0,0.0,0.0,0.0,0.0,0.0,0.0,7,0,7,,,
203217,0,0,0,0,0,0,0,93,0.0,0.0,0.0,0.0,0.0,0.0,0.0,9,0,9,3.0,0.0,3.0
9902388,0,0,0,0,0,0,0,769,0.0,0.0,0.0,0.0,0.0,0.0,0.0,2,0,2,1.0,0.0,1.0
107160,1,1,0,0,1,0,0,502,1.0,1.0,0.0,0.0,1.0,0.0,0.0,4,1,3,4.0,1.0,3.0
9307360,2,1,1,1,0,2,2,250,2.0,1.0,1.0,1.0,0.0,2.0,2.0,3,2,1,3.0,2.0,1.0
9209295,0,0,0,0,0,0,0,989,,,,,,,,1,0,1,,,
209247,0,0,0,0,0,0,0,404,0.0,0.0,0.0,0.0,0.0,0.0,0.0,2,0,2,2.0,0.0,2.0
9809434,1,1,0,0,1,0,0,427,1.0,1.0,0.0,0.0,1.0,0.0,0.0,1,1,0,1.0,1.0,0.0
111346,1,1,0,0,0,1,3,33,1.0,1.0,0.0,0.0,0.0,1.0,2.0,21,1,20,11.0,0.0,11.0
9905280,1,1,0,0,1,0,0,105,0.0,0.0,0.0,0.0,0.0,0.0,0.0,6,1,5,4.0,0.0,4.0
212335,0,0,0,0,0,0,0,64,0.0,0.0,0.0,0.0,0.0,0.0,0.0,9,0,9,3.0,0.0,3.0
9707422,2,2,0,0,0,2,7,36,2.0,2.0,0.0,0.0,0.0,2.0,7.0,12,2,10,1.0,1.0,0.0
110394,3,2,1,1,0,3,10,74,0.0,0.0,0.0,0.0,0.0,0.0,0.0,17,3,14,6.0,0.0,6.0
111384,0,0,0,0,0,0,0,68,0.0,0.0,0.0,0.0,0.0,0.0,0.0,35,0,35,18.0,0.0,18.0
9810445,0,0,0,0,0,0,0,188,,,,,,,,2,0,2,,,
10264,1,1,0,0,0,1,3,44,1.0,1.0,0.0,0.0,0.0,1.0,3.0,8,1,7,4.0,1.0,3.0
210266,0,0,0,0,0,0,0,69,0.0,0.0,0.0,0.0,0.0,0.0,0.0,30,0,30,10.0,0.0,10.0
9340,2,1,1,1,0,2,6,16,,,,,,,,7,2,5,2.0,2.0,0.0
9905265,0,0,0,0,0,0,0,158,0.0,0.0,0.0,0.0,0.0,0.0,0.0,3,0,3,1.0,0.0,1.0
101149,1,1,0,0,1,0,0,254,0.0,0.0,0.0,0.0,0.0,0.0,0.0,7,1,6,2.0,0.0,2.0
9504214,0,0,0,0,0,0,0,172,0.0,0.0,0.0,0.0,0.0,0.0,0.0,5,0,5,1.0,0.0,1.0
301038,0,0,0,0,0,0,0,1,0.0,0.0,0.0,0.0,0.0,0.0,0.0,19,0,19,11.0,0.0,11.0
3004,0,0,0,0,0,0,0,11,0.0,0.0,0.0,0.0,0.0,0.0,0.0,8,0,8,,,
201235,0,0,0,0,0,0,0,279,0.0,0.0,0.0,0.0,0.0,0.0,0.0,1,0,1,,,
210214,1,1,0,0,1,0,0,14,0.0,0.0,0.0,0.0,0.0,0.0,0.0,14,1,13,1.0,1.0,0.0
9805511,0,0,0,0,0,0,0,298,0.0,0.0,0.0,0.0,0.0,0.0,0.0,5,0,5,3.0,0.0,3.0
9809273,2,2,0,0,0,2,9,167,2.0,2.0,0.0,0.0,0.0,2.0,8.0,15,2,13,6.0,1.0,5.0
106341,1,1,0,0,0,1,1,168,1.0,1.0,0.0,0.0,0.0,1.0,1.0,7,1,6,3.0,1.0,2.0
9221,0,0,0,0,0,0,0,51,0.0,0.0,0.0,0.0,0.0,0.0,0.0,14,0,14,4.0,0.0,4.0
9810311,2,2,0,0,0,2,6,100,2.0,2.0,0.0,0.0,0.0,2.0,6.0,9,2,7,6.0,2.0,4.0
10165,0,0,0,0,0,0,0,1994,,,,,,,,3,0,3,,,
211241,3,2,1,1,1,2,5,82,3.0,2.0,1.0,1.0,1.0,2.0,5.0,10,3,7,1.0,1.0,0.0
9611318,1,1,0,0,0,1,1,39,1.0,1.0,0.0,0.0,0.0,1.0,1.0,3,1,2,2.0,1.0,1.0
302032,0,0,0,0,0,0,0,18,0.0,0.0,0.0,0.0,0.0,0.0,0.0,51,0,51,14.0,0.0,14.0
107130,0,0,0,0,0,0,0,1857,0.0,0.0,0.0,0.0,0.0,0.0,0.0,1,0,1,1.0,0.0,1.0
9501370,0,0,0,0,0,0,0,134,0.0,0.0,0.0,0.0,0.0,0.0,0.0,8,0,8,1.0,0.0,1.0
3093,0,0,0,0,0,0,0,361,0.0,0.0,0.0,0.0,0.0,0.0,0.0,6,0,6,1.0,0.0,1.0
207340,1,1,0,0,0,1,2,9,0.0,0.0,0.0,0.0,0.0,0.0,0.0,31,1,30,19.0,0.0,19.0
302136,0,0,0,0,0,0,0,614,0.0,0.0,0.0,0.0,0.0,0.0,0.0,1,0,1,1.0,0.0,1.0
9407315,0,0,0,0,0,0,0,815,,,,,,,,1,0,1,,,
105095,0,0,0,0,0,0,0,11,0.0,0.0,0.0,0.0,0.0,0.0,0.0,21,0,21,6.0,0.0,6.0
9912470,0,0,0,0,0,0,0,1820,,,,,,,,1,0,1,,,
9912553,0,0,0,0,0,0,0,70,0.0,0.0,0.0,0.0,0.0,0.0,0.0,10,0,10,,,
211066,0,0,0,0,0,0,0,1669,,,,,,,,1,0,1,,,
9805312,0,0,0,0,0,0,0,79,0.0,0.0,0.0,0.0,0.0,0.0,0.0,6,0,6,5.0,0.0,5.0
210158,0,0,0,0,0,0,0,156,,,,,,,,3,0,3,1.0,0.0,1.0
201048,7,6,1,1,1,6,19,38,2.0,2.0,0.0,0.0,0.0,2.0,3.0,34,7,27,5.0,3.0,2.0
9503339,0,0,0,0,0,0,0,906,0.0,0.0,0.0,0.0,0.0,0.0,0.0,1,0,1,,,
107042,1,1,0,0,1,0,0,54,1.0,1.0,0.0,0.0,1.0,0.0,0.0,9,1,8,2.0,1.0,1.0
111189,2,2,0,0,0,2,6,72,1.0,1.0,0.0,0.0,0.0,1.0,2.0,7,2,5,2.0,1.0,1.0
210285,0,0,0,0,0,0,0,48,0.0,0.0,0.0,0.0,0.0,0.0,0.0,19,0,19,8.0,0.0,8.0
9903347,1,1,0,0,0,1,2,26,0.0,0.0,0.0,0.0,0.0,0.0,0.0,19,1,18,2.0,0.0,2.0
211082,1,1,0,0,0,1,1,18,0.0,0.0,0.0,0.0,0.0,0.0,0.0,13,1,12,2.0,0.0,2.0
1182,2,1,1,1,0,2,6,21,2.0,1.0,1.0,1.0,0.0,2.0,6.0,8,2,6,7.0,2.0,5.0
4216,0,0,0,0,0,0,0,53,0.0,0.0,0.0,0.0,0.0,0.0,0.0,20,0,20,19.0,0.0,19.0
101324,3,1,2,3,0,3,11,31,3.0,1.0,2.0,3.0,0.0,3.0,6.0,18,3,15,3.0,0.0,3.0
201062,0,0,0,0,0,0,0,397,0.0,0.0,0.0,0.0,0.0,0.0,0.0,8,0,8,2.0,0.0,2.0
1324,1,1,0,0,0,1,1,662,0.0,0.0,0.0,0.0,0.0,0.0,0.0,3,1,2,,,
9707544,0,0,0,0,0,0,0,348,0.0,0.0,0.0,0.0,0.0,0.0,0.0,2,0,2,,,
9402267,0,0,0,0,0,0,0,155,0.0,0.0,0.0,0.0,0.0,0.0,0.0,3,0,3,1.0,0.0,1.0
9701337,1,1,0,0,0,1,5,17,,,,,,,,13,1,12,1.0,1.0,0.0
102140,0,0,0,0,0,0,0,15,,,,,,,,5,0,5,,,
205209,0,0,0,0,0,0,0,264,0.0,0.0,0.0,0.0,0.0,0.0,0.0,2,0,2,1.0,0.0,1.0
205166,0,0,0,0,0,0,0,4,0.0,0.0,0.0,0.0,0.0,0.0,0.0,18,0,18,14.0,0.0,14.0
202117,1,1,0,0,0,1,3,1,1.0,1.0,0.0,0.0,0.0,1.0,2.0,42,1,41,2.0,0.0,2.0
9510388,0,0,0,0,0,0,0,1787,,,,,,,,3,0,3,1.0,0.0,1.0
212058,0,0,0,0,0,0,0,12,0.0,0.0,0.0,0.0,0.0,0.0,0.0,18,0,18,1.0,0.0,1.0
9607323,0,0,0,0,0,0,0,1096,,,,,,,,8,0,8,1.0,0.0,1.0
104214,2,1,1,1,0,2,20,131,2.0,1.0,1.0,1.0,0.0,2.0,16.0,21,2,19,14.0,2.0,12.0
9912310,4,1,3,3,1,3,5,98,4.0,1.0,3.0,3.0,1.0,3.0,3.0,12,4,8,5.0,4.0,1.0
9907369,1,1,0,0,0,1,7,22,0.0,0.0,0.0,0.0,0.0,0.0,0.0,8,1,7,2.0,1.0,1.0
9610512,0,0,0,0,0,0,0,470,0.0,0.0,0.0,0.0,0.0,0.0,0.0,3,0,3,3.0,0.0,3.0
110226,0,0,0,0,0,0,0,113,0.0,0.0,0.0,0.0,0.0,0.0,0.0,17,0,17,14.0,0.0,14.0
207176,0,0,0,0,0,0,0,9,0.0,0.0,0.0,0.0,0.0,0.0,0.0,20,0,20,3.0,0.0,3.0
9603344,0,0,0,0,0,0,0,133,0.0,0.0,0.0,0.0,0.0,0.0,0.0,4,0,4,1.0,0.0,1.0
208131,0,0,0,0,0,0,0,18,0.0,0.0,0.0,0.0,0.0,0.0,0.0,5,0,5,3.0,0.0,3.0
301074,0,0,0,0,0,0,0,8,0.0,0.0,0.0,0.0,0.0,0.0,0.0,58,0,58,18.0,0.0,18.0
9510360,1,1,0,0,0,1,2,451,1.0,1.0,0.0,0.0,0.0,1.0,2.0,3,1,2,3.0,1.0,2.0
212051,0,0,0,0,0,0,0,412,0.0,0.0,0.0,0.0,0.0,0.0,0.0,4,0,4,1.0,0.0,1.0
9503345,0,0,0,0,0,0,0,99,,,,,,,,5,0,5,1.0,0.0,1.0
9703202,1,1,0,0,1,0,0,149,0.0,0.0,0.0,0.0,0.0,0.0,0.0,4,1,3,1.0,0.0,1.0
212120,0,0,0,0,0,0,0,312,0.0,0.0,0.0,0.0,0.0,0.0,0.0,15,0,15,8.0,0.0,8.0
9807202,0,0,0,0,0,0,0,52,0.0,0.0,0.0,0.0,0.0,0.0,0.0,7,0,7,7.0,0.0,7.0
201182,0,0,0,0,0,0,0,361,0.0,0.0,0.0,0.0,0.0,0.0,0.0,2,0,2,1.0,0.0,1.0
9607348,1,1,0,0,1,0,0,34,1.0,1.0,0.0,0.0,1.0,0.0,0.0,7,1,6,,,
207306,1,1,0,0,0,1,2,202,,,,,,,,3,1,2,2.0,1.0,1.0
9308326,0,0,0,0,0,0,0,407,0.0,0.0,0.0,0.0,0.0,0.0,0.0,3,0,3,1.0,0.0,1.0
9085,0,0,0,0,0,0,0,24,0.0,0.0,0.0,0.0,0.0,0.0,0.0,14,0,14,6.0,0.0,6.0
9908440,0,0,0,0,0,0,0,871,,,,,,,,1,0,1,,,
9308298,0,0,0,0,0,0,0,414,,,,,,,,1,0,1,1.0,0.0,1.0
9706282,1,1,0,0,1,0,0,712,0.0,0.0,0.0,0.0,0.0,0.0,0.0,2,1,1,1.0,0.0,1.0
1063,3,3,0,0,2,1,1,84,1.0,1.0,0.0,0.0,1.0,0.0,0.0,7,3,4,1.0,1.0,0.0
102034,0,0,0,0,0,0,0,714,0.0,0.0,0.0,0.0,0.0,0.0,0.0,1,0,1,1.0,0.0,1.0
210350,0,0,0,0,0,0,0,18,0.0,0.0,0.0,0.0,0.0,0.0,0.0,23,0,23,15.0,0.0,15.0
9604373,0,0,0,0,0,0,0,1720,0.0,0.0,0.0,0.0,0.0,0.0,0.0,1,0,1,1.0,0.0,1.0
9904462,0,0,0,0,0,0,0,30,0.0,0.0,0.0,0.0,0.0,0.0,0.0,5,0,5,1.0,0.0,1.0
205336,1,1,0,0,0,1,6,10,1.0,1.0,0.0,0.0,0.0,1.0,2.0,25,1,24,2.0,1.0,1.0
9605390,0,0,0,0,0,0,0,1842,0.0,0.0,0.0,0.0,0.0,0.0,0.0,5,0,5,1.0,0.0,1.0
9407219,0,0,0,0,0,0,0,790,0.0,0.0,0.0,0.0,0.0,0.0,0.0,1,0,1,1.0,0.0,1.0
302046,0,0,0,0,0,0,0,93,0.0,0.0,0.0,0.0,0.0,0.0,0.0,15,0,15,4.0,0.0,4.0
111018,0,0,0,0,0,0,0,456,0.0,0.0,0.0,0.0,0.0,0.0,0.0,7,0,7,4.0,0.0,4.0
207033,1,1,0,0,1,0,0,127,0.0,0.0,0.0,0.0,0.0,0.0,0.0,7,1,6,5.0,0.0,5.0
9505258,0,0,0,0,0,0,0,290,0.0,0.0,0.0,0.0,0.0,0.0,0.0,1,0,1,1.0,0.0,1.0
3050,1,1,0,0,1,0,0,1276,,,,,,,,1,1,0,1.0,1.0,0.0
105345,0,0,0,0,0,0,0,56,,,,,,,,5,0,5,,,
112315,0,0,0,0,0,0,0,402,0.0,0.0,0.0,0.0,0.0,0.0,0.0,3,0,3,2.0,0.0,2.0
209266,0,0,0,0,0,0,0,18,0.0,0.0,0.0,0.0,0.0,0.0,0.0,12,0,12,2.0,0.0,2.0
9809570,1,1,0,0,1,0,0,718,1.0,1.0,0.0,0.0,1.0,0.0,0.0,1,1,0,1.0,1.0,0.0
302200,0,0,0,0,0,0,0,186,0.0,0.0,0.0,0.0,0.0,0.0,0.0,7,0,7,1.0,0.0,1.0
9511276,1,1,0,0,1,0,0,265,0.0,0.0,0.0,0.0,0.0,0.0,0.0,4,1,3,2.0,0.0,2.0
204298,0,0,0,0,0,0,0,11,0.0,0.0,0.0,0.0,0.0,0.0,0.0,15,0,15,6.0,0.0,6.0
9710318,0,0,0,0,0,0,0,103,,,,,,,,2,0,2,,,
6187,0,0,0,0,0,0,0,85,0.0,0.0,0.0,0.0,0.0,0.0,0.0,15,0,15,7.0,0.0,7.0
208263,1,1,0,0,0,1,5,216,1.0,1.0,0.0,0.0,0.0,1.0,5.0,6,1,5,6.0,1.0,5.0
6353,0,0,0,0,0,0,0,68,0.0,0.0,0.0,0.0,0.0,0.0,0.0,20,0,20,9.0,0.0,9.0
10121,3,2,1,1,2,1,1,84,3.0,2.0,1.0,1.0,3.0,0.0,0.0,10,3,7,2.0,2.0,0.0
104004,0,0,0,0,0,0,0,230,0.0,0.0,0.0,0.0,0.0,0.0,0.0,10,0,10,3.0,0.0,3.0
301041,0,0,0,0,0,0,0,46,0.0,0.0,0.0,0.0,0.0,0.0,0.0,16,0,16,1.0,0.0,1.0
4009,0,0,0,0,0,0,0,8,0.0,0.0,0.0,0.0,0.0,0.0,0.0,11,0,11,1.0,0.0,1.0
9603401,0,0,0,0,0,0,0,15,0.0,0.0,0.0,0.0,0.0,0.0,0.0,10,0,10,3.0,0.0,3.0
9611372,0,0,0,0,0,0,0,111,0.0,0.0,0.0,0.0,0.0,0.0,0.0,3,0,3,1.0,0.0,1.0
5307,0,0,0,0,0,0,0,94,0.0,0.0,0.0,0.0,0.0,0.0,0.0,23,0,23,21.0,0.0,21.0
211380,0,0,0,0,0,0,0,19,0.0,0.0,0.0,0.0,0.0,0.0,0.0,22,0,22,15.0,0.0,15.0
9507355,0,0,0,0,0,0,0,119,,,,,,,,1,0,1,,,
9911520,1,1,0,0,0,1,6,13,1.0,1.0,0.0,0.0,0.0,1.0,2.0,16,1,15,1.0,1.0,0.0
9113,0,0,0,0,0,0,0,4,0.0,0.0,0.0,0.0,0.0,0.0,0.0,13,0,13,2.0,0.0,2.0
9606321,0,0,0,0,0,0,0,88,0.0,0.0,0.0,0.0,0.0,0.0,0.0,5,0,5,1.0,0.0,1.0
9706301,1,1,0,0,0,1,1,229,1.0,1.0,0.0,0.0,0.0,1.0,1.0,3,1,2,2.0,1.0,1.0
212090,0,0,0,0,0,0,0,3,0.0,0.0,0.0,0.0,0.0,0.0,0.0,25,0,25,6.0,0.0,6.0
9902224,2,1,1,1,2,0,0,556,1.0,1.0,0.0,0.0,1.0,0.0,0.0,2,2,0,2.0,2.0,0.0
2027,1,1,0,0,0,1,3,210,0.0,0.0,0.0,0.0,0.0,0.0,0.0,6,1,5,3.0,0.0,3.0
9505376,0,0,0,0,0,0,0,528,0.0,0.0,0.0,0.0,0.0,0.0,0.0,2,0,2,2.0,0.0,2.0
212198,0,0,0,0,0,0,0,11,0.0,0.0,0.0,0.0,0.0,0.0,0.0,12,0,12,,,
9701417,0,0,0,0,0,0,0,5,,,,,,,,11,0,11,,,
206301,1,1,0,0,0,1,5,113,1.0,1.0,0.0,0.0,0.0,1.0,5.0,10,1,9,7.0,1.0,6.0
9811286,1,1,0,0,0,1,3,321,1.0,1.0,0.0,0.0,1.0,0.0,0.0,4,1,3,1.0,1.0,0.0
208220,1,1,0,0,0,1,5,16,0.0,0.0,0.0,0.0,0.0,0.0,0.0,40,1,39,6.0,1.0,5.0
211188,0,0,0,0,0,0,0,672,0.0,0.0,0.0,0.0,0.0,0.0,0.0,1,0,1,1.0,0.0,1.0
9507346,3,2,1,1,3,0,0,185,2.0,2.0,0.0,0.0,2.0,0.0,0.0,3,3,0,3.0,3.0,0.0
9310303,0,0,0,0,0,0,0,441,0.0,0.0,0.0,0.0,0.0,0.0,0.0,2,0,2,2.0,0.0,2.0
9907558,0,0,0,0,0,0,0,765,0.0,0.0,0.0,0.0,0.0,0.0,0.0,1,0,1,1.0,0.0,1.0
11204,0,0,0,0,0,0,0,54,0.0,0.0,0.0,0.0,0.0,0.0,0.0,12,0,12,9.0,0.0,9.0
9711341,1,1,0,0,0,1,2,233,1.0,1.0,0.0,0.0,0.0,1.0,2.0,3,1,2,3.0,1.0,2.0
11343,0,0,0,0,0,0,0,352,0.0,0.0,0.0,0.0,0.0,0.0,0.0,10,0,10,3.0,0.0,3.0
9807404,0,0,0,0,0,0,0,1746,0.0,0.0,0.0,0.0,0.0,0.0,0.0,2,0,2,2.0,0.0,2.0
9810263,0,0,0,0,0,0,0,8,0.0,0.0,0.0,0.0,0.0,0.0,0.0,11,0,11,3.0,0.0,3.0
9901449,1,1,0,0,0,1,1,296,1.0,1.0,0.0,0.0,1.0,0.0,0.0,4,1,3,1.0,1.0,0.0
9604322,0,0,0,0,0,0,0,78,0.0,0.0,0.0,0.0,0.0,0.0,0.0,9,0,9,4.0,0.0,4.0
206286,0,0,0,0,0,0,0,14,0.0,0.0,0.0,0.0,0.0,0.0,0.0,9,0,9,2.0,0.0,2.0
9811385,0,0,0,0,0,0,0,106,0.0,0.0,0.0,0.0,0.0,0.0,0.0,7,0,7,,,
9912349,0,0,0,0,0,0,0,39,0.0,0.0,0.0,0.0,0.0,0.0,0.0,63,0,63,10.0,0.0,10.0
104059,0,0,0,0,0,0,0,427,0.0,0.0,0.0,0.0,0.0,0.0,0.0,3,0,3,1.0,0.0,1.0
201039,0,0,0,0,0,0,0,70,0.0,0.0,0.0,0.0,0.0,0.0,0.0,5,0,5,,,
110006,2,1,1,1,0,2,5,253,2.0,1.0,1.0,1.0,0.0,2.0,5.0,6,2,4,6.0,2.0,4.0
6086,0,0,0,0,0,0,0,1194,,,,,,,,2,0,2,,,
9302297,1,1,0,0,1,0,0,2136,1.0,1.0,0.0,0.0,1.0,0.0,0.0,1,1,0,,,
101117,0,0,0,0,0,0,0,132,0.0,0.0,0.0,0.0,0.0,0.0,0.0,7,0,7,4.0,0.0,4.0
9812507,0,0,0,0,0,0,0,52,0.0,0.0,0.0,0.0,0.0,0.0,0.0,7,0,7,1.0,0.0,1.0
9609328,0,0,0,0,0,0,0,378,0.0,0.0,0.0,0.0,0.0,0.0,0.0,6,0,6,1.0,0.0,1.0
9805444,0,0,0,0,0,0,0,101,0.0,0.0,0.0,0.0,0.0,0.0,0.0,2,0,2,2.0,0.0,2.0
206102,1,1,0,0,0,1,9,23,0.0,0.0,0.0,0.0,0.0,0.0,0.0,26,1,25,2.0,1.0,1.0
6140,0,0,0,0,0,0,0,12,0.0,0.0,0.0,0.0,0.0,0.0,0.0,49,0,49,15.0,0.0,15.0
108153,1,1,0,0,0,1,1,445,1.0,1.0,0.0,0.0,1.0,0.0,0.0,3,1,2,1.0,0.0,1.0
203019,0,0,0,0,0,0,0,31,0.0,0.0,0.0,0.0,0.0,0.0,0.0,18,0,18,3.0,0.0,3.0
9305317,0,0,0,0,0,0,0,217,0.0,0.0,0.0,0.0,0.0,0.0,0.0,1,0,1,1.0,0.0,1.0
212070,1,1,0,0,0,1,11,11,1.0,1.0,0.0,0.0,0.0,1.0,8.0,12,1,11,9.0,1.0,8.0
301142,0,0,0,0,0,0,0,133,0.0,0.0,0.0,0.0,0.0,0.0,0.0,17,0,17,10.0,0.0,10.0
210056,0,0,0,0,0,0,0,34,0.0,0.0,0.0,0.0,0.0,0.0,0.0,18,0,18,10.0,0.0,10.0
9711465,0,0,0,0,0,0,0,94,0.0,0.0,0.0,0.0,0.0,0.0,0.0,9,0,9,,,
112344,0,0,0,0,0,0,0,1523,,,,,,,,1,0,1,1.0,0.0,1.0
212050,0,0,0,0,0,0,0,32,0.0,0.0,0.0,0.0,0.0,0.0,0.0,45,0,45,7.0,0.0,7.0
302262,0,0,0,0,0,0,0,6,0.0,0.0,0.0,0.0,0.0,0.0,0.0,51,0,51,7.0,0.0,7.0
9512273,0,0,0,0,0,0,0,236,0.0,0.0,0.0,0.0,0.0,0.0,0.0,2,0,2,1.0,0.0,1.0
104045,0,0,0,0,0,0,0,198,0.0,0.0,0.0,0.0,0.0,0.0,0.0,5,0,5,1.0,0.0,1.0
211329,0,0,0,0,0,0,0,171,0.0,0.0,0.0,0.0,0.0,0.0,0.0,3,0,3,,,
9309273,0,0,0,0,0,0,0,669,0.0,0.0,0.0,0.0,0.0,0.0,0.0,1,0,1,1.0,0.0,1.0
9801289,0,0,0,0,0,0,0,156,0.0,0.0,0.0,0.0,0.0,0.0,0.0,4,0,4,3.0,0.0,3.0
12098,0,0,0,0,0,0,0,315,0.0,0.0,0.0,0.0,0.0,0.0,0.0,1,0,1,,,
9711383,0,0,0,0,0,0,0,47,0.0,0.0,0.0,0.0,0.0,0.0,0.0,9,0,9,2.0,0.0,2.0
301081,0,0,0,0,0,0,0,16,0.0,0.0,0.0,0.0,0.0,0.0,0.0,14,0,14,7.0,0.0,7.0
9207243,0,0,0,0,0,0,0,207,0.0,0.0,0.0,0.0,0.0,0.0,0.0,1,0,1,,,
9409441,0,0,0,0,0,0,0,29,,,,,,,,3,0,3,,,
9608284,0,0,0,0,0,0,0,292,0.0,0.0,0.0,0.0,0.0,0.0,0.0,7,0,7,2.0,0.0,2.0
9907364,0,0,0,0,0,0,0,319,0.0,0.0,0.0,0.0,0.0,0.0,0.0,4,0,4,3.0,0.0,3.0
9809271,0,0,0,0,0,0,0,18,0.0,0.0,0.0,0.0,0.0,0.0,0.0,25,0,25,8.0,0.0,8.0
205174,1,1,0,0,0,1,2,28,1.0,1.0,0.0,0.0,0.0,1.0,2.0,22,1,21,16.0,0.0,16.0
9803495,0,0,0,0,0,0,0,17,0.0,0.0,0.0,0.0,0.0,0.0,0.0,20,0,20,4.0,0.0,4.0
210065,0,0,0,0,0,0,0,20,0.0,0.0,0.0,0.0,0.0,0.0,0.0,7,0,7,1.0,0.0,1.0
301134,0,0,0,0,0,0,0,274,,,,,,,,2,0,2,1.0,0.0,1.0
9807436,0,0,0,0,0,0,0,111,,,,,,,,1,0,1,,,
9812496,0,0,0,0,0,0,0,102,0.0,0.0,0.0,0.0,0.0,0.0,0.0,4,0,4,1.0,0.0,1.0
210008,0,0,0,0,0,0,0,9,0.0,0.0,0.0,0.0,0.0,0.0,0.0,20,0,20,3.0,0.0,3.0
9404351,1,1,0,0,1,0,0,401,1.0,1.0,0.0,0.0,1.0,0.0,0.0,1,1,0,1.0,1.0,0.0
9506303,0,0,0,0,0,0,0,1989,,,,,,,,2,0,2,,,
9512315,0,0,0,0,0,0,0,49,0.0,0.0,0.0,0.0,0.0,0.0,0.0,6,0,6,5.0,0.0,5.0
9606307,0,0,0,0,0,0,0,139,,,,,,,,2,0,2,1.0,0.0,1.0
212338,0,0,0,0,0,0,0,48,0.0,0.0,0.0,0.0,0.0,0.0,0.0,12,0,12,1.0,0.0,1.0
112011,0,0,0,0,0,0,0,273,0.0,0.0,0.0,0.0,0.0,0.0,0.0,12,0,12,4.0,0.0,4.0
106091,0,0,0,0,0,0,0,112,0.0,0.0,0.0,0.0,0.0,0.0,0.0,12,0,12,3.0,0.0,3.0
11288,0,0,0,0,0,0,0,335,0.0,0.0,0.0,0.0,0.0,0.0,0.0,1,0,1,1.0,0.0,1.0
9408258,0,0,0,0,0,0,0,1188,0.0,0.0,0.0,0.0,0.0,0.0,0.0,3,0,3,1.0,0.0,1.0
111219,0,0,0,0,0,0,0,377,0.0,0.0,0.0,0.0,0.0,0.0,0.0,20,0,20,2.0,0.0,2.0
211423,0,0,0,0,0,0,0,45,0.0,0.0,0.0,0.0,0.0,0.0,0.0,6,0,6,3.0,0.0,3.0
9611297,22,6,16,28,3,19,49,100,14.0,3.0,11.0,18.0,2.0,12.0,21.0,34,22,12,13.0,11.0,2.0
9610282,11,3,8,19,1,10,17,31,9.0,2.0,7.0,17.0,0.0,9.0,16.0,13,11,2,9.0,7.0,2.0
4004,133,4,129,987,62,71,162,1,75.0,1.0,74.0,638.0,20.0,55.0,142.0,141,133,8,41.0,37.0,4.0
102077,12,1,11,35,0,12,62,1,11.0,1.0,10.0,32.0,0.0,11.0,49.0,23,12,11,17.0,9.0,8.0
9905312,278,26,252,1877,165,113,133,1,81.0,2.0,79.0,664.0,81.0,0.0,0.0,281,278,3,32.0,32.0,0.0
9310212,100,15,85,317,30,70,151,75,18.0,6.0,12.0,18.0,0.0,18.0,49.0,107,100,7,22.0,18.0,4.0
9409454,50,10,40,158,40,10,10,7,20.0,1.0,19.0,69.0,14.0,6.0,6.0,51,50,1,4.0,4.0,0.0
11392,8,5,3,6,1,7,104,1,5.0,3.0,2.0,3.0,0.0,5.0,70.0,61,8,53,26.0,3.0,23.0
10222,9,4,5,15,7,2,3,1,1.0,1.0,0.0,0.0,1.0,0.0,0.0,12,9,3,1.0,1.0,0.0
9908442,4,4,0,0,0,4,9,32,0.0,0.0,0.0,0.0,0.0,0.0,0.0,23,4,19,9.0,0.0,9.0
9410253,57,15,42,120,36,21,33,7,6.0,4.0,2.0,3.0,2.0,4.0,5.0,64,57,7,7.0,4.0,3.0
9409255,25,2,23,111,11,14,32,34,19.0,2.0,17.0,97.0,9.0,10.0,10.0,29,25,4,11.0,9.0,2.0
9602414,88,11,77,326,24,64,159,60,25.0,3.0,22.0,133.0,3.0,22.0,75.0,100,88,12,27.0,21.0,6.0
9502415,30,9,21,70,3,27,31,114,14.0,2.0,12.0,46.0,1.0,13.0,13.0,35,30,5,14.0,13.0,1.0
9312319,155,18,137,910,150,5,5,39,66.0,3.0,63.0,445.0,66.0,0.0,0.0,157,155,2,42.0,42.0,0.0
203206,7,4,3,3,7,0,0,883,1.0,1.0,0.0,0.0,1.0,0.0,0.0,7,7,0,1.0,1.0,0.0
108235,8,5,3,3,0,8,82,2,3.0,3.0,0.0,0.0,0.0,3.0,39.0,33,8,25,5.0,3.0,2.0
9912281,3,2,1,1,2,1,3,33,0.0,0.0,0.0,0.0,0.0,0.0,0.0,12,3,9,4.0,3.0,1.0
9510300,14,3,11,28,4,10,17,33,7.0,1.0,6.0,15.0,5.0,2.0,2.0,21,14,7,7.0,7.0,0.0
9612424,51,13,38,194,4,47,300,33,35.0,5.0,30.0,159.0,0.0,35.0,192.0,85,51,34,37.0,25.0,12.0
9712335,3,3,0,0,1,2,11,94,0.0,0.0,0.0,0.0,0.0,0.0,0.0,19,3,16,4.0,1.0,3.0
9810440,50,21,29,70,50,0,0,80,8.0,3.0,5.0,9.0,8.0,0.0,0.0,50,50,0,3.0,3.0,0.0
9910255,22,12,10,15,1,21,269,2,7.0,6.0,1.0,1.0,0.0,7.0,127.0,100,22,78,51.0,2.0,49.0
9802391,120,12,108,566,16,104,780,7,48.0,5.0,43.0,263.0,1.0,47.0,463.0,160,120,40,47.0,29.0,18.0
201164,6,3,3,4,1,5,7,128,1.0,1.0,0.0,0.0,1.0,0.0,0.0,10,6,4,4.0,3.0,1.0
9505256,2,2,0,0,1,1,7,26,0.0,0.0,0.0,0.0,0.0,0.0,0.0,11,2,9,1.0,0.0,1.0
9804398,616,10,606,7142,16,600,885,2,178.0,2.0,176.0,2900.0,1.0,177.0,338.0,622,616,6,62.0,61.0,1.0
9911266,25,9,16,35,1,24,96,26,12.0,5.0,7.0,10.0,1.0,11.0,41.0,42,25,17,6.0,4.0,2.0
9309322,2,2,0,0,2,0,0,1667,1.0,1.0,0.0,0.0,1.0,0.0,0.0,2,2,0,,,
9410338,88,19,69,225,31,57,83,71,30.0,2.0,28.0,97.0,0.0,30.0,48.0,95,88,7,22.0,20.0,2.0
9507389,3,3,0,0,3,0,0,863,1.0,1.0,0.0,0.0,1.0,0.0,0.0,3,3,0,1.0,1.0,0.0
9905413,16,4,12,33,16,0,0,86,6.0,1.0,5.0,11.0,6.0,0.0,0.0,18,16,2,5.0,5.0,0.0
2287,55,4,51,261,0,55,390,32,33.0,3.0,30.0,162.0,0.0,33.0,253.0,75,55,20,39.0,25.0,14.0
110340,8,5,3,5,1,7,43,4,1.0,1.0,0.0,0.0,0.0,1.0,4.0,29,8,21,5.0,2.0,3.0
9709356,175,64,111,304,36,139,918,5,25.0,7.0,18.0,73.0,1.0,24.0,77.0,299,175,124,17.0,4.0,13.0
9412360,31,11,20,33,31,0,0,20,4.0,1.0,3.0,3.0,4.0,0.0,0.0,31,31,0,4.0,4.0,0.0
9308258,6,3,3,3,3,3,5,63,2.0,1.0,1.0,1.0,0.0,2.0,4.0,11,6,5,2.0,2.0,0.0
9303311,49,9,40,138,45,4,4,13,20.0,2.0,18.0,47.0,20.0,0.0,0.0,50,49,1,11.0,11.0,0.0
9502291,79,18,61,246,6,73,145,25,30.0,9.0,21.0,79.0,1.0,29.0,61.0,88,79,9,18.0,16.0,2.0
9605447,24,9,15,21,0,24,109,61,13.0,6.0,7.0,9.0,0.0,13.0,65.0,44,24,20,19.0,12.0,7.0
9310378,37,18,19,36,29,8,16,25,6.0,6.0,0.0,0.0,6.0,0.0,0.0,41,37,4,6.0,6.0,0.0
9504216,47,13,34,89,25,22,61,41,20.0,3.0,17.0,54.0,20.0,0.0,0.0,64,47,17,11.0,3.0,8.0
9302222,13,7,6,10,13,0,0,223,2.0,2.0,0.0,0.0,2.0,0.0,0.0,13,13,0,2.0,2.0,0.0
9411273,58,11,47,123,49,9,9,55,10.0,4.0,6.0,13.0,10.0,0.0,0.0,59,58,1,7.0,7.0,0.0
9411276,24,7,17,43,5,19,77,10,4.0,4.0,0.0,0.0,3.0,1.0,2.0,41,24,17,6.0,5.0,1.0
9505425,158,23,135,690,158,0,0,0,19.0,3.0,16.0,41.0,19.0,0.0,0.0,158,158,0,11.0,11.0,0.0
9806540,141,7,134,957,2,139,210,3,82.0,3.0,79.0,680.0,0.0,82.0,82.0,150,141,9,40.0,39.0,1.0
9904210,53,3,50,205,2,51,584,3,31.0,2.0,29.0,117.0,0.0,31.0,446.0,113,53,60,50.0,17.0,33.0
9507212,90,6,84,587,23,67,140,0,61.0,1.0,60.0,484.0,8.0,53.0,116.0,104,90,14,48.0,46.0,2.0
9504222,38,5,33,121,6,32,49,0,16.0,3.0,13.0,45.0,2.0,14.0,24.0,43,38,5,5.0,4.0,1.0
9509351,57,4,53,336,13,44,224,3,32.0,1.0,31.0,202.0,11.0,21.0,32.0,89,57,32,9.0,2.0,7.0
9901228,70,8,62,363,7,63,663,3,55.0,3.0,52.0,306.0,1.0,54.0,607.0,105,70,35,49.0,28.0,21.0
9909415,15,5,10,17,3,12,59,3,4.0,1.0,3.0,3.0,1.0,3.0,17.0,27,15,12,10.0,4.0,6.0
9808405,1,1,0,0,1,0,0,539,0.0,0.0,0.0,0.0,0.0,0.0,0.0,3,1,2,2.0,0.0,2.0
9210221,27,8,19,48,26,1,1,0,9.0,2.0,7.0,9.0,9.0,0.0,0.0,28,27,1,9.0,9.0,0.0
9807306,4,3,1,1,2,2,3,1980,0.0,0.0,0.0,0.0,0.0,0.0,0.0,6,4,2,1.0,1.0,0.0
9803305,23,6,17,45,1,22,43,0,10.0,2.0,8.0,24.0,1.0,9.0,19.0,38,23,15,10.0,7.0,3.0
9503316,26,8,18,38,8,18,29,0,12.0,3.0,9.0,22.0,3.0,9.0,17.0,31,26,5,2.0,2.0,0.0
9711294,7,3,4,6,1,6,20,0,3.0,1.0,2.0,3.0,0.0,3.0,6.0,27,7,20,5.0,3.0,2.0
9702429,20,2,18,70,2,18,82,0,7.0,1.0,6.0,14.0,0.0,7.0,33.0,35,20,15,7.0,4.0,3.0
9802410,9,3,6,13,3,6,8,122,6.0,1.0,5.0,10.0,3.0,3.0,4.0,12,9,3,6.0,5.0,1.0
9905220,121,19,102,331,25,96,211,0,34.0,7.0,27.0,88.0,12.0,22.0,30.0,142,121,21,12.0,3.0,9.0
9811427,30,5,25,110,7,23,72,81,24.0,2.0,22.0,98.0,4.0,20.0,41.0,44,30,14,17.0,16.0,1.0
9808488,8,3,5,7,1,7,29,3,3.0,3.0,0.0,0.0,0.0,3.0,13.0,24,8,16,12.0,0.0,12.0
9604304,1,1,0,0,0,1,3,51,1.0,1.0,0.0,0.0,0.0,1.0,3.0,6,1,5,1.0,0.0,1.0
9602206,36,13,23,59,0,36,278,10,14.0,4.0,10.0,24.0,0.0,14.0,99.0,103,36,67,12.0,2.0,10.0
9307279,15,3,12,48,15,0,0,46,10.0,1.0,9.0,29.0,10.0,0.0,0.0,15,15,0,12.0,12.0,0.0
9605385,40,10,30,124,2,38,189,71,23.0,5.0,18.0,80.0,0.0,23.0,145.0,54,40,14,30.0,18.0,12.0
9309269,7,6,1,1,4,3,3,114,3.0,2.0,1.0,1.0,0.0,3.0,3.0,9,7,2,4.0,3.0,1.0
9805219,57,16,41,101,12,45,45,46,10.0,3.0,7.0,11.0,1.0,9.0,9.0,58,57,1,8.0,7.0,1.0
9807359,7,1,6,9,5,2,2,336,3.0,1.0,2.0,3.0,1.0,2.0,2.0,8,7,1,4.0,3.0,1.0
3301,15,5,10,32,2,13,65,0,10.0,1.0,9.0,28.0,0.0,10.0,22.0,31,15,16,10.0,4.0,6.0
9704238,8,3,5,8,1,7,19,10,4.0,2.0,2.0,5.0,4.0,0.0,0.0,18,8,10,4.0,4.0,0.0
9510219,30,8,22,78,3,27,80,5,16.0,2.0,14.0,51.0,1.0,15.0,40.0,41,30,11,3.0,3.0,0.0
9711517,18,2,16,37,0,18,103,12,4.0,4.0,0.0,0.0,0.0,4.0,19.0,32,18,14,13.0,6.0,7.0
9503271,80,6,74,338,31,49,162,5,27.0,2.0,25.0,100.0,6.0,21.0,66.0,95,80,15,25.0,19.0,6.0
9707458,23,10,13,22,1,22,197,36,10.0,7.0,3.0,6.0,0.0,10.0,119.0,56,23,33,24.0,7.0,17.0
104122,6,4,2,2,1,5,13,1,0.0,0.0,0.0,0.0,0.0,0.0,0.0,23,6,17,2.0,1.0,1.0
9806471,165,41,124,594,18,147,1459,1,42.0,3.0,39.0,248.0,2.0,40.0,333.0,366,165,201,41.0,21.0,20.0
104063,1,1,0,0,0,1,2,173,1.0,1.0,0.0,0.0,0.0,1.0,2.0,8,1,7,3.0,0.0,3.0
9702353,16,3,13,44,1,15,107,1,14.0,1.0,13.0,43.0,0.0,14.0,88.0,34,16,18,12.0,1.0,11.0
9405340,56,15,41,135,28,28,44,9,20.0,2.0,18.0,51.0,20.0,0.0,0.0,62,56,6,10.0,10.0,0.0
9812229,71,6,65,331,4,67,355,32,40.0,2.0,38.0,177.0,5.0,35.0,107.0,98,71,27,14.0,11.0,3.0
9801326,36,1,35,201,7,29,98,34,33.0,1.0,32.0,194.0,7.0,26.0,81.0,46,36,10,25.0,21.0,4.0
7338,13,4,9,21,2,11,26,34,5.0,4.0,1.0,1.0,2.0,3.0,6.0,20,13,7,13.0,9.0,4.0
9604339,28,15,13,28,7,21,113,5,3.0,2.0,1.0,2.0,1.0,2.0,8.0,70,28,42,3.0,1.0,2.0
9701394,23,5,18,65,1,22,87,5,16.0,3.0,13.0,49.0,0.0,16.0,72.0,30,23,7,2.0,2.0,0.0
9708377,19,5,14,40,0,19,301,5,16.0,5.0,11.0,34.0,0.0,16.0,281.0,67,19,48,37.0,13.0,24.0
2260,11,3,8,13,0,11,104,1,4.0,1.0,3.0,4.0,0.0,4.0,53.0,50,11,39,4.0,3.0,1.0
9412227,3,3,0,0,3,0,0,93,1.0,1.0,0.0,0.0,1.0,0.0,0.0,8,3,5,1.0,1.0,0.0
9802352,17,2,15,47,0,17,95,33,13.0,1.0,12.0,39.0,0.0,13.0,79.0,31,17,14,19.0,12.0,7.0
9808289,25,9,16,29,5,20,70,58,10.0,8.0,2.0,2.0,1.0,9.0,21.0,33,25,8,10.0,6.0,4.0
108096,15,8,7,12,0,15,69,1,4.0,1.0,3.0,6.0,0.0,4.0,4.0,39,15,24,5.0,4.0,1.0
9905520,21,5,16,32,3,18,158,6,12.0,3.0,9.0,20.0,0.0,12.0,114.0,51,21,30,6.0,5.0,1.0
9706430,85,21,64,164,22,63,161,8,6.0,2.0,4.0,11.0,1.0,5.0,17.0,100,85,15,6.0,5.0,1.0
10024,6,5,1,1,0,6,31,7,2.0,2.0,0.0,0.0,0.0,2.0,4.0,34,6,28,2.0,0.0,2.0
9803485,13,4,9,19,13,0,0,6,6.0,3.0,3.0,7.0,6.0,0.0,0.0,13,13,0,1.0,1.0,0.0
9705253,81,4,77,473,0,81,626,7,55.0,3.0,52.0,339.0,0.0,55.0,381.0,108,81,27,42.0,33.0,9.0
9708398,21,6,15,39,17,4,5,1,5.0,4.0,1.0,1.0,5.0,0.0,0.0,27,21,6,5.0,5.0,0.0
9312348,2,1,1,1,1,1,2,48,2.0,1.0,1.0,1.0,2.0,0.0,0.0,4,2,2,2.0,2.0,0.0
9401219,177,12,165,1593,106,71,75,4,75.0,3.0,72.0,896.0,48.0,27.0,27.0,179,177,2,53.0,52.0,1.0
9405352,100,11,89,602,81,19,19,21,52.0,3.0,49.0,339.0,52.0,0.0,0.0,101,100,1,27.0,27.0,0.0
9409229,21,5,16,30,20,1,1,1,7.0,1.0,6.0,10.0,7.0,0.0,0.0,22,21,1,6.0,6.0,0.0
9902355,15,5,10,23,0,15,104,7,9.0,2.0,7.0,14.0,0.0,9.0,28.0,31,15,16,17.0,10.0,7.0
9602323,83,16,67,206,49,34,37,9,20.0,2.0,18.0,46.0,7.0,13.0,13.0,90,83,7,6.0,6.0,0.0
9801456,35,5,30,115,0,35,298,7,19.0,1.0,18.0,68.0,0.0,19.0,102.0,64,35,29,12.0,7.0,5.0
9402252,2,2,0,0,1,1,2,15,0.0,0.0,0.0,0.0,0.0,0.0,0.0,16,2,14,1.0,0.0,1.0
9305345,93,15,78,570,45,48,48,15,48.0,5.0,43.0,361.0,19.0,29.0,29.0,94,93,1,33.0,32.0,1.0
9308234,5,4,1,1,2,3,14,15,1.0,1.0,0.0,0.0,1.0,0.0,0.0,14,5,9,1.0,1.0,0.0
9511321,28,7,21,47,12,16,34,98,16.0,1.0,15.0,36.0,6.0,10.0,20.0,36,28,8,11.0,7.0,4.0
9509426,7,6,1,1,3,4,4,88,2.0,2.0,0.0,0.0,1.0,1.0,1.0,11,7,4,2.0,2.0,0.0
9609474,54,1,53,345,11,43,135,19,24.0,2.0,22.0,111.0,3.0,21.0,21.0,64,54,10,24.0,22.0,2.0
9605323,203,41,162,912,53,150,362,19,46.0,9.0,37.0,264.0,6.0,40.0,153.0,216,203,13,22.0,20.0,2.0
9508291,18,6,12,31,2,16,44,62,13.0,5.0,8.0,23.0,1.0,12.0,28.0,28,18,10,14.0,11.0,3.0
9502230,6,3,3,6,0,6,20,19,1.0,1.0,0.0,0.0,0.0,1.0,1.0,14,6,8,2.0,0.0,2.0
9608491,60,8,52,380,10,50,65,24,35.0,2.0,33.0,279.0,35.0,0.0,0.0,64,60,4,26.0,26.0,0.0
9707375,10,5,5,8,3,7,12,16,2.0,1.0,1.0,1.0,0.0,2.0,4.0,17,10,7,4.0,4.0,0.0
9402283,268,31,237,1482,234,34,34,9,48.0,4.0,44.0,210.0,48.0,0.0,0.0,269,268,1,29.0,29.0,0.0
9410411,7,3,4,7,7,0,0,127,6.0,3.0,3.0,5.0,6.0,0.0,0.0,7,7,0,2.0,2.0,0.0
109180,0,0,0,0,0,0,0,98,0.0,0.0,0.0,0.0,0.0,0.0,0.0,36,0,36,6.0,0.0,6.0
9504232,5,2,3,4,2,3,3,108,3.0,1.0,2.0,3.0,1.0,2.0,2.0,6,5,1,,,
9611355,6,3,3,4,3,3,4,62,1.0,1.0,0.0,0.0,1.0,0.0,0.0,11,6,5,3.0,1.0,2.0
2258,40,20,20,66,7,33,483,4,6.0,3.0,3.0,5.0,0.0,6.0,96.0,205,40,165,26.0,10.0,16.0
9903541,25,7,18,33,2,23,66,39,11.0,4.0,7.0,10.0,0.0,11.0,17.0,38,25,13,7.0,6.0,1.0
9208220,18,8,10,24,18,0,0,35,7.0,1.0,6.0,12.0,7.0,0.0,0.0,18,18,0,7.0,7.0,0.0
9611224,7,4,3,7,0,7,34,114,5.0,3.0,2.0,4.0,0.0,5.0,30.0,24,7,17,14.0,5.0,9.0
9905351,24,4,20,55,0,24,194,6,8.0,2.0,6.0,13.0,0.0,8.0,87.0,57,24,33,13.0,8.0,5.0
9907501,7,1,6,11,0,7,52,6,4.0,1.0,3.0,4.0,0.0,4.0,9.0,21,7,14,10.0,4.0,6.0
9503404,40,9,31,118,5,35,225,6,24.0,4.0,20.0,87.0,0.0,24.0,171.0,61,40,21,7.0,5.0,2.0
9506210,17,6,11,24,2,15,37,6,8.0,2.0,6.0,15.0,0.0,8.0,23.0,26,17,9,2.0,1.0,1.0
5039,3,2,1,1,0,3,6,6,1.0,1.0,0.0,0.0,0.0,1.0,1.0,7,3,4,4.0,2.0,2.0
9408230,6,5,1,1,3,3,3,804,,,,,,,,8,6,2,1.0,0.0,1.0
9701390,188,26,162,754,115,73,100,8,28.0,1.0,27.0,139.0,28.0,0.0,0.0,192,188,4,16.0,15.0,1.0
9706467,35,8,27,75,5,30,177,8,14.0,5.0,9.0,24.0,0.0,14.0,96.0,55,35,20,21.0,11.0,10.0
4060,17,5,12,22,1,16,68,38,3.0,2.0,1.0,1.0,0.0,3.0,8.0,34,17,17,8.0,2.0,6.0
9609256,36,10,26,81,5,31,99,22,25.0,6.0,19.0,64.0,3.0,22.0,63.0,49,36,13,15.0,11.0,4.0
9607440,58,4,54,312,23,35,50,45,42.0,3.0,39.0,234.0,14.0,28.0,42.0,60,58,2,32.0,30.0,2.0
9911350,4,4,0,0,1,3,22,45,1.0,1.0,0.0,0.0,0.0,1.0,7.0,39,4,35,3.0,1.0,2.0
9501229,14,3,11,26,5,9,16,22,6.0,1.0,5.0,6.0,1.0,5.0,5.0,17,14,3,4.0,3.0,1.0
9405309,11,7,4,8,6,5,11,22,2.0,2.0,0.0,0.0,0.0,2.0,4.0,15,11,4,3.0,1.0,2.0
9904270,14,4,10,23,0,14,73,22,9.0,3.0,6.0,12.0,0.0,9.0,43.0,29,14,15,14.0,6.0,8.0
9503330,27,9,18,36,8,19,33,40,6.0,2.0,4.0,10.0,6.0,0.0,0.0,55,27,28,5.0,0.0,5.0
9901385,3,1,2,3,0,3,14,88,3.0,1.0,2.0,3.0,0.0,3.0,14.0,9,3,6,8.0,3.0,5.0
9910344,12,4,8,14,1,11,25,22,7.0,2.0,5.0,10.0,0.0,7.0,11.0,19,12,7,9.0,7.0,2.0
9804453,11,1,10,31,0,11,72,21,9.0,1.0,8.0,29.0,0.0,9.0,64.0,36,11,25,20.0,8.0,12.0
9806205,60,4,56,247,6,54,212,21,22.0,1.0,21.0,51.0,0.0,22.0,99.0,83,60,23,14.0,5.0,9.0
9405388,157,19,138,827,157,0,0,16,48.0,4.0,44.0,247.0,48.0,0.0,0.0,157,157,0,25.0,25.0,0.0
9801442,27,4,23,57,14,13,29,19,8.0,3.0,5.0,6.0,3.0,5.0,7.0,32,27,5,5.0,5.0,0.0
9903390,24,5,19,52,0,24,130,16,17.0,4.0,13.0,37.0,0.0,17.0,96.0,33,24,9,21.0,14.0,7.0
9911379,31,6,25,58,12,19,74,43,9.0,1.0,8.0,12.0,0.0,9.0,46.0,39,31,8,12.0,7.0,5.0
9912543,4,3,1,1,3,1,1,66,1.0,1.0,0.0,0.0,1.0,0.0,0.0,5,4,1,1.0,1.0,0.0
9604393,105,16,89,251,30,75,159,68,26.0,2.0,24.0,55.0,8.0,18.0,18.0,118,105,13,13.0,10.0,3.0
10321,22,1,21,60,1,21,194,20,20.0,1.0,19.0,58.0,1.0,19.0,182.0,44,22,22,29.0,9.0,20.0
9906478,87,10,77,724,5,82,762,20,74.0,4.0,70.0,686.0,0.0,74.0,702.0,110,87,23,72.0,57.0,15.0
9910351,12,5,7,11,0,12,101,31,4.0,1.0,3.0,4.0,0.0,4.0,60.0,43,12,31,24.0,4.0,20.0
9402340,28,10,18,56,7,21,48,29,17.0,5.0,12.0,30.0,1.0,16.0,38.0,34,28,6,9.0,6.0,3.0
9507353,21,12,9,13,4,17,99,17,10.0,6.0,4.0,8.0,0.0,10.0,70.0,37,21,16,3.0,3.0,0.0
9710390,3,2,1,1,1,2,2,214,1.0,1.0,0.0,0.0,0.0,1.0,1.0,6,3,3,5.0,2.0,3.0
6105,12,3,9,24,0,12,155,20,12.0,3.0,9.0,24.0,0.0,12.0,155.0,31,12,19,29.0,10.0,19.0
12311,7,2,5,7,0,7,43,20,5.0,1.0,4.0,6.0,0.0,5.0,12.0,21,7,14,6.0,2.0,4.0
102307,18,6,12,30,6,12,28,37,10.0,2.0,8.0,20.0,7.0,3.0,3.0,26,18,8,3.0,3.0,0.0
9903524,20,2,18,42,3,17,71,2,6.0,1.0,5.0,7.0,4.0,2.0,2.0,29,20,9,7.0,6.0,1.0
9908364,41,9,32,118,33,8,8,78,20.0,2.0,18.0,56.0,20.0,0.0,0.0,42,41,1,15.0,15.0,0.0
9409259,1,1,0,0,1,0,0,2059,,,,,,,,4,1,3,,,
9805275,14,4,10,18,2,12,72,4,4.0,2.0,2.0,3.0,0.0,4.0,17.0,32,14,18,1.0,1.0,0.0
9805349,25,9,16,50,0,25,168,4,10.0,3.0,7.0,24.0,0.0,10.0,66.0,54,25,29,15.0,9.0,6.0
9505296,8,6,2,2,1,7,21,35,0.0,0.0,0.0,0.0,0.0,0.0,0.0,51,8,43,3.0,2.0,1.0
9411413,24,11,13,24,8,16,29,10,6.0,2.0,4.0,5.0,0.0,6.0,10.0,28,24,4,10.0,8.0,2.0
9801280,4,2,2,3,1,3,22,99,3.0,1.0,2.0,3.0,0.0,3.0,19.0,13,4,9,9.0,3.0,6.0
9608359,18,4,14,40,3,15,17,42,11.0,1.0,10.0,19.0,5.0,6.0,6.0,24,18,6,8.0,7.0,1.0
9808276,2,2,0,0,0,2,18,73,2.0,2.0,0.0,0.0,0.0,2.0,18.0,15,2,13,14.0,2.0,12.0
9304206,32,11,21,48,32,0,0,35,8.0,1.0,7.0,24.0,8.0,0.0,0.0,32,32,0,3.0,3.0,0.0
9601224,18,8,10,27,3,15,37,30,9.0,1.0,8.0,25.0,0.0,9.0,24.0,40,18,22,11.0,8.0,3.0
9610544,115,25,90,334,61,54,94,5,17.0,6.0,11.0,32.0,3.0,14.0,25.0,120,115,5,9.0,9.0,0.0
9609420,31,7,24,61,7,24,62,4,16.0,6.0,10.0,20.0,1.0,15.0,15.0,47,31,16,8.0,7.0,1.0
9607268,5,1,4,5,1,4,11,23,1.0,1.0,0.0,0.0,0.0,1.0,2.0,8,5,3,5.0,3.0,2.0
9711334,2,1,1,1,1,1,1,1494,,,,,,,,4,2,2,,,
9812493,2,2,0,0,0,2,7,4,0.0,0.0,0.0,0.0,0.0,0.0,0.0,34,2,32,1.0,0.0,1.0
9610545,8,3,5,14,8,0,0,310,7.0,2.0,5.0,14.0,7.0,0.0,0.0,9,8,1,7.0,7.0,0.0
9906362,30,12,18,53,0,30,262,3,12.0,3.0,9.0,26.0,0.0,12.0,131.0,76,30,46,8.0,6.0,2.0
9905426,7,6,1,1,2,5,26,119,0.0,0.0,0.0,0.0,0.0,0.0,0.0,26,7,19,8.0,0.0,8.0
9708427,30,7,23,51,14,16,18,103,9.0,1.0,8.0,24.0,5.0,4.0,4.0,33,30,3,9.0,8.0,1.0
11077,1,1,0,0,1,0,0,1251,0.0,0.0,0.0,0.0,0.0,0.0,0.0,4,1,3,2.0,1.0,1.0
9704317,28,4,24,110,2,26,117,36,26.0,4.0,22.0,106.0,0.0,26.0,117.0,34,28,6,24.0,19.0,5.0
10196,9,5,4,4,4,5,10,31,1.0,1.0,0.0,0.0,0.0,1.0,1.0,24,9,15,3.0,1.0,2.0
4241,15,9,6,10,4,11,30,59,2.0,2.0,0.0,0.0,0.0,2.0,4.0,26,15,11,4.0,3.0,1.0
9409216,8,3,5,7,2,6,7,245,2.0,1.0,1.0,1.0,2.0,0.0,0.0,15,8,7,4.0,4.0,0.0
6006,4,2,2,3,1,3,17,2,3.0,1.0,2.0,3.0,0.0,3.0,17.0,11,4,7,8.0,3.0,5.0
2183,27,3,24,119,0,27,125,2,24.0,3.0,21.0,97.0,0.0,24.0,115.0,33,27,6,26.0,22.0,4.0
9410265,24,15,9,15,20,4,4,93,8.0,6.0,2.0,4.0,8.0,0.0,0.0,25,24,1,4.0,4.0,0.0
9506311,16,3,13,30,16,0,0,1,3.0,1.0,2.0,2.0,3.0,0.0,0.0,16,16,0,4.0,4.0,0.0
9312271,4,4,0,0,4,0,0,436,2.0,2.0,0.0,0.0,2.0,0.0,0.0,5,4,1,1.0,1.0,0.0
9309330,9,4,5,8,9,0,0,182,5.0,1.0,4.0,6.0,5.0,0.0,0.0,10,9,1,2.0,2.0,0.0
9601203,17,10,7,11,3,14,37,10,5.0,2.0,3.0,5.0,5.0,0.0,0.0,25,17,8,4.0,4.0,0.0
9712358,6,5,1,1,4,2,5,55,1.0,1.0,0.0,0.0,1.0,0.0,0.0,12,6,6,4.0,2.0,2.0
9912249,11,8,3,11,0,11,116,4,8.0,5.0,3.0,11.0,0.0,8.0,107.0,36,11,25,24.0,6.0,18.0
10058,16,9,7,12,1,15,73,32,5.0,3.0,2.0,3.0,0.0,5.0,21.0,30,16,14,8.0,2.0,6.0
9807215,3,2,1,1,0,3,13,20,2.0,1.0,1.0,1.0,2.0,0.0,0.0,10,3,7,2.0,2.0,0.0
9303207,20,4,16,93,0,20,86,124,20.0,4.0,16.0,93.0,1.0,19.0,65.0,33,20,13,21.0,16.0,5.0
204192,15,7,8,10,4,11,173,18,7.0,3.0,4.0,5.0,0.0,7.0,112.0,69,15,54,32.0,6.0,26.0
9706474,1,1,0,0,0,1,1,1924,,,,,,,,4,1,3,1.0,0.0,1.0
102312,56,7,49,225,6,50,94,23,30.0,2.0,28.0,148.0,5.0,25.0,25.0,61,56,5,12.0,12.0,0.0
8070,16,13,3,3,2,14,86,5,2.0,2.0,0.0,0.0,0.0,2.0,24.0,60,16,44,23.0,1.0,22.0
1203,19,8,11,18,15,4,5,18,3.0,3.0,0.0,0.0,3.0,0.0,0.0,22,19,3,3.0,3.0,0.0
9405364,1,1,0,0,1,0,0,479,0.0,0.0,0.0,0.0,0.0,0.0,0.0,3,1,2,1.0,0.0,1.0
106130,8,2,6,13,0,8,17,23,6.0,1.0,5.0,10.0,0.0,6.0,12.0,11,8,3,,,
9904413,36,9,27,95,1,35,351,7,24.0,5.0,19.0,61.0,0.0,24.0,269.0,62,36,26,41.0,20.0,21.0
2089,15,7,8,13,1,14,188,7,4.0,3.0,1.0,1.0,0.0,4.0,51.0,86,15,71,13.0,3.0,10.0
9710492,1,1,0,0,1,0,0,1126,,,,,,,,1,1,0,,,
9212257,17,7,10,39,17,0,0,147,9.0,2.0,7.0,19.0,9.0,0.0,0.0,17,17,0,5.0,5.0,0.0
12089,9,4,5,12,2,7,17,0,5.0,2.0,3.0,6.0,0.0,5.0,12.0,14,9,5,8.0,5.0,3.0
9906450,16,6,10,20,5,11,55,0,4.0,2.0,2.0,4.0,0.0,4.0,16.0,38,16,22,10.0,4.0,6.0
9610514,24,6,18,48,13,11,21,4,10.0,2.0,8.0,17.0,10.0,0.0,0.0,29,24,5,8.0,8.0,0.0
103060,9,4,5,7,2,7,31,118,6.0,2.0,4.0,6.0,0.0,6.0,22.0,42,9,33,11.0,5.0,6.0
7191,13,8,5,8,2,11,76,43,4.0,3.0,1.0,2.0,0.0,4.0,42.0,32,13,19,17.0,5.0,12.0
8152,22,4,18,67,2,20,84,19,13.0,4.0,9.0,32.0,0.0,13.0,63.0,35,22,13,16.0,12.0,4.0
9703417,25,7,18,50,3,22,119,16,3.0,2.0,1.0,1.0,0.0,3.0,20.0,45,25,20,8.0,2.0,6.0
9812311,35,10,25,64,0,35,171,11,23.0,3.0,20.0,54.0,0.0,23.0,112.0,47,35,12,5.0,2.0,3.0
9511448,60,6,54,153,24,36,59,150,28.0,4.0,24.0,61.0,13.0,15.0,27.0,65,60,5,14.0,12.0,2.0
9405308,20,5,15,80,19,1,2,94,16.0,3.0,13.0,67.0,16.0,0.0,0.0,22,20,2,14.0,14.0,0.0
9511252,24,3,21,59,14,10,12,47,16.0,1.0,15.0,48.0,11.0,5.0,5.0,30,24,6,14.0,13.0,1.0
9701418,22,7,15,33,1,21,62,8,7.0,1.0,6.0,13.0,0.0,7.0,15.0,43,22,21,8.0,6.0,2.0
9704406,33,3,30,128,1,32,151,9,21.0,1.0,20.0,92.0,0.0,21.0,110.0,52,33,19,27.0,20.0,7.0
8302,13,3,10,21,0,13,61,17,8.0,2.0,6.0,12.0,0.0,8.0,17.0,27,13,14,5.0,4.0,1.0
9503464,84,20,64,201,47,37,67,135,18.0,3.0,15.0,57.0,6.0,12.0,25.0,91,84,7,16.0,13.0,3.0
9905395,22,3,19,83,1,21,515,2,20.0,3.0,17.0,80.0,0.0,20.0,511.0,68,22,46,45.0,16.0,29.0
9911294,40,1,39,234,0,40,230,2,34.0,1.0,33.0,205.0,0.0,34.0,105.0,57,40,17,32.0,28.0,4.0
1255,12,6,6,8,5,7,15,258,5.0,2.0,3.0,4.0,0.0,5.0,11.0,20,12,8,7.0,3.0,4.0
103032,46,7,39,175,1,45,634,11,40.0,6.0,34.0,162.0,0.0,40.0,586.0,72,46,26,57.0,32.0,25.0
9908413,19,2,17,40,2,17,92,16,10.0,2.0,8.0,15.0,0.0,10.0,53.0,39,19,20,15.0,7.0,8.0
210130,9,6,3,7,0,9,88,19,6.0,4.0,2.0,5.0,0.0,6.0,62.0,38,9,29,20.0,5.0,15.0
112081,29,3,26,94,1,28,567,19,24.0,1.0,23.0,89.0,0.0,24.0,502.0,77,29,48,52.0,21.0,31.0
9193,4,1,3,3,0,4,17,19,0.0,0.0,0.0,0.0,0.0,0.0,0.0,14,4,10,7.0,1.0,6.0
108222,9,2,7,15,0,9,122,8,7.0,2.0,5.0,12.0,0.0,7.0,87.0,43,9,34,23.0,5.0,18.0
9912214,22,6,16,28,5,17,41,102,10.0,3.0,7.0,14.0,0.0,10.0,30.0,30,22,8,10.0,6.0,4.0
107119,47,2,45,492,0,47,137,28,43.0,1.0,42.0,466.0,0.0,43.0,86.0,50,47,3,40.0,38.0,2.0
111010,1,1,0,0,1,0,0,176,0.0,0.0,0.0,0.0,0.0,0.0,0.0,3,1,2,,,
112061,19,1,18,71,0,19,106,28,17.0,1.0,16.0,67.0,0.0,17.0,49.0,28,19,9,19.0,16.0,3.0
9401237,20,12,8,10,17,3,3,155,4.0,4.0,0.0,0.0,4.0,0.0,0.0,21,20,1,3.0,3.0,0.0
9909335,12,6,6,7,6,6,13,168,0.0,0.0,0.0,0.0,0.0,0.0,0.0,27,12,15,4.0,1.0,3.0
9301211,25,8,17,31,25,0,0,242,12.0,3.0,9.0,14.0,12.0,0.0,0.0,25,25,0,4.0,4.0,0.0
101131,18,4,14,21,0,18,59,2,1.0,1.0,0.0,0.0,1.0,0.0,0.0,23,18,5,5.0,5.0,0.0
9903538,28,2,26,250,0,28,323,2,27.0,2.0,25.0,245.0,0.0,27.0,317.0,42,28,14,37.0,24.0,13.0
5095,3,2,1,1,0,3,14,10,0.0,0.0,0.0,0.0,0.0,0.0,0.0,25,3,22,10.0,0.0,10.0
205247,4,3,1,2,0,4,66,10,3.0,2.0,1.0,1.0,0.0,3.0,16.0,33,4,29,4.0,3.0,1.0
9707425,18,1,17,33,0,18,132,60,3.0,1.0,2.0,3.0,0.0,3.0,21.0,48,18,30,13.0,3.0,10.0
103125,106,12,94,841,5,101,336,37,75.0,5.0,70.0,728.0,2.0,73.0,231.0,116,106,10,55.0,51.0,4.0
9709465,12,2,10,18,0,12,46,10,6.0,2.0,4.0,7.0,0.0,6.0,18.0,18,12,6,10.0,6.0,4.0
9507344,17,5,12,39,12,5,9,0,8.0,2.0,6.0,16.0,8.0,0.0,0.0,27,17,10,2.0,2.0,0.0
9907419,4,2,2,2,1,3,5,63,3.0,2.0,1.0,1.0,0.0,3.0,5.0,12,4,8,7.0,0.0,7.0
9303324,8,3,5,6,8,0,0,12,2.0,1.0,1.0,1.0,2.0,0.0,0.0,8,8,0,,,
9804307,7,2,5,7,0,7,30,119,4.0,1.0,3.0,3.0,0.0,4.0,23.0,15,7,8,12.0,4.0,8.0
9412300,2,2,0,0,2,0,0,225,1.0,1.0,0.0,0.0,1.0,0.0,0.0,3,2,1,1.0,1.0,0.0
7244,3,2,1,1,0,3,18,20,2.0,1.0,1.0,1.0,0.0,2.0,4.0,19,3,16,2.0,2.0,0.0
6138,7,4,3,3,0,7,56,3,2.0,1.0,1.0,1.0,0.0,2.0,8.0,31,7,24,15.0,1.0,14.0
9812209,27,7,20,73,7,20,78,1,7.0,2.0,5.0,7.0,1.0,6.0,6.0,54,27,27,8.0,6.0,2.0
10042,3,3,0,0,0,3,20,34,2.0,2.0,0.0,0.0,0.0,2.0,19.0,25,3,22,21.0,1.0,20.0
9611284,42,10,32,107,1,41,265,58,19.0,5.0,14.0,35.0,0.0,19.0,73.0,90,42,48,16.0,10.0,6.0
9911348,13,3,10,22,3,10,78,7,3.0,2.0,1.0,2.0,0.0,3.0,25.0,66,13,53,29.0,0.0,29.0
9402341,36,6,30,157,27,9,19,61,14.0,2.0,12.0,37.0,14.0,0.0,0.0,41,36,5,15.0,15.0,0.0
9601369,36,7,29,70,16,20,33,79,18.0,2.0,16.0,38.0,9.0,9.0,12.0,47,36,11,8.0,8.0,0.0
9701388,9,7,2,2,1,8,30,79,3.0,2.0,1.0,1.0,0.0,3.0,16.0,24,9,15,8.0,1.0,7.0
9412363,13,4,9,16,4,9,16,11,10.0,3.0,7.0,13.0,10.0,0.0,0.0,16,13,3,9.0,9.0,0.0
9207205,10,8,2,2,10,0,0,75,2.0,2.0,0.0,0.0,2.0,0.0,0.0,10,10,0,4.0,4.0,0.0
9302279,9,5,4,8,9,0,0,17,3.0,3.0,0.0,0.0,3.0,0.0,0.0,9,9,0,2.0,2.0,0.0
9609285,11,5,6,15,0,11,117,17,10.0,5.0,5.0,13.0,0.0,10.0,113.0,32,11,21,25.0,8.0,17.0
9312361,1,1,0,0,1,0,0,1462,,,,,,,,1,1,0,,,
9901369,9,6,3,4,0,9,56,48,4.0,4.0,0.0,0.0,0.0,4.0,25.0,30,9,21,9.0,1.0,8.0
9604290,4,3,1,1,0,4,20,6,2.0,1.0,1.0,1.0,0.0,2.0,13.0,16,4,12,1.0,0.0,1.0
9610426,7,5,2,2,1,6,18,59,2.0,2.0,0.0,0.0,0.0,2.0,5.0,14,7,7,4.0,2.0,2.0
9703389,23,7,16,39,6,17,34,8,8.0,3.0,5.0,9.0,5.0,3.0,3.0,30,23,7,5.0,4.0,1.0
9411312,17,6,11,28,13,4,7,8,3.0,3.0,0.0,0.0,3.0,0.0,0.0,22,17,5,3.0,2.0,1.0
9810290,7,4,3,4,5,2,2,92,1.0,1.0,0.0,0.0,0.0,1.0,1.0,14,7,7,2.0,2.0,0.0
9903211,26,4,22,71,1,25,65,4,16.0,1.0,15.0,56.0,0.0,16.0,24.0,38,26,12,11.0,8.0,3.0
9701300,27,4,23,70,0,27,93,6,5.0,3.0,2.0,3.0,0.0,5.0,10.0,53,27,26,9.0,6.0,3.0
9903474,22,4,18,54,3,19,183,12,15.0,1.0,14.0,44.0,0.0,15.0,153.0,57,22,35,33.0,12.0,21.0
9208209,9,4,5,8,9,0,0,244,5.0,1.0,4.0,5.0,5.0,0.0,0.0,9,9,0,4.0,4.0,0.0
6328,14,3,11,21,4,10,15,28,5.0,2.0,3.0,3.0,1.0,4.0,4.0,19,14,5,6.0,4.0,2.0
9510270,4,4,0,0,0,4,10,192,1.0,1.0,0.0,0.0,0.0,1.0,3.0,18,4,14,7.0,1.0,6.0
9807369,2,1,1,1,1,1,2,39,0.0,0.0,0.0,0.0,0.0,0.0,0.0,38,2,36,12.0,0.0,12.0
9508246,44,12,32,73,28,16,42,77,10.0,2.0,8.0,9.0,0.0,10.0,32.0,52,44,8,10.0,6.0,4.0
9908425,17,4,13,29,1,16,87,54,12.0,3.0,9.0,20.0,0.0,12.0,58.0,35,17,18,13.0,4.0,9.0
9904278,38,5,33,124,0,38,443,24,28.0,2.0,26.0,106.0,0.0,28.0,345.0,70,38,32,42.0,23.0,19.0
9610313,33,6,27,95,2,31,118,92,19.0,3.0,16.0,57.0,0.0,19.0,73.0,45,33,12,23.0,18.0,5.0
9608304,2,2,0,0,2,0,0,122,1.0,1.0,0.0,0.0,1.0,0.0,0.0,9,2,7,1.0,0.0,1.0
9509258,23,7,16,57,2,21,36,47,14.0,3.0,11.0,42.0,2.0,12.0,16.0,29,23,6,15.0,13.0,2.0
9807251,53,11,42,139,3,50,324,14,27.0,4.0,23.0,79.0,1.0,26.0,215.0,77,53,24,39.0,20.0,19.0
106156,2,1,1,1,0,2,2,66,,,,,,,,7,2,5,,,
9510262,28,4,24,67,9,19,23,14,9.0,2.0,7.0,9.0,1.0,8.0,8.0,32,28,4,7.0,6.0,1.0
9511330,12,4,8,22,0,12,65,14,10.0,4.0,6.0,15.0,0.0,10.0,42.0,29,12,17,2.0,2.0,0.0
9905512,36,12,24,50,11,25,73,14,12.0,5.0,7.0,15.0,1.0,11.0,36.0,44,36,8,13.0,7.0,6.0
9710561,34,7,27,81,2,32,86,27,25.0,3.0,22.0,66.0,1.0,24.0,61.0,39,34,5,7.0,7.0,0.0
9906321,17,10,7,14,6,11,30,14,6.0,1.0,5.0,11.0,6.0,0.0,0.0,26,17,9,5.0,5.0,0.0
9301244,98,19,79,445,98,0,0,13,50.0,5.0,45.0,291.0,50.0,0.0,0.0,98,98,0,15.0,15.0,0.0
9402305,10,7,3,3,8,2,2,114,3.0,3.0,0.0,0.0,3.0,0.0,0.0,11,10,1,3.0,3.0,0.0
9607246,2,1,1,1,0,2,6,77,2.0,1.0,1.0,1.0,0.0,2.0,6.0,7,2,5,4.0,0.0,4.0
106347,18,9,9,19,3,15,89,45,10.0,4.0,6.0,12.0,0.0,10.0,80.0,40,18,22,28.0,7.0,21.0
9603439,5,3,2,2,1,4,12,17,2.0,1.0,1.0,1.0,0.0,2.0,3.0,11,5,6,4.0,2.0,2.0
9510208,15,5,10,20,0,15,86,17,3.0,1.0,2.0,3.0,0.0,3.0,29.0,46,15,31,7.0,0.0,7.0
9802366,9,3,6,14,4,5,6,11,5.0,2.0,3.0,7.0,5.0,0.0,0.0,14,9,5,2.0,1.0,1.0
9607318,3,2,1,1,0,3,12,19,2.0,1.0,1.0,1.0,1.0,1.0,1.0,13,3,10,2.0,2.0,0.0
9608355,5,2,3,3,2,3,12,16,3.0,1.0,2.0,2.0,3.0,0.0,0.0,12,5,7,2.0,2.0,0.0
9707257,2,2,0,0,0,2,3,115,,,,,,,,5,2,3,,,
9810294,3,2,1,1,0,3,8,300,2.0,1.0,1.0,1.0,2.0,0.0,0.0,6,3,3,5.0,3.0,2.0
9901253,1,1,0,0,0,1,1,794,0.0,0.0,0.0,0.0,0.0,0.0,0.0,5,1,4,1.0,0.0,1.0
9708241,6,5,1,1,2,4,11,132,3.0,3.0,0.0,0.0,0.0,3.0,9.0,10,6,4,6.0,3.0,3.0
9610344,3,2,1,1,0,3,3,8,1.0,1.0,0.0,0.0,0.0,1.0,1.0,12,3,9,3.0,1.0,2.0
9212224,24,11,13,45,18,6,6,15,14.0,3.0,11.0,29.0,11.0,3.0,3.0,25,24,1,5.0,5.0,0.0
9407238,7,4,3,5,2,5,7,237,2.0,1.0,1.0,1.0,0.0,2.0,4.0,9,7,2,2.0,2.0,0.0
9605387,24,5,19,96,0,24,322,15,17.0,2.0,15.0,83.0,0.0,17.0,276.0,70,24,46,39.0,16.0,23.0
9405367,7,5,2,2,7,0,0,150,1.0,1.0,0.0,0.0,1.0,0.0,0.0,9,7,2,2.0,2.0,0.0
9701325,10,8,2,2,1,9,63,10,1.0,1.0,0.0,0.0,0.0,1.0,2.0,33,10,23,7.0,3.0,4.0
9912260,21,11,10,11,6,15,38,61,0.0,0.0,0.0,0.0,0.0,0.0,0.0,57,21,36,17.0,0.0,17.0
11217,8,3,5,7,0,8,39,3,3.0,1.0,2.0,3.0,0.0,3.0,19.0,29,8,21,1.0,1.0,0.0
4049,28,7,21,96,1,27,131,0,19.0,4.0,15.0,73.0,2.0,17.0,52.0,62,28,34,23.0,16.0,7.0
9909428,8,4,4,6,0,8,29,0,2.0,2.0,0.0,0.0,0.0,2.0,3.0,20,8,12,2.0,2.0,0.0
9301227,1,1,0,0,1,0,0,2078,,,,,,,,1,1,0,,,
9707210,3,1,2,2,2,1,1,83,1.0,1.0,0.0,0.0,0.0,1.0,1.0,4,3,1,,,
9911526,3,1,2,2,1,2,2,33,3.0,1.0,2.0,2.0,1.0,2.0,2.0,6,3,3,1.0,1.0,0.0
9809453,59,12,47,135,22,37,113,21,18.0,5.0,13.0,32.0,4.0,14.0,30.0,68,59,9,14.0,10.0,4.0
112285,7,6,1,1,1,6,18,1,1.0,1.0,0.0,0.0,0.0,1.0,3.0,25,7,18,2.0,1.0,1.0
112279,11,4,7,22,0,11,32,146,11.0,4.0,7.0,22.0,0.0,11.0,31.0,27,11,16,14.0,9.0,5.0
9283,2,1,1,1,0,2,10,120,2.0,1.0,1.0,1.0,0.0,2.0,10.0,12,2,10,8.0,2.0,6.0
9805240,7,3,4,5,0,7,19,69,2.0,1.0,1.0,1.0,0.0,2.0,5.0,20,7,13,5.0,3.0,2.0
9211250,21,9,12,33,21,0,0,155,9.0,5.0,4.0,7.0,9.0,0.0,0.0,21,21,0,5.0,5.0,0.0
9803342,29,6,23,47,4,25,171,8,11.0,2.0,9.0,22.0,0.0,11.0,105.0,57,29,28,8.0,1.0,7.0
9808458,21,2,19,44,0,21,68,3,10.0,1.0,9.0,24.0,0.0,10.0,19.0,30,21,9,9.0,7.0,2.0
108249,6,1,5,9,0,6,12,10,2.0,1.0,1.0,1.0,0.0,2.0,2.0,9,6,3,4.0,2.0,2.0
1205,2,1,1,1,0,2,5,123,1.0,1.0,0.0,0.0,0.0,1.0,4.0,9,2,7,3.0,0.0,3.0
9707489,7,5,2,2,0,7,43,22,5.0,3.0,2.0,2.0,0.0,5.0,38.0,24,7,17,6.0,2.0,4.0
9502209,1,1,0,0,1,0,0,993,0.0,0.0,0.0,0.0,0.0,0.0,0.0,2,1,1,1.0,1.0,0.0
106195,14,3,11,38,0,14,113,21,14.0,3.0,11.0,38.0,0.0,14.0,82.0,39,14,25,22.0,12.0,10.0
9608435,2,1,1,1,0,2,29,49,2.0,1.0,1.0,1.0,0.0,2.0,22.0,19,2,17,12.0,2.0,10.0
9810344,1,1,0,0,0,1,6,5,1.0,1.0,0.0,0.0,0.0,1.0,3.0,12,1,11,,,
9348,5,4,1,1,1,4,29,44,2.0,2.0,0.0,0.0,0.0,2.0,15.0,17,5,12,12.0,3.0,9.0
9302271,13,3,10,26,13,0,0,56,12.0,2.0,10.0,26.0,12.0,0.0,0.0,14,13,1,1.0,0.0,1.0
9904440,25,6,19,51,11,14,32,30,14.0,1.0,13.0,32.0,14.0,0.0,0.0,35,25,10,6.0,1.0,5.0
9804297,13,7,6,6,5,8,27,87,6.0,4.0,2.0,2.0,0.0,6.0,20.0,22,13,9,5.0,2.0,3.0
9804243,6,6,0,0,0,6,8,60,0.0,0.0,0.0,0.0,0.0,0.0,0.0,12,6,6,,,
9910267,3,2,1,1,0,3,21,32,2.0,1.0,1.0,1.0,0.0,2.0,17.0,19,3,16,1.0,1.0,0.0
107046,11,4,7,9,0,11,109,58,2.0,2.0,0.0,0.0,0.0,2.0,20.0,71,11,60,18.0,3.0,15.0
7095,5,2,3,4,0,5,25,13,5.0,2.0,3.0,4.0,0.0,5.0,25.0,14,5,9,12.0,4.0,8.0
9401324,14,7,7,9,7,7,14,26,3.0,2.0,1.0,2.0,0.0,3.0,5.0,20,14,6,1.0,0.0,1.0
9402295,26,5,21,65,14,12,20,131,19.0,4.0,15.0,55.0,9.0,10.0,18.0,29,26,3,12.0,10.0,2.0
9602319,1,1,0,0,0,1,3,14,0.0,0.0,0.0,0.0,0.0,0.0,0.0,5,1,4,,,
205296,1,1,0,0,0,1,6,64,1.0,1.0,0.0,0.0,0.0,1.0,3.0,9,1,8,6.0,1.0,5.0
9710350,4,4,0,0,0,4,21,36,3.0,3.0,0.0,0.0,0.0,3.0,12.0,22,4,18,14.0,1.0,13.0
110255,12,9,3,3,2,10,93,7,0.0,0.0,0.0,0.0,0.0,0.0,0.0,100,12,88,27.0,0.0,27.0
9811333,4,2,2,2,0,4,8,50,2.0,1.0,1.0,1.0,0.0,2.0,4.0,6,4,2,4.0,2.0,2.0
9802251,18,5,13,37,2,16,88,12,8.0,3.0,5.0,10.0,0.0,8.0,32.0,31,18,13,13.0,8.0,5.0
202061,1,1,0,0,0,1,1,169,0.0,0.0,0.0,0.0,0.0,0.0,0.0,2,1,1,2.0,1.0,1.0
9306227,4,4,0,0,4,0,0,218,2.0,2.0,0.0,0.0,2.0,0.0,0.0,4,4,0,1.0,1.0,0.0
3165,25,6,19,67,2,23,182,67,13.0,2.0,11.0,34.0,0.0,13.0,67.0,49,25,24,17.0,5.0,12.0
9405330,5,5,0,0,3,2,5,13,0.0,0.0,0.0,0.0,0.0,0.0,0.0,13,5,8,3.0,1.0,2.0
9301270,6,3,3,3,6,0,0,453,1.0,1.0,0.0,0.0,1.0,0.0,0.0,6,6,0,2.0,2.0,0.0
9807250,10,4,6,12,4,6,9,30,8.0,2.0,6.0,12.0,2.0,6.0,7.0,14,10,4,3.0,2.0,1.0
106179,2,2,0,0,1,1,9,103,1.0,1.0,0.0,0.0,0.0,1.0,9.0,11,2,9,8.0,1.0,7.0
9506388,10,3,7,13,7,3,6,41,6.0,1.0,5.0,7.0,6.0,0.0,0.0,13,10,3,2.0,2.0,0.0
9802279,3,3,0,0,1,2,6,33,1.0,1.0,0.0,0.0,0.0,1.0,3.0,7,3,4,3.0,1.0,2.0
9503431,11,4,7,14,4,7,11,5,6.0,1.0,5.0,9.0,0.0,6.0,6.0,14,11,3,8.0,7.0,1.0
10171,7,5,2,3,4,3,4,301,0.0,0.0,0.0,0.0,0.0,0.0,0.0,17,7,10,3.0,1.0,2.0
9509272,9,4,5,8,2,7,16,41,1.0,1.0,0.0,0.0,0.0,1.0,1.0,16,9,7,1.0,1.0,0.0
5110,15,8,7,8,6,9,22,144,3.0,1.0,2.0,2.0,0.0,3.0,3.0,41,15,26,5.0,3.0,2.0
201031,5,5,0,0,2,3,11,0,0.0,0.0,0.0,0.0,0.0,0.0,0.0,13,5,8,1.0,0.0,1.0
8160,2,2,0,0,0,2,4,1047,0.0,0.0,0.0,0.0,0.0,0.0,0.0,5,2,3,1.0,0.0,1.0
9601351,5,2,3,4,1,4,9,44,4.0,2.0,2.0,3.0,0.0,4.0,9.0,9,5,4,2.0,1.0,1.0
9604418,3,1,2,3,0,3,10,29,2.0,1.0,1.0,1.0,0.0,2.0,4.0,10,3,7,1.0,0.0,1.0
110115,8,7,1,1,0,8,45,29,4.0,3.0,1.0,1.0,0.0,4.0,15.0,35,8,27,12.0,2.0,10.0
9311235,1,1,0,0,1,0,0,1275,,,,,,,,1,1,0,,,
104153,9,7,2,3,1,8,49,9,4.0,3.0,1.0,1.0,0.0,4.0,15.0,38,9,29,4.0,3.0,1.0
9804377,22,6,16,33,1,21,175,85,13.0,5.0,8.0,15.0,0.0,13.0,101.0,50,22,28,17.0,9.0,8.0
9512251,15,6,9,15,9,6,7,61,7.0,2.0,5.0,6.0,7.0,0.0,0.0,22,15,7,2.0,2.0,0.0
9902341,39,5,34,144,2,37,269,8,25.0,2.0,23.0,108.0,0.0,25.0,192.0,62,39,23,35.0,21.0,14.0
4179,4,3,1,1,0,4,18,80,2.0,1.0,1.0,1.0,0.0,2.0,8.0,21,4,17,3.0,2.0,1.0
9705376,1,1,0,0,0,1,1,205,0.0,0.0,0.0,0.0,0.0,0.0,0.0,6,1,5,3.0,0.0,3.0
10164,5,3,2,3,4,1,1,187,3.0,1.0,2.0,3.0,3.0,0.0,0.0,7,5,2,1.0,0.0,1.0
11264,13,9,4,5,10,3,3,26,5.0,3.0,2.0,3.0,5.0,0.0,0.0,28,13,15,5.0,5.0,0.0
111130,6,3,3,4,0,6,41,0,6.0,3.0,3.0,4.0,0.0,6.0,41.0,17,6,11,16.0,5.0,11.0
9710293,3,3,0,0,3,0,0,200,1.0,1.0,0.0,0.0,1.0,0.0,0.0,8,3,5,1.0,1.0,0.0
9812248,2,2,0,0,0,2,15,1,2.0,2.0,0.0,0.0,0.0,2.0,14.0,25,2,23,17.0,0.0,17.0
9506375,56,16,40,110,56,0,0,113,13.0,2.0,11.0,43.0,13.0,0.0,0.0,57,56,1,10.0,10.0,0.0
4243,15,6,9,22,1,14,29,42,7.0,2.0,5.0,12.0,4.0,3.0,3.0,21,15,6,8.0,6.0,2.0
9801422,5,2,3,4,3,2,20,499,1.0,1.0,0.0,0.0,0.0,1.0,2.0,18,5,13,1.0,0.0,1.0
9910461,12,6,6,11,0,12,110,69,8.0,4.0,4.0,7.0,0.0,8.0,48.0,29,12,17,15.0,5.0,10.0
110166,8,3,5,9,0,8,84,0,4.0,1.0,3.0,6.0,0.0,4.0,45.0,60,8,52,21.0,4.0,17.0
201231,98,25,73,379,48,50,107,107,35.0,10.0,25.0,158.0,23.0,12.0,22.0,107,98,9,22.0,21.0,1.0
204253,128,11,117,765,61,67,174,0,34.0,4.0,30.0,200.0,7.0,27.0,76.0,143,128,15,31.0,23.0,8.0
210387,1,1,0,0,0,1,8,393,1.0,1.0,0.0,0.0,0.0,1.0,3.0,13,1,12,6.0,1.0,5.0
9608393,15,6,9,15,7,8,29,27,2.0,1.0,1.0,1.0,0.0,2.0,3.0,28,15,13,5.0,3.0,2.0
9707399,1,1,0,0,0,1,2,13,0.0,0.0,0.0,0.0,0.0,0.0,0.0,13,1,12,3.0,1.0,2.0
9908495,1,1,0,0,1,0,0,1432,,,,,,,,1,1,0,,,
9707431,9,3,6,21,7,2,3,184,6.0,1.0,5.0,13.0,6.0,0.0,0.0,13,9,4,6.0,6.0,0.0
9305324,8,5,3,6,4,4,5,58,4.0,1.0,3.0,4.0,1.0,3.0,4.0,11,8,3,2.0,2.0,0.0
9205212,10,9,1,1,10,0,0,248,6.0,6.0,0.0,0.0,6.0,0.0,0.0,10,10,0,4.0,4.0,0.0
9608396,9,3,6,11,6,3,3,167,6.0,1.0,5.0,8.0,3.0,3.0,3.0,10,9,1,7.0,6.0,1.0
9602220,3,3,0,0,0,3,9,30,2.0,2.0,0.0,0.0,0.0,2.0,7.0,11,3,8,2.0,1.0,1.0
9504261,4,3,1,1,1,3,3,13,1.0,1.0,0.0,0.0,1.0,0.0,0.0,5,4,1,,,
9410332,2,2,0,0,0,2,9,25,2.0,2.0,0.0,0.0,0.0,2.0,6.0,9,2,7,1.0,0.0,1.0
9504390,1,1,0,0,1,0,0,869,,,,,,,,1,1,0,,,
9712345,5,2,3,8,0,5,10,16,0.0,0.0,0.0,0.0,0.0,0.0,0.0,17,5,12,4.0,0.0,4.0
301251,0,0,0,0,0,0,0,87,0.0,0.0,0.0,0.0,0.0,0.0,0.0,10,0,10,4.0,0.0,4.0
9307285,25,8,17,54,25,0,0,58,15.0,4.0,11.0,29.0,15.0,0.0,0.0,25,25,0,6.0,6.0,0.0
9211231,7,3,4,11,7,0,0,50,5.0,2.0,3.0,6.0,5.0,0.0,0.0,7,7,0,4.0,4.0,0.0
107181,6,4,2,3,0,6,53,4,3.0,2.0,1.0,1.0,0.0,3.0,17.0,45,6,39,8.0,1.0,7.0
9904235,6,5,1,1,6,0,0,499,1.0,1.0,0.0,0.0,1.0,0.0,0.0,8,6,2,1.0,0.0,1.0
109140,20,9,11,23,0,20,202,7,11.0,6.0,5.0,11.0,0.0,11.0,141.0,60,20,40,25.0,6.0,19.0
9905524,5,5,0,0,1,4,11,105,2.0,2.0,0.0,0.0,0.0,2.0,8.0,10,5,5,6.0,2.0,4.0
9403227,49,5,44,181,40,9,12,27,36.0,1.0,35.0,161.0,31.0,5.0,5.0,51,49,2,10.0,10.0,0.0
2011,8,7,1,1,0,8,78,39,7.0,6.0,1.0,1.0,0.0,7.0,62.0,25,8,17,20.0,5.0,15.0
107005,8,7,1,1,0,8,64,3,1.0,1.0,0.0,0.0,0.0,1.0,6.0,46,8,38,10.0,1.0,9.0
207107,5,4,1,1,0,5,19,129,4.0,4.0,0.0,0.0,0.0,4.0,10.0,20,5,15,3.0,3.0,0.0
201134,19,7,12,19,1,18,114,0,7.0,3.0,4.0,6.0,0.0,7.0,22.0,60,19,41,10.0,6.0,4.0
9908381,5,3,2,2,1,4,31,3,3.0,1.0,2.0,2.0,1.0,2.0,9.0,31,5,26,3.0,0.0,3.0
9304308,8,4,4,8,8,0,0,615,4.0,1.0,3.0,6.0,4.0,0.0,0.0,8,8,0,1.0,1.0,0.0
112230,10,6,4,11,1,9,95,37,7.0,3.0,4.0,10.0,1.0,6.0,80.0,49,10,39,33.0,4.0,29.0
8073,3,2,1,1,0,3,26,32,3.0,2.0,1.0,1.0,0.0,3.0,25.0,29,3,26,17.0,2.0,15.0
9336,18,4,14,39,1,17,43,47,15.0,2.0,13.0,37.0,1.0,14.0,37.0,25,18,7,17.0,12.0,5.0
9812423,20,10,10,19,2,18,48,47,11.0,6.0,5.0,9.0,0.0,11.0,30.0,32,20,12,14.0,11.0,3.0
3224,11,6,5,5,0,11,60,3,7.0,3.0,4.0,4.0,0.0,7.0,30.0,26,11,15,15.0,7.0,8.0
112123,5,5,0,0,0,5,34,3,1.0,1.0,0.0,0.0,0.0,1.0,13.0,54,5,49,6.0,2.0,4.0
201130,9,7,2,2,0,9,46,10,0.0,0.0,0.0,0.0,0.0,0.0,0.0,44,9,35,15.0,1.0,14.0
9901305,2,2,0,0,2,0,0,263,1.0,1.0,0.0,0.0,1.0,0.0,0.0,2,2,0,,,
9911542,10,5,5,5,1,9,26,166,5.0,2.0,3.0,3.0,0.0,5.0,17.0,20,10,10,5.0,2.0,3.0
205199,6,3,3,5,0,6,151,28,6.0,3.0,3.0,5.0,0.0,6.0,139.0,49,6,43,40.0,6.0,34.0
9503332,20,6,14,45,5,15,42,100,15.0,2.0,13.0,38.0,2.0,13.0,37.0,25,20,5,17.0,13.0,4.0
9803411,2,2,0,0,0,2,3,83,1.0,1.0,0.0,0.0,0.0,1.0,1.0,5,2,3,2.0,1.0,1.0
9401217,10,7,3,4,9,1,1,62,7.0,5.0,2.0,3.0,6.0,1.0,1.0,12,10,2,4.0,4.0,0.0
9605219,16,6,10,34,3,13,28,52,12.0,2.0,10.0,34.0,0.0,12.0,23.0,21,16,5,13.0,10.0,3.0
9704342,17,3,14,48,3,14,54,115,13.0,3.0,10.0,37.0,1.0,12.0,47.0,27,17,10,10.0,8.0,2.0
9407277,7,4,3,6,7,0,0,13,1.0,1.0,0.0,0.0,1.0,0.0,0.0,7,7,0,1.0,1.0,0.0
9605328,6,3,3,4,3,3,9,52,3.0,1.0,2.0,3.0,1.0,2.0,5.0,19,6,13,4.0,4.0,0.0
9606395,1,1,0,0,1,0,0,1073,,,,,,,,1,1,0,,,
9312224,10,7,3,4,2,8,22,6,2.0,2.0,0.0,0.0,2.0,0.0,0.0,14,10,4,6.0,6.0,0.0
103294,15,5,10,31,0,15,189,32,12.0,4.0,8.0,26.0,0.0,12.0,140.0,45,15,30,27.0,7.0,20.0
9506413,3,2,1,1,1,2,2,195,1.0,1.0,0.0,0.0,1.0,0.0,0.0,5,3,2,1.0,1.0,0.0
9507451,5,2,3,4,0,5,22,62,5.0,2.0,3.0,4.0,0.0,5.0,19.0,16,5,11,7.0,3.0,4.0
110177,1,1,0,0,1,0,0,121,,,,,,,,1,1,0,,,
9506382,14,2,12,24,0,14,32,102,10.0,1.0,9.0,20.0,0.0,10.0,24.0,17,14,3,12.0,9.0,3.0
9609249,4,4,0,0,1,3,9,104,0.0,0.0,0.0,0.0,0.0,0.0,0.0,25,4,21,8.0,0.0,8.0
9608262,4,3,1,1,0,4,13,17,1.0,1.0,0.0,0.0,1.0,0.0,0.0,24,4,20,4.0,0.0,4.0
9304305,4,1,3,5,3,1,1,245,2.0,1.0,1.0,1.0,2.0,0.0,0.0,11,4,7,3.0,3.0,0.0
9612219,2,1,1,1,2,0,0,1307,2.0,1.0,1.0,1.0,2.0,0.0,0.0,2,2,0,1.0,1.0,0.0
9406299,23,3,20,110,19,4,6,25,20.0,2.0,18.0,100.0,20.0,0.0,0.0,25,23,2,18.0,18.0,0.0
9809286,3,2,1,1,1,2,2,128,2.0,1.0,1.0,1.0,0.0,2.0,2.0,8,3,5,3.0,2.0,1.0
7224,20,2,18,90,1,19,74,109,20.0,2.0,18.0,90.0,1.0,19.0,65.0,32,20,12,25.0,19.0,6.0
9911372,2,1,1,1,0,2,13,109,1.0,1.0,0.0,0.0,0.0,1.0,6.0,14,2,12,8.0,1.0,7.0
9604271,2,2,0,0,1,1,1,263,1.0,1.0,0.0,0.0,1.0,0.0,0.0,3,2,1,1.0,1.0,0.0
9909238,6,1,5,6,0,6,56,12,0.0,0.0,0.0,0.0,0.0,0.0,0.0,49,6,43,11.0,0.0,11.0
10143,0,0,0,0,0,0,0,551,0.0,0.0,0.0,0.0,0.0,0.0,0.0,2,0,2,2.0,0.0,2.0
9704314,5,3,2,3,5,0,0,121,2.0,1.0,1.0,1.0,2.0,0.0,0.0,7,5,2,2.0,2.0,0.0
9910442,12,8,4,10,0,12,83,0,10.0,6.0,4.0,10.0,0.0,10.0,68.0,30,12,18,19.0,7.0,12.0
9410248,3,1,2,2,3,0,0,339,1.0,1.0,0.0,0.0,1.0,0.0,0.0,3,3,0,1.0,1.0,0.0
9511389,2,1,1,1,0,2,4,36,1.0,1.0,0.0,0.0,0.0,1.0,1.0,5,2,3,,,
9912327,1,1,0,0,0,1,1,584,0.0,0.0,0.0,0.0,0.0,0.0,0.0,4,1,3,1.0,0.0,1.0
9609404,18,9,9,12,15,3,3,53,8.0,2.0,6.0,9.0,8.0,0.0,0.0,19,18,1,2.0,2.0,0.0
9708374,10,5,5,7,1,9,52,61,4.0,1.0,3.0,4.0,0.0,4.0,21.0,35,10,25,14.0,4.0,10.0
9705382,5,4,1,1,3,2,13,168,2.0,2.0,0.0,0.0,1.0,1.0,2.0,16,5,11,3.0,1.0,2.0
9707280,2,2,0,0,0,2,10,1,,,,,,,,9,2,7,6.0,1.0,5.0
9806363,3,2,1,1,0,3,7,328,2.0,1.0,1.0,1.0,1.0,1.0,1.0,7,3,4,2.0,1.0,1.0
6091,3,1,2,3,0,3,13,34,3.0,1.0,2.0,3.0,0.0,3.0,13.0,10,3,7,2.0,0.0,2.0
9910244,1,1,0,0,1,0,0,31,0.0,0.0,0.0,0.0,0.0,0.0,0.0,4,1,3,,,
9910326,4,3,1,1,4,0,0,463,2.0,1.0,1.0,1.0,2.0,0.0,0.0,8,4,4,2.0,2.0,0.0
9805468,12,9,3,4,2,10,20,6,1.0,1.0,0.0,0.0,0.0,1.0,6.0,35,12,23,3.0,3.0,0.0
5175,1,1,0,0,1,0,0,24,0.0,0.0,0.0,0.0,0.0,0.0,0.0,9,1,8,,,
112137,1,1,0,0,1,0,0,224,0.0,0.0,0.0,0.0,0.0,0.0,0.0,4,1,3,1.0,0.0,1.0
9701205,9,3,6,21,0,9,46,18,8.0,3.0,5.0,16.0,0.0,8.0,23.0,23,9,14,12.0,7.0,5.0
106307,10,3,7,12,0,10,22,106,9.0,2.0,7.0,12.0,1.0,8.0,16.0,17,10,7,9.0,6.0,3.0
9704235,9,6,3,5,0,9,69,53,6.0,3.0,3.0,5.0,0.0,6.0,56.0,27,9,18,16.0,3.0,13.0
105225,2,1,1,1,0,2,6,282,2.0,1.0,1.0,1.0,0.0,2.0,4.0,8,2,6,4.0,2.0,2.0
9908485,8,3,5,10,2,6,20,186,8.0,3.0,5.0,10.0,3.0,5.0,11.0,20,8,12,10.0,7.0,3.0
9407349,4,4,0,0,0,4,7,25,1.0,1.0,0.0,0.0,0.0,1.0,1.0,7,4,3,3.0,1.0,2.0
9408354,26,5,21,86,26,0,0,130,17.0,2.0,15.0,58.0,17.0,0.0,0.0,26,26,0,12.0,12.0,0.0
9604265,3,3,0,0,0,3,7,81,1.0,1.0,0.0,0.0,0.0,1.0,3.0,13,3,10,3.0,1.0,2.0
9705328,5,2,3,4,1,4,11,10,2.0,1.0,1.0,1.0,0.0,2.0,6.0,10,5,5,6.0,2.0,4.0
1140,0,0,0,0,0,0,0,2,0.0,0.0,0.0,0.0,0.0,0.0,0.0,22,0,22,12.0,0.0,12.0
9604253,6,3,3,3,1,5,9,154,6.0,3.0,3.0,3.0,2.0,4.0,8.0,11,6,5,6.0,3.0,3.0
9611371,3,2,1,2,0,3,26,10,3.0,2.0,1.0,2.0,0.0,3.0,9.0,40,3,37,11.0,3.0,8.0
9604261,4,2,2,2,0,4,7,200,3.0,1.0,2.0,2.0,1.0,2.0,4.0,13,4,9,5.0,3.0,2.0
9309321,2,2,0,0,2,0,0,1439,1.0,1.0,0.0,0.0,1.0,0.0,0.0,2,2,0,,,
9712538,6,6,0,0,4,2,4,18,2.0,2.0,0.0,0.0,2.0,0.0,0.0,13,6,7,2.0,2.0,0.0
9903300,8,1,7,24,0,8,21,46,8.0,1.0,7.0,24.0,0.0,8.0,21.0,18,8,10,7.0,0.0,7.0
9712543,10,5,5,6,0,10,52,6,0.0,0.0,0.0,0.0,0.0,0.0,0.0,38,10,28,7.0,3.0,4.0
8289,3,2,1,1,1,2,13,14,1.0,1.0,0.0,0.0,0.0,1.0,6.0,34,3,31,7.0,0.0,7.0
12282,8,5,3,4,1,7,17,52,4.0,1.0,3.0,3.0,0.0,4.0,8.0,15,8,7,7.0,5.0,2.0
9909403,2,2,0,0,0,2,12,150,1.0,1.0,0.0,0.0,0.0,1.0,2.0,12,2,10,5.0,0.0,5.0
10163,8,3,5,5,0,8,27,47,5.0,2.0,3.0,3.0,1.0,4.0,15.0,24,8,16,10.0,4.0,6.0
9910293,1,1,0,0,1,0,0,95,1.0,1.0,0.0,0.0,1.0,0.0,0.0,3,1,2,1.0,0.0,1.0
9412204,2,2,0,0,0,2,3,198,1.0,1.0,0.0,0.0,0.0,1.0,1.0,4,2,2,2.0,1.0,1.0
9603258,1,1,0,0,0,1,3,56,1.0,1.0,0.0,0.0,0.0,1.0,3.0,9,1,8,,,
9910298,2,2,0,0,0,2,8,87,0.0,0.0,0.0,0.0,0.0,0.0,0.0,23,2,21,13.0,0.0,13.0
6222,4,3,1,1,0,4,13,69,3.0,2.0,1.0,1.0,0.0,3.0,7.0,15,4,11,,,
106316,9,2,7,16,0,9,37,17,3.0,2.0,1.0,1.0,0.0,3.0,9.0,30,9,21,7.0,3.0,4.0
9709225,11,7,4,9,0,11,64,33,6.0,3.0,3.0,6.0,0.0,6.0,42.0,33,11,22,16.0,3.0,13.0
9806514,8,2,6,14,2,6,6,38,7.0,1.0,6.0,13.0,1.0,6.0,6.0,10,8,2,,,
6044,1,1,0,0,0,1,1,202,0.0,0.0,0.0,0.0,0.0,0.0,0.0,5,1,4,3.0,1.0,2.0
9904397,1,1,0,0,0,1,5,36,,,,,,,,6,1,5,,,
9308368,1,1,0,0,1,0,0,2071,1.0,1.0,0.0,0.0,1.0,0.0,0.0,1,1,0,1.0,1.0,0.0
101018,4,4,0,0,4,0,0,518,3.0,3.0,0.0,0.0,3.0,0.0,0.0,4,4,0,3.0,3.0,0.0
9407341,5,4,1,1,3,2,3,183,3.0,2.0,1.0,1.0,3.0,0.0,0.0,8,5,3,3.0,3.0,0.0
211426,1,1,0,0,0,1,6,43,0.0,0.0,0.0,0.0,0.0,0.0,0.0,14,1,13,7.0,1.0,6.0
9506295,3,2,1,1,3,0,0,248,2.0,1.0,1.0,1.0,2.0,0.0,0.0,3,3,0,2.0,2.0,0.0
9303210,4,3,1,1,4,0,0,303,2.0,2.0,0.0,0.0,2.0,0.0,0.0,4,4,0,1.0,1.0,0.0
9501316,3,2,1,1,3,0,0,191,2.0,1.0,1.0,1.0,2.0,0.0,0.0,4,3,1,2.0,2.0,0.0
205008,4,2,2,2,1,3,6,45,2.0,1.0,1.0,1.0,0.0,2.0,2.0,14,4,10,3.0,0.0,3.0
6157,13,7,6,12,1,12,23,0,6.0,4.0,2.0,4.0,2.0,4.0,8.0,32,13,19,2.0,1.0,1.0
9224,9,6,3,5,0,9,47,17,5.0,4.0,1.0,2.0,0.0,5.0,17.0,20,9,11,4.0,1.0,3.0
9804407,12,3,9,29,0,12,37,49,10.0,2.0,8.0,25.0,0.0,10.0,20.0,21,12,9,8.0,7.0,1.0
105161,3,3,0,0,0,3,15,29,2.0,2.0,0.0,0.0,0.0,2.0,13.0,19,3,16,12.0,2.0,10.0
9507391,1,1,0,0,1,0,0,391,1.0,1.0,0.0,0.0,1.0,0.0,0.0,1,1,0,1.0,1.0,0.0
9078,13,4,9,17,1,12,43,21,2.0,2.0,0.0,0.0,0.0,2.0,5.0,26,13,13,5.0,5.0,0.0
11216,4,3,1,2,1,3,12,73,0.0,0.0,0.0,0.0,0.0,0.0,0.0,15,4,11,1.0,0.0,1.0
9610322,1,1,0,0,0,1,5,42,0.0,0.0,0.0,0.0,0.0,0.0,0.0,9,1,8,1.0,0.0,1.0
9509360,4,2,2,3,0,4,8,274,2.0,2.0,0.0,0.0,0.0,2.0,3.0,10,4,6,3.0,2.0,1.0
9912293,2,2,0,0,1,1,4,184,1.0,1.0,0.0,0.0,0.0,1.0,2.0,11,2,9,3.0,1.0,2.0
9310299,5,3,2,2,3,2,2,67,,,,,,,,7,5,2,2.0,2.0,0.0
9708250,8,6,2,2,4,4,10,5,1.0,1.0,0.0,0.0,0.0,1.0,3.0,43,8,35,6.0,0.0,6.0
8263,4,2,2,5,0,4,38,50,4.0,2.0,2.0,5.0,0.0,4.0,38.0,18,4,14,17.0,4.0,13.0
9610399,8,3,5,12,0,8,10,50,2.0,1.0,1.0,1.0,0.0,2.0,4.0,10,8,2,6.0,4.0,2.0
207364,6,3,3,3,0,6,76,4,0.0,0.0,0.0,0.0,0.0,0.0,0.0,73,6,67,13.0,2.0,11.0
9404224,0,0,0,0,0,0,0,129,0.0,0.0,0.0,0.0,0.0,0.0,0.0,4,0,4,3.0,0.0,3.0
9910256,9,2,7,15,2,7,14,147,6.0,1.0,5.0,9.0,1.0,5.0,9.0,12,9,3,8.0,5.0,3.0
9604245,2,2,0,0,2,0,0,488,2.0,2.0,0.0,0.0,2.0,0.0,0.0,3,2,1,1.0,1.0,0.0
9505356,8,5,3,3,0,8,19,7,3.0,3.0,0.0,0.0,0.0,3.0,7.0,20,8,12,3.0,2.0,1.0
9411404,2,2,0,0,0,2,2,6,1.0,1.0,0.0,0.0,1.0,0.0,0.0,12,2,10,3.0,0.0,3.0
9706343,6,4,2,2,0,6,25,57,4.0,2.0,2.0,2.0,0.0,4.0,14.0,25,6,19,8.0,0.0,8.0
9809343,2,2,0,0,0,2,11,7,1.0,1.0,0.0,0.0,0.0,1.0,5.0,30,2,28,,,
9809287,9,8,1,2,1,8,20,8,4.0,3.0,1.0,1.0,0.0,4.0,12.0,19,9,10,7.0,1.0,6.0
9811441,1,1,0,0,1,0,0,149,,,,,,,,4,1,3,1.0,0.0,1.0
209048,2,1,1,1,0,2,18,22,2.0,1.0,1.0,1.0,0.0,2.0,15.0,16,2,14,11.0,2.0,9.0
9902316,3,3,0,0,1,2,21,90,1.0,1.0,0.0,0.0,0.0,1.0,17.0,34,3,31,13.0,1.0,12.0
9506420,4,2,2,2,0,4,15,39,3.0,1.0,2.0,2.0,0.0,3.0,8.0,10,4,6,6.0,3.0,3.0
101294,5,2,3,3,0,5,22,48,4.0,2.0,2.0,2.0,0.0,4.0,15.0,29,5,24,8.0,1.0,7.0
7081,13,8,5,6,7,6,6,9,7.0,4.0,3.0,4.0,7.0,0.0,0.0,17,13,4,3.0,3.0,0.0
9602423,11,5,6,6,1,10,132,17,8.0,4.0,4.0,4.0,0.0,8.0,123.0,37,11,26,26.0,7.0,19.0
205050,16,8,8,12,0,16,99,28,6.0,4.0,2.0,3.0,0.0,6.0,46.0,42,16,26,17.0,5.0,12.0
9704442,2,2,0,0,1,1,1,61,1.0,1.0,0.0,0.0,0.0,1.0,1.0,7,2,5,1.0,1.0,0.0
9304250,1,1,0,0,1,0,0,1465,,,,,,,,1,1,0,,,
204208,10,1,9,19,1,9,52,0,1.0,1.0,0.0,0.0,0.0,1.0,10.0,41,10,31,8.0,6.0,2.0
11044,5,4,1,1,1,4,16,59,2.0,2.0,0.0,0.0,0.0,2.0,4.0,15,5,10,2.0,1.0,1.0
7088,11,3,8,13,0,11,39,201,8.0,2.0,6.0,11.0,0.0,8.0,29.0,23,11,12,10.0,5.0,5.0
9409227,9,4,5,5,5,4,4,330,3.0,3.0,0.0,0.0,1.0,2.0,2.0,10,9,1,3.0,2.0,1.0
9612222,8,6,2,2,4,4,4,51,2.0,2.0,0.0,0.0,2.0,0.0,0.0,15,8,7,3.0,2.0,1.0
210181,6,5,1,1,1,5,43,3,4.0,3.0,1.0,1.0,0.0,4.0,38.0,45,6,39,8.0,0.0,8.0
208218,8,5,3,4,1,7,23,3,1.0,1.0,0.0,0.0,0.0,1.0,2.0,28,8,20,3.0,2.0,1.0
112248,1,1,0,0,0,1,8,56,0.0,0.0,0.0,0.0,0.0,0.0,0.0,23,1,22,7.0,0.0,7.0
9908244,7,5,2,4,0,7,22,51,3.0,2.0,1.0,2.0,0.0,3.0,13.0,19,7,12,7.0,4.0,3.0
9711380,2,2,0,0,0,2,3,59,0.0,0.0,0.0,0.0,0.0,0.0,0.0,15,2,13,1.0,0.0,1.0
9711499,11,4,7,15,1,10,58,35,6.0,1.0,5.0,9.0,0.0,6.0,29.0,27,11,16,10.0,4.0,6.0
9806325,4,4,0,0,1,3,6,205,2.0,2.0,0.0,0.0,0.0,2.0,4.0,11,4,7,6.0,2.0,4.0
9807523,4,1,3,6,0,4,8,112,4.0,1.0,3.0,6.0,0.0,4.0,8.0,6,4,2,6.0,4.0,2.0
111337,2,2,0,0,0,2,7,6,0.0,0.0,0.0,0.0,0.0,0.0,0.0,16,2,14,8.0,0.0,8.0
202192,1,1,0,0,1,0,0,424,1.0,1.0,0.0,0.0,1.0,0.0,0.0,3,1,2,1.0,1.0,0.0
9309220,5,2,3,4,4,1,1,58,3.0,1.0,2.0,3.0,3.0,0.0,0.0,6,5,1,3.0,3.0,0.0
9610299,8,2,6,20,2,6,9,35,6.0,1.0,5.0,14.0,1.0,5.0,7.0,10,8,2,6.0,4.0,2.0
9306335,1,1,0,0,1,0,0,930,,,,,,,,1,1,0,,,
9911291,14,3,11,27,4,10,28,65,11.0,2.0,9.0,24.0,4.0,7.0,12.0,23,14,9,13.0,10.0,3.0
9709506,11,1,10,24,0,11,38,4,8.0,1.0,7.0,17.0,1.0,7.0,28.0,24,11,13,12.0,7.0,5.0
9712406,5,4,1,1,1,4,22,5,2.0,2.0,0.0,0.0,0.0,2.0,16.0,39,5,34,17.0,1.0,16.0
11281,6,4,2,2,0,6,20,57,2.0,1.0,1.0,1.0,0.0,2.0,2.0,24,6,18,5.0,1.0,4.0
108018,6,2,4,7,5,1,2,159,3.0,2.0,1.0,1.0,2.0,1.0,1.0,15,6,9,2.0,2.0,0.0
104067,2,2,0,0,0,2,10,22,2.0,2.0,0.0,0.0,0.0,2.0,10.0,9,2,7,5.0,1.0,4.0
9704401,1,1,0,0,0,1,1,30,0.0,0.0,0.0,0.0,0.0,0.0,0.0,13,1,12,1.0,0.0,1.0
9802268,3,1,2,2,1,2,3,33,1.0,1.0,0.0,0.0,1.0,0.0,0.0,5,3,2,2.0,2.0,0.0
9701245,1,1,0,0,0,1,3,93,1.0,1.0,0.0,0.0,0.0,1.0,2.0,6,1,5,1.0,0.0,1.0
9708438,4,1,3,3,2,2,3,35,1.0,1.0,0.0,0.0,1.0,0.0,0.0,10,4,6,2.0,2.0,0.0
9804221,32,9,23,68,18,14,32,125,15.0,1.0,14.0,42.0,10.0,5.0,8.0,42,32,10,13.0,12.0,1.0
1102,5,2,3,4,0,5,14,83,4.0,1.0,3.0,4.0,1.0,3.0,3.0,11,5,6,5.0,4.0,1.0
9306295,8,6,2,2,3,5,5,341,4.0,3.0,1.0,1.0,0.0,4.0,4.0,9,8,1,5.0,4.0,1.0
9307357,1,1,0,0,1,0,0,133,,,,,,,,1,1,0,,,
11352,8,5,3,3,0,8,53,11,4.0,2.0,2.0,2.0,0.0,4.0,26.0,43,8,35,6.0,2.0,4.0
204001,17,6,11,28,0,17,128,20,14.0,5.0,9.0,24.0,0.0,14.0,107.0,40,17,23,7.0,5.0,2.0
9906501,11,2,9,19,0,11,130,21,10.0,2.0,8.0,17.0,0.0,10.0,129.0,47,11,36,36.0,7.0,29.0
208009,4,4,0,0,0,4,17,12,2.0,2.0,0.0,0.0,0.0,2.0,11.0,45,4,41,17.0,1.0,16.0
205325,11,8,3,4,0,11,115,18,2.0,2.0,0.0,0.0,0.0,2.0,20.0,85,11,74,18.0,1.0,17.0
201001,12,4,8,9,1,11,282,23,4.0,3.0,1.0,1.0,0.0,4.0,28.0,121,12,109,27.0,3.0,24.0
9812277,24,17,7,10,2,22,73,9,9.0,4.0,5.0,8.0,2.0,7.0,14.0,37,24,13,10.0,8.0,2.0
105168,2,2,0,0,0,2,7,6,2.0,2.0,0.0,0.0,0.0,2.0,4.0,7,2,5,,,
9709280,5,3,2,3,0,5,7,324,1.0,1.0,0.0,0.0,0.0,1.0,1.0,16,5,11,2.0,2.0,0.0
109291,2,2,0,0,0,2,14,4,1.0,1.0,0.0,0.0,0.0,1.0,13.0,41,2,39,9.0,0.0,9.0
9510228,2,2,0,0,0,2,4,26,2.0,2.0,0.0,0.0,0.0,2.0,4.0,6,2,4,2.0,1.0,1.0
9910411,14,2,12,24,0,14,83,48,3.0,2.0,1.0,1.0,0.0,3.0,12.0,34,14,20,13.0,9.0,4.0
110075,18,2,16,41,0,18,91,9,17.0,2.0,15.0,39.0,0.0,17.0,82.0,32,18,14,9.0,8.0,1.0
9708394,1,1,0,0,1,0,0,654,1.0,1.0,0.0,0.0,1.0,0.0,0.0,1,1,0,1.0,1.0,0.0
205314,17,6,11,33,2,15,77,2,10.0,3.0,7.0,27.0,0.0,10.0,44.0,32,17,15,19.0,10.0,9.0
201018,14,10,4,6,6,8,23,37,3.0,1.0,2.0,2.0,3.0,0.0,0.0,24,14,10,2.0,1.0,1.0
204089,3,1,2,2,0,3,9,29,3.0,1.0,2.0,2.0,0.0,3.0,6.0,16,3,13,4.0,3.0,1.0
9211284,16,6,10,24,16,0,0,96,14.0,5.0,9.0,22.0,14.0,0.0,0.0,16,16,0,12.0,12.0,0.0
111382,3,3,0,0,0,3,42,68,3.0,3.0,0.0,0.0,0.0,3.0,36.0,44,3,41,27.0,3.0,24.0
104066,4,3,1,1,4,0,0,412,2.0,2.0,0.0,0.0,2.0,0.0,0.0,4,4,0,1.0,1.0,0.0
7347,2,2,0,0,1,1,5,2,1.0,1.0,0.0,0.0,1.0,0.0,0.0,15,2,13,1.0,0.0,1.0
204341,7,3,4,7,0,7,66,7,5.0,2.0,3.0,6.0,0.0,5.0,48.0,25,7,18,6.0,1.0,5.0
9704276,14,6,8,14,1,13,78,35,7.0,2.0,5.0,11.0,0.0,7.0,64.0,61,14,47,15.0,5.0,10.0
9910228,1,1,0,0,1,0,0,1597,0.0,0.0,0.0,0.0,0.0,0.0,0.0,6,1,5,5.0,0.0,5.0
207139,8,4,4,5,0,8,123,28,7.0,3.0,4.0,5.0,0.0,7.0,108.0,75,8,67,35.0,6.0,29.0
109254,1,1,0,0,0,1,5,39,0.0,0.0,0.0,0.0,0.0,0.0,0.0,65,1,64,11.0,0.0,11.0
9612475,4,4,0,0,2,2,5,40,2.0,2.0,0.0,0.0,0.0,2.0,5.0,10,4,6,2.0,1.0,1.0
9208253,15,6,9,13,15,0,0,53,6.0,3.0,3.0,4.0,6.0,0.0,0.0,15,15,0,5.0,5.0,0.0
9308216,5,3,2,2,5,0,0,323,3.0,2.0,1.0,1.0,3.0,0.0,0.0,5,5,0,3.0,3.0,0.0
9510269,11,2,9,22,1,10,96,134,9.0,1.0,8.0,18.0,0.0,9.0,56.0,39,11,28,18.0,9.0,9.0
9502365,1,1,0,0,1,0,0,951,,,,,,,,1,1,0,,,
9503273,16,5,11,27,11,5,10,29,12.0,2.0,10.0,25.0,12.0,0.0,0.0,18,16,2,7.0,5.0,2.0
9506379,5,4,1,1,5,0,0,107,2.0,1.0,1.0,1.0,2.0,0.0,0.0,5,5,0,2.0,2.0,0.0
9910361,1,1,0,0,0,1,1,448,1.0,1.0,0.0,0.0,0.0,1.0,1.0,2,1,1,2.0,1.0,1.0
9811222,4,3,1,1,1,3,8,227,2.0,2.0,0.0,0.0,0.0,2.0,5.0,9,4,5,6.0,3.0,3.0
9901324,8,7,1,1,0,8,39,9,3.0,3.0,0.0,0.0,0.0,3.0,15.0,20,8,12,10.0,3.0,7.0
112264,2,2,0,0,0,2,5,339,0.0,0.0,0.0,0.0,0.0,0.0,0.0,16,2,14,3.0,0.0,3.0
211349,0,0,0,0,0,0,0,292,0.0,0.0,0.0,0.0,0.0,0.0,0.0,3,0,3,1.0,0.0,1.0
105001,3,3,0,0,0,3,15,42,3.0,3.0,0.0,0.0,0.0,3.0,9.0,25,3,22,14.0,2.0,12.0
9904407,4,3,1,1,4,0,0,423,1.0,1.0,0.0,0.0,1.0,0.0,0.0,4,4,0,1.0,1.0,0.0
9408212,7,4,3,4,4,3,4,65,4.0,1.0,3.0,4.0,2.0,2.0,3.0,10,7,3,1.0,0.0,1.0
9709282,4,4,0,0,2,2,12,151,1.0,1.0,0.0,0.0,0.0,1.0,6.0,17,4,13,8.0,1.0,7.0
9704425,0,0,0,0,0,0,0,275,0.0,0.0,0.0,0.0,0.0,0.0,0.0,9,0,9,2.0,0.0,2.0
9302275,2,2,0,0,2,0,0,647,1.0,1.0,0.0,0.0,1.0,0.0,0.0,2,2,0,2.0,2.0,0.0
9710284,3,1,2,2,1,2,3,82,3.0,1.0,2.0,2.0,1.0,2.0,3.0,6,3,3,,,
9502406,3,3,0,0,3,0,0,316,1.0,1.0,0.0,0.0,1.0,0.0,0.0,3,3,0,1.0,1.0,0.0
9809567,17,4,13,21,4,13,32,127,13.0,4.0,9.0,15.0,1.0,12.0,27.0,26,17,9,8.0,4.0,4.0
9611250,4,3,1,1,2,2,2,236,3.0,2.0,1.0,1.0,3.0,0.0,0.0,6,4,2,3.0,3.0,0.0
12084,0,0,0,0,0,0,0,166,0.0,0.0,0.0,0.0,0.0,0.0,0.0,1,0,1,1.0,0.0,1.0
9801286,2,2,0,0,0,2,3,123,0.0,0.0,0.0,0.0,0.0,0.0,0.0,6,2,4,4.0,0.0,4.0
105173,3,3,0,0,0,3,9,14,0.0,0.0,0.0,0.0,0.0,0.0,0.0,29,3,26,6.0,0.0,6.0
11365,11,5,6,9,1,10,39,20,8.0,4.0,4.0,7.0,0.0,8.0,35.0,24,11,13,8.0,6.0,2.0
212007,4,2,2,3,3,1,6,7,1.0,1.0,0.0,0.0,0.0,1.0,5.0,24,4,20,14.0,1.0,13.0
9803321,1,1,0,0,0,1,5,36,1.0,1.0,0.0,0.0,0.0,1.0,4.0,51,1,50,17.0,0.0,17.0
110219,2,1,1,1,0,2,9,2115,,,,,,,,7,2,5,,,
11373,6,2,4,6,2,4,16,25,3.0,1.0,2.0,2.0,0.0,3.0,11.0,18,6,12,3.0,1.0,2.0
106304,3,2,1,1,0,3,8,12,1.0,1.0,0.0,0.0,1.0,0.0,0.0,15,3,12,3.0,2.0,1.0
103169,11,3,8,18,1,10,127,49,7.0,2.0,5.0,12.0,1.0,6.0,67.0,91,11,80,27.0,5.0,22.0
6159,15,5,10,18,1,14,42,48,6.0,1.0,5.0,9.0,1.0,5.0,7.0,28,15,13,9.0,7.0,2.0
9802280,1,1,0,0,0,1,1,1723,1.0,1.0,0.0,0.0,0.0,1.0,1.0,4,1,3,1.0,1.0,0.0
9903283,5,3,2,3,1,4,21,5,4.0,2.0,2.0,3.0,0.0,4.0,12.0,21,5,16,2.0,0.0,2.0
7311,1,1,0,0,0,1,2,216,0.0,0.0,0.0,0.0,0.0,0.0,0.0,10,1,9,1.0,0.0,1.0
206203,4,4,0,0,1,3,6,64,1.0,1.0,0.0,0.0,0.0,1.0,3.0,9,4,5,3.0,1.0,2.0
9710388,2,2,0,0,0,2,14,60,1.0,1.0,0.0,0.0,0.0,1.0,7.0,11,2,9,6.0,1.0,5.0
9706402,3,2,1,1,2,1,1,78,1.0,1.0,0.0,0.0,1.0,0.0,0.0,4,3,1,1.0,1.0,0.0
9055,0,0,0,0,0,0,0,16,0.0,0.0,0.0,0.0,0.0,0.0,0.0,24,0,24,2.0,0.0,2.0
104111,4,3,1,1,1,3,14,7,0.0,0.0,0.0,0.0,0.0,0.0,0.0,12,4,8,1.0,1.0,0.0
9409261,2,1,1,1,2,0,0,179,2.0,1.0,1.0,1.0,2.0,0.0,0.0,7,2,5,2.0,2.0,0.0
9812238,3,3,0,0,1,2,7,143,2.0,2.0,0.0,0.0,0.0,2.0,7.0,13,3,10,7.0,2.0,5.0
9908291,5,3,2,2,0,5,12,455,2.0,2.0,0.0,0.0,0.0,2.0,5.0,14,5,9,7.0,3.0,4.0
8081,6,5,1,1,4,2,3,190,2.0,1.0,1.0,1.0,2.0,0.0,0.0,15,6,9,4.0,3.0,1.0
9907225,8,4,4,6,0,8,52,29,3.0,2.0,1.0,1.0,0.0,3.0,22.0,35,8,27,11.0,4.0,7.0
9807392,2,1,1,1,0,2,6,194,1.0,1.0,0.0,0.0,0.0,1.0,3.0,9,2,7,5.0,1.0,4.0
9807446,3,1,2,2,0,3,6,308,2.0,1.0,1.0,1.0,0.0,2.0,5.0,8,3,5,6.0,3.0,3.0
203087,1,1,0,0,0,1,14,58,1.0,1.0,0.0,0.0,0.0,1.0,6.0,20,1,19,7.0,1.0,6.0
9904202,3,2,1,1,3,0,0,178,2.0,1.0,1.0,1.0,2.0,0.0,0.0,3,3,0,1.0,1.0,0.0
207171,0,0,0,0,0,0,0,1204,0.0,0.0,0.0,0.0,0.0,0.0,0.0,6,0,6,4.0,0.0,4.0
301218,0,0,0,0,0,0,0,17,0.0,0.0,0.0,0.0,0.0,0.0,0.0,12,0,12,4.0,0.0,4.0
9902319,10,2,8,13,0,10,22,110,8.0,3.0,5.0,9.0,2.0,6.0,10.0,18,10,8,10.0,7.0,3.0
108271,8,7,1,1,3,5,8,110,3.0,3.0,0.0,0.0,0.0,3.0,3.0,11,8,3,2.0,2.0,0.0
9608459,1,1,0,0,1,0,0,222,0.0,0.0,0.0,0.0,0.0,0.0,0.0,10,1,9,1.0,0.0,1.0
207168,6,2,4,4,1,5,19,18,1.0,1.0,0.0,0.0,0.0,1.0,1.0,38,6,32,6.0,4.0,2.0
9911512,5,4,1,1,0,5,7,59,1.0,1.0,0.0,0.0,0.0,1.0,3.0,10,5,5,2.0,2.0,0.0
9702411,3,2,1,1,0,3,7,52,3.0,2.0,1.0,1.0,0.0,3.0,6.0,10,3,7,4.0,2.0,2.0
9705260,6,2,4,5,0,6,17,40,5.0,2.0,3.0,4.0,0.0,5.0,15.0,15,6,9,2.0,2.0,0.0
9709480,0,0,0,0,0,0,0,47,0.0,0.0,0.0,0.0,0.0,0.0,0.0,4,0,4,3.0,0.0,3.0
9701332,2,2,0,0,1,1,2,247,2.0,2.0,0.0,0.0,1.0,1.0,2.0,4,2,2,3.0,1.0,2.0
205009,4,2,2,2,2,2,3,78,2.0,1.0,1.0,1.0,1.0,1.0,1.0,17,4,13,3.0,0.0,3.0
9409277,2,2,0,0,2,0,0,79,1.0,1.0,0.0,0.0,1.0,0.0,0.0,2,2,0,,,
101016,1,1,0,0,1,0,0,97,0.0,0.0,0.0,0.0,0.0,0.0,0.0,6,1,5,,,
9902404,1,1,0,0,0,1,1,189,1.0,1.0,0.0,0.0,1.0,0.0,0.0,3,1,2,1.0,1.0,0.0
211073,0,0,0,0,0,0,0,37,0.0,0.0,0.0,0.0,0.0,0.0,0.0,3,0,3,1.0,0.0,1.0
204303,1,1,0,0,0,1,10,7,0.0,0.0,0.0,0.0,0.0,0.0,0.0,38,1,37,2.0,0.0,2.0
12189,8,3,5,8,2,6,6,102,7.0,2.0,5.0,8.0,2.0,5.0,5.0,9,8,1,4.0,3.0,1.0
9904384,4,3,1,1,4,0,0,405,3.0,2.0,1.0,1.0,3.0,0.0,0.0,4,4,0,2.0,2.0,0.0
9310234,7,2,5,6,7,0,0,334,6.0,1.0,5.0,6.0,6.0,0.0,0.0,7,7,0,5.0,5.0,0.0
9408297,7,4,3,3,6,1,1,75,3.0,2.0,1.0,1.0,3.0,0.0,0.0,11,7,4,2.0,2.0,0.0
5099,2,1,1,1,0,2,6,344,0.0,0.0,0.0,0.0,0.0,0.0,0.0,7,2,5,1.0,0.0,1.0
9911514,7,1,6,15,0,7,34,161,6.0,1.0,5.0,14.0,0.0,6.0,20.0,20,7,13,8.0,4.0,4.0
9404204,4,2,2,2,2,2,2,23,1.0,1.0,0.0,0.0,0.0,1.0,1.0,5,4,1,1.0,0.0,1.0
8326,11,8,3,4,7,4,6,64,2.0,2.0,0.0,0.0,0.0,2.0,2.0,15,11,4,3.0,2.0,1.0
9801202,5,2,3,3,3,2,2,2038,2.0,1.0,1.0,1.0,2.0,0.0,0.0,9,5,4,3.0,3.0,0.0
101183,2,2,0,0,0,2,12,25,1.0,1.0,0.0,0.0,0.0,1.0,6.0,13,2,11,3.0,1.0,2.0
9803447,7,1,6,13,0,7,36,17,7.0,1.0,6.0,13.0,0.0,7.0,36.0,22,7,15,5.0,4.0,1.0
9811272,2,2,0,0,1,1,2,90,1.0,1.0,0.0,0.0,0.0,1.0,2.0,14,2,12,2.0,1.0,1.0
212026,3,2,1,1,0,3,27,108,2.0,1.0,1.0,1.0,0.0,2.0,22.0,41,3,38,9.0,2.0,7.0
9509343,6,5,1,1,6,0,0,249,6.0,5.0,1.0,1.0,6.0,0.0,0.0,6,6,0,3.0,3.0,0.0
206268,5,5,0,0,1,4,18,346,2.0,2.0,0.0,0.0,0.0,2.0,8.0,23,5,18,6.0,1.0,5.0
9610356,2,2,0,0,0,2,3,170,2.0,2.0,0.0,0.0,0.0,2.0,3.0,4,2,2,3.0,1.0,2.0
3161,15,1,14,46,1,14,98,0,10.0,1.0,9.0,34.0,0.0,10.0,52.0,50,15,35,15.0,10.0,5.0
209329,3,3,0,0,0,3,16,23,2.0,2.0,0.0,0.0,0.0,2.0,10.0,11,3,8,1.0,1.0,0.0
9802403,3,2,1,1,0,3,13,7,1.0,1.0,0.0,0.0,0.0,1.0,10.0,22,3,19,7.0,2.0,5.0
9706257,2,2,0,0,1,1,1,138,1.0,1.0,0.0,0.0,1.0,0.0,0.0,4,2,2,2.0,1.0,1.0
111093,6,3,3,3,0,6,50,11,4.0,2.0,2.0,2.0,1.0,3.0,16.0,34,6,28,14.0,2.0,12.0
205308,1,1,0,0,0,1,8,103,1.0,1.0,0.0,0.0,0.0,1.0,8.0,9,1,8,9.0,1.0,8.0
2110,2,2,0,0,1,1,1,110,1.0,1.0,0.0,0.0,0.0,1.0,1.0,4,2,2,1.0,0.0,1.0
106148,2,2,0,0,0,2,13,18,1.0,1.0,0.0,0.0,0.0,1.0,9.0,24,2,22,1.0,0.0,1.0
1042,4,3,1,1,1,3,5,199,2.0,1.0,1.0,1.0,0.0,2.0,2.0,9,4,5,5.0,2.0,3.0
10197,1,1,0,0,0,1,1,42,,,,,,,,3,1,2,,,
210206,2,2,0,0,0,2,30,1,2.0,2.0,0.0,0.0,0.0,2.0,29.0,35,2,33,25.0,2.0,23.0
9906254,4,4,0,0,1,3,7,17,0.0,0.0,0.0,0.0,0.0,0.0,0.0,21,4,17,2.0,0.0,2.0
9706349,0,0,0,0,0,0,0,471,0.0,0.0,0.0,0.0,0.0,0.0,0.0,1,0,1,1.0,0.0,1.0
9805290,2,2,0,0,2,0,0,104,1.0,1.0,0.0,0.0,1.0,0.0,0.0,9,2,7,2.0,0.0,2.0
205208,21,4,17,37,0,21,122,9,19.0,3.0,16.0,34.0,0.0,19.0,114.0,44,21,23,11.0,9.0,2.0
9905205,11,3,8,20,5,6,6,102,9.0,2.0,7.0,18.0,4.0,5.0,5.0,15,11,4,4.0,4.0,0.0
204213,3,1,2,2,0,3,26,24,3.0,1.0,2.0,2.0,0.0,3.0,25.0,25,3,22,20.0,1.0,19.0
1250,2,2,0,0,1,1,3,308,1.0,1.0,0.0,0.0,1.0,0.0,0.0,5,2,3,2.0,1.0,1.0
9806334,3,3,0,0,2,1,1,87,0.0,0.0,0.0,0.0,0.0,0.0,0.0,25,3,22,4.0,0.0,4.0
9508252,7,5,2,5,5,2,3,49,2.0,2.0,0.0,0.0,0.0,2.0,2.0,10,7,3,2.0,2.0,0.0
201204,1,1,0,0,0,1,6,21,1.0,1.0,0.0,0.0,0.0,1.0,6.0,13,1,12,9.0,1.0,8.0
9903384,4,2,2,2,1,3,6,105,3.0,1.0,2.0,2.0,1.0,2.0,2.0,8,4,4,3.0,1.0,2.0
9311246,8,5,3,6,8,0,0,175,6.0,3.0,3.0,6.0,6.0,0.0,0.0,8,8,0,5.0,5.0,0.0
9802313,6,1,5,8,0,6,16,56,4.0,1.0,3.0,5.0,2.0,2.0,4.0,13,6,7,5.0,4.0,1.0
9711462,2,1,1,1,1,1,3,116,0.0,0.0,0.0,0.0,0.0,0.0,0.0,5,2,3,3.0,0.0,3.0
9910372,1,1,0,0,0,1,3,171,1.0,1.0,0.0,0.0,0.0,1.0,2.0,6,1,5,3.0,1.0,2.0
3160,12,4,8,23,2,10,41,63,9.0,3.0,6.0,14.0,1.0,8.0,31.0,20,12,8,16.0,9.0,7.0
9612230,2,2,0,0,2,0,0,203,1.0,1.0,0.0,0.0,1.0,0.0,0.0,3,2,1,1.0,1.0,0.0
9706374,5,5,0,0,0,5,40,17,3.0,3.0,0.0,0.0,0.0,3.0,29.0,32,5,27,22.0,0.0,22.0
209223,4,2,2,3,2,2,3,59,0.0,0.0,0.0,0.0,0.0,0.0,0.0,9,4,5,2.0,2.0,0.0
9907406,1,1,0,0,0,1,1,1778,1.0,1.0,0.0,0.0,1.0,0.0,0.0,3,1,2,,,
9407228,1,1,0,0,1,0,0,134,,,,,,,,2,1,1,1.0,0.0,1.0
9411405,4,1,3,4,2,2,3,169,3.0,1.0,2.0,3.0,3.0,0.0,0.0,6,4,2,3.0,3.0,0.0
4150,3,3,0,0,1,2,5,106,1.0,1.0,0.0,0.0,0.0,1.0,4.0,12,3,9,4.0,1.0,3.0
9410255,1,1,0,0,1,0,0,1212,,,,,,,,1,1,0,,,
7282,1,1,0,0,0,1,1,446,0.0,0.0,0.0,0.0,0.0,0.0,0.0,6,1,5,1.0,0.0,1.0
9607369,1,1,0,0,1,0,0,35,0.0,0.0,0.0,0.0,0.0,0.0,0.0,3,1,2,,,
9511395,0,0,0,0,0,0,0,5,0.0,0.0,0.0,0.0,0.0,0.0,0.0,8,0,8,2.0,0.0,2.0
10094,0,0,0,0,0,0,0,259,0.0,0.0,0.0,0.0,0.0,0.0,0.0,1,0,1,,,
111071,0,0,0,0,0,0,0,1053,,,,,,,,1,0,1,1.0,0.0,1.0
110110,1,1,0,0,0,1,2,257,0.0,0.0,0.0,0.0,0.0,0.0,0.0,11,1,10,3.0,0.0,3.0
7255,7,3,4,8,3,4,11,215,6.0,2.0,4.0,8.0,2.0,4.0,9.0,14,7,7,6.0,5.0,1.0
212238,0,0,0,0,0,0,0,9,0.0,0.0,0.0,0.0,0.0,0.0,0.0,27,0,27,10.0,0.0,10.0
6332,7,7,0,0,7,0,0,128,2.0,2.0,0.0,0.0,2.0,0.0,0.0,7,7,0,1.0,1.0,0.0
205233,5,2,3,4,0,5,24,66,4.0,1.0,3.0,3.0,0.0,4.0,23.0,15,5,10,11.0,3.0,8.0
107308,4,4,0,0,0,4,13,63,1.0,1.0,0.0,0.0,0.0,1.0,4.0,21,4,17,4.0,1.0,3.0
9609255,0,0,0,0,0,0,0,150,0.0,0.0,0.0,0.0,0.0,0.0,0.0,6,0,6,2.0,0.0,2.0
105285,3,2,1,1,0,3,9,32,2.0,1.0,1.0,1.0,0.0,2.0,3.0,20,3,17,4.0,1.0,3.0
109110,5,3,2,4,0,5,11,278,3.0,1.0,2.0,2.0,0.0,3.0,6.0,9,5,4,5.0,3.0,2.0
8167,1,1,0,0,0,1,1,69,0.0,0.0,0.0,0.0,0.0,0.0,0.0,11,1,10,7.0,0.0,7.0
9810341,5,2,3,5,0,5,21,76,5.0,2.0,3.0,5.0,0.0,5.0,21.0,13,5,8,13.0,5.0,8.0
203246,0,0,0,0,0,0,0,124,0.0,0.0,0.0,0.0,0.0,0.0,0.0,16,0,16,12.0,0.0,12.0
205264,1,1,0,0,1,0,0,37,0.0,0.0,0.0,0.0,0.0,0.0,0.0,17,1,16,3.0,0.0,3.0
101027,3,2,1,1,0,3,3,53,2.0,2.0,0.0,0.0,2.0,0.0,0.0,4,3,1,2.0,2.0,0.0
9805362,1,1,0,0,1,0,0,247,1.0,1.0,0.0,0.0,1.0,0.0,0.0,1,1,0,,,
9612459,11,3,8,13,2,9,23,90,9.0,3.0,6.0,10.0,0.0,9.0,23.0,18,11,7,5.0,2.0,3.0
9248,9,5,4,4,0,9,51,11,1.0,1.0,0.0,0.0,0.0,1.0,4.0,45,9,36,8.0,0.0,8.0
204127,5,1,4,4,0,5,25,80,4.0,1.0,3.0,3.0,0.0,4.0,19.0,11,5,6,9.0,3.0,6.0
211127,0,0,0,0,0,0,0,117,0.0,0.0,0.0,0.0,0.0,0.0,0.0,20,0,20,11.0,0.0,11.0
205251,2,2,0,0,1,1,2,153,1.0,1.0,0.0,0.0,0.0,1.0,1.0,8,2,6,2.0,1.0,1.0
6098,5,2,3,4,0,5,77,8,3.0,1.0,2.0,3.0,0.0,3.0,36.0,66,5,61,16.0,1.0,15.0
9512317,1,1,0,0,1,0,0,63,0.0,0.0,0.0,0.0,0.0,0.0,0.0,10,1,9,2.0,0.0,2.0
9609409,1,1,0,0,0,1,2,8,0.0,0.0,0.0,0.0,0.0,0.0,0.0,4,1,3,1.0,0.0,1.0
201004,5,2,3,4,1,4,15,215,5.0,2.0,3.0,4.0,1.0,4.0,9.0,15,5,10,10.0,5.0,5.0
201135,0,0,0,0,0,0,0,20,,,,,,,,6,0,6,,,
9810446,10,2,8,11,5,5,6,132,9.0,2.0,7.0,10.0,4.0,5.0,5.0,13,10,3,8.0,7.0,1.0
8025,4,3,1,1,2,2,3,294,3.0,3.0,0.0,0.0,3.0,0.0,0.0,6,4,2,3.0,2.0,1.0
9312336,1,1,0,0,1,0,0,63,1.0,1.0,0.0,0.0,1.0,0.0,0.0,1,1,0,1.0,1.0,0.0
101041,3,2,1,1,0,3,14,45,1.0,1.0,0.0,0.0,0.0,1.0,1.0,27,3,24,4.0,1.0,3.0
9603297,1,1,0,0,1,0,0,170,0.0,0.0,0.0,0.0,0.0,0.0,0.0,4,1,3,,,
205108,6,1,5,9,0,6,54,53,5.0,1.0,4.0,8.0,0.0,5.0,48.0,39,6,33,24.0,4.0,20.0
9502236,0,0,0,0,0,0,0,232,0.0,0.0,0.0,0.0,0.0,0.0,0.0,1,0,1,1.0,0.0,1.0
101287,5,3,2,3,5,0,0,84,2.0,2.0,0.0,0.0,2.0,0.0,0.0,7,5,2,2.0,0.0,2.0
112218,2,2,0,0,1,1,6,301,0.0,0.0,0.0,0.0,0.0,0.0,0.0,9,2,7,6.0,1.0,5.0
201186,1,1,0,0,0,1,1,215,1.0,1.0,0.0,0.0,0.0,1.0,1.0,13,1,12,7.0,1.0,6.0
2093,1,1,0,0,0,1,1,380,1.0,1.0,0.0,0.0,0.0,1.0,1.0,2,1,1,2.0,1.0,1.0
301154,0,0,0,0,0,0,0,1,0.0,0.0,0.0,0.0,0.0,0.0,0.0,32,0,32,21.0,0.0,21.0
9404315,0,0,0,0,0,0,0,358,0.0,0.0,0.0,0.0,0.0,0.0,0.0,2,0,2,1.0,0.0,1.0
212240,1,1,0,0,0,1,10,0,0.0,0.0,0.0,0.0,0.0,0.0,0.0,52,1,51,25.0,0.0,25.0
110181,9,2,7,19,0,9,13,127,7.0,1.0,6.0,16.0,0.0,7.0,10.0,11,9,2,9.0,7.0,2.0
202099,1,1,0,0,1,0,0,101,0.0,0.0,0.0,0.0,0.0,0.0,0.0,9,1,8,,,
9503242,0,0,0,0,0,0,0,63,0.0,0.0,0.0,0.0,0.0,0.0,0.0,15,0,15,8.0,0.0,8.0
203060,1,1,0,0,0,1,2,353,1.0,1.0,0.0,0.0,0.0,1.0,2.0,4,1,3,3.0,1.0,2.0
9708399,1,1,0,0,0,1,3,15,0.0,0.0,0.0,0.0,0.0,0.0,0.0,9,1,8,2.0,1.0,1.0
207230,4,3,1,1,0,4,35,9,2.0,1.0,1.0,1.0,0.0,2.0,21.0,35,4,31,2.0,1.0,1.0
9910536,5,2,3,8,0,5,14,29,4.0,2.0,2.0,4.0,4.0,0.0,0.0,15,5,10,4.0,4.0,0.0
9901308,2,1,1,1,2,0,0,153,2.0,1.0,1.0,1.0,2.0,0.0,0.0,2,2,0,2.0,2.0,0.0
9707221,6,3,3,5,0,6,13,123,5.0,3.0,2.0,3.0,0.0,5.0,8.0,12,6,6,7.0,4.0,3.0
9909358,0,0,0,0,0,0,0,516,0.0,0.0,0.0,0.0,0.0,0.0,0.0,2,0,2,2.0,0.0,2.0
9409456,4,4,0,0,0,4,8,16,4.0,4.0,0.0,0.0,1.0,3.0,3.0,9,4,5,2.0,2.0,0.0
202242,3,3,0,0,0,3,14,13,1.0,1.0,0.0,0.0,0.0,1.0,6.0,47,3,44,8.0,0.0,8.0
205143,10,6,4,4,1,9,96,37,7.0,4.0,3.0,3.0,0.0,7.0,73.0,42,10,32,24.0,4.0,20.0
2288,1,1,0,0,0,1,7,4,0.0,0.0,0.0,0.0,0.0,0.0,0.0,46,1,45,13.0,0.0,13.0
9501259,5,3,2,3,3,2,2,110,4.0,2.0,2.0,3.0,2.0,2.0,2.0,6,5,1,5.0,4.0,1.0
9909421,0,0,0,0,0,0,0,36,0.0,0.0,0.0,0.0,0.0,0.0,0.0,28,0,28,2.0,0.0,2.0
302116,0,0,0,0,0,0,0,146,0.0,0.0,0.0,0.0,0.0,0.0,0.0,14,0,14,12.0,0.0,12.0
9712544,0,0,0,0,0,0,0,84,0.0,0.0,0.0,0.0,0.0,0.0,0.0,5,0,5,5.0,0.0,5.0
9507325,2,2,0,0,0,2,4,74,1.0,1.0,0.0,0.0,0.0,1.0,3.0,6,2,4,2.0,1.0,1.0
5131,7,2,5,6,0,7,25,339,4.0,1.0,3.0,3.0,0.0,4.0,11.0,19,7,12,7.0,4.0,3.0
7165,1,1,0,0,0,1,4,12,0.0,0.0,0.0,0.0,0.0,0.0,0.0,34,1,33,4.0,0.0,4.0
9706490,2,1,1,1,1,1,2,599,2.0,1.0,1.0,1.0,2.0,0.0,0.0,7,2,5,3.0,2.0,1.0
9509396,2,2,0,0,0,2,6,291,2.0,2.0,0.0,0.0,0.0,2.0,2.0,8,2,6,2.0,0.0,2.0
2146,0,0,0,0,0,0,0,142,,,,,,,,2,0,2,,,
102313,7,6,1,1,0,7,23,130,1.0,1.0,0.0,0.0,0.0,1.0,7.0,21,7,14,8.0,0.0,8.0
6010,4,3,1,1,4,0,0,309,3.0,2.0,1.0,1.0,3.0,0.0,0.0,6,4,2,2.0,2.0,0.0
208197,0,0,0,0,0,0,0,671,0.0,0.0,0.0,0.0,0.0,0.0,0.0,1,0,1,1.0,0.0,1.0
9506395,1,1,0,0,0,1,1,120,1.0,1.0,0.0,0.0,1.0,0.0,0.0,2,1,1,1.0,1.0,0.0
9901347,0,0,0,0,0,0,0,24,,,,,,,,5,0,5,,,
106348,3,3,0,0,2,1,1,174,1.0,1.0,0.0,0.0,1.0,0.0,0.0,10,3,7,2.0,2.0,0.0
101148,3,2,1,1,0,3,12,0,0.0,0.0,0.0,0.0,0.0,0.0,0.0,35,3,32,5.0,0.0,5.0
112124,5,2,3,3,0,5,29,20,4.0,2.0,2.0,2.0,0.0,4.0,24.0,21,5,16,3.0,1.0,2.0
9404317,0,0,0,0,0,0,0,245,0.0,0.0,0.0,0.0,0.0,0.0,0.0,2,0,2,2.0,0.0,2.0
9909401,4,1,3,5,0,4,26,102,4.0,1.0,3.0,5.0,0.0,4.0,23.0,14,4,10,10.0,4.0,6.0
9804336,1,1,0,0,0,1,5,123,0.0,0.0,0.0,0.0,0.0,0.0,0.0,13,1,12,1.0,0.0,1.0
9908242,1,1,0,0,0,1,6,9,1.0,1.0,0.0,0.0,0.0,1.0,3.0,18,1,17,2.0,1.0,1.0
211025,0,0,0,0,0,0,0,10,0.0,0.0,0.0,0.0,0.0,0.0,0.0,28,0,28,6.0,0.0,6.0
9912219,0,0,0,0,0,0,0,72,0.0,0.0,0.0,0.0,0.0,0.0,0.0,3,0,3,2.0,0.0,2.0
9902307,3,3,0,0,1,2,5,4,0.0,0.0,0.0,0.0,0.0,0.0,0.0,34,3,31,4.0,0.0,4.0
9911405,1,1,0,0,0,1,5,6,1.0,1.0,0.0,0.0,0.0,1.0,4.0,9,1,8,6.0,1.0,5.0
9810298,1,1,0,0,1,0,0,282,0.0,0.0,0.0,0.0,0.0,0.0,0.0,2,1,1,,,
9909303,2,2,0,0,1,1,6,3,0.0,0.0,0.0,0.0,0.0,0.0,0.0,22,2,20,7.0,0.0,7.0
11351,0,0,0,0,0,0,0,12,,,,,,,,8,0,8,,,
9808381,0,0,0,0,0,0,0,113,0.0,0.0,0.0,0.0,0.0,0.0,0.0,5,0,5,,,
9511379,0,0,0,0,0,0,0,1046,,,,,,,,1,0,1,,,
9504383,3,3,0,0,0,3,11,71,2.0,2.0,0.0,0.0,0.0,2.0,10.0,9,3,6,1.0,1.0,0.0
302131,5,1,4,6,0,5,7,50,2.0,1.0,1.0,1.0,1.0,1.0,2.0,15,5,10,5.0,4.0,1.0
209122,1,1,0,0,0,1,11,23,0.0,0.0,0.0,0.0,0.0,0.0,0.0,12,1,11,1.0,0.0,1.0
9701270,1,1,0,0,0,1,1,481,1.0,1.0,0.0,0.0,0.0,1.0,1.0,2,1,1,2.0,1.0,1.0
9308331,2,2,0,0,2,0,0,1696,2.0,2.0,0.0,0.0,2.0,0.0,0.0,2,2,0,2.0,2.0,0.0
105107,6,4,2,3,0,6,15,31,4.0,3.0,1.0,1.0,0.0,4.0,11.0,14,6,8,8.0,3.0,5.0
9711329,3,1,2,2,0,3,8,111,3.0,1.0,2.0,2.0,0.0,3.0,6.0,7,3,4,6.0,3.0,3.0
204282,4,1,3,4,0,4,30,16,1.0,1.0,0.0,0.0,0.0,1.0,19.0,42,4,38,20.0,1.0,19.0
9905321,2,2,0,0,0,2,3,47,2.0,2.0,0.0,0.0,0.0,2.0,3.0,8,2,6,1.0,1.0,0.0
9505264,2,2,0,0,2,0,0,365,1.0,1.0,0.0,0.0,1.0,0.0,0.0,2,2,0,1.0,1.0,0.0
9711482,2,2,0,0,2,0,0,311,1.0,1.0,0.0,0.0,1.0,0.0,0.0,2,2,0,2.0,2.0,0.0
9503269,3,2,1,1,2,1,2,134,3.0,2.0,1.0,1.0,3.0,0.0,0.0,11,3,8,4.0,2.0,2.0
9708206,1,1,0,0,1,0,0,627,,,,,,,,1,1,0,1.0,1.0,0.0
101333,6,1,5,7,1,5,43,17,5.0,1.0,4.0,5.0,0.0,5.0,42.0,29,6,23,5.0,3.0,2.0
209091,5,5,0,0,0,5,52,67,2.0,2.0,0.0,0.0,0.0,2.0,23.0,46,5,41,20.0,1.0,19.0
206283,0,0,0,0,0,0,0,1551,,,,,,,,6,0,6,1.0,0.0,1.0
9805277,1,1,0,0,0,1,1,251,0.0,0.0,0.0,0.0,0.0,0.0,0.0,8,1,7,1.0,0.0,1.0
9512377,5,2,3,3,4,1,1,130,4.0,1.0,3.0,3.0,4.0,0.0,0.0,6,5,1,1.0,1.0,0.0
206284,3,1,2,2,0,3,26,11,3.0,1.0,2.0,2.0,0.0,3.0,20.0,32,3,29,2.0,0.0,2.0
9212293,1,1,0,0,1,0,0,332,1.0,1.0,0.0,0.0,1.0,0.0,0.0,1,1,0,,,
106317,2,1,1,1,0,2,12,14,0.0,0.0,0.0,0.0,0.0,0.0,0.0,10,2,8,4.0,0.0,4.0
9605216,3,3,0,0,0,3,5,118,2.0,2.0,0.0,0.0,0.0,2.0,4.0,6,3,3,3.0,2.0,1.0
105144,1,1,0,0,0,1,2,0,0.0,0.0,0.0,0.0,0.0,0.0,0.0,13,1,12,8.0,0.0,8.0
209013,0,0,0,0,0,0,0,45,0.0,0.0,0.0,0.0,0.0,0.0,0.0,6,0,6,2.0,0.0,2.0
207112,0,0,0,0,0,0,0,264,0.0,0.0,0.0,0.0,0.0,0.0,0.0,2,0,2,1.0,0.0,1.0
9612213,6,4,2,2,4,2,4,132,6.0,4.0,2.0,2.0,4.0,2.0,4.0,8,6,2,4.0,2.0,2.0
9307211,1,1,0,0,1,0,0,75,0.0,0.0,0.0,0.0,0.0,0.0,0.0,26,1,25,3.0,0.0,3.0
11253,2,2,0,0,0,2,5,5,1.0,1.0,0.0,0.0,0.0,1.0,2.0,25,2,23,13.0,0.0,13.0
9901270,0,0,0,0,0,0,0,176,0.0,0.0,0.0,0.0,0.0,0.0,0.0,3,0,3,,,
105233,7,4,3,3,0,7,119,18,5.0,3.0,2.0,2.0,0.0,5.0,77.0,69,7,62,24.0,4.0,20.0
9905206,6,3,3,5,0,6,6,91,6.0,3.0,3.0,5.0,1.0,5.0,5.0,8,6,2,6.0,5.0,1.0
205186,0,0,0,0,0,0,0,184,0.0,0.0,0.0,0.0,0.0,0.0,0.0,4,0,4,3.0,0.0,3.0
210115,1,1,0,0,0,1,4,20,0.0,0.0,0.0,0.0,0.0,0.0,0.0,14,1,13,4.0,1.0,3.0
109169,0,0,0,0,0,0,0,538,0.0,0.0,0.0,0.0,0.0,0.0,0.0,12,0,12,2.0,0.0,2.0
111351,3,3,0,0,0,3,3,445,3.0,3.0,0.0,0.0,3.0,0.0,0.0,6,3,3,1.0,1.0,0.0
9410396,0,0,0,0,0,0,0,99,0.0,0.0,0.0,0.0,0.0,0.0,0.0,10,0,10,3.0,0.0,3.0
207035,2,2,0,0,1,1,6,122,1.0,1.0,0.0,0.0,0.0,1.0,5.0,12,2,10,8.0,1.0,7.0
9406326,0,0,0,0,0,0,0,433,0.0,0.0,0.0,0.0,0.0,0.0,0.0,2,0,2,1.0,0.0,1.0
9903342,2,1,1,1,2,0,0,84,2.0,1.0,1.0,1.0,2.0,0.0,0.0,6,2,4,1.0,0.0,1.0
9912469,1,1,0,0,0,1,2,16,0.0,0.0,0.0,0.0,0.0,0.0,0.0,11,1,10,8.0,1.0,7.0
9809313,3,3,0,0,2,1,2,40,2.0,2.0,0.0,0.0,1.0,1.0,1.0,5,3,2,2.0,1.0,1.0
210104,3,2,1,1,0,3,24,45,3.0,2.0,1.0,1.0,0.0,3.0,22.0,21,3,18,16.0,2.0,14.0
9810224,2,2,0,0,0,2,14,14,1.0,1.0,0.0,0.0,0.0,1.0,10.0,31,2,29,6.0,1.0,5.0
9256,0,0,0,0,0,0,0,92,0.0,0.0,0.0,0.0,0.0,0.0,0.0,5,0,5,3.0,0.0,3.0
202179,0,0,0,0,0,0,0,72,0.0,0.0,0.0,0.0,0.0,0.0,0.0,8,0,8,3.0,0.0,3.0
112299,0,0,0,0,0,0,0,1670,,,,,,,,1,0,1,,,
204345,1,1,0,0,1,0,0,206,1.0,1.0,0.0,0.0,1.0,0.0,0.0,4,1,3,1.0,0.0,1.0
210046,1,1,0,0,1,0,0,79,1.0,1.0,0.0,0.0,1.0,0.0,0.0,9,1,8,3.0,0.0,3.0
201140,1,1,0,0,1,0,0,42,0.0,0.0,0.0,0.0,0.0,0.0,0.0,14,1,13,1.0,0.0,1.0
9302309,1,1,0,0,1,0,0,1475,,,,,,,,1,1,0,,,
9912437,2,2,0,0,1,1,1,141,1.0,1.0,0.0,0.0,0.0,1.0,1.0,4,2,2,3.0,1.0,2.0
212166,2,1,1,1,0,2,31,37,2.0,1.0,1.0,1.0,0.0,2.0,29.0,40,2,38,27.0,2.0,25.0
301072,5,4,1,1,0,5,51,0,3.0,3.0,0.0,0.0,0.0,3.0,26.0,47,5,42,16.0,2.0,14.0
9611456,7,3,4,5,2,5,6,328,6.0,2.0,4.0,5.0,2.0,4.0,4.0,12,7,5,6.0,5.0,1.0
9606462,1,1,0,0,0,1,6,17,1.0,1.0,0.0,0.0,0.0,1.0,6.0,13,1,12,2.0,1.0,1.0
9805466,0,0,0,0,0,0,0,340,0.0,0.0,0.0,0.0,0.0,0.0,0.0,3,0,3,3.0,0.0,3.0
11297,1,1,0,0,1,0,0,0,1.0,1.0,0.0,0.0,1.0,0.0,0.0,6,1,5,3.0,0.0,3.0
9407384,2,2,0,0,0,2,5,35,1.0,1.0,0.0,0.0,1.0,0.0,0.0,11,2,9,3.0,0.0,3.0
110412,2,2,0,0,0,2,11,282,2.0,2.0,0.0,0.0,0.0,2.0,10.0,8,2,6,4.0,1.0,3.0
1251,4,3,1,1,0,4,27,20,3.0,2.0,1.0,1.0,0.0,3.0,23.0,15,4,11,3.0,3.0,0.0
9810418,2,1,1,1,0,2,2,139,1.0,1.0,0.0,0.0,0.0,1.0,1.0,9,2,7,7.0,2.0,5.0
9612375,4,4,0,0,2,2,4,91,2.0,2.0,0.0,0.0,0.0,2.0,2.0,9,4,5,3.0,2.0,1.0
103016,1,1,0,0,1,0,0,83,1.0,1.0,0.0,0.0,1.0,0.0,0.0,4,1,3,1.0,1.0,0.0
9904322,1,1,0,0,0,1,1,178,1.0,1.0,0.0,0.0,0.0,1.0,1.0,5,1,4,2.0,0.0,2.0
211221,2,2,0,0,0,2,3,52,1.0,1.0,0.0,0.0,1.0,0.0,0.0,6,2,4,2.0,1.0,1.0
107085,2,2,0,0,0,2,8,261,2.0,2.0,0.0,0.0,0.0,2.0,5.0,9,2,7,6.0,2.0,4.0
107322,0,0,0,0,0,0,0,42,0.0,0.0,0.0,0.0,0.0,0.0,0.0,22,0,22,9.0,0.0,9.0
9911409,0,0,0,0,0,0,0,77,0.0,0.0,0.0,0.0,0.0,0.0,0.0,5,0,5,1.0,0.0,1.0
9808496,2,1,1,1,0,2,26,94,2.0,1.0,1.0,1.0,0.0,2.0,26.0,15,2,13,15.0,2.0,13.0
9905517,1,1,0,0,1,0,0,9,,,,,,,,9,1,8,2.0,0.0,2.0
9711375,0,0,0,0,0,0,0,432,0.0,0.0,0.0,0.0,0.0,0.0,0.0,4,0,4,4.0,0.0,4.0
9504253,2,1,1,1,2,0,0,152,1.0,1.0,0.0,0.0,1.0,0.0,0.0,3,2,1,1.0,0.0,1.0
9405351,5,3,2,2,4,1,2,199,2.0,1.0,1.0,1.0,2.0,0.0,0.0,7,5,2,2.0,2.0,0.0
9509394,0,0,0,0,0,0,0,60,0.0,0.0,0.0,0.0,0.0,0.0,0.0,5,0,5,1.0,0.0,1.0
9411248,1,1,0,0,1,0,0,62,0.0,0.0,0.0,0.0,0.0,0.0,0.0,11,1,10,1.0,0.0,1.0
210281,0,0,0,0,0,0,0,131,0.0,0.0,0.0,0.0,0.0,0.0,0.0,5,0,5,2.0,0.0,2.0
301121,0,0,0,0,0,0,0,158,0.0,0.0,0.0,0.0,0.0,0.0,0.0,50,0,50,20.0,0.0,20.0
9612427,1,1,0,0,1,0,0,769,1.0,1.0,0.0,0.0,1.0,0.0,0.0,1,1,0,1.0,1.0,0.0
9407307,0,0,0,0,0,0,0,207,0.0,0.0,0.0,0.0,0.0,0.0,0.0,2,0,2,1.0,0.0,1.0
206190,3,3,0,0,0,3,9,16,0.0,0.0,0.0,0.0,0.0,0.0,0.0,22,3,19,4.0,0.0,4.0
211355,0,0,0,0,0,0,0,63,0.0,0.0,0.0,0.0,0.0,0.0,0.0,11,0,11,4.0,0.0,4.0
8185,2,1,1,1,2,0,0,404,2.0,1.0,1.0,1.0,2.0,0.0,0.0,4,2,2,2.0,2.0,0.0
9911430,0,0,0,0,0,0,0,1833,,,,,,,,3,0,3,,,
202241,1,1,0,0,0,1,1,33,0.0,0.0,0.0,0.0,0.0,0.0,0.0,51,1,50,18.0,0.0,18.0
9905299,1,1,0,0,1,0,0,1207,,,,,,,,3,1,2,1.0,1.0,0.0
1024,3,3,0,0,0,3,7,3,1.0,1.0,0.0,0.0,0.0,1.0,4.0,37,3,34,20.0,0.0,20.0
9807493,3,3,0,0,0,3,5,379,3.0,3.0,0.0,0.0,0.0,3.0,5.0,6,3,3,6.0,3.0,3.0
9906455,1,1,0,0,1,0,0,2011,0.0,0.0,0.0,0.0,0.0,0.0,0.0,3,1,2,1.0,1.0,0.0
11312,1,1,0,0,0,1,3,54,0.0,0.0,0.0,0.0,0.0,0.0,0.0,10,1,9,5.0,0.0,5.0
112153,0,0,0,0,0,0,0,153,0.0,0.0,0.0,0.0,0.0,0.0,0.0,9,0,9,5.0,0.0,5.0
2105,0,0,0,0,0,0,0,119,0.0,0.0,0.0,0.0,0.0,0.0,0.0,11,0,11,9.0,0.0,9.0
11255,0,0,0,0,0,0,0,1240,,,,,,,,1,0,1,,,
10184,1,1,0,0,0,1,1,43,1.0,1.0,0.0,0.0,0.0,1.0,1.0,6,1,5,,,
212038,0,0,0,0,0,0,0,0,0.0,0.0,0.0,0.0,0.0,0.0,0.0,14,0,14,5.0,0.0,5.0
10167,1,1,0,0,0,1,5,254,1.0,1.0,0.0,0.0,0.0,1.0,3.0,7,1,6,2.0,1.0,1.0
9706414,0,0,0,0,0,0,0,14,0.0,0.0,0.0,0.0,0.0,0.0,0.0,10,0,10,1.0,0.0,1.0
212077,0,0,0,0,0,0,0,161,0.0,0.0,0.0,0.0,0.0,0.0,0.0,8,0,8,5.0,0.0,5.0
9609225,0,0,0,0,0,0,0,22,0.0,0.0,0.0,0.0,0.0,0.0,0.0,10,0,10,8.0,0.0,8.0
9704270,0,0,0,0,0,0,0,14,0.0,0.0,0.0,0.0,0.0,0.0,0.0,13,0,13,4.0,0.0,4.0
211027,1,1,0,0,0,1,2,27,1.0,1.0,0.0,0.0,1.0,0.0,0.0,11,1,10,1.0,1.0,0.0
102299,3,3,0,0,0,3,20,85,2.0,2.0,0.0,0.0,0.0,2.0,11.0,28,3,25,11.0,2.0,9.0
9905519,1,1,0,0,0,1,3,127,1.0,1.0,0.0,0.0,0.0,1.0,2.0,4,1,3,,,
9100,1,1,0,0,1,0,0,33,0.0,0.0,0.0,0.0,0.0,0.0,0.0,28,1,27,3.0,0.0,3.0
3319,1,1,0,0,0,1,3,88,0.0,0.0,0.0,0.0,0.0,0.0,0.0,6,1,5,3.0,1.0,2.0
9712366,0,0,0,0,0,0,0,996,,,,,,,,3,0,3,,,
9911201,0,0,0,0,0,0,0,215,0.0,0.0,0.0,0.0,0.0,0.0,0.0,3,0,3,1.0,0.0,1.0
9907551,1,1,0,0,0,1,6,82,1.0,1.0,0.0,0.0,0.0,1.0,6.0,7,1,6,2.0,1.0,1.0
103292,8,3,5,6,1,7,37,23,2.0,1.0,1.0,1.0,0.0,2.0,13.0,49,8,41,4.0,0.0,4.0
212171,0,0,0,0,0,0,0,34,0.0,0.0,0.0,0.0,0.0,0.0,0.0,8,0,8,5.0,0.0,5.0
9710219,2,1,1,1,0,2,2,148,2.0,1.0,1.0,1.0,0.0,2.0,2.0,8,2,6,4.0,2.0,2.0
9812317,0,0,0,0,0,0,0,16,0.0,0.0,0.0,0.0,0.0,0.0,0.0,17,0,17,,,
3041,1,1,0,0,1,0,0,361,1.0,1.0,0.0,0.0,1.0,0.0,0.0,1,1,0,1.0,1.0,0.0
108143,1,1,0,0,0,1,6,9,1.0,1.0,0.0,0.0,0.0,1.0,6.0,13,1,12,2.0,0.0,2.0
102333,1,1,0,0,1,0,0,614,1.0,1.0,0.0,0.0,1.0,0.0,0.0,3,1,2,1.0,1.0,0.0
211077,0,0,0,0,0,0,0,7,0.0,0.0,0.0,0.0,0.0,0.0,0.0,33,0,33,11.0,0.0,11.0
9806405,0,0,0,0,0,0,0,1107,,,,,,,,2,0,2,1.0,0.0,1.0
9608446,0,0,0,0,0,0,0,79,0.0,0.0,0.0,0.0,0.0,0.0,0.0,12,0,12,6.0,0.0,6.0
112066,2,2,0,0,1,1,1,224,1.0,1.0,0.0,0.0,1.0,0.0,0.0,3,2,1,1.0,0.0,1.0
9406333,0,0,0,0,0,0,0,10,0.0,0.0,0.0,0.0,0.0,0.0,0.0,19,0,19,6.0,0.0,6.0
9504207,0,0,0,0,0,0,0,295,0.0,0.0,0.0,0.0,0.0,0.0,0.0,2,0,2,2.0,0.0,2.0
9807295,0,0,0,0,0,0,0,166,0.0,0.0,0.0,0.0,0.0,0.0,0.0,12,0,12,5.0,0.0,5.0
9610234,0,0,0,0,0,0,0,584,0.0,0.0,0.0,0.0,0.0,0.0,0.0,11,0,11,1.0,0.0,1.0
9501310,0,0,0,0,0,0,0,1701,0.0,0.0,0.0,0.0,0.0,0.0,0.0,1,0,1,,,
11120,1,1,0,0,1,0,0,343,0.0,0.0,0.0,0.0,0.0,0.0,0.0,4,1,3,2.0,0.0,2.0
9602339,0,0,0,0,0,0,0,30,0.0,0.0,0.0,0.0,0.0,0.0,0.0,7,0,7,2.0,0.0,2.0
112090,1,1,0,0,0,1,7,2,0.0,0.0,0.0,0.0,0.0,0.0,0.0,18,1,17,2.0,1.0,1.0
10258,0,0,0,0,0,0,0,395,0.0,0.0,0.0,0.0,0.0,0.0,0.0,4,0,4,1.0,0.0,1.0
107019,0,0,0,0,0,0,0,97,0.0,0.0,0.0,0.0,0.0,0.0,0.0,4,0,4,3.0,0.0,3.0
301046,0,0,0,0,0,0,0,392,0.0,0.0,0.0,0.0,0.0,0.0,0.0,3,0,3,2.0,0.0,2.0
209363,0,0,0,0,0,0,0,144,0.0,0.0,0.0,0.0,0.0,0.0,0.0,1,0,1,,,
110019,2,1,1,1,0,2,28,52,2.0,1.0,1.0,1.0,0.0,2.0,22.0,22,2,20,13.0,2.0,11.0
9708387,0,0,0,0,0,0,0,1,0.0,0.0,0.0,0.0,0.0,0.0,0.0,32,0,32,10.0,0.0,10.0
212252,1,1,0,0,0,1,7,129,1.0,1.0,0.0,0.0,0.0,1.0,7.0,8,1,7,5.0,1.0,4.0
202119,0,0,0,0,0,0,0,48,0.0,0.0,0.0,0.0,0.0,0.0,0.0,8,0,8,2.0,0.0,2.0
12315,2,2,0,0,1,1,2,395,1.0,1.0,0.0,0.0,0.0,1.0,2.0,6,2,4,2.0,1.0,1.0
11110,0,0,0,0,0,0,0,111,0.0,0.0,0.0,0.0,0.0,0.0,0.0,7,0,7,3.0,0.0,3.0
9505332,0,0,0,0,0,0,0,17,0.0,0.0,0.0,0.0,0.0,0.0,0.0,12,0,12,,,
210126,0,0,0,0,0,0,0,110,0.0,0.0,0.0,0.0,0.0,0.0,0.0,3,0,3,1.0,0.0,1.0
3008,0,0,0,0,0,0,0,4,0.0,0.0,0.0,0.0,0.0,0.0,0.0,10,0,10,2.0,0.0,2.0
9901336,0,0,0,0,0,0,0,1576,0.0,0.0,0.0,0.0,0.0,0.0,0.0,1,0,1,,,
9804259,0,0,0,0,0,0,0,120,0.0,0.0,0.0,0.0,0.0,0.0,0.0,3,0,3,,,
110131,0,0,0,0,0,0,0,111,0.0,0.0,0.0,0.0,0.0,0.0,0.0,6,0,6,4.0,0.0,4.0
9609312,0,0,0,0,0,0,0,57,0.0,0.0,0.0,0.0,0.0,0.0,0.0,11,0,11,1.0,0.0,1.0
11354,1,1,0,0,0,1,1,20,0.0,0.0,0.0,0.0,0.0,0.0,0.0,22,1,21,5.0,0.0,5.0
9406380,1,1,0,0,0,1,1,345,1.0,1.0,0.0,0.0,0.0,1.0,1.0,3,1,2,2.0,0.0,2.0
9511353,0,0,0,0,0,0,0,284,0.0,0.0,0.0,0.0,0.0,0.0,0.0,1,0,1,1.0,0.0,1.0
207361,0,0,0,0,0,0,0,585,0.0,0.0,0.0,0.0,0.0,0.0,0.0,5,0,5,1.0,0.0,1.0
9605232,0,0,0,0,0,0,0,104,,,,,,,,2,0,2,,,
204231,2,2,0,0,0,2,15,2,1.0,1.0,0.0,0.0,0.0,1.0,4.0,31,2,29,5.0,0.0,5.0
110329,0,0,0,0,0,0,0,904,,,,,,,,5,0,5,,,
302150,0,0,0,0,0,0,0,219,,,,,,,,2,0,2,1.0,0.0,1.0
301065,0,0,0,0,0,0,0,20,0.0,0.0,0.0,0.0,0.0,0.0,0.0,20,0,20,4.0,0.0,4.0
9412316,0,0,0,0,0,0,0,153,0.0,0.0,0.0,0.0,0.0,0.0,0.0,2,0,2,2.0,0.0,2.0
9808398,0,0,0,0,0,0,0,203,0.0,0.0,0.0,0.0,0.0,0.0,0.0,3,0,3,3.0,0.0,3.0
9708428,0,0,0,0,0,0,0,1062,,,,,,,,2,0,2,,,
204247,0,0,0,0,0,0,0,2,0.0,0.0,0.0,0.0,0.0,0.0,0.0,35,0,35,19.0,0.0,19.0
9907304,0,0,0,0,0,0,0,9,0.0,0.0,0.0,0.0,0.0,0.0,0.0,13,0,13,3.0,0.0,3.0
9609507,1,1,0,0,0,1,1,249,1.0,1.0,0.0,0.0,0.0,1.0,1.0,2,1,1,2.0,1.0,1.0
9312326,0,0,0,0,0,0,0,1506,,,,,,,,1,0,1,,,
109193,0,0,0,0,0,0,0,121,0.0,0.0,0.0,0.0,0.0,0.0,0.0,5,0,5,,,
11290,0,0,0,0,0,0,0,4,0.0,0.0,0.0,0.0,0.0,0.0,0.0,8,0,8,6.0,0.0,6.0
202173,0,0,0,0,0,0,0,51,0.0,0.0,0.0,0.0,0.0,0.0,0.0,14,0,14,11.0,0.0,11.0
9907404,1,1,0,0,0,1,5,24,1.0,1.0,0.0,0.0,0.0,1.0,1.0,8,1,7,4.0,1.0,3.0
9706440,0,0,0,0,0,0,0,1420,,,,,,,,2,0,2,2.0,0.0,2.0
103249,0,0,0,0,0,0,0,2,0.0,0.0,0.0,0.0,0.0,0.0,0.0,28,0,28,5.0,0.0,5.0
9304313,1,1,0,0,1,0,0,712,1.0,1.0,0.0,0.0,1.0,0.0,0.0,1,1,0,1.0,1.0,0.0
302011,0,0,0,0,0,0,0,174,0.0,0.0,0.0,0.0,0.0,0.0,0.0,4,0,4,3.0,0.0,3.0
9811332,1,1,0,0,1,0,0,714,1.0,1.0,0.0,0.0,1.0,0.0,0.0,1,1,0,1.0,1.0,0.0
9905315,0,0,0,0,0,0,0,12,0.0,0.0,0.0,0.0,0.0,0.0,0.0,16,0,16,3.0,0.0,3.0
301275,0,0,0,0,0,0,0,198,0.0,0.0,0.0,0.0,0.0,0.0,0.0,6,0,6,1.0,0.0,1.0
9504303,0,0,0,0,0,0,0,1552,0.0,0.0,0.0,0.0,0.0,0.0,0.0,2,0,2,1.0,0.0,1.0
101096,0,0,0,0,0,0,0,15,0.0,0.0,0.0,0.0,0.0,0.0,0.0,10,0,10,2.0,0.0,2.0
212192,0,0,0,0,0,0,0,201,0.0,0.0,0.0,0.0,0.0,0.0,0.0,15,0,15,11.0,0.0,11.0
9509335,1,1,0,0,0,1,1,444,1.0,1.0,0.0,0.0,0.0,1.0,1.0,2,1,1,2.0,1.0,1.0
9912432,0,0,0,0,0,0,0,152,0.0,0.0,0.0,0.0,0.0,0.0,0.0,7,0,7,5.0,0.0,5.0
12164,2,2,0,0,0,2,6,64,1.0,1.0,0.0,0.0,0.0,1.0,2.0,20,2,18,3.0,1.0,2.0
204245,2,2,0,0,0,2,8,127,1.0,1.0,0.0,0.0,0.0,1.0,1.0,11,2,9,1.0,0.0,1.0
9912259,0,0,0,0,0,0,0,64,0.0,0.0,0.0,0.0,0.0,0.0,0.0,9,0,9,,,
9908312,0,0,0,0,0,0,0,8,0.0,0.0,0.0,0.0,0.0,0.0,0.0,9,0,9,1.0,0.0,1.0
211443,0,0,0,0,0,0,0,110,0.0,0.0,0.0,0.0,0.0,0.0,0.0,3,0,3,1.0,0.0,1.0
9906451,1,1,0,0,0,1,1,27,1.0,1.0,0.0,0.0,1.0,0.0,0.0,7,1,6,1.0,1.0,0.0
9610338,0,0,0,0,0,0,0,143,,,,,,,,1,0,1,,,
9706544,0,0,0,0,0,0,0,90,,,,,,,,2,0,2,1.0,0.0,1.0
9911239,1,1,0,0,1,0,0,186,1.0,1.0,0.0,0.0,1.0,0.0,0.0,1,1,0,1.0,1.0,0.0
4036,0,0,0,0,0,0,0,3,0.0,0.0,0.0,0.0,0.0,0.0,0.0,12,0,12,8.0,0.0,8.0
211052,0,0,0,0,0,0,0,66,0.0,0.0,0.0,0.0,0.0,0.0,0.0,41,0,41,3.0,0.0,3.0
9804405,0,0,0,0,0,0,0,57,0.0,0.0,0.0,0.0,0.0,0.0,0.0,4,0,4,3.0,0.0,3.0
210051,0,0,0,0,0,0,0,169,0.0,0.0,0.0,0.0,0.0,0.0,0.0,4,0,4,3.0,0.0,3.0
209351,0,0,0,0,0,0,0,30,0.0,0.0,0.0,0.0,0.0,0.0,0.0,15,0,15,9.0,0.0,9.0
9407258,1,1,0,0,1,0,0,1403,,,,,,,,1,1,0,,,
9310305,0,0,0,0,0,0,0,758,0.0,0.0,0.0,0.0,0.0,0.0,0.0,1,0,1,1.0,0.0,1.0
9902213,0,0,0,0,0,0,0,16,0.0,0.0,0.0,0.0,0.0,0.0,0.0,19,0,19,1.0,0.0,1.0
9909252,2,1,1,1,0,2,11,107,2.0,1.0,1.0,1.0,0.0,2.0,8.0,20,2,18,9.0,2.0,7.0
9510278,0,0,0,0,0,0,0,79,0.0,0.0,0.0,0.0,0.0,0.0,0.0,6,0,6,1.0,0.0,1.0
302194,0,0,0,0,0,0,0,45,0.0,0.0,0.0,0.0,0.0,0.0,0.0,11,0,11,11.0,0.0,11.0
9503382,0,0,0,0,0,0,0,116,0.0,0.0,0.0,0.0,0.0,0.0,0.0,9,0,9,6.0,0.0,6.0
301191,0,0,0,0,0,0,0,70,0.0,0.0,0.0,0.0,0.0,0.0,0.0,16,0,16,4.0,0.0,4.0
105018,0,0,0,0,0,0,0,171,0.0,0.0,0.0,0.0,0.0,0.0,0.0,7,0,7,2.0,0.0,2.0
211260,0,0,0,0,0,0,0,350,0.0,0.0,0.0,0.0,0.0,0.0,0.0,20,0,20,5.0,0.0,5.0
207216,0,0,0,0,0,0,0,306,,,,,,,,2,0,2,,,
206281,0,0,0,0,0,0,0,2015,,,,,,,,6,0,6,3.0,0.0,3.0
9505363,0,0,0,0,0,0,0,29,0.0,0.0,0.0,0.0,0.0,0.0,0.0,9,0,9,2.0,0.0,2.0
210142,0,0,0,0,0,0,0,28,0.0,0.0,0.0,0.0,0.0,0.0,0.0,79,0,79,12.0,0.0,12.0
112171,1,1,0,0,0,1,5,0,1.0,1.0,0.0,0.0,0.0,1.0,3.0,17,1,16,5.0,1.0,4.0
6356,0,0,0,0,0,0,0,288,0.0,0.0,0.0,0.0,0.0,0.0,0.0,6,0,6,1.0,0.0,1.0
9610473,0,0,0,0,0,0,0,43,0.0,0.0,0.0,0.0,0.0,0.0,0.0,9,0,9,,,
9608391,0,0,0,0,0,0,0,57,0.0,0.0,0.0,0.0,0.0,0.0,0.0,5,0,5,1.0,0.0,1.0
9511408,0,0,0,0,0,0,0,1604,,,,,,,,1,0,1,,,
206282,0,0,0,0,0,0,0,2,0.0,0.0,0.0,0.0,0.0,0.0,0.0,22,0,22,7.0,0.0,7.0
211362,0,0,0,0,0,0,0,119,0.0,0.0,0.0,0.0,0.0,0.0,0.0,6,0,6,4.0,0.0,4.0
110048,0,0,0,0,0,0,0,45,0.0,0.0,0.0,0.0,0.0,0.0,0.0,16,0,16,1.0,0.0,1.0
209195,1,1,0,0,1,0,0,122,0.0,0.0,0.0,0.0,0.0,0.0,0.0,12,1,11,8.0,0.0,8.0
10268,0,0,0,0,0,0,0,3,0.0,0.0,0.0,0.0,0.0,0.0,0.0,16,0,16,3.0,0.0,3.0
9905402,1,1,0,0,0,1,1,185,0.0,0.0,0.0,0.0,0.0,0.0,0.0,3,1,2,2.0,1.0,1.0
105032,0,0,0,0,0,0,0,105,0.0,0.0,0.0,0.0,0.0,0.0,0.0,19,0,19,4.0,0.0,4.0
9611230,0,0,0,0,0,0,0,130,0.0,0.0,0.0,0.0,0.0,0.0,0.0,3,0,3,,,
9907508,0,0,0,0,0,0,0,271,0.0,0.0,0.0,0.0,0.0,0.0,0.0,3,0,3,1.0,0.0,1.0
301239,0,0,0,0,0,0,0,28,0.0,0.0,0.0,0.0,0.0,0.0,0.0,50,0,50,21.0,0.0,21.0
210401,0,0,0,0,0,0,0,4,0.0,0.0,0.0,0.0,0.0,0.0,0.0,13,0,13,1.0,0.0,1.0
201057,0,0,0,0,0,0,0,368,0.0,0.0,0.0,0.0,0.0,0.0,0.0,2,0,2,1.0,0.0,1.0
9712265,0,0,0,0,0,0,0,2121,,,,,,,,1,0,1,,,
9506250,0,0,0,0,0,0,0,150,,,,,,,,1,0,1,,,
210443,0,0,0,0,0,0,0,32,0.0,0.0,0.0,0.0,0.0,0.0,0.0,9,0,9,,,
9811329,0,0,0,0,0,0,0,968,,,,,,,,3,0,3,,,
201020,0,0,0,0,0,0,0,268,0.0,0.0,0.0,0.0,0.0,0.0,0.0,9,0,9,5.0,0.0,5.0
9907215,0,0,0,0,0,0,0,1982,,,,,,,,1,0,1,,,
10085,1,1,0,0,1,0,0,427,1.0,1.0,0.0,0.0,1.0,0.0,0.0,3,1,2,1.0,1.0,0.0
201084,0,0,0,0,0,0,0,617,0.0,0.0,0.0,0.0,0.0,0.0,0.0,3,0,3,1.0,0.0,1.0
210290,0,0,0,0,0,0,0,410,0.0,0.0,0.0,0.0,0.0,0.0,0.0,9,0,9,6.0,0.0,6.0
5231,0,0,0,0,0,0,0,305,0.0,0.0,0.0,0.0,0.0,0.0,0.0,16,0,16,2.0,0.0,2.0
9611370,0,0,0,0,0,0,0,155,0.0,0.0,0.0,0.0,0.0,0.0,0.0,5,0,5,4.0,0.0,4.0
112170,0,0,0,0,0,0,0,2107,0.0,0.0,0.0,0.0,0.0,0.0,0.0,1,0,1,,,
9506252,0,0,0,0,0,0,0,93,0.0,0.0,0.0,0.0,0.0,0.0,0.0,1,0,1,1.0,0.0,1.0
9609299,1,1,0,0,1,0,0,378,1.0,1.0,0.0,0.0,1.0,0.0,0.0,1,1,0,1.0,1.0,0.0
205045,0,0,0,0,0,0,0,2026,,,,,,,,7,0,7,1.0,0.0,1.0
9910398,0,0,0,0,0,0,0,249,0.0,0.0,0.0,0.0,0.0,0.0,0.0,2,0,2,1.0,0.0,1.0
102024,0,0,0,0,0,0,0,214,0.0,0.0,0.0,0.0,0.0,0.0,0.0,2,0,2,1.0,0.0,1.0
9609461,0,0,0,0,0,0,0,306,0.0,0.0,0.0,0.0,0.0,0.0,0.0,6,0,6,2.0,0.0,2.0
3288,0,0,0,0,0,0,0,72,0.0,0.0,0.0,0.0,0.0,0.0,0.0,2,0,2,,,
210294,0,0,0,0,0,0,0,80,0.0,0.0,0.0,0.0,0.0,0.0,0.0,31,0,31,16.0,0.0,16.0
107293,0,0,0,0,0,0,0,48,0.0,0.0,0.0,0.0,0.0,0.0,0.0,28,0,28,3.0,0.0,3.0
107092,0,0,0,0,0,0,0,141,0.0,0.0,0.0,0.0,0.0,0.0,0.0,16,0,16,3.0,0.0,3.0
9602427,0,0,0,0,0,0,0,224,0.0,0.0,0.0,0.0,0.0,0.0,0.0,1,0,1,,,
105047,0,0,0,0,0,0,0,45,0.0,0.0,0.0,0.0,0.0,0.0,0.0,16,0,16,3.0,0.0,3.0
111369,0,0,0,0,0,0,0,191,0.0,0.0,0.0,0.0,0.0,0.0,0.0,7,0,7,6.0,0.0,6.0
301006,0,0,0,0,0,0,0,779,0.0,0.0,0.0,0.0,0.0,0.0,0.0,1,0,1,1.0,0.0,1.0
9711390,0,0,0,0,0,0,0,1356,,,,,,,,1,0,1,,,
9505202,0,0,0,0,0,0,0,35,0.0,0.0,0.0,0.0,0.0,0.0,0.0,4,0,4,1.0,0.0,1.0
203020,0,0,0,0,0,0,0,91,,,,,,,,1,0,1,1.0,0.0,1.0
2269,0,0,0,0,0,0,0,167,0.0,0.0,0.0,0.0,0.0,0.0,0.0,7,0,7,3.0,0.0,3.0
106092,0,0,0,0,0,0,0,27,0.0,0.0,0.0,0.0,0.0,0.0,0.0,8,0,8,1.0,0.0,1.0
9510335,0,0,0,0,0,0,0,91,0.0,0.0,0.0,0.0,0.0,0.0,0.0,5,0,5,3.0,0.0,3.0
8178,0,0,0,0,0,0,0,404,0.0,0.0,0.0,0.0,0.0,0.0,0.0,1,0,1,1.0,0.0,1.0
9711457,0,0,0,0,0,0,0,122,0.0,0.0,0.0,0.0,0.0,0.0,0.0,5,0,5,1.0,0.0,1.0
9610288,0,0,0,0,0,0,0,1292,,,,,,,,2,0,2,,,
211003,0,0,0,0,0,0,0,1,0.0,0.0,0.0,0.0,0.0,0.0,0.0,32,0,32,7.0,0.0,7.0
9290,0,0,0,0,0,0,0,50,0.0,0.0,0.0,0.0,0.0,0.0,0.0,17,0,17,8.0,0.0,8.0
9501309,0,0,0,0,0,0,0,550,0.0,0.0,0.0,0.0,0.0,0.0,0.0,5,0,5,1.0,0.0,1.0
12146,0,0,0,0,0,0,0,85,0.0,0.0,0.0,0.0,0.0,0.0,0.0,3,0,3,1.0,0.0,1.0
9909488,0,0,0,0,0,0,0,11,0.0,0.0,0.0,0.0,0.0,0.0,0.0,13,0,13,9.0,0.0,9.0
9908348,1,1,0,0,0,1,7,47,1.0,1.0,0.0,0.0,0.0,1.0,7.0,13,1,12,2.0,1.0,1.0
101135,0,0,0,0,0,0,0,4,0.0,0.0,0.0,0.0,0.0,0.0,0.0,13,0,13,1.0,0.0,1.0
109199,0,0,0,0,0,0,0,1145,,,,,,,,1,0,1,,,
211383,0,0,0,0,0,0,0,104,0.0,0.0,0.0,0.0,0.0,0.0,0.0,12,0,12,6.0,0.0,6.0
108032,0,0,0,0,0,0,0,73,,,,,,,,4,0,4,,,
212010,0,0,0,0,0,0,0,4,0.0,0.0,0.0,0.0,0.0,0.0,0.0,12,0,12,,,
9906294,0,0,0,0,0,0,0,9,0.0,0.0,0.0,0.0,0.0,0.0,0.0,14,0,14,2.0,0.0,2.0
211205,0,0,0,0,0,0,0,2,0.0,0.0,0.0,0.0,0.0,0.0,0.0,23,0,23,1.0,0.0,1.0
9409245,0,0,0,0,0,0,0,1559,,,,,,,,1,0,1,,,
207338,0,0,0,0,0,0,0,98,0.0,0.0,0.0,0.0,0.0,0.0,0.0,8,0,8,6.0,0.0,6.0
302180,0,0,0,0,0,0,0,19,0.0,0.0,0.0,0.0,0.0,0.0,0.0,49,0,49,29.0,0.0,29.0
9909272,0,0,0,0,0,0,0,741,0.0,0.0,0.0,0.0,0.0,0.0,0.0,1,0,1,1.0,0.0,1.0
203013,0,0,0,0,0,0,0,189,0.0,0.0,0.0,0.0,0.0,0.0,0.0,5,0,5,3.0,0.0,3.0
9712268,0,0,0,0,0,0,0,437,0.0,0.0,0.0,0.0,0.0,0.0,0.0,6,0,6,1.0,0.0,1.0
9909263,0,0,0,0,0,0,0,258,0.0,0.0,0.0,0.0,0.0,0.0,0.0,7,0,7,2.0,0.0,2.0
9512214,0,0,0,0,0,0,0,189,0.0,0.0,0.0,0.0,0.0,0.0,0.0,1,0,1,1.0,0.0,1.0
204038,0,0,0,0,0,0,0,321,0.0,0.0,0.0,0.0,0.0,0.0,0.0,7,0,7,6.0,0.0,6.0
9901240,0,0,0,0,0,0,0,507,0.0,0.0,0.0,0.0,0.0,0.0,0.0,5,0,5,2.0,0.0,2.0
9702314,69,11,58,249,31,38,81,89,25.0,1.0,24.0,108.0,13.0,12.0,22.0,76,69,7,21.0,19.0,2.0
9803242,70,9,61,248,20,50,118,89,33.0,2.0,31.0,132.0,0.0,33.0,82.0,78,70,8,30.0,26.0,4.0
4173,158,6,152,1006,4,154,927,1,85.0,4.0,81.0,654.0,0.0,85.0,430.0,209,158,51,46.0,37.0,9.0
102219,8,2,6,10,0,8,41,8,1.0,1.0,0.0,0.0,0.0,1.0,11.0,43,8,35,5.0,4.0,1.0
9909564,9,5,4,7,0,9,64,1,3.0,2.0,1.0,1.0,0.0,3.0,22.0,33,9,24,22.0,3.0,19.0
9310311,107,9,98,723,107,0,0,34,33.0,3.0,30.0,214.0,33.0,0.0,0.0,107,107,0,23.0,23.0,0.0
9410388,55,9,46,294,29,26,40,1,36.0,5.0,31.0,211.0,36.0,0.0,0.0,60,55,5,20.0,20.0,0.0
12161,3,3,0,0,0,3,13,74,0.0,0.0,0.0,0.0,0.0,0.0,0.0,24,3,21,4.0,0.0,4.0
11086,19,9,10,19,8,11,32,1,3.0,2.0,1.0,1.0,1.0,2.0,3.0,33,19,14,4.0,1.0,3.0
9909530,6,4,2,3,0,6,16,34,0.0,0.0,0.0,0.0,0.0,0.0,0.0,17,6,11,4.0,1.0,3.0
9503486,139,39,100,314,88,51,163,6,24.0,5.0,19.0,68.0,20.0,4.0,4.0,157,139,18,16.0,16.0,0.0
9412243,7,6,1,1,4,3,3,208,2.0,2.0,0.0,0.0,1.0,1.0,1.0,12,7,5,4.0,2.0,2.0
9603409,17,6,11,27,1,16,33,114,11.0,3.0,8.0,19.0,0.0,11.0,22.0,21,17,4,13.0,10.0,3.0
9604312,8,5,3,4,1,7,21,114,5.0,4.0,1.0,2.0,2.0,3.0,12.0,22,8,14,7.0,3.0,4.0
9401243,4,4,0,0,3,1,1,218,1.0,1.0,0.0,0.0,1.0,0.0,0.0,5,4,1,1.0,1.0,0.0
205270,12,7,5,6,1,11,107,4,4.0,3.0,1.0,1.0,0.0,4.0,34.0,49,12,37,9.0,4.0,5.0
109106,57,5,52,573,0,57,341,28,52.0,2.0,50.0,557.0,1.0,51.0,209.0,72,57,15,49.0,45.0,4.0
1086,89,28,61,210,89,0,0,18,9.0,5.0,4.0,8.0,9.0,0.0,0.0,89,89,0,8.0,8.0,0.0
9511260,29,4,25,61,0,29,69,33,15.0,3.0,12.0,20.0,0.0,15.0,28.0,38,29,9,13.0,10.0,3.0
9701350,7,3,4,7,0,7,20,403,3.0,2.0,1.0,1.0,0.0,3.0,5.0,14,7,7,2.0,1.0,1.0
9712394,13,2,11,22,5,8,18,48,7.0,2.0,5.0,10.0,0.0,7.0,15.0,17,13,4,5.0,5.0,0.0
9810485,2,1,1,1,0,2,4,281,0.0,0.0,0.0,0.0,0.0,0.0,0.0,6,2,4,3.0,1.0,2.0
9910412,7,6,1,1,0,7,23,43,1.0,1.0,0.0,0.0,0.0,1.0,3.0,17,7,10,,,
9803459,29,11,18,36,5,24,77,7,4.0,3.0,1.0,2.0,0.0,4.0,26.0,45,29,16,14.0,9.0,5.0
9204204,59,7,52,321,59,0,0,26,37.0,3.0,34.0,257.0,37.0,0.0,0.0,59,59,0,22.0,22.0,0.0
9505336,18,5,13,33,10,8,14,26,12.0,2.0,10.0,25.0,12.0,0.0,0.0,22,18,4,5.0,5.0,0.0
9805254,54,6,48,189,1,53,200,26,43.0,5.0,38.0,160.0,0.0,43.0,174.0,63,54,9,32.0,27.0,5.0
9912343,42,10,32,81,1,41,222,2,5.0,2.0,3.0,5.0,0.0,5.0,25.0,67,42,25,10.0,6.0,4.0
2082,21,2,19,48,1,20,40,30,8.0,3.0,5.0,14.0,0.0,8.0,15.0,27,21,6,10.0,9.0,1.0
9503442,30,6,24,98,23,7,15,109,16.0,1.0,15.0,76.0,16.0,0.0,0.0,36,30,6,16.0,16.0,0.0
9508263,13,6,7,8,0,13,24,69,4.0,4.0,0.0,0.0,0.0,4.0,7.0,19,13,6,5.0,3.0,2.0
9906465,14,5,9,17,2,12,24,121,9.0,2.0,7.0,14.0,1.0,8.0,16.0,46,14,32,8.0,6.0,2.0
3091,18,6,12,27,2,16,87,32,6.0,4.0,2.0,2.0,2.0,4.0,17.0,32,18,14,10.0,6.0,4.0
110390,2,2,0,0,0,2,7,86,0.0,0.0,0.0,0.0,0.0,0.0,0.0,16,2,14,2.0,0.0,2.0
9803297,84,1,83,762,66,18,31,32,58.0,1.0,57.0,549.0,42.0,16.0,16.0,90,84,6,44.0,43.0,1.0
9507343,31,9,22,49,15,16,17,104,7.0,1.0,6.0,12.0,2.0,5.0,5.0,33,31,2,7.0,6.0,1.0
9308318,11,8,3,4,3,8,17,63,2.0,2.0,0.0,0.0,0.0,2.0,6.0,19,11,8,1.0,1.0,0.0
9309211,30,8,22,57,17,13,16,13,5.0,2.0,3.0,5.0,3.0,2.0,2.0,33,30,3,5.0,4.0,1.0
9502298,273,45,228,1386,238,35,44,23,61.0,4.0,57.0,424.0,44.0,17.0,22.0,279,273,6,33.0,32.0,1.0
9607259,64,12,52,236,5,59,233,23,37.0,8.0,29.0,93.0,2.0,35.0,153.0,71,64,7,29.0,22.0,7.0
9312223,16,3,13,37,7,9,14,25,10.0,2.0,8.0,22.0,1.0,9.0,14.0,18,16,2,1.0,1.0,0.0
9510241,3,2,1,1,3,0,0,346,0.0,0.0,0.0,0.0,0.0,0.0,0.0,5,3,2,1.0,0.0,1.0
9310297,60,7,53,260,53,7,8,73,19.0,1.0,18.0,59.0,19.0,0.0,0.0,62,60,2,14.0,14.0,0.0
9412367,74,11,63,279,6,68,110,3,35.0,3.0,32.0,112.0,0.0,35.0,61.0,81,74,7,22.0,20.0,2.0
9412208,78,4,74,394,22,56,99,12,42.0,2.0,40.0,179.0,7.0,35.0,61.0,83,78,5,22.0,19.0,3.0
9509389,140,11,129,845,90,50,69,3,64.0,1.0,63.0,445.0,64.0,0.0,0.0,146,140,6,29.0,29.0,0.0
9807216,399,50,349,2412,237,162,333,0,84.0,5.0,79.0,639.0,71.0,13.0,13.0,423,399,24,37.0,37.0,0.0
9904279,132,8,124,880,9,123,1134,3,80.0,4.0,76.0,596.0,0.0,80.0,892.0,201,132,69,55.0,19.0,36.0
9604364,71,7,64,410,9,62,312,0,51.0,2.0,49.0,317.0,2.0,49.0,233.0,94,71,23,33.0,28.0,5.0
9504405,54,7,47,240,49,5,5,0,27.0,3.0,24.0,134.0,27.0,0.0,0.0,55,54,1,17.0,17.0,0.0
9511446,63,9,54,240,41,22,40,3,22.0,3.0,19.0,67.0,22.0,0.0,0.0,86,63,23,10.0,10.0,0.0
9901243,49,6,43,141,5,44,306,3,28.0,4.0,24.0,61.0,0.0,28.0,212.0,79,49,30,16.0,12.0,4.0
9909518,6,5,1,1,2,4,6,107,4.0,3.0,1.0,1.0,4.0,0.0,0.0,10,6,4,2.0,2.0,0.0
9405239,26,4,22,93,9,17,31,119,21.0,4.0,17.0,71.0,6.0,15.0,26.0,29,26,3,22.0,20.0,2.0
9411341,35,13,22,54,29,6,7,0,11.0,5.0,6.0,10.0,11.0,0.0,0.0,37,35,2,3.0,3.0,0.0
9807327,91,4,87,717,6,85,325,12,56.0,2.0,54.0,504.0,1.0,55.0,202.0,108,91,17,30.0,27.0,3.0
9804367,18,4,14,30,1,17,34,0,4.0,2.0,2.0,2.0,4.0,0.0,0.0,24,18,6,3.0,3.0,0.0
9505334,39,7,32,98,38,1,1,0,19.0,4.0,15.0,39.0,19.0,0.0,0.0,40,39,1,4.0,4.0,0.0
9609343,28,2,26,112,3,25,41,0,21.0,1.0,20.0,98.0,2.0,19.0,33.0,37,28,9,20.0,16.0,4.0
9710565,57,9,48,254,27,30,51,0,16.0,3.0,13.0,44.0,16.0,0.0,0.0,65,57,8,11.0,10.0,1.0
9803261,17,3,14,27,1,16,51,50,7.0,3.0,4.0,11.0,7.0,0.0,0.0,25,17,8,9.0,8.0,1.0
9910335,14,5,9,14,13,1,1,0,1.0,1.0,0.0,0.0,1.0,0.0,0.0,19,14,5,1.0,1.0,0.0
9901203,6,3,3,8,0,6,13,81,6.0,3.0,3.0,8.0,0.0,6.0,11.0,16,6,10,7.0,6.0,1.0
9809537,6,2,4,6,6,0,0,81,0.0,0.0,0.0,0.0,0.0,0.0,0.0,8,6,2,2.0,0.0,2.0
9605448,11,4,7,10,3,8,8,51,4.0,2.0,2.0,3.0,4.0,0.0,0.0,12,11,1,4.0,4.0,0.0
9811381,4,1,3,5,4,0,0,3,0.0,0.0,0.0,0.0,0.0,0.0,0.0,10,4,6,3.0,0.0,3.0
9408271,8,3,5,12,1,7,12,46,0.0,0.0,0.0,0.0,0.0,0.0,0.0,11,8,3,7.0,5.0,2.0
9612439,9,3,6,7,0,9,53,63,4.0,2.0,2.0,3.0,0.0,4.0,15.0,22,9,13,12.0,4.0,8.0
9401234,4,3,1,1,1,3,5,15,1.0,1.0,0.0,0.0,1.0,0.0,0.0,10,4,6,1.0,1.0,0.0
9805390,21,8,13,28,1,20,42,71,11.0,3.0,8.0,20.0,1.0,10.0,18.0,27,21,6,13.0,11.0,2.0
9807432,4,1,3,3,1,3,3,336,3.0,1.0,2.0,2.0,1.0,2.0,2.0,5,4,1,4.0,3.0,1.0
4075,6,2,4,6,1,5,38,0,2.0,1.0,1.0,1.0,0.0,2.0,10.0,20,6,14,12.0,3.0,9.0
9706280,2,1,1,1,0,2,3,10,2.0,1.0,1.0,1.0,0.0,2.0,2.0,11,2,9,3.0,2.0,1.0
9510246,23,9,14,23,4,19,98,10,5.0,4.0,1.0,1.0,0.0,5.0,39.0,45,23,22,9.0,2.0,7.0
9802292,8,6,2,2,2,6,36,12,3.0,2.0,1.0,1.0,0.0,3.0,22.0,37,8,29,3.0,0.0,3.0
9511466,18,2,16,47,3,15,40,12,9.0,2.0,7.0,15.0,0.0,9.0,27.0,24,18,6,13.0,8.0,5.0
9708272,37,6,31,120,5,32,141,12,20.0,3.0,17.0,65.0,9.0,11.0,11.0,49,37,12,18.0,16.0,2.0
104238,24,4,20,50,0,24,278,1,6.0,2.0,4.0,7.0,0.0,6.0,54.0,71,24,47,28.0,9.0,19.0
9811471,55,3,52,268,1,54,249,58,14.0,3.0,11.0,23.0,0.0,14.0,61.0,75,55,20,15.0,9.0,6.0
104293,15,9,6,10,0,15,78,2,6.0,2.0,4.0,7.0,0.0,6.0,43.0,36,15,21,16.0,5.0,11.0
9708356,21,5,16,35,2,19,92,1,10.0,3.0,7.0,12.0,0.0,10.0,55.0,40,21,19,15.0,2.0,13.0
9407250,11,7,4,7,1,10,15,155,3.0,2.0,1.0,1.0,0.0,3.0,5.0,14,11,3,5.0,3.0,2.0
9812337,32,6,26,92,4,28,126,32,23.0,3.0,20.0,72.0,1.0,22.0,85.0,42,32,10,10.0,7.0,3.0
9804462,37,2,35,187,3,34,150,67,21.0,2.0,19.0,109.0,1.0,20.0,95.0,49,37,12,25.0,18.0,7.0
10111,3,2,1,1,1,2,23,34,2.0,1.0,1.0,1.0,0.0,2.0,23.0,24,3,21,1.0,0.0,1.0
9604452,97,6,91,710,2,95,322,5,64.0,2.0,62.0,514.0,0.0,64.0,211.0,105,97,8,44.0,40.0,4.0
9702291,28,5,23,71,5,23,258,5,16.0,4.0,12.0,49.0,0.0,16.0,198.0,62,28,34,30.0,14.0,16.0
9709306,15,5,10,22,0,15,143,5,12.0,4.0,8.0,18.0,0.0,12.0,126.0,32,15,17,14.0,6.0,8.0
3119,27,3,24,91,0,27,321,1,24.0,3.0,21.0,78.0,0.0,24.0,275.0,53,27,26,34.0,16.0,18.0
9412268,14,3,11,25,14,0,0,411,8.0,2.0,6.0,19.0,8.0,0.0,0.0,15,14,1,8.0,8.0,0.0
9806354,61,11,50,227,7,54,379,15,37.0,2.0,35.0,204.0,0.0,37.0,334.0,83,61,22,32.0,15.0,17.0
9328,10,6,4,6,1,9,50,1,8.0,4.0,4.0,6.0,0.0,8.0,47.0,25,10,15,11.0,6.0,5.0
108121,17,11,6,7,0,17,150,1,3.0,2.0,1.0,2.0,0.0,3.0,36.0,84,17,67,7.0,5.0,2.0
9905550,80,4,76,293,9,71,459,24,33.0,2.0,31.0,158.0,0.0,33.0,261.0,102,80,22,22.0,17.0,5.0
9707474,18,9,9,11,3,15,42,8,2.0,1.0,1.0,1.0,1.0,1.0,1.0,28,18,10,5.0,3.0,2.0
10175,41,18,23,38,2,39,238,29,7.0,1.0,6.0,9.0,0.0,7.0,49.0,169,41,128,22.0,5.0,17.0
9805241,43,14,29,70,6,37,97,6,12.0,7.0,5.0,8.0,1.0,11.0,17.0,53,43,10,7.0,4.0,3.0
9706438,49,4,45,154,2,47,265,5,29.0,2.0,27.0,98.0,1.0,28.0,110.0,80,49,31,30.0,20.0,10.0
9909560,22,8,14,63,0,22,137,1,11.0,2.0,9.0,37.0,0.0,11.0,75.0,40,22,18,6.0,2.0,4.0
9304248,12,5,7,14,12,0,0,141,8.0,1.0,7.0,14.0,8.0,0.0,0.0,12,12,0,3.0,3.0,0.0
9409375,121,10,111,917,47,74,114,4,61.0,3.0,58.0,641.0,14.0,47.0,70.0,124,121,3,45.0,43.0,2.0
9509413,25,3,22,47,9,16,16,21,17.0,2.0,15.0,33.0,5.0,12.0,12.0,26,25,1,3.0,3.0,0.0
9506289,62,3,59,284,45,17,24,7,31.0,3.0,28.0,132.0,20.0,11.0,11.0,67,62,5,14.0,14.0,0.0
9905463,15,4,11,19,0,15,114,7,7.0,2.0,5.0,7.0,0.0,7.0,36.0,36,15,21,10.0,4.0,6.0
9709460,9,3,6,7,9,0,0,296,2.0,1.0,1.0,1.0,2.0,0.0,0.0,10,9,1,1.0,0.0,1.0
9803314,34,7,27,90,5,29,233,7,19.0,4.0,15.0,62.0,1.0,18.0,160.0,69,34,35,27.0,8.0,19.0
9406288,43,13,30,72,5,38,82,15,18.0,3.0,15.0,40.0,3.0,15.0,44.0,49,43,6,7.0,7.0,0.0
9308315,24,4,20,110,1,23,47,15,22.0,3.0,19.0,103.0,1.0,21.0,36.0,28,24,4,6.0,5.0,1.0
9506359,50,11,39,123,9,41,205,69,19.0,3.0,16.0,59.0,0.0,19.0,110.0,71,50,21,17.0,13.0,4.0
9605425,3,3,0,0,2,1,2,98,0.0,0.0,0.0,0.0,0.0,0.0,0.0,11,3,8,2.0,0.0,2.0
9512236,1,1,0,0,1,0,0,1744,,,,,,,,1,1,0,,,
9610370,61,7,54,320,2,59,322,19,22.0,3.0,19.0,83.0,4.0,18.0,128.0,94,61,33,26.0,22.0,4.0
9611320,23,4,19,56,17,6,10,62,11.0,3.0,8.0,18.0,11.0,0.0,0.0,30,23,7,5.0,5.0,0.0
9511336,21,2,19,69,0,21,162,19,14.0,1.0,13.0,54.0,0.0,14.0,90.0,49,21,28,18.0,6.0,12.0
9408359,48,12,36,103,35,13,23,95,16.0,1.0,15.0,44.0,16.0,0.0,0.0,53,48,5,10.0,10.0,0.0
9610209,132,1,131,1197,131,1,2,24,83.0,1.0,82.0,935.0,83.0,0.0,0.0,134,132,2,39.0,39.0,0.0
9707426,21,3,18,60,0,21,103,11,14.0,2.0,12.0,38.0,0.0,14.0,71.0,35,21,14,20.0,12.0,8.0
9609365,23,10,13,46,5,18,38,11,10.0,2.0,8.0,23.0,1.0,9.0,24.0,31,23,8,12.0,9.0,3.0
9601336,36,13,23,45,13,23,25,106,11.0,2.0,9.0,23.0,11.0,0.0,0.0,39,36,3,10.0,10.0,0.0
2103,1,1,0,0,0,1,13,62,1.0,1.0,0.0,0.0,0.0,1.0,6.0,38,1,37,4.0,1.0,3.0
9505211,18,9,9,19,18,0,0,94,4.0,1.0,3.0,5.0,4.0,0.0,0.0,18,18,0,1.0,1.0,0.0
9711518,12,3,9,18,2,10,40,19,4.0,2.0,2.0,2.0,0.0,4.0,21.0,30,12,18,12.0,2.0,10.0
9409326,55,10,45,193,55,0,0,30,31.0,4.0,27.0,104.0,31.0,0.0,0.0,55,55,0,12.0,12.0,0.0
9904455,14,9,5,7,4,10,15,97,9.0,5.0,4.0,4.0,0.0,9.0,9.0,17,14,3,6.0,5.0,1.0
9311363,7,2,5,7,7,0,0,454,4.0,2.0,2.0,2.0,4.0,0.0,0.0,7,7,0,4.0,4.0,0.0
9612378,9,7,2,2,4,5,11,30,2.0,2.0,0.0,0.0,0.0,2.0,6.0,24,9,15,4.0,1.0,3.0
9209268,130,19,111,860,120,10,10,6,74.0,9.0,65.0,596.0,74.0,0.0,0.0,131,130,1,39.0,39.0,0.0
9205228,142,33,109,463,142,0,0,6,25.0,6.0,19.0,72.0,25.0,0.0,0.0,142,142,0,13.0,13.0,0.0
9708327,26,4,22,65,0,26,314,6,22.0,5.0,17.0,57.0,0.0,22.0,274.0,53,26,27,20.0,14.0,6.0
9208207,51,17,34,104,51,0,0,85,9.0,2.0,7.0,18.0,9.0,0.0,0.0,51,51,0,4.0,4.0,0.0
5278,3,1,2,3,0,3,13,6,0.0,0.0,0.0,0.0,0.0,0.0,0.0,12,3,9,1.0,0.0,1.0
9503445,48,16,32,79,8,40,136,10,4.0,2.0,2.0,3.0,0.0,4.0,14.0,70,48,22,6.0,4.0,2.0
9710364,22,5,17,52,1,21,68,19,15.0,4.0,11.0,24.0,0.0,15.0,45.0,30,22,8,9.0,6.0,3.0
9710302,39,7,32,103,1,38,176,8,20.0,1.0,19.0,56.0,2.0,18.0,22.0,58,39,19,17.0,13.0,4.0
6205,27,4,23,95,10,17,83,38,9.0,2.0,7.0,12.0,0.0,9.0,53.0,43,27,16,13.0,13.0,0.0
9701410,20,9,11,19,10,10,18,22,8.0,1.0,7.0,13.0,3.0,5.0,8.0,26,20,6,3.0,2.0,1.0
9608322,97,10,87,479,27,70,120,45,54.0,4.0,50.0,294.0,7.0,47.0,86.0,102,97,5,36.0,34.0,2.0
9308232,65,8,57,224,54,11,23,38,18.0,3.0,15.0,41.0,18.0,0.0,0.0,68,65,3,10.0,10.0,0.0
9502324,34,6,28,83,5,29,104,22,19.0,4.0,15.0,34.0,1.0,18.0,57.0,46,34,12,11.0,9.0,2.0
9409250,66,17,49,194,54,12,12,22,27.0,5.0,22.0,102.0,27.0,0.0,0.0,67,66,1,17.0,17.0,0.0
9906210,28,5,23,45,0,28,181,22,20.0,4.0,16.0,32.0,0.0,20.0,152.0,42,28,14,22.0,10.0,12.0
9503357,3,2,1,1,0,3,4,331,2.0,1.0,1.0,1.0,0.0,2.0,2.0,5,3,2,3.0,2.0,1.0
9902268,13,4,9,13,5,8,24,88,7.0,2.0,5.0,8.0,1.0,6.0,17.0,22,13,9,9.0,4.0,5.0
9910367,13,7,6,11,3,10,14,22,2.0,2.0,0.0,0.0,1.0,1.0,1.0,17,13,4,7.0,6.0,1.0
9606463,19,3,16,51,0,19,110,21,15.0,3.0,12.0,43.0,0.0,15.0,83.0,35,19,16,6.0,2.0,4.0
9807339,53,9,44,178,3,50,132,21,21.0,5.0,16.0,32.0,0.0,21.0,74.0,58,53,5,12.0,12.0,0.0
9411214,10,4,6,12,10,0,0,66,4.0,1.0,3.0,5.0,4.0,0.0,0.0,10,10,0,1.0,1.0,0.0
9802439,67,9,58,525,19,48,273,19,45.0,2.0,43.0,445.0,7.0,38.0,236.0,86,67,19,40.0,38.0,2.0
9903436,48,11,37,150,4,44,217,43,32.0,7.0,25.0,99.0,2.0,30.0,163.0,61,48,13,15.0,11.0,4.0
9911460,13,1,12,38,0,13,121,43,11.0,1.0,10.0,33.0,0.0,11.0,100.0,33,13,20,27.0,11.0,16.0
101051,28,5,23,64,2,26,114,66,18.0,3.0,15.0,41.0,0.0,18.0,79.0,41,28,13,23.0,16.0,7.0
9701364,16,5,11,34,2,14,32,39,9.0,3.0,6.0,21.0,1.0,8.0,12.0,19,16,3,4.0,4.0,0.0
11379,27,7,20,50,4,23,122,20,23.0,6.0,17.0,44.0,3.0,20.0,109.0,40,27,13,6.0,6.0,0.0
9906512,101,3,98,1073,1,100,635,20,91.0,2.0,89.0,1024.0,1.0,90.0,603.0,111,101,10,75.0,65.0,10.0
9306220,45,22,23,74,44,1,1,104,17.0,8.0,9.0,23.0,17.0,0.0,0.0,46,45,1,10.0,10.0,0.0
9403208,57,11,46,268,53,4,5,49,26.0,3.0,23.0,109.0,26.0,0.0,0.0,60,57,3,17.0,17.0,0.0
9510447,3,2,1,1,0,3,7,7,0.0,0.0,0.0,0.0,0.0,0.0,0.0,29,3,26,3.0,0.0,3.0
9803371,13,3,10,25,0,13,46,136,13.0,3.0,10.0,25.0,0.0,13.0,46.0,19,13,6,18.0,12.0,6.0
7034,11,5,6,14,0,11,90,20,11.0,5.0,6.0,14.0,0.0,11.0,90.0,22,11,11,1.0,1.0,0.0
9401320,10,6,4,6,10,0,0,65,5.0,2.0,3.0,4.0,5.0,0.0,0.0,10,10,0,2.0,2.0,0.0
107331,27,4,23,112,0,27,151,37,23.0,2.0,21.0,108.0,0.0,23.0,116.0,48,27,21,25.0,19.0,6.0
9904221,25,7,18,65,1,24,225,2,10.0,5.0,5.0,10.0,0.0,10.0,153.0,58,25,33,22.0,3.0,19.0
9212277,12,2,10,29,12,0,0,78,9.0,2.0,7.0,19.0,9.0,0.0,0.0,12,12,0,6.0,6.0,0.0
9504429,3,2,1,1,1,2,3,1775,2.0,1.0,1.0,1.0,1.0,1.0,2.0,6,3,3,2.0,1.0,1.0
9806430,23,5,18,51,3,20,76,5,9.0,1.0,8.0,18.0,1.0,8.0,17.0,39,23,16,14.0,10.0,4.0
9512229,17,10,7,11,0,17,109,75,1.0,1.0,0.0,0.0,0.0,1.0,10.0,70,17,53,13.0,1.0,12.0
9506459,20,7,13,36,7,13,40,5,8.0,2.0,6.0,14.0,1.0,7.0,26.0,29,20,9,12.0,7.0,5.0
9607292,45,8,37,128,45,0,0,18,17.0,1.0,16.0,59.0,17.0,0.0,0.0,48,45,3,7.0,7.0,0.0
9802271,9,4,5,12,1,8,65,99,6.0,2.0,4.0,8.0,0.0,6.0,46.0,22,9,13,14.0,6.0,8.0
9608441,41,7,34,106,3,38,113,5,9.0,2.0,7.0,16.0,0.0,9.0,9.0,53,41,12,13.0,11.0,2.0
9801212,26,5,21,72,1,25,116,73,24.0,4.0,20.0,71.0,0.0,24.0,109.0,35,26,9,24.0,18.0,6.0
9312308,17,6,11,17,8,9,9,190,6.0,3.0,3.0,6.0,3.0,3.0,3.0,19,17,2,7.0,6.0,1.0
9601362,68,4,64,423,21,47,50,5,49.0,2.0,47.0,353.0,10.0,39.0,39.0,70,68,2,30.0,29.0,1.0
9611409,46,16,30,66,13,33,116,5,10.0,3.0,7.0,12.0,3.0,7.0,13.0,81,46,35,3.0,3.0,0.0
2035,20,13,7,19,0,20,104,4,5.0,5.0,0.0,0.0,0.0,5.0,23.0,43,20,23,13.0,6.0,7.0
1080,17,7,10,16,2,15,65,11,1.0,1.0,0.0,0.0,0.0,1.0,3.0,41,17,24,10.0,5.0,5.0
9712426,6,3,3,5,0,6,16,48,0.0,0.0,0.0,0.0,0.0,0.0,0.0,18,6,12,7.0,0.0,7.0
1226,6,3,3,3,2,4,26,4,0.0,0.0,0.0,0.0,0.0,0.0,0.0,34,6,28,3.0,0.0,3.0
9611383,8,5,3,5,4,4,4,242,5.0,2.0,3.0,5.0,2.0,3.0,3.0,10,8,2,3.0,3.0,0.0
9906470,48,6,42,200,4,44,230,3,38.0,2.0,36.0,170.0,0.0,38.0,208.0,62,48,14,9.0,8.0,1.0
9709399,17,3,14,37,5,12,16,28,4.0,1.0,3.0,4.0,0.0,4.0,4.0,22,17,5,5.0,5.0,0.0
9708497,15,6,9,24,7,8,9,62,8.0,3.0,5.0,13.0,8.0,0.0,0.0,20,15,5,6.0,6.0,0.0
102085,13,9,4,5,10,3,9,121,1.0,1.0,0.0,0.0,1.0,0.0,0.0,20,13,7,4.0,2.0,2.0
9705414,29,7,22,61,0,29,406,36,25.0,4.0,21.0,58.0,0.0,25.0,376.0,62,29,33,43.0,16.0,27.0
9706507,43,18,25,48,16,27,37,110,20.0,4.0,16.0,30.0,20.0,0.0,0.0,47,43,4,11.0,10.0,1.0
9701222,28,8,20,63,22,6,12,227,15.0,2.0,13.0,43.0,15.0,0.0,0.0,32,28,4,13.0,13.0,0.0
9408352,33,6,27,83,11,22,40,17,21.0,3.0,18.0,64.0,3.0,18.0,29.0,37,33,4,8.0,5.0,3.0
6135,20,12,8,25,4,16,38,301,9.0,5.0,4.0,8.0,0.0,9.0,20.0,27,20,7,11.0,8.0,3.0
9907218,72,2,70,328,1,71,258,2,43.0,1.0,42.0,225.0,0.0,43.0,43.0,83,72,11,21.0,20.0,1.0
9505262,44,7,37,156,26,18,28,25,22.0,1.0,21.0,84.0,6.0,16.0,25.0,47,44,3,17.0,15.0,2.0
9603253,19,4,15,53,5,14,27,1,11.0,2.0,9.0,36.0,4.0,7.0,8.0,27,19,8,9.0,9.0,0.0
9508303,10,7,3,8,2,8,71,1,8.0,5.0,3.0,8.0,0.0,8.0,68.0,26,10,16,16.0,7.0,9.0
9403354,3,2,1,1,3,0,0,182,1.0,1.0,0.0,0.0,1.0,0.0,0.0,3,3,0,1.0,1.0,0.0
9601358,13,6,7,10,3,10,30,10,3.0,2.0,1.0,1.0,1.0,2.0,5.0,20,13,7,3.0,3.0,0.0
1101,70,4,66,301,8,62,399,0,14.0,3.0,11.0,44.0,0.0,14.0,169.0,125,70,55,40.0,8.0,32.0
9308233,3,2,1,1,1,2,3,10,0.0,0.0,0.0,0.0,0.0,0.0,0.0,11,3,8,1.0,1.0,0.0
10086,20,6,14,37,1,19,60,55,15.0,4.0,11.0,24.0,0.0,15.0,51.0,27,20,7,5.0,5.0,0.0
1303,5,2,3,5,1,4,21,116,0.0,0.0,0.0,0.0,0.0,0.0,0.0,29,5,24,8.0,0.0,8.0
9306277,11,8,3,4,6,5,5,29,3.0,1.0,2.0,3.0,3.0,0.0,0.0,17,11,6,1.0,1.0,0.0
206271,3,3,0,0,3,0,0,27,0.0,0.0,0.0,0.0,0.0,0.0,0.0,22,3,19,10.0,0.0,10.0
9707278,18,11,7,9,6,12,43,10,1.0,1.0,0.0,0.0,0.0,1.0,6.0,39,18,21,7.0,1.0,6.0
102315,69,4,65,434,1,68,605,23,39.0,2.0,37.0,269.0,0.0,39.0,311.0,115,69,46,40.0,30.0,10.0
9195,21,7,14,28,0,21,236,5,10.0,2.0,8.0,18.0,0.0,10.0,106.0,68,21,47,28.0,10.0,18.0
2283,8,7,1,1,3,5,11,13,1.0,1.0,0.0,0.0,1.0,0.0,0.0,19,8,11,3.0,1.0,2.0
9407209,10,6,4,5,5,5,19,10,2.0,1.0,1.0,1.0,0.0,2.0,12.0,20,10,10,9.0,2.0,7.0
3186,41,6,35,135,1,40,362,18,28.0,3.0,25.0,101.0,0.0,28.0,181.0,89,41,48,19.0,13.0,6.0
202076,18,5,13,32,0,18,257,18,16.0,4.0,12.0,28.0,0.0,16.0,216.0,55,18,37,32.0,15.0,17.0
7006,37,8,29,94,3,34,379,4,21.0,3.0,18.0,71.0,0.0,21.0,301.0,76,37,39,27.0,7.0,20.0
9807262,13,2,11,22,2,11,42,4,1.0,1.0,0.0,0.0,0.0,1.0,1.0,35,13,22,1.0,0.0,1.0
9307303,10,5,5,9,10,0,0,147,3.0,2.0,1.0,1.0,3.0,0.0,0.0,10,10,0,2.0,2.0,0.0
12168,3,2,1,1,3,0,0,119,0.0,0.0,0.0,0.0,0.0,0.0,0.0,9,3,6,,,
9908525,8,2,6,10,1,7,48,50,6.0,1.0,5.0,9.0,0.0,6.0,40.0,22,8,14,14.0,5.0,9.0
9306264,31,5,26,85,11,20,37,56,16.0,2.0,14.0,40.0,0.0,16.0,30.0,33,31,2,11.0,11.0,0.0
104269,9,3,6,9,0,9,40,118,8.0,2.0,6.0,9.0,0.0,8.0,35.0,32,9,23,14.0,5.0,9.0
10041,13,5,8,24,0,13,76,11,12.0,4.0,8.0,23.0,0.0,12.0,72.0,23,13,10,1.0,0.0,1.0
8184,14,5,9,28,0,14,59,19,4.0,2.0,2.0,2.0,0.0,4.0,13.0,30,14,16,10.0,7.0,3.0
9704239,24,5,19,61,7,17,31,43,8.0,1.0,7.0,16.0,7.0,1.0,3.0,31,24,7,10.0,8.0,2.0
9902234,14,2,12,29,0,14,33,43,5.0,2.0,3.0,3.0,0.0,5.0,12.0,17,14,3,10.0,7.0,3.0
9605270,14,3,11,18,5,9,18,39,3.0,2.0,1.0,1.0,0.0,3.0,3.0,21,14,7,1.0,1.0,0.0
9405394,44,4,40,214,18,26,38,94,34.0,2.0,32.0,186.0,9.0,25.0,37.0,46,44,2,29.0,27.0,2.0
9511347,9,4,5,14,0,9,20,162,7.0,3.0,4.0,11.0,2.0,5.0,10.0,17,9,8,7.0,5.0,2.0
9606219,12,4,8,19,1,11,40,7,5.0,2.0,3.0,6.0,0.0,5.0,19.0,19,12,7,9.0,5.0,4.0
9707329,5,5,0,0,5,0,0,199,1.0,1.0,0.0,0.0,1.0,0.0,0.0,11,5,6,3.0,0.0,3.0
9412327,67,20,47,133,58,9,9,16,21.0,3.0,18.0,71.0,21.0,0.0,0.0,68,67,1,14.0,14.0,0.0
9705446,6,3,3,3,1,5,10,17,2.0,1.0,1.0,1.0,2.0,0.0,0.0,23,6,17,6.0,0.0,6.0
7181,31,9,22,75,1,30,282,0,18.0,2.0,16.0,61.0,0.0,18.0,198.0,73,31,42,38.0,18.0,20.0
9501394,73,15,58,205,73,0,0,10,8.0,1.0,7.0,14.0,8.0,0.0,0.0,75,73,2,15.0,15.0,0.0
5049,24,5,19,35,3,21,176,11,9.0,1.0,8.0,15.0,0.0,9.0,83.0,58,24,34,15.0,6.0,9.0
104285,23,9,14,22,3,20,214,11,11.0,2.0,9.0,16.0,0.0,11.0,185.0,53,23,30,34.0,10.0,24.0
9908454,16,4,12,18,0,16,127,11,3.0,1.0,2.0,3.0,0.0,3.0,17.0,62,16,46,12.0,3.0,9.0
210157,6,5,1,1,0,6,110,19,5.0,4.0,1.0,1.0,0.0,5.0,93.0,64,6,58,43.0,3.0,40.0
201206,48,9,39,132,11,37,159,19,21.0,4.0,17.0,61.0,1.0,20.0,71.0,61,48,13,21.0,13.0,8.0
9412338,10,5,5,7,6,4,6,19,2.0,2.0,0.0,0.0,2.0,0.0,0.0,13,10,3,2.0,2.0,0.0
109066,23,8,15,31,0,23,95,4,9.0,6.0,3.0,4.0,0.0,9.0,31.0,38,23,15,12.0,8.0,4.0
9912501,11,2,9,21,4,7,14,25,6.0,1.0,5.0,11.0,0.0,6.0,13.0,14,11,3,7.0,7.0,0.0
108060,46,3,43,427,0,46,224,28,42.0,2.0,40.0,405.0,0.0,42.0,117.0,52,46,6,41.0,38.0,3.0
111052,13,1,12,40,0,13,69,28,11.0,1.0,10.0,36.0,0.0,11.0,32.0,21,13,8,13.0,10.0,3.0
112351,23,5,18,52,1,22,111,28,15.0,0.0,15.0,31.0,0.0,15.0,80.0,36,23,13,24.0,14.0,10.0
9507298,44,11,33,114,23,21,41,9,13.0,8.0,5.0,9.0,0.0,13.0,25.0,49,44,5,11.0,9.0,2.0
9207278,68,27,41,82,68,0,0,26,11.0,5.0,6.0,8.0,11.0,0.0,0.0,68,68,0,6.0,6.0,0.0
9301247,13,4,9,12,13,0,0,242,10.0,3.0,7.0,9.0,10.0,0.0,0.0,13,13,0,4.0,4.0,0.0
103072,21,3,18,68,1,20,139,23,16.0,3.0,13.0,60.0,0.0,16.0,117.0,47,21,26,14.0,7.0,7.0
9906400,16,5,11,44,0,16,327,2,14.0,4.0,10.0,43.0,0.0,14.0,316.0,47,16,31,39.0,12.0,27.0
6143,4,4,0,0,1,3,5,26,1.0,1.0,0.0,0.0,0.0,1.0,3.0,24,4,20,10.0,0.0,10.0
9506467,27,6,21,42,3,24,56,10,5.0,2.0,3.0,3.0,0.0,5.0,12.0,35,27,8,6.0,3.0,3.0
9710453,8,2,6,10,1,7,35,60,2.0,1.0,1.0,1.0,0.0,2.0,12.0,25,8,17,9.0,2.0,7.0
103264,3,2,1,1,3,0,0,1138,1.0,1.0,0.0,0.0,1.0,0.0,0.0,3,3,0,,,
9901443,17,6,11,27,0,17,220,2,13.0,4.0,9.0,20.0,0.0,13.0,194.0,48,17,31,21.0,7.0,14.0
9707407,13,5,8,12,0,13,66,119,10.0,4.0,6.0,9.0,0.0,10.0,54.0,25,13,12,17.0,7.0,10.0
9910494,5,4,1,1,3,2,8,0,0.0,0.0,0.0,0.0,0.0,0.0,0.0,26,5,21,4.0,0.0,4.0
9502211,15,4,11,42,2,13,33,164,2.0,2.0,0.0,0.0,0.0,2.0,9.0,25,15,10,12.0,3.0,9.0
9810382,9,2,7,9,1,8,22,107,3.0,1.0,2.0,2.0,1.0,2.0,3.0,23,9,14,6.0,3.0,3.0
9612380,11,8,3,3,0,11,41,86,4.0,3.0,1.0,1.0,0.0,4.0,15.0,31,11,20,7.0,3.0,4.0
5101,11,10,1,1,1,10,41,40,1.0,1.0,0.0,0.0,0.0,1.0,7.0,40,11,29,9.0,3.0,6.0
6312,22,4,18,36,9,13,41,12,6.0,2.0,4.0,8.0,3.0,3.0,5.0,51,22,29,9.0,7.0,2.0
9906274,35,8,27,110,4,31,376,1,23.0,4.0,19.0,94.0,0.0,23.0,310.0,60,35,25,42.0,21.0,21.0
10107,3,2,1,1,0,3,25,34,1.0,1.0,0.0,0.0,0.0,1.0,13.0,28,3,25,7.0,0.0,7.0
9612307,5,1,4,7,1,4,121,7,2.0,1.0,1.0,1.0,0.0,2.0,20.0,59,5,54,1.0,0.0,1.0
9911454,21,12,9,14,8,13,88,67,3.0,3.0,0.0,0.0,0.0,3.0,23.0,60,21,39,19.0,2.0,17.0
9402299,17,7,10,18,3,14,104,75,7.0,1.0,6.0,11.0,0.0,7.0,44.0,61,17,44,13.0,3.0,10.0
9603340,24,6,18,56,1,23,68,7,19.0,3.0,16.0,47.0,0.0,19.0,52.0,33,24,9,19.0,15.0,4.0
9702311,2,2,0,0,0,2,2,79,1.0,1.0,0.0,0.0,0.0,1.0,1.0,3,2,1,2.0,1.0,1.0
9411372,57,11,46,188,41,16,31,17,31.0,4.0,27.0,130.0,19.0,12.0,23.0,59,57,2,4.0,4.0,0.0
9206254,10,6,4,8,10,0,0,407,4.0,4.0,0.0,0.0,4.0,0.0,0.0,10,10,0,2.0,2.0,0.0
9302306,3,3,0,0,3,0,0,1691,,,,,,,,4,3,1,,,
9307315,10,3,7,24,3,7,7,17,2.0,1.0,1.0,1.0,2.0,0.0,0.0,11,10,1,,,
9403220,1,1,0,0,1,0,0,1326,,,,,,,,1,1,0,,,
9903471,9,5,4,4,0,9,42,12,2.0,2.0,0.0,0.0,0.0,2.0,11.0,27,9,18,10.0,3.0,7.0
9604352,17,3,14,50,2,15,23,245,10.0,2.0,8.0,20.0,10.0,0.0,0.0,19,17,2,14.0,13.0,1.0
9612326,34,6,28,107,34,0,0,8,11.0,2.0,9.0,45.0,11.0,0.0,0.0,34,34,0,11.0,11.0,0.0
9704351,19,8,11,25,1,18,103,8,11.0,3.0,8.0,17.0,1.0,10.0,39.0,59,19,40,11.0,7.0,4.0
9412295,18,4,14,31,6,12,15,67,5.0,4.0,1.0,1.0,5.0,0.0,0.0,24,18,6,3.0,1.0,2.0
9812407,3,3,0,0,2,1,1,92,0.0,0.0,0.0,0.0,0.0,0.0,0.0,11,3,8,4.0,0.0,4.0
6223,10,6,4,5,1,9,68,4,3.0,2.0,1.0,1.0,0.0,3.0,5.0,53,10,43,3.0,3.0,0.0
9801269,34,20,14,24,2,32,217,6,1.0,1.0,0.0,0.0,0.0,1.0,7.0,135,34,101,21.0,2.0,19.0
9906224,70,16,54,157,2,68,576,12,19.0,4.0,15.0,39.0,0.0,19.0,186.0,146,70,76,32.0,12.0,20.0
9212212,78,15,63,240,63,15,15,47,18.0,2.0,16.0,59.0,18.0,0.0,0.0,79,78,1,9.0,9.0,0.0
9803500,18,3,15,62,13,5,7,28,14.0,2.0,12.0,46.0,14.0,0.0,0.0,21,18,3,7.0,6.0,1.0
8089,1,1,0,0,1,0,0,54,0.0,0.0,0.0,0.0,0.0,0.0,0.0,25,1,24,7.0,0.0,7.0
9410239,2,2,0,0,2,0,0,668,1.0,1.0,0.0,0.0,1.0,0.0,0.0,2,2,0,1.0,1.0,0.0
9511299,1,1,0,0,1,0,0,1179,,,,,,,,2,1,1,,,
9909489,22,3,19,54,0,22,173,9,18.0,2.0,16.0,45.0,0.0,18.0,139.0,47,22,25,24.0,10.0,14.0
9406329,19,9,10,18,19,0,0,24,3.0,1.0,2.0,3.0,3.0,0.0,0.0,20,19,1,3.0,3.0,0.0
9611232,12,2,10,13,2,10,23,92,4.0,1.0,3.0,3.0,0.0,4.0,11.0,17,12,5,4.0,1.0,3.0
9708248,11,6,5,9,11,0,0,64,4.0,2.0,2.0,3.0,4.0,0.0,0.0,11,11,0,5.0,5.0,0.0
9607258,1,1,0,0,1,0,0,236,,,,,,,,2,1,1,1.0,1.0,0.0
9807397,4,2,2,2,0,4,4,9,3.0,1.0,2.0,2.0,0.0,3.0,3.0,5,4,1,2.0,2.0,0.0
9405250,35,9,26,73,29,6,6,14,8.0,8.0,0.0,0.0,8.0,0.0,0.0,36,35,1,8.0,8.0,0.0
9603302,15,5,10,18,2,13,34,14,6.0,3.0,3.0,3.0,2.0,4.0,8.0,22,15,7,3.0,1.0,2.0
9608399,5,2,3,5,0,5,22,14,4.0,1.0,3.0,5.0,0.0,4.0,21.0,13,5,8,1.0,0.0,1.0
1021,13,6,7,9,0,13,44,27,7.0,5.0,2.0,2.0,0.0,7.0,31.0,23,13,10,8.0,7.0,1.0
9711387,54,8,46,226,10,44,178,68,29.0,4.0,25.0,149.0,1.0,28.0,108.0,76,54,22,29.0,22.0,7.0
9307329,73,12,61,205,68,5,5,27,30.0,2.0,28.0,89.0,27.0,3.0,3.0,74,73,1,7.0,7.0,0.0
9409426,18,6,12,56,18,0,0,13,13.0,2.0,11.0,53.0,13.0,0.0,0.0,18,18,0,12.0,12.0,0.0
9404306,36,13,23,63,22,14,14,134,15.0,3.0,12.0,38.0,3.0,12.0,12.0,37,36,1,13.0,12.0,1.0
9609361,4,2,2,3,1,3,14,77,3.0,1.0,2.0,3.0,0.0,3.0,12.0,16,4,12,4.0,0.0,4.0
111002,6,2,4,5,3,3,5,45,0.0,0.0,0.0,0.0,0.0,0.0,0.0,22,6,16,7.0,0.0,7.0
9606220,5,4,1,1,1,4,8,17,2.0,1.0,1.0,1.0,1.0,1.0,2.0,9,5,4,5.0,2.0,3.0
9510457,13,5,8,10,1,12,62,17,8.0,2.0,6.0,7.0,0.0,8.0,44.0,23,13,10,4.0,4.0,0.0
9509249,28,5,23,78,28,0,0,97,22.0,1.0,21.0,70.0,22.0,0.0,0.0,28,28,0,15.0,15.0,0.0
9608201,5,2,3,3,0,5,19,150,4.0,2.0,2.0,2.0,0.0,4.0,15.0,12,5,7,7.0,2.0,5.0
9608425,2,2,0,0,0,2,3,192,0.0,0.0,0.0,0.0,0.0,0.0,0.0,6,2,4,1.0,0.0,1.0
9707289,3,3,0,0,0,3,9,39,1.0,1.0,0.0,0.0,1.0,0.0,0.0,9,3,6,1.0,1.0,0.0
9809568,1,1,0,0,0,1,5,13,1.0,1.0,0.0,0.0,0.0,1.0,5.0,9,1,8,7.0,1.0,6.0
9904312,3,3,0,0,1,2,2,159,2.0,2.0,0.0,0.0,0.0,2.0,2.0,4,3,1,2.0,1.0,1.0
9709246,5,2,3,5,0,5,7,97,2.0,2.0,0.0,0.0,0.0,2.0,4.0,8,5,3,3.0,3.0,0.0
9704298,67,15,52,237,6,61,339,8,42.0,5.0,37.0,178.0,0.0,42.0,267.0,83,67,16,38.0,28.0,10.0
9212299,8,3,5,7,6,2,2,15,1.0,1.0,0.0,0.0,1.0,0.0,0.0,9,8,1,4.0,4.0,0.0
9407241,6,2,4,5,6,0,0,22,,,,,,,,6,6,0,1.0,1.0,0.0
9610335,8,4,4,5,0,8,46,15,3.0,3.0,0.0,0.0,0.0,3.0,14.0,31,8,23,3.0,1.0,2.0
9504230,45,14,31,100,13,32,41,47,10.0,2.0,8.0,23.0,5.0,5.0,5.0,48,45,3,9.0,9.0,0.0
9404311,19,8,11,19,13,6,6,60,6.0,4.0,2.0,5.0,2.0,4.0,4.0,20,19,1,3.0,3.0,0.0
110189,0,0,0,0,0,0,0,0,0.0,0.0,0.0,0.0,0.0,0.0,0.0,128,0,128,13.0,0.0,13.0
11263,15,5,10,14,0,15,133,3,8.0,3.0,5.0,5.0,0.0,8.0,80.0,65,15,50,15.0,10.0,5.0
5173,16,9,7,17,4,12,19,0,4.0,4.0,0.0,0.0,1.0,3.0,5.0,27,16,11,10.0,9.0,1.0
9603335,16,7,9,15,2,14,50,119,12.0,5.0,7.0,12.0,0.0,12.0,48.0,25,16,9,18.0,11.0,7.0
9303235,5,4,1,1,5,0,0,441,4.0,4.0,0.0,0.0,4.0,0.0,0.0,5,5,0,4.0,4.0,0.0
9707327,37,4,33,153,3,34,59,52,28.0,1.0,27.0,131.0,2.0,26.0,37.0,43,37,6,25.0,23.0,2.0
9612428,15,4,11,24,5,10,22,15,5.0,2.0,3.0,6.0,5.0,0.0,0.0,21,15,6,4.0,2.0,2.0
9809529,4,3,1,1,0,4,47,15,2.0,2.0,0.0,0.0,0.0,2.0,37.0,44,4,40,32.0,2.0,30.0
9909561,12,5,7,8,2,10,31,1,4.0,3.0,1.0,1.0,1.0,3.0,3.0,25,12,13,8.0,6.0,2.0
9606486,28,4,24,83,28,0,0,146,20.0,2.0,18.0,77.0,20.0,0.0,0.0,28,28,0,17.0,17.0,0.0
9806470,2,2,0,0,0,2,2,313,1.0,1.0,0.0,0.0,0.0,1.0,1.0,3,2,1,2.0,1.0,1.0
9805417,6,2,4,8,0,6,14,10,3.0,1.0,2.0,3.0,0.0,3.0,3.0,22,6,16,5.0,4.0,1.0
9412205,3,2,1,2,0,3,4,145,3.0,2.0,1.0,2.0,2.0,1.0,1.0,5,3,2,2.0,1.0,1.0
9803382,14,5,9,23,0,14,246,8,12.0,4.0,8.0,21.0,0.0,12.0,218.0,48,14,34,24.0,8.0,16.0
9909251,6,1,5,9,0,6,13,10,0.0,0.0,0.0,0.0,0.0,0.0,0.0,11,6,5,6.0,2.0,4.0
110121,34,4,30,116,0,34,253,7,18.0,2.0,16.0,51.0,0.0,18.0,83.0,57,34,23,28.0,21.0,7.0
9132,3,3,0,0,0,3,24,15,2.0,2.0,0.0,0.0,0.0,2.0,13.0,48,3,45,20.0,1.0,19.0
9709401,9,3,6,10,1,8,28,22,9.0,3.0,6.0,10.0,1.0,8.0,22.0,16,9,7,6.0,3.0,3.0
9506215,1,1,0,0,0,1,2,123,1.0,1.0,0.0,0.0,0.0,1.0,1.0,6,1,5,1.0,0.0,1.0
9705452,28,4,24,68,2,26,61,22,14.0,2.0,12.0,29.0,0.0,14.0,32.0,34,28,6,12.0,8.0,4.0
9703341,6,2,4,9,0,6,100,49,5.0,1.0,4.0,8.0,0.0,5.0,65.0,34,6,28,20.0,5.0,15.0
110014,4,3,1,2,0,4,31,14,4.0,3.0,1.0,2.0,0.0,4.0,24.0,18,4,14,10.0,2.0,8.0
11083,10,8,2,2,1,9,119,44,2.0,2.0,0.0,0.0,0.0,2.0,21.0,100,10,90,12.0,0.0,12.0
9401228,31,8,23,92,0,31,126,56,28.0,7.0,21.0,83.0,0.0,28.0,118.0,42,31,11,22.0,17.0,5.0
9906277,32,5,27,79,8,24,50,30,14.0,3.0,11.0,30.0,2.0,12.0,29.0,38,32,6,14.0,10.0,4.0
9909567,11,5,6,14,0,11,253,2,9.0,3.0,6.0,14.0,0.0,9.0,247.0,72,11,61,49.0,9.0,40.0
9810266,23,5,18,64,0,23,185,60,10.0,1.0,9.0,25.0,0.0,10.0,101.0,54,23,31,26.0,8.0,18.0
9910408,18,2,16,40,0,18,114,32,9.0,1.0,8.0,19.0,0.0,9.0,66.0,37,18,19,18.0,8.0,10.0
107182,19,8,11,27,0,19,100,23,4.0,3.0,1.0,2.0,0.0,4.0,22.0,40,19,21,7.0,3.0,4.0
7101,24,12,12,20,1,23,70,83,8.0,3.0,5.0,10.0,0.0,8.0,26.0,51,24,27,10.0,5.0,5.0
9409304,8,6,2,2,3,5,10,26,1.0,1.0,0.0,0.0,0.0,1.0,1.0,17,8,9,3.0,1.0,2.0
9708303,20,2,18,55,6,14,63,131,16.0,2.0,14.0,50.0,7.0,9.0,17.0,30,20,10,12.0,10.0,2.0
9603422,14,7,7,8,1,13,34,27,3.0,3.0,0.0,0.0,3.0,0.0,0.0,37,14,23,4.0,3.0,1.0
2267,53,18,35,101,33,20,22,64,17.0,5.0,12.0,26.0,8.0,9.0,10.0,56,53,3,11.0,11.0,0.0
9902251,23,9,14,21,1,22,118,10,2.0,2.0,0.0,0.0,0.0,2.0,7.0,72,23,49,8.0,4.0,4.0
112135,13,6,7,15,0,13,96,1,5.0,4.0,1.0,1.0,0.0,5.0,29.0,38,13,25,12.0,2.0,10.0
9903549,32,5,27,63,12,20,28,12,7.0,1.0,6.0,9.0,7.0,0.0,0.0,37,32,5,6.0,6.0,0.0
9804339,14,4,10,27,1,13,75,12,7.0,1.0,6.0,11.0,0.0,7.0,26.0,30,14,16,14.0,8.0,6.0
202200,7,6,1,1,2,5,14,67,0.0,0.0,0.0,0.0,0.0,0.0,0.0,91,7,84,18.0,0.0,18.0
9807542,1,1,0,0,1,0,0,218,1.0,1.0,0.0,0.0,1.0,0.0,0.0,4,1,3,2.0,0.0,2.0
12002,11,2,9,21,3,8,44,25,4.0,1.0,3.0,5.0,0.0,4.0,19.0,27,11,16,8.0,3.0,5.0
9311264,28,12,16,27,28,0,0,13,7.0,5.0,2.0,4.0,7.0,0.0,0.0,28,28,0,5.0,5.0,0.0
108013,3,2,1,1,0,3,20,373,0.0,0.0,0.0,0.0,0.0,0.0,0.0,18,3,15,4.0,1.0,3.0
9507406,3,3,0,0,2,1,2,25,0.0,0.0,0.0,0.0,0.0,0.0,0.0,12,3,9,1.0,1.0,0.0
9309235,27,9,18,35,14,13,19,40,13.0,5.0,8.0,20.0,4.0,9.0,15.0,33,27,6,3.0,3.0,0.0
9708201,5,3,2,3,2,3,10,10,0.0,0.0,0.0,0.0,0.0,0.0,0.0,51,5,46,13.0,0.0,13.0
9803427,2,2,0,0,1,1,2,204,0.0,0.0,0.0,0.0,0.0,0.0,0.0,7,2,5,2.0,0.0,2.0
9607273,4,2,2,3,1,3,19,5,3.0,1.0,2.0,3.0,0.0,3.0,19.0,12,4,8,1.0,0.0,1.0
10238,3,2,1,1,0,3,7,299,0.0,0.0,0.0,0.0,0.0,0.0,0.0,10,3,7,1.0,0.0,1.0
9510267,12,3,9,20,12,0,0,7,10.0,3.0,7.0,18.0,10.0,0.0,0.0,13,12,1,3.0,3.0,0.0
6152,4,1,3,3,1,3,4,80,1.0,1.0,0.0,0.0,0.0,1.0,1.0,7,4,3,2.0,1.0,1.0
108177,94,21,73,261,4,90,456,0,33.0,7.0,26.0,86.0,0.0,33.0,227.0,136,94,42,23.0,16.0,7.0
9603209,17,8,9,15,5,12,17,43,7.0,2.0,5.0,7.0,0.0,7.0,10.0,21,17,4,1.0,1.0,0.0
9608438,16,2,14,46,1,15,45,44,15.0,1.0,14.0,46.0,0.0,15.0,45.0,23,16,7,9.0,6.0,3.0
12073,16,7,9,15,0,16,125,26,13.0,4.0,9.0,15.0,0.0,13.0,110.0,36,16,20,20.0,10.0,10.0
112085,6,5,1,1,0,6,16,9,3.0,2.0,1.0,1.0,0.0,3.0,6.0,19,6,13,7.0,4.0,3.0
9506292,11,7,4,6,7,4,4,24,2.0,2.0,0.0,0.0,0.0,2.0,2.0,13,11,2,3.0,3.0,0.0
108220,15,11,4,5,1,14,69,9,6.0,4.0,2.0,3.0,0.0,6.0,22.0,50,15,35,11.0,3.0,8.0
9807461,12,7,5,12,0,12,83,85,7.0,4.0,3.0,5.0,0.0,7.0,55.0,30,12,18,11.0,4.0,7.0
9412382,21,3,18,46,18,3,4,92,11.0,2.0,9.0,22.0,11.0,0.0,0.0,27,21,6,8.0,8.0,0.0
9310279,21,3,18,69,21,0,0,43,16.0,1.0,15.0,64.0,16.0,0.0,0.0,22,21,1,5.0,5.0,0.0
9911447,7,6,1,1,2,5,25,42,1.0,1.0,0.0,0.0,0.0,1.0,7.0,24,7,17,10.0,1.0,9.0
9510305,3,2,1,1,0,3,7,38,0.0,0.0,0.0,0.0,0.0,0.0,0.0,24,3,21,4.0,1.0,3.0
10230,6,2,4,8,1,5,35,45,2.0,1.0,1.0,1.0,1.0,1.0,2.0,29,6,23,4.0,2.0,2.0
9703430,3,3,0,0,3,0,0,319,0.0,0.0,0.0,0.0,0.0,0.0,0.0,11,3,8,3.0,0.0,3.0
5134,13,3,10,26,0,13,92,0,13.0,3.0,10.0,26.0,0.0,13.0,90.0,26,13,13,21.0,11.0,10.0
9802296,2,2,0,0,1,1,3,48,1.0,1.0,0.0,0.0,0.0,1.0,3.0,34,2,32,6.0,0.0,6.0
9503390,22,9,13,31,18,4,5,1,5.0,2.0,3.0,7.0,5.0,0.0,0.0,25,22,3,6.0,6.0,0.0
9608462,4,2,2,4,3,1,1,126,2.0,1.0,1.0,1.0,2.0,0.0,0.0,6,4,2,2.0,1.0,1.0
9504420,7,5,2,2,1,6,13,42,4.0,2.0,2.0,2.0,0.0,4.0,7.0,14,7,7,3.0,2.0,1.0
9903284,7,3,4,7,0,7,15,169,5.0,1.0,4.0,7.0,0.0,5.0,9.0,18,7,11,9.0,5.0,4.0
9911435,8,5,3,3,0,8,48,32,2.0,2.0,0.0,0.0,0.0,2.0,5.0,45,8,37,2.0,0.0,2.0
201002,4,3,1,1,0,4,17,63,2.0,2.0,0.0,0.0,0.0,2.0,7.0,36,4,32,10.0,0.0,10.0
202048,8,2,6,8,1,7,124,0,5.0,1.0,4.0,6.0,0.0,5.0,59.0,60,8,52,23.0,5.0,18.0
207157,26,7,19,28,1,25,154,0,2.0,2.0,0.0,0.0,0.0,2.0,18.0,73,26,47,20.0,0.0,20.0
9610502,0,0,0,0,0,0,0,140,0.0,0.0,0.0,0.0,0.0,0.0,0.0,3,0,3,2.0,0.0,2.0
9606267,24,11,13,35,10,14,31,27,10.0,3.0,7.0,13.0,5.0,5.0,5.0,32,24,8,2.0,2.0,0.0
9404236,15,6,9,23,9,6,6,13,7.0,2.0,5.0,14.0,3.0,4.0,4.0,16,15,1,4.0,4.0,0.0
9809538,5,2,3,4,0,5,27,8,4.0,2.0,2.0,2.0,0.0,4.0,12.0,14,5,9,7.0,4.0,3.0
7193,8,4,4,5,4,4,5,81,4.0,1.0,3.0,4.0,1.0,3.0,3.0,16,8,8,4.0,3.0,1.0
9308204,10,6,4,5,6,4,4,58,5.0,2.0,3.0,4.0,2.0,3.0,3.0,11,10,1,2.0,2.0,0.0
9402275,10,4,6,9,3,7,9,75,2.0,2.0,0.0,0.0,2.0,0.0,0.0,13,10,3,6.0,5.0,1.0
9807364,9,4,5,5,0,9,31,74,3.0,2.0,1.0,1.0,0.0,3.0,7.0,21,9,12,7.0,4.0,3.0
9608488,8,3,5,5,1,7,7,141,4.0,1.0,3.0,3.0,4.0,0.0,0.0,9,8,1,2.0,2.0,0.0
9304264,10,3,7,14,9,1,1,13,3.0,1.0,2.0,2.0,3.0,0.0,0.0,12,10,2,4.0,3.0,1.0
9508407,9,2,7,11,0,9,27,13,3.0,1.0,2.0,2.0,0.0,3.0,8.0,16,9,7,6.0,3.0,3.0
9511338,5,2,3,3,2,3,8,95,1.0,1.0,0.0,0.0,1.0,0.0,0.0,11,5,6,1.0,1.0,0.0
9806394,13,2,11,27,2,11,25,16,6.0,2.0,4.0,7.0,5.0,1.0,2.0,18,13,5,5.0,5.0,0.0
101033,3,3,0,0,2,1,1,1,0.0,0.0,0.0,0.0,0.0,0.0,0.0,66,3,63,27.0,0.0,27.0
4110,15,4,11,36,0,15,64,12,10.0,1.0,9.0,25.0,0.0,10.0,29.0,27,15,12,16.0,11.0,5.0
9906411,10,1,9,29,7,3,3,15,2.0,1.0,1.0,1.0,2.0,0.0,0.0,11,10,1,5.0,5.0,0.0
9612320,8,3,5,9,0,8,27,4,6.0,2.0,4.0,8.0,1.0,5.0,17.0,16,8,8,9.0,5.0,4.0
9905428,8,7,1,1,7,1,1,25,1.0,1.0,0.0,0.0,1.0,0.0,0.0,20,8,12,1.0,0.0,1.0
203069,25,5,20,63,0,25,147,7,12.0,3.0,9.0,23.0,1.0,11.0,38.0,49,25,24,18.0,12.0,6.0
9908281,1,1,0,0,0,1,4,27,0.0,0.0,0.0,0.0,0.0,0.0,0.0,23,1,22,7.0,0.0,7.0
9408305,23,5,18,48,23,0,0,27,17.0,1.0,16.0,45.0,17.0,0.0,0.0,25,23,2,9.0,9.0,0.0
105207,9,4,5,6,1,8,27,66,5.0,2.0,3.0,3.0,0.0,5.0,18.0,16,9,7,9.0,5.0,4.0
107083,10,6,4,6,0,10,75,3,4.0,2.0,2.0,3.0,0.0,4.0,24.0,57,10,47,12.0,0.0,12.0
207266,4,2,2,2,0,4,37,129,3.0,1.0,2.0,2.0,0.0,3.0,11.0,26,4,22,9.0,3.0,6.0
201176,27,9,18,48,0,27,246,3,15.0,4.0,11.0,26.0,0.0,15.0,129.0,83,27,56,14.0,9.0,5.0
9909293,5,3,2,2,0,5,14,0,3.0,3.0,0.0,0.0,0.0,3.0,7.0,21,5,16,1.0,1.0,0.0
9610350,10,9,1,1,4,6,12,4,0.0,0.0,0.0,0.0,0.0,0.0,0.0,19,10,9,2.0,2.0,0.0
202136,13,9,4,4,0,13,55,37,6.0,5.0,1.0,1.0,0.0,6.0,25.0,30,13,17,9.0,6.0,3.0
103008,14,5,9,16,1,13,98,7,5.0,2.0,3.0,6.0,0.0,5.0,48.0,49,14,35,13.0,4.0,9.0
105224,8,4,4,9,1,7,53,47,6.0,2.0,4.0,9.0,0.0,6.0,49.0,37,8,29,27.0,6.0,21.0
9912534,6,4,2,2,1,5,17,47,1.0,1.0,0.0,0.0,0.0,1.0,4.0,22,6,16,6.0,1.0,5.0
11053,20,5,15,66,1,19,162,46,16.0,1.0,15.0,64.0,1.0,15.0,115.0,53,20,33,27.0,15.0,12.0
201224,24,5,19,97,7,17,81,107,21.0,5.0,16.0,80.0,21.0,0.0,0.0,74,24,50,16.0,16.0,0.0
8020,17,4,13,23,0,17,73,3,10.0,3.0,7.0,15.0,0.0,10.0,48.0,41,17,24,6.0,3.0,3.0
9904316,4,4,0,0,2,2,2,0,,,,,,,,8,4,4,1.0,1.0,0.0
9604411,4,4,0,0,3,1,1,84,0.0,0.0,0.0,0.0,0.0,0.0,0.0,9,4,5,4.0,1.0,3.0
204040,5,2,3,3,0,5,66,28,5.0,2.0,3.0,3.0,0.0,5.0,53.0,24,5,19,19.0,5.0,14.0
9504308,1,1,0,0,0,1,1,30,0.0,0.0,0.0,0.0,0.0,0.0,0.0,13,1,12,1.0,0.0,1.0
9611357,11,2,9,26,1,10,61,94,8.0,2.0,6.0,15.0,0.0,8.0,57.0,22,11,11,17.0,8.0,9.0
102050,0,0,0,0,0,0,0,126,0.0,0.0,0.0,0.0,0.0,0.0,0.0,5,0,5,3.0,0.0,3.0
9312343,13,5,8,20,13,0,0,52,7.0,1.0,6.0,18.0,7.0,0.0,0.0,13,13,0,7.0,7.0,0.0
9706373,7,1,6,9,4,3,4,115,1.0,1.0,0.0,0.0,1.0,0.0,0.0,9,7,2,5.0,4.0,1.0
9707406,4,2,2,2,0,4,12,13,2.0,1.0,1.0,1.0,2.0,0.0,0.0,16,4,12,3.0,0.0,3.0
9611351,1,1,0,0,0,1,6,12,1.0,1.0,0.0,0.0,0.0,1.0,6.0,20,1,19,3.0,0.0,3.0
9608378,3,3,0,0,1,2,3,44,0.0,0.0,0.0,0.0,0.0,0.0,0.0,6,3,3,2.0,1.0,1.0
9404214,4,2,2,2,0,4,6,6,,,,,,,,7,4,3,1.0,0.0,1.0
4098,8,3,5,11,0,8,179,32,6.0,2.0,4.0,10.0,0.0,6.0,164.0,70,8,62,35.0,6.0,29.0
207332,1,1,0,0,1,0,0,39,0.0,0.0,0.0,0.0,0.0,0.0,0.0,17,1,16,3.0,0.0,3.0
9702301,8,1,7,15,1,7,40,62,6.0,1.0,5.0,10.0,0.0,6.0,32.0,24,8,16,10.0,5.0,5.0
111028,17,8,9,15,2,15,34,121,6.0,3.0,3.0,4.0,0.0,6.0,19.0,26,17,9,7.0,3.0,4.0
9507401,8,6,2,2,1,7,17,102,3.0,1.0,2.0,2.0,0.0,3.0,8.0,12,8,4,2.0,1.0,1.0
9610218,9,4,5,13,0,9,30,41,5.0,2.0,3.0,7.0,0.0,5.0,17.0,21,9,12,5.0,3.0,2.0
5086,0,0,0,0,0,0,0,115,0.0,0.0,0.0,0.0,0.0,0.0,0.0,1,0,1,1.0,0.0,1.0
9501338,8,4,4,6,1,7,7,24,2.0,2.0,0.0,0.0,2.0,0.0,0.0,9,8,1,4.0,4.0,0.0
9708252,2,1,1,1,0,2,12,6,2.0,1.0,1.0,1.0,0.0,2.0,6.0,29,2,27,6.0,1.0,5.0
9312358,18,7,11,17,18,0,0,24,3.0,3.0,0.0,0.0,3.0,0.0,0.0,18,18,0,3.0,3.0,0.0
9911324,3,2,1,1,2,1,2,128,2.0,2.0,0.0,0.0,1.0,1.0,2.0,5,3,2,3.0,1.0,2.0
7329,34,2,32,227,0,34,201,109,33.0,2.0,31.0,224.0,0.0,33.0,199.0,43,34,9,40.0,31.0,9.0
1142,22,3,19,101,1,21,64,109,21.0,2.0,19.0,100.0,0.0,21.0,64.0,28,22,6,25.0,19.0,6.0
9805204,2,1,1,1,0,2,8,99,2.0,1.0,1.0,1.0,0.0,2.0,8.0,10,2,8,3.0,1.0,2.0
9904443,8,3,5,6,8,0,0,336,0.0,0.0,0.0,0.0,0.0,0.0,0.0,12,8,4,1.0,0.0,1.0
9903255,3,2,1,1,2,1,1,551,2.0,1.0,1.0,1.0,1.0,1.0,1.0,5,3,2,3.0,2.0,1.0
211008,2,2,0,0,0,2,5,39,1.0,1.0,0.0,0.0,0.0,1.0,2.0,24,2,22,7.0,0.0,7.0
9809548,3,1,2,2,0,3,16,182,3.0,1.0,2.0,2.0,0.0,3.0,15.0,15,3,12,12.0,3.0,9.0
9709423,2,2,0,0,1,1,13,19,1.0,1.0,0.0,0.0,0.0,1.0,10.0,26,2,24,14.0,0.0,14.0
9602355,4,3,1,1,0,4,32,36,3.0,3.0,0.0,0.0,0.0,3.0,19.0,17,4,13,14.0,2.0,12.0
9406407,15,7,8,16,11,4,5,25,5.0,2.0,3.0,5.0,5.0,0.0,0.0,17,15,2,3.0,3.0,0.0
9611236,1,1,0,0,0,1,4,6,0.0,0.0,0.0,0.0,0.0,0.0,0.0,15,1,14,4.0,0.0,4.0
9804229,10,3,7,18,2,8,16,60,7.0,1.0,6.0,16.0,0.0,7.0,14.0,13,10,3,10.0,7.0,3.0
9609210,11,7,4,5,1,10,16,61,0.0,0.0,0.0,0.0,0.0,0.0,0.0,25,11,14,2.0,2.0,0.0
9707284,6,4,2,3,0,6,24,48,1.0,1.0,0.0,0.0,0.0,1.0,7.0,17,6,11,8.0,1.0,7.0
9405281,3,3,0,0,3,0,0,766,1.0,1.0,0.0,0.0,1.0,0.0,0.0,3,3,0,1.0,1.0,0.0
7061,3,1,2,3,0,3,21,34,3.0,1.0,2.0,3.0,0.0,3.0,21.0,14,3,11,3.0,0.0,3.0
9807505,10,7,3,6,0,10,16,31,5.0,5.0,0.0,0.0,5.0,0.0,0.0,13,10,3,7.0,6.0,1.0
9609413,7,3,4,6,2,5,22,5,4.0,1.0,3.0,4.0,0.0,4.0,12.0,19,7,12,8.0,5.0,3.0
9905232,1,1,0,0,0,1,3,296,1.0,1.0,0.0,0.0,0.0,1.0,2.0,5,1,4,3.0,0.0,3.0
12283,12,5,7,12,2,10,71,8,6.0,2.0,4.0,8.0,0.0,6.0,48.0,37,12,25,20.0,4.0,16.0
9806319,1,1,0,0,1,0,0,51,0.0,0.0,0.0,0.0,0.0,0.0,0.0,14,1,13,7.0,0.0,7.0
9802253,6,2,4,10,0,6,52,18,5.0,2.0,3.0,6.0,0.0,5.0,19.0,21,6,15,11.0,5.0,6.0
110256,5,4,1,1,0,5,22,11,1.0,1.0,0.0,0.0,0.0,1.0,9.0,35,5,30,4.0,1.0,3.0
9402206,11,3,8,17,3,8,22,53,10.0,3.0,7.0,15.0,2.0,8.0,22.0,14,11,3,3.0,3.0,0.0
201242,6,1,5,9,0,6,13,282,5.0,1.0,4.0,8.0,0.0,5.0,11.0,12,6,6,8.0,5.0,3.0
9911449,4,4,0,0,4,0,0,186,0.0,0.0,0.0,0.0,0.0,0.0,0.0,7,4,3,2.0,0.0,2.0
9910435,15,4,11,22,2,13,61,12,6.0,1.0,5.0,8.0,1.0,5.0,10.0,31,15,16,8.0,5.0,3.0
9502287,1,1,0,0,0,1,1,117,,,,,,,,2,1,1,2.0,1.0,1.0
111431,0,0,0,0,0,0,0,1485,0.0,0.0,0.0,0.0,0.0,0.0,0.0,4,0,4,1.0,0.0,1.0
8319,3,2,1,1,0,3,23,8,3.0,2.0,1.0,1.0,0.0,3.0,15.0,20,3,17,11.0,2.0,9.0
9311265,20,13,7,13,14,6,6,41,4.0,4.0,0.0,0.0,2.0,2.0,2.0,28,20,8,4.0,3.0,1.0
9606329,10,4,6,8,4,6,6,154,8.0,2.0,6.0,8.0,2.0,6.0,6.0,13,10,3,8.0,5.0,3.0
9705336,1,1,0,0,1,0,0,14,0.0,0.0,0.0,0.0,0.0,0.0,0.0,6,1,5,2.0,0.0,2.0
9810228,1,1,0,0,0,1,1,27,,,,,,,,3,1,2,,,
9312252,9,5,4,9,9,0,0,90,3.0,3.0,0.0,0.0,3.0,0.0,0.0,9,9,0,2.0,2.0,0.0
9810526,4,4,0,0,1,3,4,219,1.0,1.0,0.0,0.0,0.0,1.0,1.0,8,4,4,3.0,2.0,1.0
9906490,12,2,10,35,0,12,70,46,9.0,1.0,8.0,31.0,0.0,9.0,51.0,43,12,31,16.0,9.0,7.0
9812514,12,2,10,33,0,12,51,49,8.0,1.0,7.0,23.0,0.0,8.0,30.0,23,12,11,14.0,9.0,5.0
102036,2,1,1,1,0,2,12,9,1.0,1.0,0.0,0.0,0.0,1.0,1.0,29,2,27,4.0,2.0,2.0
105320,2,2,0,0,0,2,8,52,2.0,2.0,0.0,0.0,0.0,2.0,6.0,9,2,7,5.0,2.0,3.0
102340,2,1,1,1,0,2,9,41,2.0,1.0,1.0,1.0,0.0,2.0,5.0,17,2,15,2.0,0.0,2.0
7051,3,3,0,0,1,2,2,97,2.0,2.0,0.0,0.0,1.0,1.0,1.0,8,3,5,1.0,1.0,0.0
9707376,5,1,4,6,5,0,0,937,1.0,1.0,0.0,0.0,1.0,0.0,0.0,5,5,0,2.0,2.0,0.0
9503459,3,3,0,0,0,3,4,198,2.0,2.0,0.0,0.0,0.0,2.0,2.0,5,3,2,3.0,2.0,1.0
9803273,12,3,9,17,9,3,4,212,8.0,2.0,6.0,14.0,8.0,0.0,0.0,14,12,2,8.0,8.0,0.0
103096,8,3,5,12,0,8,56,56,5.0,3.0,2.0,3.0,0.0,5.0,25.0,38,8,30,7.0,4.0,3.0
106154,4,3,1,1,2,2,10,4,0.0,0.0,0.0,0.0,0.0,0.0,0.0,51,4,47,6.0,0.0,6.0
201136,4,2,2,3,0,4,17,6,2.0,1.0,1.0,1.0,0.0,2.0,2.0,14,4,10,2.0,2.0,0.0
9707518,5,5,0,0,1,4,37,36,1.0,1.0,0.0,0.0,0.0,1.0,17.0,54,5,49,18.0,1.0,17.0
9906305,4,2,2,3,1,3,7,38,3.0,1.0,2.0,3.0,1.0,2.0,6.0,9,4,5,3.0,1.0,2.0
9809539,15,13,2,2,7,8,18,57,1.0,1.0,0.0,0.0,0.0,1.0,4.0,27,15,12,5.0,4.0,1.0
9607324,11,5,6,16,0,11,56,17,7.0,2.0,5.0,13.0,0.0,7.0,7.0,24,11,13,10.0,7.0,3.0
9306327,1,1,0,0,1,0,0,1951,,,,,,,,1,1,0,,,
9408269,0,0,0,0,0,0,0,35,0.0,0.0,0.0,0.0,0.0,0.0,0.0,12,0,12,1.0,0.0,1.0
112200,0,0,0,0,0,0,0,3,0.0,0.0,0.0,0.0,0.0,0.0,0.0,17,0,17,3.0,0.0,3.0
203150,4,3,1,1,0,4,45,8,4.0,3.0,1.0,1.0,0.0,4.0,41.0,42,4,38,30.0,0.0,30.0
9507345,1,1,0,0,0,1,1,221,0.0,0.0,0.0,0.0,0.0,0.0,0.0,3,1,2,1.0,0.0,1.0
9408307,4,4,0,0,4,0,0,303,1.0,1.0,0.0,0.0,1.0,0.0,0.0,4,4,0,,,
9507467,6,5,1,1,3,3,3,298,4.0,3.0,1.0,1.0,2.0,2.0,2.0,7,6,1,4.0,3.0,1.0
12348,20,6,14,24,1,19,50,43,10.0,8.0,2.0,2.0,0.0,10.0,16.0,31,20,11,8.0,7.0,1.0
9811221,8,4,4,10,0,8,18,28,7.0,3.0,4.0,10.0,0.0,7.0,13.0,19,8,11,12.0,7.0,5.0
7292,17,7,10,30,0,17,139,17,14.0,5.0,9.0,27.0,0.0,14.0,114.0,31,17,14,10.0,8.0,2.0
9804458,9,5,4,7,1,8,63,7,7.0,4.0,3.0,5.0,0.0,7.0,43.0,25,9,16,14.0,3.0,11.0
106057,3,1,2,3,0,3,64,34,2.0,1.0,1.0,1.0,0.0,2.0,47.0,72,3,69,38.0,2.0,36.0
9906370,3,3,0,0,0,3,22,78,0.0,0.0,0.0,0.0,0.0,0.0,0.0,31,3,28,6.0,2.0,4.0
12052,18,6,12,33,1,17,46,46,9.0,1.0,8.0,17.0,0.0,9.0,21.0,31,18,13,8.0,6.0,2.0
12369,3,1,2,3,0,3,44,73,3.0,1.0,2.0,3.0,0.0,3.0,34.0,40,3,37,21.0,2.0,19.0
9809562,12,5,7,9,0,12,44,42,10.0,4.0,6.0,7.0,0.0,10.0,27.0,16,12,4,11.0,8.0,3.0
9706453,19,3,16,24,7,12,25,274,0.0,0.0,0.0,0.0,0.0,0.0,0.0,27,19,8,3.0,1.0,2.0
9708332,4,3,1,1,1,3,12,33,1.0,1.0,0.0,0.0,0.0,1.0,7.0,35,4,31,12.0,1.0,11.0
9709495,3,3,0,0,1,2,4,25,0.0,0.0,0.0,0.0,0.0,0.0,0.0,16,3,13,1.0,0.0,1.0
9711283,7,4,3,7,6,1,1,160,0.0,0.0,0.0,0.0,0.0,0.0,0.0,12,7,5,3.0,2.0,1.0
9083,5,5,0,0,3,2,11,50,0.0,0.0,0.0,0.0,0.0,0.0,0.0,16,5,11,1.0,0.0,1.0
9703241,18,4,14,54,0,18,59,82,16.0,4.0,12.0,45.0,0.0,16.0,50.0,27,18,9,16.0,11.0,5.0
1254,1,1,0,0,0,1,12,92,0.0,0.0,0.0,0.0,0.0,0.0,0.0,21,1,20,13.0,1.0,12.0
9310266,3,3,0,0,1,2,2,129,2.0,2.0,0.0,0.0,0.0,2.0,2.0,5,3,2,4.0,3.0,1.0
9911373,5,5,0,0,2,3,4,68,0.0,0.0,0.0,0.0,0.0,0.0,0.0,8,5,3,2.0,1.0,1.0
9603278,9,3,6,7,4,5,9,13,6.0,3.0,3.0,4.0,3.0,3.0,6.0,13,9,4,3.0,3.0,0.0
9705209,4,2,2,2,0,4,30,7,1.0,1.0,0.0,0.0,0.0,1.0,4.0,19,4,15,2.0,1.0,1.0
5234,11,2,9,20,0,11,143,18,11.0,2.0,9.0,20.0,0.0,11.0,101.0,67,11,56,21.0,0.0,21.0
9803434,1,1,0,0,1,0,0,202,,,,,,,,2,1,1,,,
9404271,4,2,2,3,0,4,5,48,3.0,2.0,1.0,1.0,0.0,3.0,3.0,7,4,3,5.0,3.0,2.0
9601355,5,1,4,5,0,5,10,86,5.0,1.0,4.0,5.0,3.0,2.0,2.0,10,5,5,5.0,4.0,1.0
9902218,9,4,5,6,1,8,41,15,3.0,1.0,2.0,3.0,0.0,3.0,12.0,42,9,33,11.0,3.0,8.0
209353,4,3,1,1,1,3,18,22,1.0,1.0,0.0,0.0,0.0,1.0,5.0,22,4,18,7.0,3.0,4.0
9905217,5,3,2,2,2,3,7,40,0.0,0.0,0.0,0.0,0.0,0.0,0.0,12,5,7,4.0,2.0,2.0
9411257,4,4,0,0,0,4,18,26,3.0,3.0,0.0,0.0,0.0,3.0,10.0,20,4,16,7.0,2.0,5.0
102037,7,4,3,4,0,7,62,12,6.0,3.0,3.0,4.0,0.0,6.0,48.0,72,7,65,22.0,4.0,18.0
10040,7,5,2,3,0,7,36,9,5.0,3.0,2.0,3.0,0.0,5.0,12.0,23,7,16,4.0,3.0,1.0
9704348,15,5,10,18,10,5,5,273,6.0,1.0,5.0,5.0,6.0,0.0,0.0,19,15,4,6.0,6.0,0.0
205116,2,2,0,0,0,2,6,28,0.0,0.0,0.0,0.0,0.0,0.0,0.0,28,2,26,8.0,0.0,8.0
9807426,19,3,16,81,1,18,49,0,14.0,1.0,13.0,66.0,0.0,14.0,27.0,26,19,7,17.0,14.0,3.0
7075,6,5,1,1,2,4,13,299,2.0,2.0,0.0,0.0,1.0,1.0,4.0,16,6,10,6.0,1.0,5.0
7283,4,1,3,5,0,4,23,0,2.0,1.0,1.0,1.0,0.0,2.0,4.0,18,4,14,6.0,3.0,3.0
9901239,21,7,14,38,4,17,103,67,13.0,4.0,9.0,30.0,0.0,13.0,93.0,41,21,20,23.0,10.0,13.0
9903364,17,1,16,71,3,14,30,201,17.0,1.0,16.0,71.0,3.0,14.0,26.0,21,17,4,18.0,16.0,2.0
9506426,3,3,0,0,1,2,4,298,1.0,1.0,0.0,0.0,0.0,1.0,1.0,8,3,5,1.0,1.0,0.0
9905515,26,6,20,71,7,19,44,51,19.0,2.0,17.0,66.0,13.0,6.0,6.0,38,26,12,16.0,16.0,0.0
210260,2,2,0,0,0,2,8,410,1.0,1.0,0.0,0.0,0.0,1.0,4.0,22,2,20,5.0,1.0,4.0
10270,7,4,3,3,3,4,13,3,2.0,1.0,1.0,1.0,0.0,2.0,4.0,35,7,28,3.0,2.0,1.0
202064,10,4,6,16,0,10,123,3,4.0,2.0,2.0,3.0,0.0,4.0,19.0,45,10,35,13.0,5.0,8.0
1038,5,4,1,1,0,5,15,8,0.0,0.0,0.0,0.0,0.0,0.0,0.0,27,5,22,8.0,5.0,3.0
9711459,1,1,0,0,0,1,1,480,0.0,0.0,0.0,0.0,0.0,0.0,0.0,6,1,5,2.0,0.0,2.0
9712419,6,5,1,1,1,5,15,94,0.0,0.0,0.0,0.0,0.0,0.0,0.0,36,6,30,15.0,0.0,15.0
9606426,8,4,4,6,0,8,18,205,6.0,2.0,4.0,4.0,0.0,6.0,14.0,15,8,7,9.0,6.0,3.0
9809409,9,3,6,11,2,7,29,112,7.0,1.0,6.0,11.0,0.0,7.0,28.0,18,9,9,13.0,7.0,6.0
202010,17,7,10,15,2,15,69,1,3.0,3.0,0.0,0.0,0.0,3.0,14.0,39,17,22,10.0,3.0,7.0
206018,5,5,0,0,2,3,5,17,2.0,2.0,0.0,0.0,1.0,1.0,1.0,15,5,10,2.0,0.0,2.0
9406313,6,3,3,3,4,2,2,58,5.0,2.0,3.0,3.0,5.0,0.0,0.0,7,6,1,2.0,2.0,0.0
9301238,4,3,1,1,4,0,0,71,2.0,1.0,1.0,1.0,2.0,0.0,0.0,4,4,0,2.0,2.0,0.0
9411396,0,0,0,0,0,0,0,208,0.0,0.0,0.0,0.0,0.0,0.0,0.0,10,0,10,3.0,0.0,3.0
209330,1,1,0,0,0,1,20,30,1.0,1.0,0.0,0.0,0.0,1.0,15.0,37,1,36,13.0,1.0,12.0
2039,17,8,9,16,1,16,149,4,8.0,4.0,4.0,7.0,0.0,8.0,78.0,63,17,46,6.0,4.0,2.0
9906363,9,6,3,3,0,9,50,5,2.0,2.0,0.0,0.0,0.0,2.0,13.0,33,9,24,3.0,2.0,1.0
103275,19,1,18,35,1,18,76,9,17.0,1.0,16.0,31.0,2.0,15.0,42.0,29,19,10,14.0,11.0,3.0
209177,2,1,1,1,0,2,56,19,2.0,1.0,1.0,1.0,0.0,2.0,46.0,42,2,40,27.0,2.0,25.0
9703326,3,3,0,0,0,3,38,15,3.0,3.0,0.0,0.0,0.0,3.0,36.0,47,3,44,31.0,2.0,29.0
9806385,4,3,1,1,0,4,10,167,2.0,1.0,1.0,1.0,0.0,2.0,7.0,16,4,12,4.0,2.0,2.0
9504286,3,3,0,0,2,1,2,413,1.0,1.0,0.0,0.0,0.0,1.0,2.0,10,3,7,5.0,1.0,4.0
211146,0,0,0,0,0,0,0,143,0.0,0.0,0.0,0.0,0.0,0.0,0.0,5,0,5,3.0,0.0,3.0
9807227,2,2,0,0,1,1,13,94,1.0,1.0,0.0,0.0,0.0,1.0,13.0,16,2,14,14.0,1.0,13.0
9510237,2,2,0,0,1,1,2,117,0.0,0.0,0.0,0.0,0.0,0.0,0.0,6,2,4,2.0,0.0,2.0
9912517,2,2,0,0,0,2,4,13,1.0,1.0,0.0,0.0,0.0,1.0,2.0,10,2,8,3.0,0.0,3.0
9306208,9,2,7,8,9,0,0,341,6.0,1.0,5.0,6.0,6.0,0.0,0.0,9,9,0,6.0,6.0,0.0
9312249,22,3,19,50,22,0,0,133,12.0,1.0,11.0,19.0,12.0,0.0,0.0,22,22,0,7.0,7.0,0.0
12299,9,2,7,25,0,9,95,66,8.0,1.0,7.0,24.0,0.0,8.0,65.0,33,9,24,17.0,8.0,9.0
11229,12,4,8,15,1,11,72,20,11.0,4.0,7.0,14.0,1.0,10.0,67.0,33,12,21,4.0,4.0,0.0
8042,5,2,3,5,0,5,16,2,5.0,2.0,3.0,5.0,0.0,5.0,16.0,9,5,4,1.0,1.0,0.0
210182,3,2,1,1,0,3,45,12,2.0,1.0,1.0,1.0,0.0,2.0,37.0,60,3,57,27.0,1.0,26.0
201121,9,1,8,14,0,9,89,32,3.0,1.0,2.0,3.0,0.0,3.0,22.0,50,9,41,13.0,4.0,9.0
7278,5,2,3,3,3,2,3,126,4.0,1.0,3.0,3.0,2.0,2.0,2.0,8,5,3,5.0,3.0,2.0
9901233,3,2,1,1,0,3,7,9,2.0,1.0,1.0,1.0,2.0,0.0,0.0,7,3,4,1.0,1.0,0.0
102138,2,1,1,1,0,2,23,6,2.0,1.0,1.0,1.0,0.0,2.0,9.0,14,2,12,10.0,2.0,8.0
301257,0,0,0,0,0,0,0,0,0.0,0.0,0.0,0.0,0.0,0.0,0.0,17,0,17,5.0,0.0,5.0
202212,7,5,2,2,1,6,18,63,1.0,1.0,0.0,0.0,0.0,1.0,3.0,50,7,43,8.0,0.0,8.0
9611394,2,1,1,1,2,0,0,10,2.0,1.0,1.0,1.0,2.0,0.0,0.0,9,2,7,3.0,0.0,3.0
9712330,5,4,1,1,2,3,34,94,2.0,1.0,1.0,1.0,0.0,2.0,30.0,31,5,26,17.0,2.0,15.0
111037,3,2,1,1,0,3,21,9,1.0,1.0,0.0,0.0,0.0,1.0,16.0,19,3,16,1.0,0.0,1.0
103140,3,2,1,1,0,3,23,17,1.0,1.0,0.0,0.0,0.0,1.0,14.0,32,3,29,4.0,0.0,4.0
9507265,8,2,6,15,1,7,53,71,7.0,1.0,6.0,15.0,0.0,7.0,53.0,24,8,16,17.0,7.0,10.0
203186,5,2,3,3,1,4,36,5,2.0,1.0,1.0,1.0,0.0,2.0,20.0,34,5,29,16.0,2.0,14.0
9912357,9,7,2,2,0,9,42,85,6.0,4.0,2.0,2.0,0.0,6.0,28.0,23,9,14,11.0,4.0,7.0
9308223,16,10,6,16,4,12,18,96,11.0,6.0,5.0,12.0,1.0,10.0,14.0,19,16,3,9.0,8.0,1.0
111403,3,3,0,0,0,3,15,68,3.0,3.0,0.0,0.0,0.0,3.0,15.0,14,3,11,11.0,2.0,9.0
9812532,7,2,5,8,6,1,1,66,1.0,1.0,0.0,0.0,1.0,0.0,0.0,9,7,2,1.0,1.0,0.0
11275,9,4,5,12,0,9,67,2,7.0,3.0,4.0,9.0,0.0,7.0,52.0,22,9,13,17.0,8.0,9.0
206096,4,3,1,1,0,4,13,5,1.0,1.0,0.0,0.0,1.0,0.0,0.0,24,4,20,3.0,1.0,2.0
9409224,8,2,6,12,8,0,0,63,8.0,2.0,6.0,12.0,8.0,0.0,0.0,8,8,0,3.0,3.0,0.0
9910543,8,6,2,3,0,8,36,12,1.0,1.0,0.0,0.0,0.0,1.0,2.0,43,8,35,1.0,0.0,1.0
9810439,1,1,0,0,1,0,0,1890,,,,,,,,2,1,1,,,
5200,2,2,0,0,1,1,6,39,1.0,1.0,0.0,0.0,0.0,1.0,6.0,13,2,11,7.0,1.0,6.0
9703258,12,8,4,7,0,12,92,40,11.0,7.0,4.0,7.0,0.0,11.0,88.0,48,12,36,21.0,5.0,16.0
9509310,2,2,0,0,0,2,4,53,2.0,2.0,0.0,0.0,0.0,2.0,2.0,9,2,7,4.0,2.0,2.0
9409354,2,2,0,0,1,1,1,323,1.0,1.0,0.0,0.0,0.0,1.0,1.0,7,2,5,3.0,1.0,2.0
9710297,1,1,0,0,0,1,1,263,0.0,0.0,0.0,0.0,0.0,0.0,0.0,8,1,7,1.0,1.0,0.0
9611281,2,1,1,1,0,2,6,60,2.0,1.0,1.0,1.0,0.0,2.0,6.0,7,2,5,1.0,0.0,1.0
9809262,11,5,6,12,1,10,53,29,7.0,3.0,4.0,9.0,0.0,7.0,12.0,32,11,21,10.0,3.0,7.0
9707248,5,3,2,2,2,3,7,49,2.0,1.0,1.0,1.0,0.0,2.0,5.0,13,5,8,2.0,0.0,2.0
9705407,3,2,1,1,3,0,0,448,3.0,2.0,1.0,1.0,3.0,0.0,0.0,3,3,0,2.0,2.0,0.0
9909322,6,4,2,2,4,2,2,59,3.0,2.0,1.0,1.0,3.0,0.0,0.0,9,6,3,3.0,3.0,0.0
9912500,8,6,2,2,0,8,40,54,5.0,4.0,1.0,1.0,0.0,5.0,19.0,30,8,22,8.0,1.0,7.0
9611294,3,3,0,0,3,0,0,133,1.0,1.0,0.0,0.0,1.0,0.0,0.0,3,3,0,2.0,2.0,0.0
9911492,4,3,1,1,2,2,4,292,4.0,3.0,1.0,1.0,2.0,2.0,4.0,8,4,4,5.0,2.0,3.0
112069,5,1,4,6,3,2,5,128,1.0,1.0,0.0,0.0,0.0,1.0,1.0,12,5,7,2.0,1.0,1.0
9908356,4,2,2,2,0,4,5,65,2.0,1.0,1.0,1.0,2.0,0.0,0.0,9,4,5,2.0,2.0,0.0
9506346,3,1,2,2,3,0,0,254,1.0,1.0,0.0,0.0,1.0,0.0,0.0,3,3,0,2.0,2.0,0.0
9806445,2,2,0,0,0,2,7,8,0.0,0.0,0.0,0.0,0.0,0.0,0.0,23,2,21,2.0,0.0,2.0
9602435,1,1,0,0,0,1,1,275,,,,,,,,2,1,1,2.0,1.0,1.0
9804308,2,1,1,1,0,2,3,60,0.0,0.0,0.0,0.0,0.0,0.0,0.0,11,2,9,2.0,0.0,2.0
9807266,16,3,13,52,0,16,38,82,15.0,3.0,12.0,49.0,0.0,15.0,35.0,21,16,5,13.0,11.0,2.0
9510205,3,3,0,0,2,1,2,100,1.0,1.0,0.0,0.0,1.0,0.0,0.0,6,3,3,2.0,1.0,1.0
9008,9,6,3,3,1,8,20,11,3.0,2.0,1.0,1.0,0.0,3.0,6.0,29,9,20,5.0,1.0,4.0
9808392,6,3,3,4,1,5,14,236,4.0,2.0,2.0,3.0,0.0,4.0,7.0,25,6,19,6.0,4.0,2.0
9508287,1,1,0,0,1,0,0,166,1.0,1.0,0.0,0.0,1.0,0.0,0.0,3,1,2,1.0,1.0,0.0
9809404,4,4,0,0,1,3,6,131,2.0,2.0,0.0,0.0,0.0,2.0,4.0,13,4,9,2.0,1.0,1.0
207261,7,5,2,3,0,7,27,8,2.0,1.0,1.0,1.0,0.0,2.0,4.0,24,7,17,4.0,4.0,0.0
9192,2,1,1,1,2,0,0,1368,,,,,,,,2,2,0,,,
204187,5,5,0,0,2,3,9,18,1.0,1.0,0.0,0.0,0.0,1.0,3.0,32,5,27,2.0,2.0,0.0
9711315,7,1,6,14,0,7,10,107,6.0,1.0,5.0,13.0,0.0,6.0,6.0,9,7,2,7.0,6.0,1.0
202101,7,6,1,1,0,7,66,5,2.0,2.0,0.0,0.0,0.0,2.0,26.0,61,7,54,26.0,2.0,24.0
207315,3,3,0,0,2,1,5,24,2.0,2.0,0.0,0.0,1.0,1.0,5.0,14,3,11,,,
108236,6,6,0,0,0,6,73,5,1.0,1.0,0.0,0.0,0.0,1.0,9.0,164,6,158,12.0,1.0,11.0
9903446,11,4,7,15,1,10,31,78,4.0,1.0,3.0,5.0,0.0,4.0,8.0,18,11,7,7.0,5.0,2.0
5113,5,2,3,4,4,1,1,48,3.0,1.0,2.0,3.0,3.0,0.0,0.0,10,5,5,2.0,2.0,0.0
9305252,2,1,1,1,2,0,0,261,2.0,1.0,1.0,1.0,2.0,0.0,0.0,2,2,0,2.0,2.0,0.0
7174,7,1,6,12,0,7,45,5,1.0,1.0,0.0,0.0,0.0,1.0,1.0,25,7,18,8.0,5.0,3.0
101269,9,5,4,7,0,9,49,108,6.0,3.0,3.0,4.0,0.0,6.0,25.0,21,9,12,12.0,7.0,5.0
9810429,1,1,0,0,0,1,1,188,0.0,0.0,0.0,0.0,0.0,0.0,0.0,14,1,13,8.0,0.0,8.0
9708249,1,1,0,0,0,1,1,18,,,,,,,,7,1,6,,,
201010,5,4,1,1,0,5,22,45,2.0,2.0,0.0,0.0,0.0,2.0,10.0,23,5,18,10.0,2.0,8.0
1180,4,3,1,1,2,2,9,16,1.0,1.0,0.0,0.0,0.0,1.0,8.0,18,4,14,2.0,0.0,2.0
104287,1,1,0,0,0,1,4,31,0.0,0.0,0.0,0.0,0.0,0.0,0.0,38,1,37,9.0,0.0,9.0
9412229,1,1,0,0,0,1,3,179,1.0,1.0,0.0,0.0,0.0,1.0,2.0,12,1,11,3.0,1.0,2.0
7149,6,5,1,1,6,0,0,143,2.0,2.0,0.0,0.0,2.0,0.0,0.0,6,6,0,2.0,2.0,0.0
302254,1,1,0,0,0,1,1,381,0.0,0.0,0.0,0.0,0.0,0.0,0.0,9,1,8,,,
103167,10,7,3,5,1,9,58,5,4.0,1.0,3.0,5.0,0.0,4.0,24.0,31,10,21,7.0,1.0,6.0
107043,2,2,0,0,0,2,4,273,0.0,0.0,0.0,0.0,0.0,0.0,0.0,9,2,7,5.0,2.0,3.0
9802400,4,3,1,1,4,0,0,10,2.0,2.0,0.0,0.0,2.0,0.0,0.0,11,4,7,2.0,2.0,0.0
3116,0,0,0,0,0,0,0,78,0.0,0.0,0.0,0.0,0.0,0.0,0.0,22,0,22,7.0,0.0,7.0
9903275,7,4,3,4,0,7,23,34,3.0,2.0,1.0,1.0,0.0,3.0,14.0,20,7,13,3.0,3.0,0.0
9506211,0,0,0,0,0,0,0,399,0.0,0.0,0.0,0.0,0.0,0.0,0.0,3,0,3,2.0,0.0,2.0
202019,2,2,0,0,0,2,18,12,2.0,2.0,0.0,0.0,0.0,2.0,3.0,29,2,27,6.0,1.0,5.0
211085,5,1,4,6,0,5,9,17,5.0,1.0,4.0,6.0,5.0,0.0,0.0,13,5,8,5.0,5.0,0.0
9907412,3,1,2,2,0,3,5,53,0.0,0.0,0.0,0.0,0.0,0.0,0.0,13,3,10,,,
201076,2,2,0,0,1,1,5,27,2.0,2.0,0.0,0.0,1.0,1.0,5.0,13,2,11,,,
9711245,4,3,1,1,0,4,5,351,2.0,2.0,0.0,0.0,0.0,2.0,2.0,7,4,3,2.0,1.0,1.0
209061,6,6,0,0,0,6,28,18,0.0,0.0,0.0,0.0,0.0,0.0,0.0,48,6,42,5.0,3.0,2.0
9710456,4,1,3,5,0,4,4,31,1.0,1.0,0.0,0.0,1.0,0.0,0.0,5,4,1,4.0,4.0,0.0
9711359,3,2,1,1,0,3,4,52,3.0,2.0,1.0,1.0,0.0,3.0,4.0,11,3,8,2.0,1.0,1.0
9808249,1,1,0,0,0,1,4,21,0.0,0.0,0.0,0.0,0.0,0.0,0.0,10,1,9,,,
9309247,1,1,0,0,1,0,0,324,1.0,1.0,0.0,0.0,1.0,0.0,0.0,2,1,1,2.0,1.0,1.0
9701329,3,2,1,2,3,0,0,247,3.0,2.0,1.0,2.0,3.0,0.0,0.0,3,3,0,3.0,3.0,0.0
208054,2,2,0,0,0,2,12,12,1.0,1.0,0.0,0.0,0.0,1.0,2.0,16,2,14,2.0,1.0,1.0
9409338,4,4,0,0,4,0,0,208,1.0,1.0,0.0,0.0,1.0,0.0,0.0,4,4,0,1.0,1.0,0.0
9808389,1,1,0,0,0,1,1,8,0.0,0.0,0.0,0.0,0.0,0.0,0.0,10,1,9,3.0,0.0,3.0
9811496,3,2,1,1,2,1,3,397,3.0,2.0,1.0,1.0,2.0,1.0,1.0,9,3,6,3.0,2.0,1.0
205093,4,4,0,0,1,3,5,37,1.0,1.0,0.0,0.0,1.0,0.0,0.0,8,4,4,1.0,1.0,0.0
9809298,11,8,3,4,5,6,8,41,0.0,0.0,0.0,0.0,0.0,0.0,0.0,22,11,11,4.0,0.0,4.0
202004,4,1,3,6,0,4,17,102,4.0,1.0,3.0,6.0,0.0,4.0,5.0,18,4,14,6.0,4.0,2.0
9911509,0,0,0,0,0,0,0,24,0.0,0.0,0.0,0.0,0.0,0.0,0.0,17,0,17,1.0,0.0,1.0
9512238,1,1,0,0,0,1,1,27,0.0,0.0,0.0,0.0,0.0,0.0,0.0,7,1,6,1.0,0.0,1.0
4067,7,4,3,5,0,7,29,7,3.0,2.0,1.0,1.0,0.0,3.0,9.0,41,7,34,2.0,1.0,1.0
211255,0,0,0,0,0,0,0,165,,,,,,,,9,0,9,1.0,0.0,1.0
9502361,5,4,1,1,2,3,3,104,3.0,3.0,0.0,0.0,0.0,3.0,3.0,6,5,1,2.0,2.0,0.0
9802254,5,5,0,0,2,3,7,23,0.0,0.0,0.0,0.0,0.0,0.0,0.0,24,5,19,2.0,1.0,1.0
9170,12,8,4,5,5,7,13,64,6.0,3.0,3.0,3.0,1.0,5.0,9.0,23,12,11,7.0,5.0,2.0
6042,2,2,0,0,1,1,5,2,1.0,1.0,0.0,0.0,1.0,0.0,0.0,15,2,13,1.0,0.0,1.0
11067,2,1,1,1,0,2,7,71,0.0,0.0,0.0,0.0,0.0,0.0,0.0,10,2,8,3.0,2.0,1.0
3082,3,2,1,1,1,2,14,140,2.0,1.0,1.0,1.0,0.0,2.0,12.0,25,3,22,8.0,0.0,8.0
9608271,3,3,0,0,3,0,0,459,1.0,1.0,0.0,0.0,1.0,0.0,0.0,6,3,3,2.0,1.0,1.0
9703256,8,3,5,7,6,2,3,149,8.0,3.0,5.0,7.0,8.0,0.0,0.0,13,8,5,7.0,7.0,0.0
9509344,15,10,5,7,15,0,0,249,11.0,6.0,5.0,7.0,11.0,0.0,0.0,19,15,4,6.0,6.0,0.0
210146,6,4,2,5,0,6,92,37,5.0,3.0,2.0,5.0,0.0,5.0,81.0,52,6,46,32.0,5.0,27.0
9608244,1,1,0,0,0,1,1,1171,1.0,1.0,0.0,0.0,1.0,0.0,0.0,3,1,2,1.0,1.0,0.0
9511437,4,2,2,2,0,4,12,234,2.0,1.0,1.0,1.0,0.0,2.0,6.0,9,4,5,7.0,3.0,4.0
9812394,3,3,0,0,1,2,2,23,1.0,1.0,0.0,0.0,1.0,0.0,0.0,14,3,11,1.0,1.0,0.0
9910513,2,2,0,0,0,2,4,95,0.0,0.0,0.0,0.0,0.0,0.0,0.0,7,2,5,2.0,0.0,2.0
9605253,0,0,0,0,0,0,0,44,0.0,0.0,0.0,0.0,0.0,0.0,0.0,4,0,4,3.0,0.0,3.0
9807389,3,2,1,1,0,3,13,16,1.0,1.0,0.0,0.0,0.0,1.0,1.0,13,3,10,2.0,2.0,0.0
3298,4,2,2,3,1,3,13,103,3.0,1.0,2.0,3.0,0.0,3.0,13.0,12,4,8,9.0,3.0,6.0
9811483,4,4,0,0,2,2,2,110,2.0,2.0,0.0,0.0,0.0,2.0,2.0,7,4,3,3.0,2.0,1.0
206266,10,4,6,9,0,10,91,18,7.0,2.0,5.0,8.0,0.0,7.0,82.0,34,10,24,25.0,6.0,19.0
5038,7,6,1,2,0,7,35,53,5.0,4.0,1.0,2.0,0.0,5.0,31.0,16,7,9,14.0,5.0,9.0
5116,7,2,5,7,1,6,18,5,2.0,1.0,1.0,1.0,0.0,2.0,10.0,42,7,35,6.0,3.0,3.0
210289,6,4,2,2,1,5,59,1,5.0,4.0,1.0,1.0,0.0,5.0,59.0,45,6,39,29.0,4.0,25.0
206295,2,2,0,0,0,2,7,9,2.0,2.0,0.0,0.0,0.0,2.0,5.0,8,2,6,1.0,1.0,0.0
9511432,1,1,0,0,0,1,1,471,1.0,1.0,0.0,0.0,0.0,1.0,1.0,5,1,4,2.0,1.0,1.0
9809231,1,1,0,0,0,1,1,184,0.0,0.0,0.0,0.0,0.0,0.0,0.0,5,1,4,2.0,0.0,2.0
204337,7,1,6,18,0,7,74,9,7.0,1.0,6.0,18.0,0.0,7.0,74.0,24,7,17,8.0,4.0,4.0
9341,7,2,5,10,5,2,3,392,5.0,1.0,4.0,7.0,5.0,0.0,0.0,19,7,12,5.0,5.0,0.0
9511366,1,1,0,0,1,0,0,206,0.0,0.0,0.0,0.0,0.0,0.0,0.0,3,1,2,,,
210425,0,0,0,0,0,0,0,12,0.0,0.0,0.0,0.0,0.0,0.0,0.0,16,0,16,5.0,0.0,5.0
9602283,1,1,0,0,0,1,3,69,0.0,0.0,0.0,0.0,0.0,0.0,0.0,12,1,11,1.0,0.0,1.0
9606405,1,1,0,0,0,1,1,6,0.0,0.0,0.0,0.0,0.0,0.0,0.0,15,1,14,1.0,0.0,1.0
109170,1,1,0,0,0,1,6,21,1.0,1.0,0.0,0.0,0.0,1.0,6.0,32,1,31,15.0,1.0,14.0
9912352,2,2,0,0,0,2,6,22,0.0,0.0,0.0,0.0,0.0,0.0,0.0,9,2,7,3.0,0.0,3.0
9606473,0,0,0,0,0,0,0,1831,,,,,,,,1,0,1,,,
9712407,2,2,0,0,2,0,0,308,2.0,2.0,0.0,0.0,2.0,0.0,0.0,2,2,0,,,
9902370,3,3,0,0,2,1,3,203,1.0,1.0,0.0,0.0,1.0,0.0,0.0,7,3,4,1.0,1.0,0.0
9908297,1,1,0,0,0,1,1,171,0.0,0.0,0.0,0.0,0.0,0.0,0.0,3,1,2,1.0,1.0,0.0
102005,6,3,3,4,0,6,17,71,3.0,1.0,2.0,3.0,0.0,3.0,6.0,18,6,12,3.0,0.0,3.0
9910471,7,5,2,3,7,0,0,153,4.0,3.0,1.0,1.0,4.0,0.0,0.0,7,7,0,5.0,5.0,0.0
9606252,1,1,0,0,1,0,0,17,0.0,0.0,0.0,0.0,0.0,0.0,0.0,24,1,23,2.0,0.0,2.0
208081,2,1,1,1,1,1,15,59,2.0,1.0,1.0,1.0,1.0,1.0,10.0,18,2,16,11.0,1.0,10.0
9706250,1,1,0,0,0,1,2,282,1.0,1.0,0.0,0.0,0.0,1.0,2.0,4,1,3,3.0,1.0,2.0
9805308,4,1,3,4,0,4,6,160,3.0,1.0,2.0,2.0,0.0,3.0,5.0,6,4,2,5.0,3.0,2.0
9502398,2,2,0,0,1,1,3,29,1.0,1.0,0.0,0.0,0.0,1.0,3.0,9,2,7,3.0,0.0,3.0
9512372,1,1,0,0,0,1,5,47,1.0,1.0,0.0,0.0,0.0,1.0,2.0,9,1,8,4.0,1.0,3.0
9602368,3,3,0,0,0,3,6,156,3.0,3.0,0.0,0.0,0.0,3.0,6.0,6,3,3,6.0,3.0,3.0
9711279,6,3,3,4,5,1,2,23,0.0,0.0,0.0,0.0,0.0,0.0,0.0,26,6,20,5.0,0.0,5.0
9608371,2,2,0,0,1,1,7,35,1.0,1.0,0.0,0.0,0.0,1.0,4.0,12,2,10,4.0,1.0,3.0
9510426,1,1,0,0,0,1,6,5,1.0,1.0,0.0,0.0,0.0,1.0,1.0,8,1,7,2.0,1.0,1.0
9701217,0,0,0,0,0,0,0,99,0.0,0.0,0.0,0.0,0.0,0.0,0.0,3,0,3,,,
102251,1,1,0,0,0,1,3,1606,1.0,1.0,0.0,0.0,0.0,1.0,3.0,5,1,4,1.0,0.0,1.0
109009,2,2,0,0,0,2,5,257,1.0,1.0,0.0,0.0,0.0,1.0,2.0,5,2,3,4.0,2.0,2.0
1023,6,2,4,7,4,2,3,215,5.0,1.0,4.0,7.0,4.0,1.0,1.0,9,6,3,4.0,4.0,0.0
210238,2,2,0,0,0,2,39,9,2.0,2.0,0.0,0.0,0.0,2.0,39.0,29,2,27,11.0,2.0,9.0
101340,4,3,1,2,0,4,34,2,2.0,1.0,1.0,1.0,0.0,2.0,5.0,26,4,22,9.0,2.0,7.0
207067,2,2,0,0,0,2,17,66,2.0,2.0,0.0,0.0,0.0,2.0,9.0,12,2,10,7.0,1.0,6.0
5290,1,1,0,0,0,1,1,173,0.0,0.0,0.0,0.0,0.0,0.0,0.0,8,1,7,3.0,0.0,3.0
9502325,2,2,0,0,1,1,2,170,0.0,0.0,0.0,0.0,0.0,0.0,0.0,4,2,2,1.0,0.0,1.0
204017,3,2,1,1,0,3,11,81,3.0,2.0,1.0,1.0,0.0,3.0,6.0,12,3,9,4.0,2.0,2.0
109228,7,6,1,1,0,7,12,71,1.0,1.0,0.0,0.0,0.0,1.0,5.0,14,7,7,6.0,1.0,5.0
10293,1,1,0,0,1,0,0,44,0.0,0.0,0.0,0.0,0.0,0.0,0.0,4,1,3,,,
9811283,4,3,1,2,0,4,8,76,3.0,2.0,1.0,2.0,0.0,3.0,7.0,7,4,3,4.0,1.0,3.0
3131,7,2,5,10,1,6,47,124,5.0,1.0,4.0,8.0,0.0,5.0,29.0,24,7,17,11.0,4.0,7.0
9504361,1,1,0,0,0,1,1,1384,1.0,1.0,0.0,0.0,1.0,0.0,0.0,2,1,1,1.0,1.0,0.0
3167,16,6,10,26,5,11,68,53,9.0,2.0,7.0,16.0,1.0,8.0,63.0,31,16,15,19.0,7.0,12.0
206044,0,0,0,0,0,0,0,1373,,,,,,,,1,0,1,,,
9604227,9,3,6,12,0,9,9,90,8.0,2.0,6.0,12.0,0.0,8.0,8.0,10,9,1,8.0,7.0,1.0
106313,3,2,1,1,0,3,28,11,3.0,2.0,1.0,1.0,0.0,3.0,28.0,15,3,12,,,
110113,9,2,7,21,0,9,46,80,7.0,2.0,5.0,13.0,0.0,7.0,35.0,26,9,17,18.0,7.0,11.0
12115,5,3,2,2,0,5,44,117,5.0,3.0,2.0,2.0,0.0,5.0,33.0,21,5,16,13.0,5.0,8.0
110091,5,4,1,1,3,2,3,153,2.0,2.0,0.0,0.0,2.0,0.0,0.0,10,5,5,4.0,4.0,0.0
9811367,12,3,9,25,2,10,36,8,11.0,2.0,9.0,25.0,2.0,9.0,22.0,24,12,12,6.0,4.0,2.0
207040,0,0,0,0,0,0,0,284,0.0,0.0,0.0,0.0,0.0,0.0,0.0,4,0,4,1.0,0.0,1.0
9811399,2,2,0,0,1,1,1,71,1.0,1.0,0.0,0.0,1.0,0.0,0.0,8,2,6,2.0,1.0,1.0
108157,6,1,5,11,6,0,0,215,6.0,1.0,5.0,11.0,6.0,0.0,0.0,9,6,3,6.0,6.0,0.0
202002,0,0,0,0,0,0,0,58,0.0,0.0,0.0,0.0,0.0,0.0,0.0,9,0,9,3.0,0.0,3.0
9905210,5,5,0,0,1,4,5,132,4.0,4.0,0.0,0.0,1.0,3.0,3.0,7,5,2,2.0,1.0,1.0
9403267,2,2,0,0,0,2,2,112,2.0,2.0,0.0,0.0,0.0,2.0,2.0,3,2,1,3.0,2.0,1.0
9610273,0,0,0,0,0,0,0,94,0.0,0.0,0.0,0.0,0.0,0.0,0.0,9,0,9,9.0,0.0,9.0
9807260,3,1,2,3,0,3,12,45,2.0,1.0,1.0,1.0,0.0,2.0,2.0,15,3,12,3.0,2.0,1.0
9708287,4,3,1,1,2,2,7,170,0.0,0.0,0.0,0.0,0.0,0.0,0.0,11,4,7,2.0,2.0,0.0
209174,4,2,2,3,0,4,69,53,4.0,2.0,2.0,3.0,0.0,4.0,66.0,41,4,37,33.0,4.0,29.0
207177,0,0,0,0,0,0,0,1,0.0,0.0,0.0,0.0,0.0,0.0,0.0,24,0,24,3.0,0.0,3.0
106080,5,2,3,5,4,1,1,84,1.0,1.0,0.0,0.0,0.0,1.0,1.0,11,5,6,3.0,1.0,2.0
9907277,2,2,0,0,2,0,0,313,0.0,0.0,0.0,0.0,0.0,0.0,0.0,4,2,2,2.0,0.0,2.0
9203207,6,2,4,10,6,0,0,333,5.0,1.0,4.0,10.0,5.0,0.0,0.0,6,6,0,5.0,5.0,0.0
11137,1,1,0,0,0,1,1,380,1.0,1.0,0.0,0.0,0.0,1.0,1.0,2,1,1,2.0,1.0,1.0
112022,4,3,1,2,0,4,49,1,4.0,3.0,1.0,2.0,0.0,4.0,47.0,27,4,23,18.0,3.0,15.0
9811287,0,0,0,0,0,0,0,349,0.0,0.0,0.0,0.0,0.0,0.0,0.0,1,0,1,,,
9608266,5,5,0,0,5,0,0,520,3.0,3.0,0.0,0.0,3.0,0.0,0.0,5,5,0,3.0,3.0,0.0
111185,4,2,2,3,3,1,1,127,3.0,1.0,2.0,3.0,2.0,1.0,1.0,6,4,2,,,
9806377,1,1,0,0,1,0,0,101,1.0,1.0,0.0,0.0,1.0,0.0,0.0,13,1,12,6.0,0.0,6.0
9408237,5,5,0,0,5,0,0,229,1.0,1.0,0.0,0.0,1.0,0.0,0.0,6,5,1,1.0,1.0,0.0
8112,1,1,0,0,0,1,1,367,0.0,0.0,0.0,0.0,0.0,0.0,0.0,4,1,3,3.0,1.0,2.0
9801213,1,1,0,0,0,1,4,15,0.0,0.0,0.0,0.0,0.0,0.0,0.0,12,1,11,1.0,0.0,1.0
209073,10,6,4,4,1,9,50,27,8.0,5.0,3.0,3.0,0.0,8.0,49.0,20,10,10,16.0,7.0,9.0
9906235,9,3,6,21,1,8,22,29,8.0,2.0,6.0,21.0,0.0,8.0,20.0,14,9,5,11.0,8.0,3.0
4199,1,1,0,0,0,1,2,228,1.0,1.0,0.0,0.0,0.0,1.0,2.0,6,1,5,4.0,0.0,4.0
9911446,3,2,1,1,0,3,23,21,1.0,1.0,0.0,0.0,0.0,1.0,3.0,16,3,13,5.0,1.0,4.0
9406222,3,2,1,1,3,0,0,516,3.0,2.0,1.0,1.0,3.0,0.0,0.0,3,3,0,3.0,3.0,0.0
9709371,9,5,4,6,2,7,18,115,7.0,4.0,3.0,5.0,1.0,6.0,15.0,17,9,8,5.0,5.0,0.0
111165,1,1,0,0,0,1,1,83,0.0,0.0,0.0,0.0,0.0,0.0,0.0,23,1,22,7.0,0.0,7.0
205280,2,1,1,1,0,2,9,37,0.0,0.0,0.0,0.0,0.0,0.0,0.0,11,2,9,3.0,1.0,2.0
9711202,5,5,0,0,1,4,8,141,3.0,3.0,0.0,0.0,0.0,3.0,6.0,10,5,5,4.0,2.0,2.0
9511232,2,2,0,0,0,2,6,124,1.0,1.0,0.0,0.0,0.0,1.0,4.0,8,2,6,1.0,1.0,0.0
9807547,2,2,0,0,0,2,11,36,2.0,2.0,0.0,0.0,0.0,2.0,9.0,75,2,73,40.0,0.0,40.0
205340,6,3,3,4,2,4,34,146,4.0,1.0,3.0,4.0,0.0,4.0,33.0,32,6,26,20.0,4.0,16.0
9704252,0,0,0,0,0,0,0,39,0.0,0.0,0.0,0.0,0.0,0.0,0.0,6,0,6,1.0,0.0,1.0
9708316,0,0,0,0,0,0,0,6,0.0,0.0,0.0,0.0,0.0,0.0,0.0,22,0,22,15.0,0.0,15.0
9905560,3,2,1,1,0,3,5,25,3.0,2.0,1.0,1.0,0.0,3.0,3.0,11,3,8,2.0,1.0,1.0
209105,1,1,0,0,0,1,7,20,1.0,1.0,0.0,0.0,0.0,1.0,7.0,15,1,14,1.0,1.0,0.0
212406,1,1,0,0,0,1,8,19,1.0,1.0,0.0,0.0,0.0,1.0,8.0,155,1,154,38.0,0.0,38.0
6219,1,1,0,0,0,1,5,59,1.0,1.0,0.0,0.0,0.0,1.0,5.0,8,1,7,8.0,1.0,7.0
9406305,2,2,0,0,0,2,2,159,2.0,2.0,0.0,0.0,0.0,2.0,2.0,3,2,1,3.0,2.0,1.0
9803282,8,4,4,4,2,6,24,130,4.0,1.0,3.0,3.0,0.0,4.0,19.0,17,8,9,8.0,3.0,5.0
9302264,0,0,0,0,0,0,0,1143,,,,,,,,1,0,1,,,
205188,1,1,0,0,1,0,0,671,1.0,1.0,0.0,0.0,1.0,0.0,0.0,1,1,0,1.0,1.0,0.0
9607435,1,1,0,0,0,1,1,120,1.0,1.0,0.0,0.0,1.0,0.0,0.0,2,1,1,1.0,1.0,0.0
211091,0,0,0,0,0,0,0,0,0.0,0.0,0.0,0.0,0.0,0.0,0.0,13,0,13,11.0,0.0,11.0
9605466,3,1,2,3,0,3,11,14,3.0,1.0,2.0,3.0,0.0,3.0,9.0,18,3,15,3.0,0.0,3.0
9401247,5,5,0,0,3,2,4,534,5.0,5.0,0.0,0.0,5.0,0.0,0.0,7,5,2,2.0,2.0,0.0
205007,3,3,0,0,0,3,35,20,2.0,2.0,0.0,0.0,0.0,2.0,26.0,48,3,45,6.0,1.0,5.0
8093,2,2,0,0,0,2,15,50,1.0,1.0,0.0,0.0,0.0,1.0,4.0,26,2,24,3.0,1.0,2.0
9906303,3,1,2,3,0,3,12,198,3.0,1.0,2.0,3.0,0.0,3.0,12.0,9,3,6,9.0,3.0,6.0
106265,0,0,0,0,0,0,0,1915,0.0,0.0,0.0,0.0,0.0,0.0,0.0,7,0,7,1.0,0.0,1.0
7264,0,0,0,0,0,0,0,397,0.0,0.0,0.0,0.0,0.0,0.0,0.0,2,0,2,1.0,0.0,1.0
106070,1,1,0,0,0,1,5,8,0.0,0.0,0.0,0.0,0.0,0.0,0.0,23,1,22,7.0,0.0,7.0
302143,0,0,0,0,0,0,0,220,0.0,0.0,0.0,0.0,0.0,0.0,0.0,4,0,4,3.0,0.0,3.0
9710470,3,3,0,0,3,0,0,60,0.0,0.0,0.0,0.0,0.0,0.0,0.0,5,3,2,1.0,1.0,0.0
9509224,2,2,0,0,2,0,0,292,1.0,1.0,0.0,0.0,1.0,0.0,0.0,2,2,0,1.0,1.0,0.0
110008,0,0,0,0,0,0,0,81,0.0,0.0,0.0,0.0,0.0,0.0,0.0,14,0,14,2.0,0.0,2.0
9511238,4,4,0,0,4,0,0,409,2.0,2.0,0.0,0.0,2.0,0.0,0.0,5,4,1,1.0,1.0,0.0
201068,0,0,0,0,0,0,0,23,0.0,0.0,0.0,0.0,0.0,0.0,0.0,21,0,21,1.0,0.0,1.0
9306,0,0,0,0,0,0,0,132,0.0,0.0,0.0,0.0,0.0,0.0,0.0,3,0,3,3.0,0.0,3.0
12045,0,0,0,0,0,0,0,101,0.0,0.0,0.0,0.0,0.0,0.0,0.0,10,0,10,5.0,0.0,5.0
9504384,2,2,0,0,1,1,7,71,1.0,1.0,0.0,0.0,0.0,1.0,7.0,10,2,8,1.0,1.0,0.0
210411,3,3,0,0,1,2,8,119,3.0,3.0,0.0,0.0,1.0,2.0,8.0,10,3,7,8.0,3.0,5.0
204324,2,1,1,1,2,0,0,420,1.0,1.0,0.0,0.0,1.0,0.0,0.0,6,2,4,2.0,0.0,2.0
212231,0,0,0,0,0,0,0,888,,,,,,,,2,0,2,1.0,0.0,1.0
9511453,1,1,0,0,1,0,0,93,0.0,0.0,0.0,0.0,0.0,0.0,0.0,13,1,12,10.0,0.0,10.0
9503482,0,0,0,0,0,0,0,1380,,,,,,,,1,0,1,,,
9805213,2,2,0,0,0,2,9,111,2.0,2.0,0.0,0.0,0.0,2.0,8.0,9,2,7,6.0,2.0,4.0
204287,3,2,1,1,0,3,8,16,0.0,0.0,0.0,0.0,0.0,0.0,0.0,26,3,23,16.0,0.0,16.0
9905308,4,3,1,1,1,3,9,16,0.0,0.0,0.0,0.0,0.0,0.0,0.0,16,4,12,3.0,0.0,3.0
9807571,0,0,0,0,0,0,0,5,,,,,,,,8,0,8,,,
9803209,3,2,1,1,2,1,1,311,3.0,2.0,1.0,1.0,2.0,1.0,1.0,10,3,7,4.0,2.0,2.0
9503270,2,1,1,1,1,1,2,134,2.0,1.0,1.0,1.0,2.0,0.0,0.0,7,2,5,4.0,2.0,2.0
9809219,0,0,0,0,0,0,0,77,,,,,,,,3,0,3,1.0,0.0,1.0
103329,1,1,0,0,0,1,10,44,0.0,0.0,0.0,0.0,0.0,0.0,0.0,16,1,15,12.0,1.0,11.0
7221,3,1,2,3,3,0,0,1920,,,,,,,,4,3,1,3.0,3.0,0.0
8111,1,1,0,0,0,1,3,264,0.0,0.0,0.0,0.0,0.0,0.0,0.0,9,1,8,2.0,0.0,2.0
9812408,0,0,0,0,0,0,0,148,0.0,0.0,0.0,0.0,0.0,0.0,0.0,3,0,3,1.0,0.0,1.0
205141,3,2,1,1,0,3,75,107,3.0,2.0,1.0,1.0,0.0,3.0,41.0,49,3,46,16.0,3.0,13.0
104252,7,4,3,3,0,7,28,9,0.0,0.0,0.0,0.0,0.0,0.0,0.0,47,7,40,6.0,2.0,4.0
9808271,1,1,0,0,0,1,1,76,1.0,1.0,0.0,0.0,0.0,1.0,1.0,4,1,3,4.0,1.0,3.0
9607365,1,1,0,0,1,0,0,1993,,,,,,,,1,1,0,,,
9706481,0,0,0,0,0,0,0,53,0.0,0.0,0.0,0.0,0.0,0.0,0.0,23,0,23,16.0,0.0,16.0
9405284,1,1,0,0,1,0,0,196,0.0,0.0,0.0,0.0,0.0,0.0,0.0,6,1,5,4.0,0.0,4.0
207120,4,3,1,1,1,3,8,45,2.0,2.0,0.0,0.0,0.0,2.0,5.0,16,4,12,1.0,1.0,0.0
9504223,0,0,0,0,0,0,0,94,0.0,0.0,0.0,0.0,0.0,0.0,0.0,4,0,4,,,
9704391,0,0,0,0,0,0,0,78,0.0,0.0,0.0,0.0,0.0,0.0,0.0,4,0,4,2.0,0.0,2.0
9709206,0,0,0,0,0,0,0,108,0.0,0.0,0.0,0.0,0.0,0.0,0.0,8,0,8,2.0,0.0,2.0
110084,3,2,1,1,1,2,2,170,1.0,1.0,0.0,0.0,0.0,1.0,1.0,13,3,10,5.0,0.0,5.0
9401318,1,1,0,0,1,0,0,176,,,,,,,,1,1,0,,,
205224,4,2,2,2,1,3,18,81,3.0,2.0,1.0,1.0,0.0,3.0,16.0,19,4,15,7.0,2.0,5.0
9608362,0,0,0,0,0,0,0,311,0.0,0.0,0.0,0.0,0.0,0.0,0.0,4,0,4,,,
9612339,0,0,0,0,0,0,0,245,0.0,0.0,0.0,0.0,0.0,0.0,0.0,7,0,7,3.0,0.0,3.0
201106,3,3,0,0,0,3,15,2,1.0,1.0,0.0,0.0,0.0,1.0,3.0,24,3,21,8.0,1.0,7.0
9603283,5,3,2,2,1,4,4,134,3.0,3.0,0.0,0.0,0.0,3.0,3.0,6,5,1,2.0,2.0,0.0
4126,2,2,0,0,1,1,2,199,1.0,1.0,0.0,0.0,0.0,1.0,2.0,6,2,4,3.0,1.0,2.0
9403275,2,2,0,0,1,1,2,99,2.0,2.0,0.0,0.0,1.0,1.0,1.0,5,2,3,3.0,1.0,2.0
9602398,3,1,2,3,2,1,1,242,3.0,1.0,2.0,3.0,3.0,0.0,0.0,5,3,2,,,
212306,0,0,0,0,0,0,0,2062,0.0,0.0,0.0,0.0,0.0,0.0,0.0,4,0,4,,,
9709404,3,3,0,0,1,2,2,227,2.0,2.0,0.0,0.0,0.0,2.0,2.0,4,3,1,2.0,1.0,1.0
301105,0,0,0,0,0,0,0,612,0.0,0.0,0.0,0.0,0.0,0.0,0.0,7,0,7,2.0,0.0,2.0
9712431,2,1,1,1,1,1,3,40,2.0,1.0,1.0,1.0,2.0,0.0,0.0,6,2,4,1.0,1.0,0.0
209038,3,1,2,2,0,3,27,45,3.0,1.0,2.0,2.0,0.0,3.0,27.0,33,3,30,26.0,2.0,24.0
9712207,1,1,0,0,1,0,0,1986,,,,,,,,4,1,3,,,
111081,0,0,0,0,0,0,0,157,0.0,0.0,0.0,0.0,0.0,0.0,0.0,3,0,3,1.0,0.0,1.0
103107,2,2,0,0,2,0,0,72,2.0,2.0,0.0,0.0,2.0,0.0,0.0,2,2,0,2.0,2.0,0.0
9909226,0,0,0,0,0,0,0,8,,,,,,,,4,0,4,,,
9404358,2,2,0,0,2,0,0,341,1.0,1.0,0.0,0.0,1.0,0.0,0.0,2,2,0,,,
301137,1,1,0,0,1,0,0,79,1.0,1.0,0.0,0.0,1.0,0.0,0.0,1,1,0,1.0,1.0,0.0
102309,1,1,0,0,1,0,0,146,1.0,1.0,0.0,0.0,1.0,0.0,0.0,2,1,1,1.0,1.0,0.0
9906333,0,0,0,0,0,0,0,109,0.0,0.0,0.0,0.0,0.0,0.0,0.0,18,0,18,7.0,0.0,7.0
9710202,1,1,0,0,0,1,1,141,1.0,1.0,0.0,0.0,0.0,1.0,1.0,2,1,1,2.0,1.0,1.0
2294,0,0,0,0,0,0,0,70,0.0,0.0,0.0,0.0,0.0,0.0,0.0,11,0,11,1.0,0.0,1.0
211394,4,4,0,0,1,3,24,46,2.0,2.0,0.0,0.0,0.0,2.0,17.0,32,4,28,4.0,1.0,3.0
9504236,1,1,0,0,1,0,0,328,1.0,1.0,0.0,0.0,1.0,0.0,0.0,1,1,0,,,
9603275,1,1,0,0,0,1,3,17,0.0,0.0,0.0,0.0,0.0,0.0,0.0,10,1,9,1.0,1.0,0.0
9511262,3,2,1,1,3,0,0,340,2.0,1.0,1.0,1.0,2.0,0.0,0.0,3,3,0,2.0,2.0,0.0
106309,3,2,1,1,1,2,4,70,2.0,1.0,1.0,1.0,1.0,1.0,1.0,9,3,6,4.0,2.0,2.0
9708402,2,1,1,1,0,2,25,35,2.0,1.0,1.0,1.0,0.0,2.0,23.0,18,2,16,11.0,2.0,9.0
9605202,0,0,0,0,0,0,0,235,0.0,0.0,0.0,0.0,0.0,0.0,0.0,7,0,7,1.0,0.0,1.0
9606227,1,1,0,0,0,1,5,61,1.0,1.0,0.0,0.0,0.0,1.0,5.0,11,1,10,7.0,1.0,6.0
9709472,1,1,0,0,1,0,0,120,0.0,0.0,0.0,0.0,0.0,0.0,0.0,11,1,10,3.0,0.0,3.0
9607391,1,1,0,0,1,0,0,358,1.0,1.0,0.0,0.0,1.0,0.0,0.0,3,1,2,1.0,1.0,0.0
9507385,0,0,0,0,0,0,0,570,0.0,0.0,0.0,0.0,0.0,0.0,0.0,2,0,2,2.0,0.0,2.0
9304297,1,1,0,0,1,0,0,213,1.0,1.0,0.0,0.0,1.0,0.0,0.0,1,1,0,1.0,1.0,0.0
211275,1,1,0,0,0,1,3,31,0.0,0.0,0.0,0.0,0.0,0.0,0.0,30,1,29,11.0,1.0,10.0
108107,1,1,0,0,1,0,0,813,1.0,1.0,0.0,0.0,1.0,0.0,0.0,3,1,2,,,
9710499,1,1,0,0,0,1,3,17,1.0,1.0,0.0,0.0,0.0,1.0,1.0,13,1,12,1.0,0.0,1.0
9806276,0,0,0,0,0,0,0,27,0.0,0.0,0.0,0.0,0.0,0.0,0.0,8,0,8,,,
211450,0,0,0,0,0,0,0,129,0.0,0.0,0.0,0.0,0.0,0.0,0.0,6,0,6,1.0,0.0,1.0
9905570,1,1,0,0,1,0,0,115,0.0,0.0,0.0,0.0,0.0,0.0,0.0,16,1,15,9.0,0.0,9.0
9704426,2,2,0,0,0,2,4,432,2.0,2.0,0.0,0.0,0.0,2.0,2.0,6,2,4,4.0,2.0,2.0
9706216,0,0,0,0,0,0,0,70,0.0,0.0,0.0,0.0,0.0,0.0,0.0,7,0,7,,,
210405,1,1,0,0,0,1,6,24,0.0,0.0,0.0,0.0,0.0,0.0,0.0,29,1,28,5.0,0.0,5.0
110385,0,0,0,0,0,0,0,42,,,,,,,,2,0,2,,,
12265,0,0,0,0,0,0,0,587,0.0,0.0,0.0,0.0,0.0,0.0,0.0,2,0,2,1.0,0.0,1.0
202026,1,1,0,0,0,1,2,71,1.0,1.0,0.0,0.0,0.0,1.0,1.0,8,1,7,4.0,1.0,3.0
203078,1,1,0,0,0,1,6,158,1.0,1.0,0.0,0.0,0.0,1.0,5.0,10,1,9,7.0,1.0,6.0
111408,0,0,0,0,0,0,0,59,0.0,0.0,0.0,0.0,0.0,0.0,0.0,2,0,2,2.0,0.0,2.0
112107,0,0,0,0,0,0,0,656,0.0,0.0,0.0,0.0,0.0,0.0,0.0,3,0,3,3.0,0.0,3.0
111391,2,2,0,0,0,2,16,9,1.0,1.0,0.0,0.0,0.0,1.0,5.0,25,2,23,6.0,1.0,5.0
9502239,1,1,0,0,0,1,1,75,,,,,,,,8,1,7,,,
201108,1,1,0,0,0,1,1,404,1.0,1.0,0.0,0.0,0.0,1.0,1.0,3,1,2,2.0,1.0,1.0
9906405,0,0,0,0,0,0,0,1320,0.0,0.0,0.0,0.0,0.0,0.0,0.0,3,0,3,1.0,0.0,1.0
112035,1,1,0,0,0,1,19,30,1.0,1.0,0.0,0.0,0.0,1.0,8.0,25,1,24,6.0,1.0,5.0
9905535,1,1,0,0,1,0,0,27,0.0,0.0,0.0,0.0,0.0,0.0,0.0,10,1,9,1.0,1.0,0.0
8224,4,3,1,1,1,3,9,11,2.0,1.0,1.0,1.0,0.0,2.0,6.0,18,4,14,9.0,1.0,8.0
9803270,2,1,1,1,0,2,9,379,2.0,1.0,1.0,1.0,0.0,2.0,5.0,9,2,7,5.0,2.0,3.0
207076,1,1,0,0,0,1,6,14,0.0,0.0,0.0,0.0,0.0,0.0,0.0,28,1,27,4.0,0.0,4.0
302149,0,0,0,0,0,0,0,41,0.0,0.0,0.0,0.0,0.0,0.0,0.0,31,0,31,5.0,0.0,5.0
210310,2,2,0,0,0,2,25,17,1.0,1.0,0.0,0.0,0.0,1.0,11.0,33,2,31,8.0,1.0,7.0
6186,0,0,0,0,0,0,0,85,0.0,0.0,0.0,0.0,0.0,0.0,0.0,8,0,8,,,
9410410,1,1,0,0,1,0,0,253,1.0,1.0,0.0,0.0,1.0,0.0,0.0,4,1,3,1.0,1.0,0.0
111232,1,1,0,0,0,1,8,16,0.0,0.0,0.0,0.0,0.0,0.0,0.0,72,1,71,13.0,0.0,13.0
209254,1,1,0,0,1,0,0,257,0.0,0.0,0.0,0.0,0.0,0.0,0.0,11,1,10,4.0,0.0,4.0
110297,3,3,0,0,0,3,7,178,2.0,2.0,0.0,0.0,0.0,2.0,5.0,15,3,12,7.0,2.0,5.0
9802377,2,1,1,1,1,1,1,119,1.0,1.0,0.0,0.0,0.0,1.0,1.0,10,2,8,3.0,2.0,1.0
210200,1,1,0,0,0,1,4,161,1.0,1.0,0.0,0.0,0.0,1.0,2.0,20,1,19,10.0,1.0,9.0
9812362,0,0,0,0,0,0,0,89,0.0,0.0,0.0,0.0,0.0,0.0,0.0,9,0,9,5.0,0.0,5.0
301146,0,0,0,0,0,0,0,16,0.0,0.0,0.0,0.0,0.0,0.0,0.0,11,0,11,2.0,0.0,2.0
211083,2,2,0,0,1,1,2,14,1.0,1.0,0.0,0.0,1.0,0.0,0.0,11,2,9,2.0,0.0,2.0
9908487,0,0,0,0,0,0,0,597,0.0,0.0,0.0,0.0,0.0,0.0,0.0,7,0,7,1.0,0.0,1.0
210098,1,1,0,0,0,1,6,201,1.0,1.0,0.0,0.0,0.0,1.0,5.0,9,1,8,7.0,1.0,6.0
211347,0,0,0,0,0,0,0,10,0.0,0.0,0.0,0.0,0.0,0.0,0.0,72,0,72,16.0,0.0,16.0
302025,1,1,0,0,0,1,7,3,0.0,0.0,0.0,0.0,0.0,0.0,0.0,24,1,23,6.0,0.0,6.0
103120,1,1,0,0,1,0,0,7,0.0,0.0,0.0,0.0,0.0,0.0,0.0,18,1,17,6.0,0.0,6.0
9503378,1,1,0,0,1,0,0,11,1.0,1.0,0.0,0.0,1.0,0.0,0.0,6,1,5,1.0,1.0,0.0
9507338,3,3,0,0,1,2,8,363,2.0,2.0,0.0,0.0,0.0,2.0,3.0,15,3,12,3.0,1.0,2.0
9812306,3,3,0,0,1,2,2,56,1.0,1.0,0.0,0.0,1.0,0.0,0.0,9,3,6,1.0,1.0,0.0
209260,1,1,0,0,0,1,4,34,1.0,1.0,0.0,0.0,0.0,1.0,4.0,16,1,15,9.0,1.0,8.0
212339,1,1,0,0,0,1,1,207,1.0,1.0,0.0,0.0,0.0,1.0,1.0,12,1,11,2.0,0.0,2.0
204033,0,0,0,0,0,0,0,26,0.0,0.0,0.0,0.0,0.0,0.0,0.0,37,0,37,19.0,0.0,19.0
111177,1,1,0,0,1,0,0,1,1.0,1.0,0.0,0.0,1.0,0.0,0.0,19,1,18,2.0,0.0,2.0
12079,0,0,0,0,0,0,0,32,0.0,0.0,0.0,0.0,0.0,0.0,0.0,35,0,35,3.0,0.0,3.0
9809408,0,0,0,0,0,0,0,112,0.0,0.0,0.0,0.0,0.0,0.0,0.0,1,0,1,1.0,0.0,1.0
9504370,0,0,0,0,0,0,0,265,0.0,0.0,0.0,0.0,0.0,0.0,0.0,5,0,5,2.0,0.0,2.0
212233,0,0,0,0,0,0,0,327,0.0,0.0,0.0,0.0,0.0,0.0,0.0,1,0,1,1.0,0.0,1.0
9906532,0,0,0,0,0,0,0,9,0.0,0.0,0.0,0.0,0.0,0.0,0.0,46,0,46,7.0,0.0,7.0
102282,2,1,1,1,2,0,0,224,1.0,1.0,0.0,0.0,1.0,0.0,0.0,5,2,3,2.0,1.0,1.0
105346,0,0,0,0,0,0,0,257,0.0,0.0,0.0,0.0,0.0,0.0,0.0,4,0,4,1.0,0.0,1.0
9402257,1,1,0,0,1,0,0,295,1.0,1.0,0.0,0.0,1.0,0.0,0.0,1,1,0,1.0,1.0,0.0
301066,0,0,0,0,0,0,0,427,0.0,0.0,0.0,0.0,0.0,0.0,0.0,2,0,2,1.0,0.0,1.0
9609398,1,1,0,0,0,1,1,66,0.0,0.0,0.0,0.0,0.0,0.0,0.0,20,1,19,1.0,0.0,1.0
9305211,0,0,0,0,0,0,0,1336,0.0,0.0,0.0,0.0,0.0,0.0,0.0,1,0,1,,,
302095,0,0,0,0,0,0,0,17,0.0,0.0,0.0,0.0,0.0,0.0,0.0,18,0,18,5.0,0.0,5.0
207116,1,1,0,0,0,1,1,521,1.0,1.0,0.0,0.0,0.0,1.0,1.0,2,1,1,2.0,1.0,1.0
11063,0,0,0,0,0,0,0,2,,,,,,,,8,0,8,,,
9911417,0,0,0,0,0,0,0,426,0.0,0.0,0.0,0.0,0.0,0.0,0.0,1,0,1,1.0,0.0,1.0
301054,0,0,0,0,0,0,0,16,0.0,0.0,0.0,0.0,0.0,0.0,0.0,8,0,8,8.0,0.0,8.0
9907543,1,1,0,0,1,0,0,105,0.0,0.0,0.0,0.0,0.0,0.0,0.0,7,1,6,5.0,0.0,5.0
9909264,0,0,0,0,0,0,0,336,0.0,0.0,0.0,0.0,0.0,0.0,0.0,1,0,1,,,
212286,1,1,0,0,0,1,16,52,1.0,1.0,0.0,0.0,0.0,1.0,14.0,17,1,16,13.0,1.0,12.0
9805408,0,0,0,0,0,0,0,33,0.0,0.0,0.0,0.0,0.0,0.0,0.0,11,0,11,4.0,0.0,4.0
12339,0,0,0,0,0,0,0,1813,,,,,,,,1,0,1,1.0,0.0,1.0
302119,0,0,0,0,0,0,0,72,,,,,,,,1,0,1,,,
9802208,0,0,0,0,0,0,0,486,0.0,0.0,0.0,0.0,0.0,0.0,0.0,1,0,1,1.0,0.0,1.0
302199,0,0,0,0,0,0,0,191,0.0,0.0,0.0,0.0,0.0,0.0,0.0,6,0,6,4.0,0.0,4.0
9707440,1,1,0,0,0,1,3,22,,,,,,,,5,1,4,,,
9602428,0,0,0,0,0,0,0,44,0.0,0.0,0.0,0.0,0.0,0.0,0.0,7,0,7,2.0,0.0,2.0
209292,0,0,0,0,0,0,0,108,0.0,0.0,0.0,0.0,0.0,0.0,0.0,6,0,6,,,
211079,0,0,0,0,0,0,0,64,0.0,0.0,0.0,0.0,0.0,0.0,0.0,6,0,6,4.0,0.0,4.0
212094,0,0,0,0,0,0,0,17,0.0,0.0,0.0,0.0,0.0,0.0,0.0,20,0,20,9.0,0.0,9.0
105286,0,0,0,0,0,0,0,20,0.0,0.0,0.0,0.0,0.0,0.0,0.0,14,0,14,1.0,0.0,1.0
105240,1,1,0,0,0,1,7,24,1.0,1.0,0.0,0.0,0.0,1.0,6.0,31,1,30,17.0,1.0,16.0
212297,0,0,0,0,0,0,0,24,0.0,0.0,0.0,0.0,0.0,0.0,0.0,17,0,17,6.0,0.0,6.0
9301230,1,1,0,0,1,0,0,345,1.0,1.0,0.0,0.0,1.0,0.0,0.0,1,1,0,1.0,1.0,0.0
9258,0,0,0,0,0,0,0,187,0.0,0.0,0.0,0.0,0.0,0.0,0.0,3,0,3,1.0,0.0,1.0
201280,1,1,0,0,0,1,1,585,0.0,0.0,0.0,0.0,0.0,0.0,0.0,3,1,2,2.0,1.0,1.0
212097,2,1,1,1,0,2,26,19,2.0,1.0,1.0,1.0,0.0,2.0,26.0,38,2,36,27.0,1.0,26.0
209063,2,2,0,0,0,2,27,2,1.0,1.0,0.0,0.0,0.0,1.0,7.0,29,2,27,15.0,1.0,14.0
106172,0,0,0,0,0,0,0,115,,,,,,,,5,0,5,,,
101107,1,1,0,0,0,1,2,90,1.0,1.0,0.0,0.0,0.0,1.0,2.0,9,1,8,3.0,0.0,3.0
201271,2,2,0,0,0,2,9,33,1.0,1.0,0.0,0.0,0.0,1.0,5.0,18,2,16,2.0,1.0,1.0
9807288,0,0,0,0,0,0,0,148,0.0,0.0,0.0,0.0,0.0,0.0,0.0,3,0,3,2.0,0.0,2.0
9412211,0,0,0,0,0,0,0,232,0.0,0.0,0.0,0.0,0.0,0.0,0.0,1,0,1,1.0,0.0,1.0
301153,0,0,0,0,0,0,0,23,0.0,0.0,0.0,0.0,0.0,0.0,0.0,10,0,10,3.0,0.0,3.0
106222,4,3,1,1,1,3,3,121,3.0,2.0,1.0,1.0,0.0,3.0,3.0,5,4,1,4.0,3.0,1.0
9905342,1,1,0,0,0,1,12,9,1.0,1.0,0.0,0.0,0.0,1.0,12.0,19,1,18,3.0,1.0,2.0
9406425,0,0,0,0,0,0,0,220,0.0,0.0,0.0,0.0,0.0,0.0,0.0,4,0,4,1.0,0.0,1.0
107236,2,2,0,0,0,2,9,321,2.0,2.0,0.0,0.0,0.0,2.0,7.0,8,2,6,6.0,2.0,4.0
9605308,0,0,0,0,0,0,0,1334,,,,,,,,2,0,2,,,
9810462,0,0,0,0,0,0,0,225,0.0,0.0,0.0,0.0,0.0,0.0,0.0,3,0,3,2.0,0.0,2.0
211234,0,0,0,0,0,0,0,131,0.0,0.0,0.0,0.0,0.0,0.0,0.0,9,0,9,4.0,0.0,4.0
208244,0,0,0,0,0,0,0,31,0.0,0.0,0.0,0.0,0.0,0.0,0.0,13,0,13,4.0,0.0,4.0
12064,0,0,0,0,0,0,0,277,0.0,0.0,0.0,0.0,0.0,0.0,0.0,7,0,7,7.0,0.0,7.0
3248,0,0,0,0,0,0,0,4,0.0,0.0,0.0,0.0,0.0,0.0,0.0,9,0,9,,,
211343,1,1,0,0,0,1,3,4,0.0,0.0,0.0,0.0,0.0,0.0,0.0,15,1,14,3.0,0.0,3.0
9910564,0,0,0,0,0,0,0,194,0.0,0.0,0.0,0.0,0.0,0.0,0.0,2,0,2,2.0,0.0,2.0
9810326,0,0,0,0,0,0,0,5,0.0,0.0,0.0,0.0,0.0,0.0,0.0,15,0,15,3.0,0.0,3.0
9412207,0,0,0,0,0,0,0,1408,,,,,,,,2,0,2,,,
9605320,0,0,0,0,0,0,0,1557,,,,,,,,1,0,1,,,
208094,0,0,0,0,0,0,0,45,0.0,0.0,0.0,0.0,0.0,0.0,0.0,15,0,15,12.0,0.0,12.0
9604291,0,0,0,0,0,0,0,2063,,,,,,,,1,0,1,,,
205187,2,2,0,0,0,2,15,201,2.0,2.0,0.0,0.0,0.0,2.0,15.0,11,2,9,11.0,2.0,9.0
204239,0,0,0,0,0,0,0,166,0.0,0.0,0.0,0.0,0.0,0.0,0.0,13,0,13,3.0,0.0,3.0
9709434,0,0,0,0,0,0,0,310,0.0,0.0,0.0,0.0,0.0,0.0,0.0,5,0,5,5.0,0.0,5.0
12329,0,0,0,0,0,0,0,1079,,,,,,,,1,0,1,1.0,0.0,1.0
9504341,1,1,0,0,1,0,0,127,,,,,,,,1,1,0,1.0,1.0,0.0
212046,0,0,0,0,0,0,0,118,0.0,0.0,0.0,0.0,0.0,0.0,0.0,10,0,10,2.0,0.0,2.0
101222,0,0,0,0,0,0,0,98,0.0,0.0,0.0,0.0,0.0,0.0,0.0,1,0,1,1.0,0.0,1.0
206244,0,0,0,0,0,0,0,1972,,,,,,,,1,0,1,,,
112272,1,1,0,0,0,1,2,107,1.0,1.0,0.0,0.0,0.0,1.0,2.0,12,1,11,7.0,0.0,7.0
210259,0,0,0,0,0,0,0,308,0.0,0.0,0.0,0.0,0.0,0.0,0.0,12,0,12,3.0,0.0,3.0
212176,0,0,0,0,0,0,0,57,0.0,0.0,0.0,0.0,0.0,0.0,0.0,22,0,22,2.0,0.0,2.0
209019,0,0,0,0,0,0,0,0,0.0,0.0,0.0,0.0,0.0,0.0,0.0,13,0,13,5.0,0.0,5.0
9712424,0,0,0,0,0,0,0,10,0.0,0.0,0.0,0.0,0.0,0.0,0.0,18,0,18,3.0,0.0,3.0
107202,4,4,0,0,0,4,39,14,2.0,2.0,0.0,0.0,0.0,2.0,35.0,25,4,21,17.0,2.0,15.0
209204,0,0,0,0,0,0,0,39,0.0,0.0,0.0,0.0,0.0,0.0,0.0,20,0,20,8.0,0.0,8.0
302077,0,0,0,0,0,0,0,20,0.0,0.0,0.0,0.0,0.0,0.0,0.0,18,0,18,1.0,0.0,1.0
209268,1,1,0,0,0,1,3,30,0.0,0.0,0.0,0.0,0.0,0.0,0.0,12,1,11,3.0,0.0,3.0
212073,0,0,0,0,0,0,0,41,,,,,,,,8,0,8,,,
209298,0,0,0,0,0,0,0,57,0.0,0.0,0.0,0.0,0.0,0.0,0.0,14,0,14,2.0,0.0,2.0
101243,1,1,0,0,0,1,3,98,1.0,1.0,0.0,0.0,0.0,1.0,3.0,9,1,8,1.0,1.0,0.0
208161,0,0,0,0,0,0,0,118,0.0,0.0,0.0,0.0,0.0,0.0,0.0,2,0,2,1.0,0.0,1.0
212114,0,0,0,0,0,0,0,48,0.0,0.0,0.0,0.0,0.0,0.0,0.0,34,0,34,10.0,0.0,10.0
302184,1,1,0,0,0,1,10,45,1.0,1.0,0.0,0.0,0.0,1.0,10.0,30,1,29,19.0,1.0,18.0
106273,0,0,0,0,0,0,0,722,0.0,0.0,0.0,0.0,0.0,0.0,0.0,1,0,1,1.0,0.0,1.0
6033,1,1,0,0,0,1,9,70,1.0,1.0,0.0,0.0,0.0,1.0,9.0,19,1,18,17.0,0.0,17.0
9601286,1,1,0,0,1,0,0,35,0.0,0.0,0.0,0.0,0.0,0.0,0.0,24,1,23,4.0,0.0,4.0
207323,1,1,0,0,0,1,2,350,1.0,1.0,0.0,0.0,0.0,1.0,2.0,5,1,4,1.0,0.0,1.0
209276,0,0,0,0,0,0,0,65,0.0,0.0,0.0,0.0,0.0,0.0,0.0,24,0,24,18.0,0.0,18.0
9706422,0,0,0,0,0,0,0,1161,,,,,,,,3,0,3,1.0,0.0,1.0
111364,0,0,0,0,0,0,0,118,,,,,,,,2,0,2,1.0,0.0,1.0
9909346,1,1,0,0,0,1,3,80,1.0,1.0,0.0,0.0,0.0,1.0,1.0,13,1,12,2.0,1.0,1.0
110190,0,0,0,0,0,0,0,971,0.0,0.0,0.0,0.0,0.0,0.0,0.0,3,0,3,,,
212065,0,0,0,0,0,0,0,100,0.0,0.0,0.0,0.0,0.0,0.0,0.0,2,0,2,,,
9601312,0,0,0,0,0,0,0,25,0.0,0.0,0.0,0.0,0.0,0.0,0.0,5,0,5,,,
111371,0,0,0,0,0,0,0,42,,,,,,,,4,0,4,,,
9607368,0,0,0,0,0,0,0,1386,,,,,,,,1,0,1,,,
9511312,0,0,0,0,0,0,0,256,0.0,0.0,0.0,0.0,0.0,0.0,0.0,12,0,12,3.0,0.0,3.0
302231,0,0,0,0,0,0,0,108,0.0,0.0,0.0,0.0,0.0,0.0,0.0,18,0,18,6.0,0.0,6.0
9808339,0,0,0,0,0,0,0,38,0.0,0.0,0.0,0.0,0.0,0.0,0.0,6,0,6,2.0,0.0,2.0
202273,0,0,0,0,0,0,0,196,0.0,0.0,0.0,0.0,0.0,0.0,0.0,2,0,2,1.0,0.0,1.0
209090,0,0,0,0,0,0,0,70,0.0,0.0,0.0,0.0,0.0,0.0,0.0,14,0,14,2.0,0.0,2.0
211401,0,0,0,0,0,0,0,1039,0.0,0.0,0.0,0.0,0.0,0.0,0.0,5,0,5,,,
9707343,0,0,0,0,0,0,0,353,0.0,0.0,0.0,0.0,0.0,0.0,0.0,1,0,1,1.0,0.0,1.0
9810256,0,0,0,0,0,0,0,430,0.0,0.0,0.0,0.0,0.0,0.0,0.0,4,0,4,1.0,0.0,1.0
9709456,0,0,0,0,0,0,0,1243,,,,,,,,1,0,1,,,
111400,0,0,0,0,0,0,0,11,0.0,0.0,0.0,0.0,0.0,0.0,0.0,21,0,21,21.0,0.0,21.0
202164,0,0,0,0,0,0,0,22,0.0,0.0,0.0,0.0,0.0,0.0,0.0,9,0,9,,,
9505375,0,0,0,0,0,0,0,528,0.0,0.0,0.0,0.0,0.0,0.0,0.0,2,0,2,2.0,0.0,2.0
9608356,0,0,0,0,0,0,0,94,0.0,0.0,0.0,0.0,0.0,0.0,0.0,19,0,19,9.0,0.0,9.0
105070,0,0,0,0,0,0,0,4,0.0,0.0,0.0,0.0,0.0,0.0,0.0,30,0,30,3.0,0.0,3.0
9504401,0,0,0,0,0,0,0,114,0.0,0.0,0.0,0.0,0.0,0.0,0.0,8,0,8,3.0,0.0,3.0
9709378,0,0,0,0,0,0,0,2056,,,,,,,,3,0,3,,,
111399,1,1,0,0,0,1,3,268,1.0,1.0,0.0,0.0,0.0,1.0,3.0,5,1,4,5.0,1.0,4.0
9404300,0,0,0,0,0,0,0,164,0.0,0.0,0.0,0.0,0.0,0.0,0.0,12,0,12,5.0,0.0,5.0
9910385,0,0,0,0,0,0,0,31,,,,,,,,4,0,4,,,
8239,0,0,0,0,0,0,0,38,0.0,0.0,0.0,0.0,0.0,0.0,0.0,7,0,7,3.0,0.0,3.0
9404256,0,0,0,0,0,0,0,959,,,,,,,,3,0,3,,,
9712272,0,0,0,0,0,0,0,260,0.0,0.0,0.0,0.0,0.0,0.0,0.0,8,0,8,1.0,0.0,1.0
112105,1,1,0,0,0,1,16,83,1.0,1.0,0.0,0.0,0.0,1.0,11.0,20,1,19,12.0,1.0,11.0
9604350,0,0,0,0,0,0,0,115,0.0,0.0,0.0,0.0,0.0,0.0,0.0,4,0,4,1.0,0.0,1.0
9501393,0,0,0,0,0,0,0,60,0.0,0.0,0.0,0.0,0.0,0.0,0.0,5,0,5,1.0,0.0,1.0
9806393,1,1,0,0,0,1,1,743,1.0,1.0,0.0,0.0,1.0,0.0,0.0,4,1,3,1.0,1.0,0.0
112240,0,0,0,0,0,0,0,139,0.0,0.0,0.0,0.0,0.0,0.0,0.0,7,0,7,4.0,0.0,4.0
3062,0,0,0,0,0,0,0,735,0.0,0.0,0.0,0.0,0.0,0.0,0.0,1,0,1,1.0,0.0,1.0
9411421,3,3,0,0,3,0,0,214,2.0,2.0,0.0,0.0,2.0,0.0,0.0,3,3,0,2.0,2.0,0.0
12198,0,0,0,0,0,0,0,16,0.0,0.0,0.0,0.0,0.0,0.0,0.0,7,0,7,1.0,0.0,1.0
212328,0,0,0,0,0,0,0,736,0.0,0.0,0.0,0.0,0.0,0.0,0.0,2,0,2,1.0,0.0,1.0
110009,1,1,0,0,0,1,4,44,1.0,1.0,0.0,0.0,0.0,1.0,4.0,28,1,27,9.0,1.0,8.0
9903316,0,0,0,0,0,0,0,82,0.0,0.0,0.0,0.0,0.0,0.0,0.0,3,0,3,1.0,0.0,1.0
112327,0,0,0,0,0,0,0,0,,,,,,,,8,0,8,,,
205193,0,0,0,0,0,0,0,9,0.0,0.0,0.0,0.0,0.0,0.0,0.0,30,0,30,1.0,0.0,1.0
201126,0,0,0,0,0,0,0,41,0.0,0.0,0.0,0.0,0.0,0.0,0.0,33,0,33,4.0,0.0,4.0
204219,0,0,0,0,0,0,0,7,0.0,0.0,0.0,0.0,0.0,0.0,0.0,46,0,46,19.0,0.0,19.0
9301,0,0,0,0,0,0,0,145,0.0,0.0,0.0,0.0,0.0,0.0,0.0,8,0,8,7.0,0.0,7.0
105342,0,0,0,0,0,0,0,9,0.0,0.0,0.0,0.0,0.0,0.0,0.0,7,0,7,5.0,0.0,5.0
9607224,0,0,0,0,0,0,0,998,,,,,,,,1,0,1,,,
9704289,0,0,0,0,0,0,0,55,,,,,,,,2,0,2,,,
9604408,0,0,0,0,0,0,0,330,0.0,0.0,0.0,0.0,0.0,0.0,0.0,2,0,2,,,
9702335,0,0,0,0,0,0,0,132,0.0,0.0,0.0,0.0,0.0,0.0,0.0,2,0,2,1.0,0.0,1.0
9608473,0,0,0,0,0,0,0,84,0.0,0.0,0.0,0.0,0.0,0.0,0.0,7,0,7,1.0,0.0,1.0
12302,0,0,0,0,0,0,0,560,0.0,0.0,0.0,0.0,0.0,0.0,0.0,2,0,2,2.0,0.0,2.0
112096,0,0,0,0,0,0,0,72,0.0,0.0,0.0,0.0,0.0,0.0,0.0,10,0,10,5.0,0.0,5.0
3127,0,0,0,0,0,0,0,1436,,,,,,,,1,0,1,,,
9310366,0,0,0,0,0,0,0,207,0.0,0.0,0.0,0.0,0.0,0.0,0.0,10,0,10,,,
9806338,1,1,0,0,1,0,0,198,0.0,0.0,0.0,0.0,0.0,0.0,0.0,6,1,5,1.0,0.0,1.0
201238,0,0,0,0,0,0,0,42,0.0,0.0,0.0,0.0,0.0,0.0,0.0,6,0,6,6.0,0.0,6.0
9305,0,0,0,0,0,0,0,119,0.0,0.0,0.0,0.0,0.0,0.0,0.0,3,0,3,1.0,0.0,1.0
9307246,1,1,0,0,1,0,0,200,1.0,1.0,0.0,0.0,1.0,0.0,0.0,2,1,1,2.0,1.0,1.0
9803392,0,0,0,0,0,0,0,374,0.0,0.0,0.0,0.0,0.0,0.0,0.0,3,0,3,1.0,0.0,1.0
9501239,0,0,0,0,0,0,0,116,0.0,0.0,0.0,0.0,0.0,0.0,0.0,10,0,10,3.0,0.0,3.0
112136,0,0,0,0,0,0,0,21,0.0,0.0,0.0,0.0,0.0,0.0,0.0,25,0,25,1.0,0.0,1.0
111121,0,0,0,0,0,0,0,31,0.0,0.0,0.0,0.0,0.0,0.0,0.0,14,0,14,4.0,0.0,4.0
11106,0,0,0,0,0,0,0,264,0.0,0.0,0.0,0.0,0.0,0.0,0.0,4,0,4,,,
211100,0,0,0,0,0,0,0,2126,,,,,,,,1,0,1,,,
9812271,1,1,0,0,0,1,7,9,1.0,1.0,0.0,0.0,1.0,0.0,0.0,11,1,10,1.0,1.0,0.0
9909462,0,0,0,0,0,0,0,12,0.0,0.0,0.0,0.0,0.0,0.0,0.0,33,0,33,18.0,0.0,18.0
9512394,0,0,0,0,0,0,0,117,0.0,0.0,0.0,0.0,0.0,0.0,0.0,4,0,4,,,
9402353,0,0,0,0,0,0,0,1542,,,,,,,,1,0,1,,,
204074,0,0,0,0,0,0,0,212,0.0,0.0,0.0,0.0,0.0,0.0,0.0,6,0,6,1.0,0.0,1.0
9809559,1,1,0,0,1,0,0,741,1.0,1.0,0.0,0.0,1.0,0.0,0.0,1,1,0,1.0,1.0,0.0
9412306,1,1,0,0,1,0,0,189,1.0,1.0,0.0,0.0,1.0,0.0,0.0,1,1,0,,,
9403247,0,0,0,0,0,0,0,744,0.0,0.0,0.0,0.0,0.0,0.0,0.0,1,0,1,1.0,0.0,1.0
212030,0,0,0,0,0,0,0,178,0.0,0.0,0.0,0.0,0.0,0.0,0.0,14,0,14,7.0,0.0,7.0
209042,0,0,0,0,0,0,0,154,,,,,,,,1,0,1,,,
201172,0,0,0,0,0,0,0,70,0.0,0.0,0.0,0.0,0.0,0.0,0.0,10,0,10,2.0,0.0,2.0
210156,0,0,0,0,0,0,0,46,0.0,0.0,0.0,0.0,0.0,0.0,0.0,15,0,15,1.0,0.0,1.0
9704296,8,6,2,3,0,8,24,100,6.0,5.0,1.0,1.0,1.0,5.0,14.0,15,8,7,8.0,5.0,3.0
9804209,93,17,76,257,11,82,255,89,34.0,5.0,29.0,88.0,0.0,34.0,139.0,108,93,15,31.0,24.0,7.0
4213,69,9,60,407,4,65,373,1,55.0,3.0,52.0,373.0,0.0,55.0,264.0,95,69,26,40.0,33.0,7.0
103020,16,4,12,29,1,15,35,1,4.0,3.0,1.0,1.0,2.0,2.0,2.0,21,16,5,5.0,4.0,1.0
9910291,43,7,36,121,2,41,217,1,19.0,1.0,18.0,70.0,0.0,19.0,47.0,68,43,25,13.0,10.0,3.0
9310332,67,16,51,150,58,9,9,7,18.0,5.0,13.0,42.0,18.0,0.0,0.0,68,67,1,12.0,12.0,0.0
9411229,153,6,147,833,45,108,204,8,38.0,1.0,37.0,251.0,38.0,0.0,0.0,160,153,7,13.0,13.0,0.0
101259,5,2,3,5,1,4,49,1,1.0,1.0,0.0,0.0,0.0,1.0,5.0,26,5,21,14.0,2.0,12.0
12215,4,1,3,4,1,3,20,1,2.0,1.0,1.0,1.0,0.0,2.0,4.0,18,4,14,2.0,0.0,2.0
9403249,66,12,54,193,15,51,70,6,36.0,4.0,32.0,117.0,1.0,35.0,53.0,68,66,2,19.0,17.0,2.0
9508250,36,24,12,16,19,17,52,6,2.0,2.0,0.0,0.0,0.0,2.0,7.0,74,36,38,4.0,3.0,1.0
9412273,21,10,11,24,11,10,16,67,9.0,4.0,5.0,5.0,9.0,0.0,0.0,31,21,10,3.0,3.0,0.0
9609437,35,2,33,84,6,29,115,114,12.0,2.0,10.0,18.0,0.0,12.0,60.0,59,35,24,23.0,13.0,10.0
9702321,9,1,8,11,0,9,23,275,9.0,1.0,8.0,11.0,2.0,7.0,16.0,15,9,6,3.0,3.0,0.0
9403283,46,6,40,176,27,19,22,35,21.0,1.0,20.0,83.0,10.0,11.0,11.0,50,46,4,18.0,18.0,0.0
206293,11,5,6,7,0,11,61,80,2.0,1.0,1.0,1.0,0.0,2.0,8.0,47,11,36,12.0,2.0,10.0
111307,8,3,5,7,2,6,11,4,2.0,1.0,1.0,1.0,1.0,1.0,1.0,15,8,7,5.0,4.0,1.0
1286,47,16,31,70,7,40,459,24,28.0,8.0,20.0,50.0,0.0,28.0,348.0,99,47,52,42.0,13.0,29.0
9511449,14,7,7,9,2,12,26,39,2.0,2.0,0.0,0.0,1.0,1.0,2.0,21,14,7,3.0,2.0,1.0
9702287,75,28,47,117,21,54,205,39,12.0,6.0,6.0,9.0,1.0,11.0,34.0,155,75,80,12.0,3.0,9.0
9712400,40,5,35,125,24,16,29,4,10.0,2.0,8.0,26.0,10.0,0.0,0.0,46,40,6,10.0,10.0,0.0
9811237,29,6,23,65,0,29,228,48,17.0,3.0,14.0,31.0,0.0,17.0,122.0,85,29,56,23.0,12.0,11.0
9911407,3,2,1,1,0,3,10,48,1.0,1.0,0.0,0.0,0.0,1.0,2.0,10,3,7,5.0,2.0,3.0
9903289,20,7,13,24,7,13,47,4,6.0,2.0,4.0,6.0,0.0,6.0,12.0,39,20,19,7.0,5.0,2.0
9204214,98,9,89,385,98,0,0,26,40.0,3.0,37.0,169.0,40.0,0.0,0.0,98,98,0,24.0,24.0,0.0
9506305,41,5,36,181,1,40,72,26,31.0,3.0,28.0,153.0,1.0,30.0,58.0,46,41,5,20.0,19.0,1.0
9805478,12,2,10,22,2,10,36,26,10.0,2.0,8.0,17.0,2.0,8.0,30.0,22,12,10,13.0,7.0,6.0
9601393,13,7,6,10,1,12,21,35,3.0,3.0,0.0,0.0,0.0,3.0,10.0,21,13,8,4.0,3.0,1.0
3275,30,9,21,54,2,28,147,35,1.0,1.0,0.0,0.0,0.0,1.0,4.0,127,30,97,14.0,8.0,6.0
9403306,84,22,62,288,25,59,204,10,23.0,9.0,14.0,39.0,1.0,22.0,87.0,102,84,18,18.0,18.0,0.0
9510431,32,9,23,49,11,21,25,170,15.0,3.0,12.0,24.0,2.0,13.0,13.0,36,32,4,14.0,13.0,1.0
9907238,33,7,26,68,7,26,96,86,12.0,4.0,8.0,18.0,4.0,8.0,46.0,45,33,12,16.0,7.0,9.0
3170,19,8,11,12,3,16,65,26,4.0,1.0,3.0,3.0,0.0,4.0,8.0,41,19,22,12.0,7.0,5.0
111027,14,10,4,5,0,14,82,2,1.0,1.0,0.0,0.0,0.0,1.0,13.0,83,14,69,5.0,4.0,1.0
9805446,9,2,7,13,4,5,9,170,4.0,1.0,3.0,5.0,2.0,2.0,4.0,18,9,9,6.0,2.0,4.0
9704456,29,2,27,64,29,0,0,177,7.0,1.0,6.0,14.0,7.0,0.0,0.0,30,29,1,4.0,4.0,0.0
9312291,72,21,51,128,68,4,4,63,11.0,4.0,7.0,24.0,11.0,0.0,0.0,73,72,1,11.0,11.0,0.0
9309268,29,9,20,61,25,4,7,13,11.0,3.0,8.0,28.0,11.0,0.0,0.0,32,29,3,8.0,8.0,0.0
9212285,83,25,58,203,51,32,32,25,25.0,5.0,20.0,68.0,9.0,16.0,16.0,84,83,1,11.0,11.0,0.0
9607319,34,7,27,87,0,34,94,23,21.0,4.0,17.0,50.0,0.0,21.0,61.0,40,34,6,16.0,12.0,4.0
9312323,30,13,17,25,26,4,4,25,6.0,6.0,0.0,0.0,6.0,0.0,0.0,31,30,1,6.0,6.0,0.0
9511378,72,5,67,295,41,31,66,41,30.0,2.0,28.0,135.0,20.0,10.0,10.0,88,72,16,20.0,20.0,0.0
9311326,39,8,31,99,39,0,0,42,13.0,3.0,10.0,29.0,13.0,0.0,0.0,39,39,0,6.0,6.0,0.0
9412385,172,16,156,927,20,152,251,3,61.0,1.0,60.0,296.0,0.0,61.0,110.0,176,172,4,33.0,31.0,2.0
9503210,33,11,22,52,13,20,25,46,10.0,1.0,9.0,17.0,10.0,0.0,0.0,48,33,15,5.0,5.0,0.0
9509423,116,17,99,453,116,0,0,0,28.0,10.0,18.0,60.0,28.0,0.0,0.0,116,116,0,16.0,16.0,0.0
9807228,101,10,91,609,28,73,153,3,57.0,2.0,55.0,415.0,22.0,35.0,37.0,110,101,9,35.0,35.0,0.0
9904281,40,4,36,198,9,31,127,0,24.0,1.0,23.0,143.0,3.0,21.0,38.0,57,40,17,25.0,22.0,3.0
9604370,103,10,93,550,66,37,41,0,43.0,1.0,42.0,241.0,35.0,8.0,8.0,106,103,3,34.0,34.0,0.0
9506350,59,11,48,189,9,50,114,0,16.0,1.0,15.0,39.0,4.0,12.0,20.0,68,59,9,10.0,8.0,2.0
9603376,7,4,3,6,3,4,15,182,4.0,1.0,3.0,6.0,0.0,4.0,12.0,14,7,7,8.0,4.0,4.0
9901245,29,4,25,90,0,29,302,3,25.0,4.0,21.0,78.0,0.0,25.0,264.0,63,29,34,30.0,13.0,17.0
9910314,31,6,25,68,1,30,226,3,16.0,5.0,11.0,26.0,1.0,15.0,86.0,67,31,36,13.0,4.0,9.0
9410353,38,1,37,161,16,22,25,119,31.0,1.0,30.0,124.0,13.0,18.0,18.0,41,38,3,26.0,25.0,1.0
9502306,23,10,13,32,13,10,14,0,9.0,3.0,6.0,20.0,2.0,7.0,11.0,25,23,2,1.0,1.0,0.0
9808224,48,7,41,217,4,44,285,12,33.0,3.0,30.0,178.0,0.0,33.0,242.0,64,48,16,26.0,16.0,10.0
9804421,49,8,41,197,2,47,417,0,35.0,5.0,30.0,165.0,0.0,35.0,335.0,74,49,25,41.0,27.0,14.0
9601342,11,5,6,13,11,0,0,366,3.0,3.0,0.0,0.0,3.0,0.0,0.0,11,11,0,2.0,2.0,0.0
9712291,29,3,26,110,0,29,89,0,20.0,2.0,18.0,77.0,0.0,20.0,54.0,53,29,24,16.0,14.0,2.0
9712390,8,6,2,2,0,8,19,288,1.0,1.0,0.0,0.0,0.0,1.0,4.0,15,8,7,3.0,1.0,2.0
9803323,11,4,7,10,6,5,13,215,6.0,3.0,3.0,4.0,5.0,1.0,2.0,15,11,4,4.0,1.0,3.0
9910546,28,4,24,58,10,18,30,0,13.0,0.0,13.0,31.0,4.0,9.0,11.0,37,28,9,7.0,6.0,1.0
9904301,28,3,25,107,2,26,82,81,23.0,2.0,21.0,97.0,0.0,23.0,72.0,48,28,20,19.0,16.0,3.0
9811355,21,5,16,38,1,20,85,41,9.0,1.0,8.0,19.0,0.0,9.0,17.0,39,21,18,15.0,7.0,8.0
9606460,36,4,32,96,8,28,38,51,21.0,2.0,19.0,55.0,1.0,20.0,20.0,39,36,3,15.0,14.0,1.0
9408214,164,10,154,1115,162,2,2,21,57.0,3.0,54.0,452.0,57.0,0.0,0.0,165,164,1,33.0,33.0,0.0
9605319,128,6,122,1022,48,80,125,46,87.0,2.0,85.0,776.0,20.0,67.0,108.0,133,128,5,42.0,41.0,1.0
9704366,6,1,5,5,2,4,22,46,4.0,1.0,3.0,3.0,0.0,4.0,22.0,14,6,8,6.0,2.0,4.0
9404302,90,25,65,346,26,64,132,15,42.0,5.0,37.0,281.0,2.0,40.0,104.0,95,90,5,33.0,29.0,4.0
9807307,8,4,4,5,0,8,27,318,1.0,1.0,0.0,0.0,0.0,1.0,4.0,16,8,8,5.0,1.0,4.0
9302227,70,17,53,156,70,0,0,60,11.0,1.0,10.0,25.0,11.0,0.0,0.0,70,70,0,7.0,7.0,0.0
4151,5,2,3,4,0,5,21,0,1.0,1.0,0.0,0.0,0.0,1.0,5.0,19,5,14,8.0,2.0,6.0
9803335,8,4,4,5,4,4,15,10,2.0,1.0,1.0,1.0,1.0,1.0,3.0,23,8,15,4.0,2.0,2.0
9206203,32,9,23,54,32,0,0,10,7.0,6.0,1.0,1.0,7.0,0.0,0.0,32,32,0,4.0,4.0,0.0
9810371,46,8,38,176,1,45,507,12,36.0,3.0,33.0,163.0,0.0,36.0,434.0,92,46,46,35.0,16.0,19.0
9512383,79,14,65,236,2,77,241,5,26.0,5.0,21.0,72.0,1.0,25.0,81.0,103,79,24,22.0,13.0,9.0
9708495,16,4,12,39,0,16,61,12,8.0,1.0,7.0,14.0,0.0,8.0,18.0,24,16,8,11.0,8.0,3.0
105011,28,10,18,28,0,28,430,34,15.0,2.0,13.0,20.0,0.0,15.0,267.0,115,28,87,47.0,6.0,41.0
9901278,37,3,34,105,4,33,81,7,14.0,1.0,13.0,27.0,2.0,12.0,20.0,47,37,10,14.0,11.0,3.0
105049,4,3,1,1,1,3,14,173,3.0,2.0,1.0,1.0,0.0,3.0,11.0,12,4,8,6.0,1.0,5.0
9711262,77,3,74,753,4,73,392,1,61.0,2.0,59.0,616.0,1.0,60.0,330.0,100,77,23,52.0,47.0,5.0
9409313,69,13,56,338,60,9,11,1,41.0,2.0,39.0,281.0,41.0,0.0,0.0,71,69,2,25.0,25.0,0.0
9812369,56,9,47,176,1,55,315,32,24.0,2.0,22.0,65.0,0.0,24.0,123.0,75,56,19,14.0,9.0,5.0
9805335,43,6,37,178,3,40,200,67,22.0,2.0,20.0,86.0,1.0,21.0,105.0,57,43,14,24.0,17.0,7.0
10162,4,2,2,3,0,4,29,34,2.0,2.0,0.0,0.0,0.0,2.0,15.0,22,4,18,12.0,3.0,9.0
9605222,34,5,29,91,8,26,79,5,21.0,2.0,19.0,69.0,1.0,20.0,65.0,39,34,5,19.0,15.0,4.0
9702299,52,13,39,117,17,35,158,5,17.0,5.0,12.0,26.0,0.0,17.0,100.0,78,52,26,10.0,10.0,0.0
9709383,14,3,11,23,0,14,168,5,13.0,3.0,10.0,22.0,0.0,13.0,153.0,33,14,19,21.0,9.0,12.0
7080,4,3,1,1,0,4,53,1,3.0,2.0,1.0,1.0,0.0,3.0,41.0,35,4,31,5.0,2.0,3.0
9503383,29,3,26,58,6,23,40,231,11.0,1.0,10.0,16.0,3.0,8.0,8.0,34,29,5,9.0,8.0,1.0
9301228,9,5,4,4,6,3,3,15,2.0,1.0,1.0,1.0,2.0,0.0,0.0,12,9,3,3.0,3.0,0.0
103305,13,4,9,23,0,13,127,1,11.0,3.0,8.0,22.0,0.0,11.0,101.0,33,13,20,17.0,6.0,11.0
109045,36,10,26,110,1,35,175,193,23.0,2.0,21.0,92.0,0.0,23.0,81.0,58,36,22,26.0,22.0,4.0
9906376,21,9,12,26,5,16,55,6,6.0,4.0,2.0,3.0,2.0,4.0,4.0,37,21,16,7.0,6.0,1.0
9912398,22,10,12,27,2,20,113,13,15.0,4.0,11.0,23.0,0.0,15.0,85.0,42,22,20,19.0,10.0,9.0
11179,20,8,12,28,1,19,99,1,13.0,4.0,9.0,20.0,0.0,13.0,56.0,38,20,18,14.0,8.0,6.0
9806270,5,4,1,2,0,5,34,1,2.0,2.0,0.0,0.0,0.0,2.0,10.0,16,5,11,9.0,3.0,6.0
9707482,60,9,51,224,2,58,435,7,27.0,6.0,21.0,104.0,0.0,27.0,272.0,81,60,21,31.0,17.0,14.0
9911382,2,2,0,0,0,2,3,58,1.0,1.0,0.0,0.0,1.0,0.0,0.0,6,2,4,1.0,1.0,0.0
9404344,7,4,3,5,3,4,4,114,4.0,2.0,2.0,4.0,0.0,4.0,4.0,8,7,1,5.0,4.0,1.0
9410267,58,19,39,72,51,7,7,7,12.0,3.0,9.0,19.0,12.0,0.0,0.0,60,58,2,3.0,3.0,0.0
9610345,85,13,72,378,11,74,161,21,48.0,3.0,45.0,239.0,7.0,41.0,51.0,91,85,6,25.0,24.0,1.0
9510403,75,8,67,309,7,68,211,7,30.0,3.0,27.0,89.0,2.0,28.0,64.0,94,75,19,23.0,19.0,4.0
9410280,162,38,124,587,50,112,269,29,49.0,6.0,43.0,234.0,6.0,43.0,89.0,177,162,15,31.0,28.0,3.0
9801222,40,7,33,89,4,36,135,29,14.0,4.0,10.0,24.0,2.0,12.0,63.0,60,40,20,19.0,11.0,8.0
9807418,14,4,10,20,0,14,68,7,2.0,2.0,0.0,0.0,2.0,0.0,0.0,36,14,22,6.0,1.0,5.0
9406289,93,25,68,316,32,61,138,15,41.0,6.0,35.0,235.0,3.0,38.0,105.0,98,93,5,31.0,27.0,4.0
9311222,115,31,84,340,52,63,125,10,41.0,13.0,28.0,124.0,12.0,29.0,63.0,118,115,3,16.0,13.0,3.0
9302224,67,9,58,351,36,31,31,69,43.0,5.0,38.0,258.0,21.0,22.0,22.0,68,67,1,29.0,28.0,1.0
9611400,14,10,4,5,3,11,24,22,2.0,2.0,0.0,0.0,0.0,2.0,2.0,33,14,19,3.0,2.0,1.0
9602431,5,4,1,2,5,0,0,76,4.0,3.0,1.0,2.0,4.0,0.0,0.0,6,5,1,1.0,0.0,1.0
9612334,24,8,16,37,6,18,52,12,3.0,2.0,1.0,1.0,0.0,3.0,12.0,44,24,20,9.0,3.0,6.0
9708342,12,2,10,25,0,12,106,19,9.0,2.0,7.0,17.0,0.0,9.0,41.0,31,12,19,20.0,9.0,11.0
9601359,26,8,18,62,6,20,112,19,14.0,1.0,13.0,48.0,0.0,14.0,72.0,41,26,15,14.0,6.0,8.0
9409419,67,7,60,228,67,0,0,5,19.0,1.0,18.0,89.0,19.0,0.0,0.0,67,67,0,18.0,18.0,0.0
9610534,47,8,39,259,6,41,50,24,25.0,1.0,24.0,195.0,25.0,0.0,0.0,50,47,3,24.0,24.0,0.0
9708296,4,1,3,4,1,3,5,127,2.0,1.0,1.0,1.0,0.0,2.0,3.0,12,4,8,1.0,0.0,1.0
9612338,4,1,3,6,0,4,10,11,4.0,1.0,3.0,6.0,0.0,4.0,10.0,8,4,4,7.0,4.0,3.0
9612251,48,12,36,92,31,17,37,16,12.0,3.0,9.0,18.0,12.0,0.0,0.0,55,48,7,3.0,3.0,0.0
4270,12,4,8,17,1,11,30,80,5.0,2.0,3.0,7.0,0.0,5.0,8.0,26,12,14,3.0,2.0,1.0
9506392,18,3,15,39,0,18,32,108,14.0,1.0,13.0,33.0,0.0,14.0,26.0,22,18,4,13.0,10.0,3.0
9809429,19,7,12,18,1,18,139,19,5.0,3.0,2.0,2.0,0.0,5.0,32.0,54,19,35,22.0,4.0,18.0
9607454,39,18,21,46,39,0,0,30,7.0,1.0,6.0,14.0,7.0,0.0,0.0,39,39,0,10.0,10.0,0.0
9911256,9,5,4,4,0,9,102,43,3.0,3.0,0.0,0.0,0.0,3.0,18.0,90,9,81,5.0,0.0,5.0
9407231,8,6,2,2,4,4,10,86,1.0,1.0,0.0,0.0,0.0,1.0,4.0,24,8,16,6.0,0.0,6.0
9306267,34,18,16,26,34,0,0,26,13.0,8.0,5.0,8.0,13.0,0.0,0.0,34,34,0,6.0,6.0,0.0
9311325,143,16,127,601,41,102,157,6,63.0,10.0,53.0,216.0,2.0,61.0,111.0,147,143,4,23.0,23.0,0.0
9302269,20,11,9,16,3,17,28,6,3.0,2.0,1.0,1.0,3.0,0.0,0.0,25,20,5,5.0,3.0,2.0
9710513,24,5,19,57,0,24,165,6,15.0,2.0,13.0,36.0,0.0,15.0,115.0,37,24,13,21.0,15.0,6.0
9307260,24,15,9,17,22,2,2,85,6.0,3.0,3.0,7.0,6.0,0.0,0.0,25,24,1,3.0,3.0,0.0
9805404,12,6,6,11,1,11,17,6,5.0,4.0,1.0,1.0,0.0,5.0,7.0,19,12,7,4.0,2.0,2.0
9507455,10,3,7,10,5,5,17,41,1.0,1.0,0.0,0.0,0.0,1.0,3.0,16,10,6,5.0,1.0,4.0
9801224,16,6,10,17,2,14,23,287,7.0,2.0,5.0,7.0,1.0,6.0,6.0,21,16,5,2.0,1.0,1.0
9605367,47,10,37,172,3,44,132,66,26.0,1.0,25.0,105.0,1.0,25.0,44.0,65,47,18,24.0,20.0,4.0
7087,6,4,2,4,0,6,14,22,4.0,2.0,2.0,2.0,0.0,4.0,11.0,29,6,23,7.0,2.0,5.0
9804224,52,12,40,191,25,27,85,22,35.0,7.0,28.0,155.0,13.0,22.0,67.0,61,52,9,22.0,22.0,0.0
9609287,22,5,17,35,7,15,34,172,7.0,2.0,5.0,6.0,1.0,6.0,16.0,33,22,11,11.0,6.0,5.0
9408262,40,11,29,82,6,34,98,22,11.0,5.0,6.0,11.0,2.0,9.0,23.0,52,40,12,10.0,9.0,1.0
9504408,25,8,17,36,6,19,61,22,9.0,3.0,6.0,11.0,6.0,3.0,6.0,37,25,12,7.0,6.0,1.0
9411334,56,9,47,132,15,41,125,15,11.0,3.0,8.0,17.0,4.0,7.0,7.0,68,56,12,13.0,8.0,5.0
9906259,26,3,23,65,4,22,149,22,13.0,2.0,11.0,34.0,0.0,13.0,104.0,45,26,19,22.0,12.0,10.0
9503413,11,4,7,13,6,5,6,88,5.0,1.0,4.0,10.0,5.0,0.0,0.0,16,11,5,2.0,2.0,0.0
9904353,109,14,95,866,2,107,731,20,88.0,8.0,80.0,797.0,0.0,88.0,627.0,135,109,26,65.0,54.0,11.0
9702251,12,9,3,5,5,7,10,52,6.0,3.0,3.0,5.0,6.0,0.0,0.0,18,12,6,3.0,2.0,1.0
9809574,24,4,20,89,0,24,162,21,23.0,3.0,20.0,87.0,0.0,23.0,157.0,34,24,10,25.0,15.0,10.0
9809583,15,3,12,36,1,14,36,112,13.0,1.0,12.0,36.0,0.0,13.0,31.0,20,15,5,15.0,12.0,3.0
9501231,63,11,52,256,28,35,56,16,31.0,8.0,23.0,91.0,15.0,16.0,28.0,67,63,4,18.0,18.0,0.0
9803241,55,7,48,251,3,52,257,43,34.0,3.0,31.0,180.0,0.0,34.0,207.0,79,55,24,40.0,24.0,16.0
9903515,43,5,38,280,5,38,192,19,36.0,2.0,34.0,266.0,4.0,32.0,174.0,54,43,11,33.0,28.0,5.0
9912251,43,2,41,381,0,43,112,19,42.0,2.0,40.0,376.0,2.0,40.0,99.0,48,43,5,38.0,35.0,3.0
6148,3,2,1,1,0,3,11,66,2.0,1.0,1.0,1.0,0.0,2.0,6.0,16,3,13,1.0,0.0,1.0
9712301,67,34,33,64,13,54,284,16,0.0,0.0,0.0,0.0,0.0,0.0,0.0,309,67,242,27.0,0.0,27.0
11394,12,5,7,16,0,12,134,20,11.0,4.0,7.0,16.0,0.0,11.0,119.0,65,12,53,42.0,5.0,37.0
9908227,63,1,62,509,1,62,647,20,59.0,1.0,58.0,484.0,0.0,59.0,627.0,85,63,22,63.0,45.0,18.0
9512385,16,3,13,31,16,0,0,20,4.0,2.0,2.0,2.0,4.0,0.0,0.0,16,16,0,2.0,2.0,0.0
9403370,43,15,28,70,19,24,37,7,9.0,3.0,6.0,10.0,4.0,5.0,5.0,49,43,6,8.0,7.0,1.0
9605293,4,4,0,0,1,3,6,179,1.0,1.0,0.0,0.0,1.0,0.0,0.0,7,4,3,1.0,1.0,0.0
9808206,5,3,2,3,0,5,9,8,4.0,2.0,2.0,3.0,0.0,4.0,7.0,12,5,7,4.0,3.0,1.0
9129,14,3,11,21,0,14,209,20,10.0,2.0,8.0,17.0,0.0,10.0,189.0,55,14,41,43.0,7.0,36.0
9508206,8,4,4,7,3,5,8,65,7.0,3.0,4.0,7.0,2.0,5.0,5.0,12,8,4,2.0,1.0,1.0
111327,7,2,5,14,0,7,22,37,5.0,2.0,3.0,6.0,0.0,5.0,12.0,17,7,10,3.0,2.0,1.0
9904383,16,5,11,17,4,12,21,2,5.0,2.0,3.0,3.0,0.0,5.0,9.0,18,16,2,6.0,4.0,2.0
9304309,2,2,0,0,0,2,4,78,2.0,2.0,0.0,0.0,0.0,2.0,4.0,5,2,3,,,
9602372,24,7,17,77,22,2,2,78,14.0,2.0,12.0,55.0,14.0,0.0,0.0,25,24,1,15.0,15.0,0.0
9810411,37,5,32,102,0,37,143,5,14.0,1.0,13.0,39.0,0.0,14.0,19.0,53,37,16,19.0,14.0,5.0
9512441,8,5,3,4,0,8,30,4,2.0,1.0,1.0,1.0,0.0,2.0,2.0,15,8,7,3.0,2.0,1.0
9811456,21,14,7,13,9,12,25,4,0.0,0.0,0.0,0.0,0.0,0.0,0.0,60,21,39,6.0,0.0,6.0
9611448,3,3,0,0,2,1,15,30,1.0,1.0,0.0,0.0,0.0,1.0,11.0,19,3,16,8.0,1.0,7.0
9804411,5,4,1,1,4,1,1,101,2.0,2.0,0.0,0.0,2.0,0.0,0.0,6,5,1,3.0,3.0,0.0
9612389,32,11,21,39,9,23,114,5,9.0,5.0,4.0,8.0,0.0,9.0,47.0,60,32,28,2.0,2.0,0.0
9806213,26,6,20,52,1,25,181,73,21.0,3.0,18.0,47.0,0.0,21.0,127.0,45,26,19,25.0,16.0,9.0
9401306,8,3,5,6,3,5,6,35,2.0,2.0,0.0,0.0,2.0,0.0,0.0,11,8,3,6.0,5.0,1.0
9604338,15,2,13,26,1,14,61,5,9.0,1.0,8.0,19.0,0.0,9.0,45.0,24,15,9,6.0,3.0,3.0
9704215,7,6,1,2,2,5,21,35,5.0,4.0,1.0,2.0,0.0,5.0,21.0,19,7,12,3.0,2.0,1.0
2043,18,7,11,24,6,12,26,93,6.0,2.0,4.0,8.0,0.0,6.0,12.0,24,18,6,2.0,2.0,0.0
1194,7,4,3,4,0,7,14,4,3.0,2.0,1.0,1.0,0.0,3.0,5.0,13,7,6,6.0,4.0,2.0
9806315,44,12,32,112,7,37,157,4,24.0,2.0,22.0,82.0,4.0,20.0,73.0,57,44,13,6.0,6.0,0.0
3221,24,10,14,22,0,24,84,4,5.0,1.0,4.0,6.0,0.0,5.0,5.0,65,24,41,5.0,3.0,2.0
9701216,6,2,4,8,1,5,5,310,6.0,2.0,4.0,8.0,1.0,5.0,5.0,8,6,2,7.0,6.0,1.0
9906481,57,7,50,208,5,52,386,3,38.0,4.0,34.0,169.0,0.0,38.0,319.0,91,57,34,16.0,11.0,5.0
9805221,11,2,9,23,0,11,13,28,5.0,1.0,4.0,5.0,1.0,4.0,6.0,14,11,3,1.0,0.0,1.0
9709485,11,3,8,18,4,7,11,62,4.0,2.0,2.0,2.0,1.0,3.0,3.0,17,11,6,5.0,5.0,0.0
9805448,23,8,15,25,4,19,65,41,11.0,4.0,7.0,14.0,0.0,11.0,42.0,35,23,12,7.0,4.0,3.0
9705435,21,7,14,22,5,16,67,36,12.0,3.0,9.0,14.0,1.0,11.0,51.0,35,21,14,7.0,6.0,1.0
9808346,16,8,8,9,4,12,33,84,10.0,5.0,5.0,5.0,2.0,8.0,26.0,30,16,14,12.0,3.0,9.0
9710450,19,3,16,35,3,16,26,227,13.0,1.0,12.0,29.0,1.0,12.0,19.0,27,19,8,14.0,12.0,2.0
9409203,29,5,24,64,5,24,47,17,17.0,3.0,14.0,42.0,0.0,17.0,33.0,32,29,3,2.0,2.0,0.0
9501224,14,2,12,30,14,0,0,301,6.0,1.0,5.0,9.0,6.0,0.0,0.0,14,14,0,3.0,3.0,0.0
9911406,84,9,75,430,0,84,463,2,39.0,1.0,38.0,247.0,0.0,39.0,87.0,129,84,45,31.0,30.0,1.0
9505303,5,3,2,2,4,1,1,93,2.0,1.0,1.0,1.0,2.0,0.0,0.0,6,5,1,2.0,2.0,0.0
9610461,20,6,14,44,0,20,461,1,10.0,2.0,8.0,20.0,0.0,10.0,144.0,165,20,145,25.0,2.0,23.0
9510441,18,4,14,24,0,18,41,55,8.0,2.0,6.0,8.0,0.0,8.0,19.0,27,18,9,3.0,3.0,0.0
9501299,4,4,0,0,2,2,2,182,2.0,2.0,0.0,0.0,2.0,0.0,0.0,6,4,2,3.0,1.0,2.0
9609458,15,4,11,16,0,15,38,87,6.0,2.0,4.0,5.0,0.0,6.0,14.0,22,15,7,5.0,2.0,3.0
2063,37,2,35,147,3,34,105,0,25.0,1.0,24.0,101.0,3.0,22.0,58.0,44,37,7,18.0,16.0,2.0
9309287,23,5,18,45,11,12,16,56,10.0,2.0,8.0,17.0,0.0,10.0,13.0,25,23,2,4.0,4.0,0.0
12145,24,5,19,52,0,24,151,32,12.0,2.0,10.0,25.0,0.0,12.0,97.0,47,24,23,10.0,9.0,1.0
9506473,21,7,14,35,10,11,11,31,4.0,2.0,2.0,2.0,3.0,1.0,1.0,24,21,3,5.0,4.0,1.0
9310309,12,3,9,31,2,10,18,124,8.0,2.0,6.0,21.0,1.0,7.0,14.0,15,12,3,10.0,8.0,2.0
9409270,40,4,36,93,40,0,0,18,19.0,2.0,17.0,50.0,19.0,0.0,0.0,40,40,0,2.0,2.0,0.0
9708285,4,2,2,2,0,4,10,18,0.0,0.0,0.0,0.0,0.0,0.0,0.0,22,4,18,3.0,0.0,3.0
9207253,34,19,15,38,34,0,0,75,13.0,8.0,5.0,17.0,13.0,0.0,0.0,34,34,0,7.0,7.0,0.0
11356,26,14,12,19,2,24,166,10,2.0,2.0,0.0,0.0,0.0,2.0,10.0,111,26,85,16.0,2.0,14.0
5021,7,3,4,5,0,7,25,18,2.0,2.0,0.0,0.0,0.0,2.0,4.0,19,7,12,2.0,1.0,1.0
9408226,15,1,14,28,0,15,24,18,9.0,1.0,8.0,14.0,0.0,9.0,17.0,18,15,3,1.0,1.0,0.0
6266,27,2,25,89,0,27,250,18,18.0,2.0,16.0,54.0,0.0,18.0,145.0,70,27,43,22.0,15.0,7.0
202167,11,2,9,18,0,11,122,4,9.0,1.0,8.0,16.0,0.0,9.0,116.0,35,11,24,23.0,4.0,19.0
8237,31,6,25,104,0,31,408,32,23.0,4.0,19.0,83.0,0.0,23.0,294.0,71,31,40,38.0,15.0,23.0
9808361,8,2,6,16,2,6,17,5,3.0,1.0,2.0,2.0,1.0,2.0,3.0,17,8,9,2.0,1.0,1.0
108191,33,8,25,57,1,32,164,0,13.0,2.0,11.0,17.0,0.0,13.0,80.0,55,33,22,12.0,7.0,5.0
101273,14,3,11,27,1,13,30,0,6.0,1.0,5.0,8.0,3.0,3.0,4.0,29,14,15,8.0,6.0,2.0
9909395,3,2,1,1,0,3,19,0,2.0,1.0,1.0,1.0,0.0,2.0,14.0,45,3,42,37.0,2.0,35.0
9408244,10,4,6,15,0,10,20,41,8.0,2.0,6.0,15.0,0.0,8.0,8.0,14,10,4,10.0,8.0,2.0
104303,3,3,0,0,2,1,1,138,2.0,2.0,0.0,0.0,2.0,0.0,0.0,4,3,1,1.0,1.0,0.0
9402335,178,9,169,1764,178,0,0,11,130.0,3.0,127.0,1593.0,130.0,0.0,0.0,178,178,0,72.0,72.0,0.0
10146,24,7,17,46,6,18,66,19,7.0,1.0,6.0,9.0,0.0,7.0,31.0,36,24,12,12.0,5.0,7.0
9704333,107,14,93,458,56,51,83,8,44.0,5.0,39.0,231.0,23.0,21.0,27.0,112,107,5,28.0,26.0,2.0
9902324,14,4,10,20,1,13,68,16,1.0,1.0,0.0,0.0,0.0,1.0,12.0,37,14,23,19.0,2.0,17.0
9609521,7,3,4,5,1,6,24,150,2.0,2.0,0.0,0.0,0.0,2.0,7.0,16,7,9,4.0,1.0,3.0
9406432,21,7,14,60,17,4,4,94,16.0,5.0,11.0,52.0,12.0,4.0,4.0,22,21,1,12.0,12.0,0.0
9602318,4,3,1,1,0,4,20,4,1.0,1.0,0.0,0.0,1.0,0.0,0.0,10,4,6,1.0,1.0,0.0
9710323,18,6,12,21,3,15,62,7,7.0,2.0,5.0,7.0,0.0,7.0,36.0,35,18,17,13.0,6.0,7.0
9709379,62,3,59,354,1,61,361,9,45.0,1.0,44.0,291.0,0.0,45.0,292.0,80,62,18,46.0,35.0,11.0
9506338,20,4,16,54,20,0,0,192,16.0,1.0,15.0,51.0,16.0,0.0,0.0,20,20,0,13.0,13.0,0.0
9504285,13,10,3,4,9,4,5,150,4.0,3.0,1.0,1.0,4.0,0.0,0.0,15,13,2,3.0,3.0,0.0
9512302,11,4,7,14,7,4,4,238,1.0,1.0,0.0,0.0,1.0,0.0,0.0,12,11,1,2.0,2.0,0.0
9809467,40,2,38,144,1,39,169,2,28.0,2.0,26.0,100.0,0.0,28.0,120.0,66,40,26,16.0,11.0,5.0
7192,52,12,40,185,3,49,233,11,37.0,7.0,30.0,165.0,1.0,36.0,153.0,78,52,26,34.0,26.0,8.0
105088,29,12,17,33,8,21,32,106,6.0,1.0,5.0,10.0,2.0,4.0,4.0,35,29,6,6.0,5.0,1.0
9911228,15,3,12,30,0,15,131,16,9.0,2.0,7.0,17.0,0.0,9.0,101.0,43,15,28,12.0,6.0,6.0
210171,4,4,0,0,3,1,1,19,1.0,1.0,0.0,0.0,1.0,0.0,0.0,11,4,7,2.0,0.0,2.0
207020,6,3,3,3,0,6,110,19,5.0,3.0,2.0,2.0,0.0,5.0,103.0,31,6,25,27.0,5.0,22.0
9610499,12,5,7,11,1,11,43,19,9.0,4.0,5.0,9.0,0.0,9.0,32.0,21,12,9,5.0,2.0,3.0
109168,2,2,0,0,0,2,12,43,0.0,0.0,0.0,0.0,0.0,0.0,0.0,11,2,9,2.0,0.0,2.0
9806280,37,5,32,103,22,15,15,19,11.0,1.0,10.0,29.0,2.0,9.0,9.0,39,37,2,11.0,10.0,1.0
109242,47,1,46,464,0,47,460,28,46.0,1.0,45.0,455.0,0.0,46.0,263.0,69,47,22,47.0,42.0,5.0
111069,21,1,20,106,0,21,195,28,19.0,1.0,18.0,101.0,0.0,19.0,136.0,37,21,16,27.0,19.0,8.0
9803488,26,8,18,45,6,20,42,122,15.0,3.0,12.0,30.0,2.0,13.0,17.0,35,26,9,14.0,11.0,3.0
9605431,155,6,149,1183,11,144,273,9,84.0,1.0,83.0,814.0,8.0,76.0,132.0,159,155,4,47.0,44.0,3.0
9710308,12,7,5,8,4,8,13,168,4.0,1.0,3.0,5.0,4.0,0.0,0.0,17,12,5,3.0,3.0,0.0
9410389,8,4,4,9,1,7,12,242,5.0,3.0,2.0,3.0,0.0,5.0,9.0,12,8,4,5.0,2.0,3.0
103127,20,4,16,52,3,17,192,23,13.0,2.0,11.0,46.0,1.0,12.0,131.0,61,20,41,13.0,5.0,8.0
9908328,7,1,6,9,0,7,90,2,7.0,1.0,6.0,9.0,0.0,7.0,90.0,33,7,26,19.0,6.0,13.0
8158,12,6,6,10,0,12,133,2,5.0,2.0,3.0,4.0,0.0,5.0,35.0,35,12,23,19.0,4.0,15.0
9807411,23,3,20,51,2,21,66,10,13.0,1.0,12.0,29.0,0.0,13.0,36.0,31,23,8,11.0,10.0,1.0
9808401,15,5,10,15,2,13,54,5,3.0,2.0,1.0,1.0,0.0,3.0,20.0,31,15,16,3.0,3.0,0.0
104041,40,2,38,246,1,39,114,37,35.0,2.0,33.0,234.0,0.0,35.0,66.0,58,40,18,29.0,27.0,2.0
9902423,50,6,44,306,26,24,43,37,37.0,2.0,35.0,271.0,37.0,0.0,0.0,55,50,5,29.0,29.0,0.0
9809396,12,2,10,18,4,8,54,119,6.0,1.0,5.0,7.0,0.0,6.0,40.0,24,12,12,15.0,6.0,9.0
9911298,12,1,11,30,1,11,32,63,10.0,1.0,9.0,22.0,1.0,9.0,22.0,18,12,6,13.0,9.0,4.0
9506318,7,5,2,3,7,0,0,370,4.0,3.0,1.0,2.0,4.0,0.0,0.0,8,7,1,3.0,3.0,0.0
9811500,46,2,44,234,1,45,205,12,36.0,2.0,34.0,195.0,1.0,35.0,125.0,63,46,17,23.0,22.0,1.0
9706476,43,9,34,129,2,41,264,5,25.0,5.0,20.0,75.0,0.0,25.0,111.0,70,43,27,28.0,18.0,10.0
6160,43,3,40,200,10,33,149,21,32.0,2.0,30.0,170.0,4.0,28.0,99.0,55,43,12,27.0,23.0,4.0
6355,2,2,0,0,1,1,1,263,1.0,1.0,0.0,0.0,0.0,1.0,1.0,6,2,4,2.0,0.0,2.0
9909297,37,14,23,68,0,37,341,1,18.0,7.0,11.0,45.0,0.0,18.0,206.0,101,37,64,32.0,14.0,18.0
10142,4,2,2,2,0,4,10,34,1.0,1.0,0.0,0.0,1.0,0.0,0.0,7,4,3,,,
9704277,51,8,43,148,6,45,101,1,19.0,3.0,16.0,43.0,1.0,18.0,47.0,59,51,8,11.0,9.0,2.0
9911505,22,3,19,57,9,13,47,33,18.0,2.0,16.0,53.0,5.0,13.0,47.0,28,22,6,14.0,9.0,5.0
9408345,11,4,7,15,0,11,30,75,3.0,2.0,1.0,2.0,0.0,3.0,13.0,35,11,24,10.0,3.0,7.0
9606296,5,3,2,2,2,3,4,79,1.0,1.0,0.0,0.0,0.0,1.0,1.0,7,5,2,2.0,1.0,1.0
9703425,1,1,0,0,0,1,3,68,0.0,0.0,0.0,0.0,0.0,0.0,0.0,14,1,13,7.0,0.0,7.0
9508409,68,16,52,159,2,66,206,17,41.0,4.0,37.0,130.0,0.0,41.0,144.0,81,68,13,25.0,19.0,6.0
9801240,1,1,0,0,0,1,6,17,1.0,1.0,0.0,0.0,0.0,1.0,6.0,18,1,17,2.0,0.0,2.0
9307230,26,13,13,21,22,4,4,6,4.0,3.0,1.0,1.0,4.0,0.0,0.0,28,26,2,3.0,3.0,0.0
9211268,3,3,0,0,3,0,0,174,1.0,1.0,0.0,0.0,1.0,0.0,0.0,3,3,0,1.0,1.0,0.0
9407269,6,5,1,1,6,0,0,229,1.0,1.0,0.0,0.0,1.0,0.0,0.0,6,6,0,1.0,1.0,0.0
9905407,12,6,6,11,0,12,79,48,7.0,3.0,4.0,6.0,0.0,7.0,46.0,49,12,37,18.0,5.0,13.0
9607233,20,5,15,55,3,17,55,24,6.0,3.0,3.0,3.0,0.0,6.0,6.0,37,20,17,11.0,9.0,2.0
9204236,19,12,7,12,19,0,0,274,8.0,4.0,4.0,8.0,8.0,0.0,0.0,19,19,0,5.0,5.0,0.0
9411331,8,3,5,10,6,2,2,8,3.0,1.0,2.0,2.0,3.0,0.0,0.0,9,8,1,1.0,1.0,0.0
9308369,16,11,5,6,4,12,21,6,3.0,1.0,2.0,2.0,0.0,3.0,3.0,19,16,3,6.0,5.0,1.0
103058,16,3,13,39,0,16,86,37,10.0,1.0,9.0,23.0,0.0,10.0,10.0,46,16,30,19.0,1.0,18.0
9610421,10,4,6,10,10,0,0,4,5.0,3.0,2.0,3.0,5.0,0.0,0.0,10,10,0,1.0,1.0,0.0
9912308,6,2,4,6,0,6,40,6,1.0,1.0,0.0,0.0,0.0,1.0,1.0,19,6,13,4.0,3.0,1.0
9906343,27,4,23,81,2,25,276,12,22.0,3.0,19.0,75.0,0.0,22.0,235.0,68,27,41,36.0,19.0,17.0
9407227,9,4,5,6,0,9,15,11,1.0,1.0,0.0,0.0,1.0,0.0,0.0,12,9,3,6.0,5.0,1.0
9806469,3,2,1,1,0,3,3,103,0.0,0.0,0.0,0.0,0.0,0.0,0.0,5,3,2,,,
7341,5,4,1,1,1,4,24,54,1.0,1.0,0.0,0.0,0.0,1.0,3.0,33,5,28,2.0,2.0,0.0
9503221,10,6,4,8,8,2,2,101,7.0,3.0,4.0,8.0,7.0,0.0,0.0,11,10,1,5.0,5.0,0.0
9512305,1,1,0,0,0,1,2,129,0.0,0.0,0.0,0.0,0.0,0.0,0.0,4,1,3,2.0,0.0,2.0
112328,1,1,0,0,0,1,22,24,1.0,1.0,0.0,0.0,0.0,1.0,22.0,28,1,27,14.0,0.0,14.0
9707525,1,1,0,0,0,1,2,24,0.0,0.0,0.0,0.0,0.0,0.0,0.0,11,1,10,1.0,0.0,1.0
9602378,23,8,15,60,4,19,29,92,13.0,2.0,11.0,48.0,7.0,6.0,6.0,30,23,7,12.0,11.0,1.0
9710310,6,1,5,8,1,5,10,64,4.0,1.0,3.0,3.0,0.0,4.0,9.0,12,6,6,9.0,4.0,5.0
9609448,48,18,30,73,8,40,76,9,18.0,6.0,12.0,28.0,1.0,17.0,24.0,58,48,10,5.0,4.0,1.0
9810466,46,9,37,148,1,45,314,9,31.0,6.0,25.0,114.0,0.0,31.0,234.0,62,46,16,34.0,19.0,15.0
9410375,14,6,8,19,14,0,0,286,7.0,3.0,4.0,7.0,7.0,0.0,0.0,14,14,0,5.0,5.0,0.0
9807405,19,8,11,24,1,18,112,14,13.0,6.0,7.0,16.0,0.0,13.0,59.0,38,19,19,9.0,7.0,2.0
9609309,15,4,11,22,1,14,72,16,3.0,2.0,1.0,1.0,0.0,3.0,28.0,47,15,32,10.0,3.0,7.0
2081,16,6,10,25,0,16,102,68,10.0,2.0,8.0,15.0,0.0,10.0,65.0,32,16,16,19.0,9.0,10.0
9801300,22,9,13,26,2,20,80,14,9.0,3.0,6.0,11.0,0.0,9.0,41.0,42,22,20,12.0,6.0,6.0
9401356,23,10,13,36,22,1,1,117,5.0,1.0,4.0,8.0,5.0,0.0,0.0,24,23,1,4.0,4.0,0.0
9410302,10,1,9,20,4,6,6,13,10.0,1.0,9.0,20.0,4.0,6.0,6.0,11,10,1,9.0,8.0,1.0
9912504,6,3,3,4,0,6,72,10,5.0,2.0,3.0,3.0,0.0,5.0,42.0,31,6,25,12.0,4.0,8.0
9609362,1,1,0,0,1,0,0,2101,,,,,,,,1,1,0,,,
201066,7,4,3,3,0,7,23,45,5.0,2.0,3.0,3.0,0.0,5.0,10.0,21,7,14,2.0,2.0,0.0
9609284,9,4,5,13,1,8,48,17,5.0,3.0,2.0,4.0,0.0,5.0,44.0,31,9,22,6.0,0.0,6.0
9511410,1,1,0,0,0,1,8,49,0.0,0.0,0.0,0.0,0.0,0.0,0.0,12,1,11,5.0,0.0,5.0
9311376,24,10,14,29,23,1,1,16,9.0,3.0,6.0,14.0,9.0,0.0,0.0,26,24,2,3.0,3.0,0.0
9603450,35,4,31,98,0,35,84,14,16.0,5.0,11.0,30.0,0.0,16.0,40.0,42,35,7,13.0,12.0,1.0
9609231,17,7,10,24,0,17,32,16,4.0,3.0,1.0,1.0,0.0,4.0,7.0,22,17,5,2.0,1.0,1.0
9707292,1,1,0,0,1,0,0,1225,,,,,,,,1,1,0,,,
9705323,15,3,12,34,1,14,61,13,12.0,2.0,10.0,28.0,0.0,12.0,56.0,22,15,7,15.0,10.0,5.0
9406382,60,16,44,167,60,0,0,44,23.0,6.0,17.0,65.0,23.0,0.0,0.0,60,60,0,9.0,9.0,0.0
9710361,3,2,1,1,3,0,0,97,1.0,1.0,0.0,0.0,1.0,0.0,0.0,3,3,0,2.0,2.0,0.0
9705460,14,5,9,18,0,14,38,8,3.0,1.0,2.0,2.0,0.0,3.0,7.0,23,14,9,8.0,7.0,1.0
9301217,3,2,1,1,1,2,2,793,1.0,1.0,0.0,0.0,1.0,0.0,0.0,4,3,1,1.0,1.0,0.0
9408339,41,5,36,140,15,26,61,15,32.0,3.0,29.0,119.0,13.0,19.0,49.0,46,41,5,7.0,7.0,0.0
9611462,8,3,5,8,0,8,55,15,2.0,1.0,1.0,1.0,0.0,2.0,27.0,32,8,24,11.0,2.0,9.0
9505254,5,3,2,2,3,2,2,47,1.0,1.0,0.0,0.0,1.0,0.0,0.0,12,5,7,1.0,1.0,0.0
9609457,20,8,12,25,11,9,29,5,3.0,2.0,1.0,1.0,0.0,3.0,6.0,27,20,7,7.0,5.0,2.0
3256,5,2,3,5,1,4,12,283,3.0,1.0,2.0,3.0,0.0,3.0,6.0,11,5,6,6.0,2.0,4.0
104131,6,3,3,3,0,6,46,3,3.0,3.0,0.0,0.0,0.0,3.0,24.0,21,6,15,9.0,3.0,6.0
105196,12,2,10,42,0,12,90,0,10.0,1.0,9.0,33.0,0.0,10.0,46.0,59,12,47,16.0,8.0,8.0
9601389,2,2,0,0,0,2,4,707,1.0,1.0,0.0,0.0,0.0,1.0,2.0,4,2,2,1.0,1.0,0.0
9305209,5,4,1,1,5,0,0,441,4.0,4.0,0.0,0.0,4.0,0.0,0.0,5,5,0,4.0,4.0,0.0
9707421,8,3,5,10,0,8,14,52,6.0,3.0,3.0,7.0,0.0,6.0,10.0,10,8,2,8.0,6.0,2.0
9311284,28,2,26,132,28,0,0,71,24.0,1.0,23.0,127.0,24.0,0.0,0.0,29,28,1,22.0,22.0,0.0
9810261,11,7,4,7,0,11,82,15,6.0,3.0,3.0,5.0,0.0,6.0,45.0,39,11,28,6.0,3.0,3.0
11183,4,2,2,3,0,4,30,1,4.0,2.0,2.0,3.0,0.0,4.0,27.0,34,4,30,2.0,0.0,2.0
9809549,16,3,13,41,0,16,16,146,15.0,2.0,13.0,41.0,0.0,15.0,15.0,17,16,1,14.0,13.0,1.0
9912426,2,1,1,1,0,2,10,120,2.0,1.0,1.0,1.0,0.0,2.0,8.0,14,2,12,8.0,2.0,6.0
9806398,10,6,4,8,3,7,34,5,4.0,2.0,2.0,3.0,1.0,3.0,7.0,30,10,20,8.0,4.0,4.0
9601386,2,2,0,0,1,1,2,145,1.0,1.0,0.0,0.0,0.0,1.0,1.0,6,2,4,3.0,0.0,3.0
9608239,10,3,7,18,4,6,11,41,1.0,1.0,0.0,0.0,0.0,1.0,2.0,21,10,11,5.0,5.0,0.0
9512442,28,7,21,44,14,14,25,25,8.0,1.0,7.0,13.0,8.0,0.0,0.0,32,28,4,6.0,6.0,0.0
110341,11,3,8,15,0,11,306,23,5.0,2.0,3.0,3.0,0.0,5.0,112.0,84,11,73,31.0,6.0,25.0
11115,4,2,2,2,0,4,25,21,3.0,1.0,2.0,2.0,0.0,3.0,7.0,17,4,13,6.0,2.0,4.0
9809535,4,1,3,4,0,4,47,22,4.0,1.0,3.0,4.0,0.0,4.0,37.0,27,4,23,17.0,4.0,13.0
9305227,8,7,1,1,8,0,0,476,4.0,3.0,1.0,1.0,4.0,0.0,0.0,8,8,0,4.0,4.0,0.0
9805360,11,2,9,31,3,8,11,21,11.0,2.0,9.0,31.0,3.0,8.0,11.0,14,11,3,11.0,10.0,1.0
9305315,35,12,23,105,32,3,3,49,23.0,4.0,19.0,98.0,23.0,0.0,0.0,36,35,1,15.0,15.0,0.0
7055,10,3,7,13,0,10,64,14,8.0,2.0,6.0,10.0,0.0,8.0,30.0,39,10,29,13.0,7.0,6.0
9810253,13,8,5,12,2,11,11,140,8.0,3.0,5.0,12.0,1.0,7.0,7.0,14,13,1,5.0,4.0,1.0
9405298,19,5,14,22,9,10,10,71,9.0,3.0,6.0,9.0,9.0,0.0,0.0,21,19,2,6.0,6.0,0.0
9907229,17,4,13,28,5,12,33,30,7.0,1.0,6.0,11.0,0.0,7.0,10.0,26,17,9,10.0,6.0,4.0
9703369,23,7,16,36,0,23,126,36,13.0,3.0,10.0,22.0,0.0,13.0,90.0,40,23,17,19.0,10.0,9.0
9904201,10,1,9,22,0,10,65,60,7.0,1.0,6.0,14.0,1.0,6.0,28.0,48,10,38,14.0,6.0,8.0
9910477,15,6,9,28,0,15,119,32,14.0,5.0,9.0,28.0,0.0,14.0,117.0,38,15,23,21.0,11.0,10.0
108275,12,3,9,22,0,12,80,55,5.0,1.0,4.0,7.0,0.0,5.0,26.0,50,12,38,14.0,6.0,8.0
8124,14,10,4,5,5,9,74,13,4.0,3.0,1.0,1.0,0.0,4.0,46.0,101,14,87,20.0,3.0,17.0
9712457,48,9,39,136,25,23,35,34,11.0,3.0,8.0,16.0,11.0,0.0,0.0,53,48,5,15.0,15.0,0.0
9710234,43,8,35,112,14,29,122,131,28.0,2.0,26.0,86.0,8.0,20.0,43.0,61,43,18,13.0,9.0,4.0
9604391,7,7,0,0,5,2,8,196,0.0,0.0,0.0,0.0,0.0,0.0,0.0,27,7,20,4.0,0.0,4.0
204011,1,1,0,0,1,0,0,1658,1.0,1.0,0.0,0.0,1.0,0.0,0.0,1,1,0,,,
9903419,14,5,9,33,1,13,36,12,8.0,2.0,6.0,21.0,2.0,6.0,11.0,23,14,9,11.0,9.0,2.0
9610297,14,4,10,22,0,14,26,7,5.0,1.0,4.0,9.0,4.0,1.0,1.0,25,14,11,3.0,1.0,2.0
9904354,4,2,2,2,2,2,2,12,2.0,1.0,1.0,1.0,2.0,0.0,0.0,6,4,2,2.0,2.0,0.0
9812230,21,3,18,67,1,20,39,92,9.0,1.0,8.0,17.0,1.0,8.0,9.0,26,21,5,8.0,7.0,1.0
9511287,4,3,1,1,4,0,0,169,2.0,2.0,0.0,0.0,2.0,0.0,0.0,4,4,0,3.0,3.0,0.0
9911455,2,2,0,0,1,1,2,218,0.0,0.0,0.0,0.0,0.0,0.0,0.0,9,2,7,4.0,1.0,3.0
12231,21,6,15,26,8,13,47,23,10.0,1.0,9.0,16.0,0.0,10.0,12.0,39,21,18,6.0,0.0,6.0
9609427,14,4,10,31,2,12,52,35,5.0,2.0,3.0,4.0,0.0,5.0,19.0,27,14,13,8.0,5.0,3.0
5147,8,5,3,3,0,8,25,373,6.0,3.0,3.0,3.0,1.0,5.0,10.0,16,8,8,4.0,3.0,1.0
9352,1,1,0,0,0,1,4,30,0.0,0.0,0.0,0.0,0.0,0.0,0.0,10,1,9,2.0,0.0,2.0
105216,4,3,1,1,3,1,5,42,3.0,2.0,1.0,1.0,3.0,0.0,0.0,14,4,10,2.0,2.0,0.0
9411339,7,4,3,3,4,3,15,0,1.0,1.0,0.0,0.0,0.0,1.0,8.0,26,7,19,5.0,1.0,4.0
9306297,8,6,2,2,0,8,10,381,2.0,1.0,1.0,1.0,0.0,2.0,2.0,11,8,3,3.0,2.0,1.0
9510424,5,3,2,3,0,5,14,5,1.0,1.0,0.0,0.0,1.0,0.0,0.0,14,5,9,1.0,1.0,0.0
9211311,26,9,17,46,26,0,0,208,14.0,5.0,9.0,27.0,14.0,0.0,0.0,26,26,0,11.0,11.0,0.0
9602218,17,5,12,16,1,16,95,1,13.0,4.0,9.0,13.0,0.0,13.0,87.0,28,17,11,15.0,6.0,9.0
6259,9,6,3,4,3,6,20,19,2.0,2.0,0.0,0.0,0.0,2.0,4.0,54,9,45,14.0,0.0,14.0
102279,19,7,12,26,0,19,206,2,12.0,4.0,8.0,15.0,0.0,12.0,88.0,50,19,31,29.0,12.0,17.0
9712338,7,5,2,3,3,4,9,263,2.0,1.0,1.0,1.0,0.0,2.0,2.0,15,7,8,2.0,2.0,0.0
9401269,22,10,12,40,22,0,0,44,12.0,4.0,8.0,26.0,12.0,0.0,0.0,22,22,0,7.0,7.0,0.0
104236,11,4,7,19,0,11,114,29,7.0,2.0,5.0,11.0,0.0,7.0,59.0,40,11,29,18.0,6.0,12.0
204299,11,7,4,6,0,11,109,24,3.0,3.0,0.0,0.0,0.0,3.0,62.0,152,11,141,49.0,1.0,48.0
9902304,18,5,13,27,3,15,66,24,3.0,2.0,1.0,2.0,0.0,3.0,18.0,42,18,24,5.0,4.0,1.0
112352,6,3,3,4,1,5,16,13,2.0,1.0,1.0,1.0,0.0,2.0,11.0,14,6,8,,,
9810243,8,4,4,8,3,5,26,78,4.0,1.0,3.0,5.0,3.0,1.0,3.0,24,8,16,4.0,0.0,4.0
9402268,5,5,0,0,0,5,14,75,0.0,0.0,0.0,0.0,0.0,0.0,0.0,17,5,12,1.0,0.0,1.0
9311294,26,4,22,68,22,4,4,43,9.0,1.0,8.0,30.0,9.0,0.0,0.0,27,26,1,4.0,4.0,0.0
9711337,7,3,4,4,0,7,16,39,0.0,0.0,0.0,0.0,0.0,0.0,0.0,18,7,11,3.0,3.0,0.0
9702340,5,5,0,0,4,1,1,415,0.0,0.0,0.0,0.0,0.0,0.0,0.0,12,5,7,3.0,0.0,3.0
103203,3,2,1,1,0,3,20,45,3.0,2.0,1.0,1.0,0.0,3.0,12.0,30,3,27,8.0,3.0,5.0
5168,3,3,0,0,1,2,4,26,1.0,1.0,0.0,0.0,1.0,0.0,0.0,5,3,2,1.0,1.0,0.0
9141,15,1,14,40,1,14,134,0,13.0,1.0,12.0,32.0,1.0,12.0,116.0,37,15,22,30.0,12.0,18.0
9604345,8,7,1,1,1,7,30,16,2.0,2.0,0.0,0.0,0.0,2.0,11.0,40,8,32,3.0,1.0,2.0
9507280,14,6,8,14,4,10,24,1,8.0,2.0,6.0,12.0,2.0,6.0,8.0,25,14,11,3.0,3.0,0.0
9611399,5,4,1,1,5,0,0,126,2.0,2.0,0.0,0.0,2.0,0.0,0.0,5,5,0,2.0,2.0,0.0
9606297,15,4,11,35,5,10,10,42,8.0,2.0,6.0,18.0,0.0,8.0,8.0,16,15,1,7.0,7.0,0.0
9407254,2,2,0,0,1,1,1,10,0.0,0.0,0.0,0.0,0.0,0.0,0.0,21,2,19,1.0,0.0,1.0
207319,1,1,0,0,0,1,9,63,0.0,0.0,0.0,0.0,0.0,0.0,0.0,17,1,16,3.0,1.0,2.0
201291,59,13,46,192,1,58,515,3,12.0,2.0,10.0,19.0,0.0,12.0,148.0,178,59,119,21.0,5.0,16.0
202149,4,3,1,1,1,3,11,12,,,,,,,,10,4,6,1.0,1.0,0.0
207227,49,20,29,93,3,46,313,0,21.0,7.0,14.0,44.0,0.0,21.0,173.0,82,49,33,25.0,15.0,10.0
9805214,14,5,9,15,7,7,7,125,8.0,1.0,7.0,13.0,1.0,7.0,7.0,17,14,3,8.0,7.0,1.0
9703411,20,6,14,42,2,18,58,27,5.0,2.0,3.0,8.0,0.0,5.0,9.0,28,20,8,6.0,4.0,2.0
9402337,41,4,37,201,21,20,34,13,31.0,3.0,28.0,157.0,23.0,8.0,8.0,46,41,5,21.0,20.0,1.0
9310247,18,8,10,15,9,9,9,110,8.0,7.0,1.0,1.0,8.0,0.0,0.0,19,18,1,4.0,4.0,0.0
7342,3,2,1,1,0,3,11,62,1.0,1.0,0.0,0.0,0.0,1.0,5.0,18,3,15,6.0,1.0,5.0
9308328,12,4,8,23,12,0,0,58,9.0,2.0,7.0,16.0,9.0,0.0,0.0,12,12,0,2.0,2.0,0.0
9501293,4,2,2,2,0,4,4,75,0.0,0.0,0.0,0.0,0.0,0.0,0.0,5,4,1,4.0,3.0,1.0
9909391,12,5,7,19,1,11,28,74,6.0,2.0,4.0,7.0,0.0,6.0,12.0,34,12,22,11.0,5.0,6.0
9712303,9,6,3,3,1,8,14,95,2.0,2.0,0.0,0.0,2.0,0.0,0.0,24,9,15,4.0,2.0,2.0
9406283,17,12,5,9,12,5,6,13,3.0,3.0,0.0,0.0,3.0,0.0,0.0,20,17,3,3.0,3.0,0.0
301232,0,0,0,0,0,0,0,2,0.0,0.0,0.0,0.0,0.0,0.0,0.0,24,0,24,5.0,0.0,5.0
9610235,4,3,1,1,0,4,32,5,4.0,3.0,1.0,1.0,0.0,4.0,30.0,15,4,11,3.0,1.0,2.0
9812318,1,1,0,0,0,1,3,16,,,,,,,,6,1,5,2.0,0.0,2.0
108176,4,2,2,2,0,4,18,87,2.0,1.0,1.0,1.0,0.0,2.0,5.0,33,4,29,10.0,2.0,8.0
4170,5,2,3,3,0,5,17,12,0.0,0.0,0.0,0.0,0.0,0.0,0.0,25,5,20,4.0,2.0,2.0
9906452,24,3,21,122,1,23,96,50,21.0,2.0,19.0,119.0,0.0,21.0,89.0,34,24,10,28.0,21.0,7.0
9605444,20,3,17,63,6,14,35,4,14.0,2.0,12.0,45.0,4.0,10.0,28.0,27,20,7,13.0,10.0,3.0
9706406,5,4,1,1,2,3,13,35,1.0,1.0,0.0,0.0,0.0,1.0,2.0,27,5,22,7.0,2.0,5.0
9504288,13,4,9,14,7,6,7,58,8.0,2.0,6.0,9.0,2.0,6.0,7.0,15,13,2,5.0,5.0,0.0
9908412,13,4,9,30,0,13,28,27,13.0,4.0,9.0,30.0,0.0,13.0,28.0,17,13,4,11.0,9.0,2.0
9605434,33,4,29,133,5,28,57,27,15.0,2.0,13.0,33.0,11.0,4.0,4.0,39,33,6,13.0,10.0,3.0
110247,9,6,3,3,3,6,34,39,4.0,4.0,0.0,0.0,0.0,4.0,23.0,25,9,16,13.0,1.0,12.0
108181,4,2,2,2,1,3,5,0,1.0,1.0,0.0,0.0,1.0,0.0,0.0,9,4,5,1.0,1.0,0.0
208258,1,1,0,0,0,1,6,178,0.0,0.0,0.0,0.0,0.0,0.0,0.0,26,1,25,7.0,0.0,7.0
202054,7,5,2,2,0,7,73,12,2.0,2.0,0.0,0.0,0.0,2.0,24.0,79,7,72,27.0,1.0,26.0
9507299,24,3,21,57,15,9,9,3,9.0,2.0,7.0,14.0,9.0,0.0,0.0,27,24,3,8.0,8.0,0.0
9243,0,0,0,0,0,0,0,224,0.0,0.0,0.0,0.0,0.0,0.0,0.0,7,0,7,1.0,0.0,1.0
107094,8,3,5,11,0,8,64,37,1.0,1.0,0.0,0.0,0.0,1.0,12.0,36,8,28,12.0,1.0,11.0
103284,6,4,2,3,0,6,86,32,5.0,3.0,2.0,3.0,0.0,5.0,66.0,56,6,50,29.0,4.0,25.0
107113,11,1,10,34,0,11,39,47,11.0,1.0,10.0,34.0,0.0,11.0,37.0,20,11,9,18.0,10.0,8.0
10015,14,11,3,4,8,6,18,115,1.0,1.0,0.0,0.0,0.0,1.0,5.0,27,14,13,6.0,1.0,5.0
106085,4,4,0,0,0,4,21,3,2.0,2.0,0.0,0.0,0.0,2.0,16.0,62,4,58,29.0,0.0,29.0
110393,19,6,13,27,3,16,70,0,6.0,2.0,4.0,9.0,0.0,6.0,29.0,35,19,16,8.0,6.0,2.0
9411249,13,7,6,11,1,12,20,10,6.0,3.0,3.0,5.0,0.0,6.0,6.0,24,13,11,8.0,7.0,1.0
9904331,4,3,1,1,4,0,0,497,1.0,1.0,0.0,0.0,1.0,0.0,0.0,7,4,3,1.0,1.0,0.0
9609233,21,4,17,47,0,21,35,264,13.0,4.0,9.0,21.0,0.0,13.0,24.0,23,21,2,11.0,9.0,2.0
204112,4,1,3,5,0,4,57,28,4.0,1.0,3.0,5.0,0.0,4.0,41.0,38,4,34,5.0,0.0,5.0
9508225,28,17,11,15,4,24,38,52,13.0,6.0,7.0,11.0,2.0,11.0,14.0,35,28,7,4.0,4.0,0.0
9704299,11,4,7,23,0,11,75,94,9.0,3.0,6.0,19.0,0.0,9.0,69.0,24,11,13,20.0,9.0,11.0
2158,18,8,10,15,7,11,16,126,10.0,2.0,8.0,12.0,5.0,5.0,9.0,37,18,19,8.0,2.0,6.0
9401315,5,2,3,3,5,0,0,179,3.0,1.0,2.0,2.0,3.0,0.0,0.0,5,5,0,2.0,2.0,0.0
9801277,4,2,2,3,1,3,4,115,0.0,0.0,0.0,0.0,0.0,0.0,0.0,11,4,7,4.0,0.0,4.0
9809455,4,2,2,2,0,4,20,13,4.0,2.0,2.0,2.0,0.0,4.0,18.0,13,4,9,6.0,3.0,3.0
9704213,26,6,20,45,2,24,92,12,16.0,3.0,13.0,27.0,0.0,16.0,60.0,40,26,14,18.0,10.0,8.0
9712256,6,6,0,0,1,5,39,44,2.0,2.0,0.0,0.0,0.0,2.0,15.0,37,6,31,13.0,3.0,10.0
9406279,3,2,1,1,3,0,0,987,,,,,,,,3,3,0,,,
8052,11,1,10,32,0,11,60,32,11.0,1.0,10.0,32.0,0.0,11.0,60.0,26,11,15,19.0,9.0,10.0
9511311,14,4,10,17,7,7,8,135,5.0,1.0,4.0,7.0,5.0,0.0,0.0,21,14,7,5.0,5.0,0.0
9703318,8,2,6,11,0,8,27,62,7.0,2.0,5.0,9.0,0.0,7.0,24.0,18,8,10,9.0,6.0,3.0
203132,6,4,2,2,1,5,12,121,4.0,3.0,1.0,1.0,1.0,3.0,10.0,12,6,6,6.0,1.0,5.0
9611463,21,6,15,33,8,13,37,102,11.0,1.0,10.0,25.0,1.0,10.0,30.0,26,21,5,13.0,9.0,4.0
9612470,1,1,0,0,0,1,3,41,0.0,0.0,0.0,0.0,0.0,0.0,0.0,10,1,9,6.0,0.0,6.0
9908216,3,2,1,1,2,1,3,115,2.0,2.0,0.0,0.0,2.0,0.0,0.0,8,3,5,2.0,2.0,0.0
9602345,4,3,1,1,0,4,23,24,0.0,0.0,0.0,0.0,0.0,0.0,0.0,18,4,14,5.0,2.0,3.0
9708265,11,6,5,7,1,10,18,84,5.0,1.0,4.0,6.0,0.0,5.0,9.0,27,11,16,2.0,2.0,0.0
9407338,34,10,24,83,30,4,4,25,16.0,2.0,14.0,68.0,16.0,0.0,0.0,35,34,1,13.0,13.0,0.0
9912218,4,3,1,1,0,4,13,128,2.0,1.0,1.0,1.0,0.0,2.0,9.0,19,4,15,9.0,2.0,7.0
10201,29,2,27,174,0,29,271,109,29.0,2.0,27.0,174.0,0.0,29.0,264.0,46,29,17,41.0,28.0,13.0
4071,17,3,14,58,1,16,78,109,17.0,3.0,14.0,58.0,1.0,16.0,78.0,25,17,8,21.0,14.0,7.0
9804450,6,5,1,5,0,6,65,5,6.0,5.0,1.0,5.0,0.0,6.0,65.0,23,6,17,13.0,3.0,10.0
9906310,23,3,20,70,3,20,144,12,14.0,3.0,11.0,22.0,0.0,14.0,109.0,46,23,23,12.0,9.0,3.0
9912255,1,1,0,0,0,1,1,551,1.0,1.0,0.0,0.0,0.0,1.0,1.0,4,1,3,3.0,1.0,2.0
11155,14,11,3,3,6,8,39,135,2.0,2.0,0.0,0.0,0.0,2.0,11.0,26,14,12,10.0,3.0,7.0
9910359,3,1,2,2,0,3,16,182,3.0,1.0,2.0,2.0,0.0,3.0,14.0,12,3,9,9.0,3.0,6.0
6249,2,2,0,0,0,2,8,19,2.0,2.0,0.0,0.0,0.0,2.0,8.0,9,2,7,7.0,2.0,5.0
9701285,10,4,6,16,3,7,12,36,4.0,1.0,3.0,6.0,0.0,4.0,7.0,13,10,3,4.0,2.0,2.0
9349,0,0,0,0,0,0,0,22,0.0,0.0,0.0,0.0,0.0,0.0,0.0,11,0,11,1.0,0.0,1.0
9406201,1,1,0,0,0,1,1,631,1.0,1.0,0.0,0.0,1.0,0.0,0.0,2,1,1,1.0,1.0,0.0
9804242,9,1,8,13,0,9,62,5,6.0,1.0,5.0,8.0,0.0,6.0,17.0,34,9,25,2.0,2.0,0.0
9509430,4,4,0,0,1,3,9,5,0.0,0.0,0.0,0.0,0.0,0.0,0.0,12,4,8,1.0,0.0,1.0
9707437,11,4,7,16,0,11,41,157,6.0,2.0,4.0,5.0,1.0,5.0,11.0,25,11,14,9.0,6.0,3.0
9604420,5,2,3,7,4,1,1,41,3.0,2.0,1.0,2.0,2.0,1.0,1.0,8,5,3,6.0,3.0,3.0
1151,24,4,20,47,6,18,55,7,11.0,1.0,10.0,22.0,2.0,9.0,22.0,42,24,18,11.0,7.0,4.0
9503427,4,3,1,1,4,0,0,104,0.0,0.0,0.0,0.0,0.0,0.0,0.0,16,4,12,2.0,0.0,2.0
9801242,9,4,5,10,0,9,34,5,3.0,2.0,1.0,1.0,0.0,3.0,15.0,26,9,17,13.0,7.0,6.0
102013,34,5,29,137,2,32,202,1,29.0,2.0,27.0,131.0,0.0,29.0,177.0,53,34,19,32.0,23.0,9.0
9808457,2,1,1,1,0,2,11,8,2.0,1.0,1.0,1.0,0.0,2.0,8.0,12,2,10,,,
9912213,1,1,0,0,1,0,0,51,0.0,0.0,0.0,0.0,0.0,0.0,0.0,10,1,9,1.0,0.0,1.0
12214,2,2,0,0,2,0,0,42,0.0,0.0,0.0,0.0,0.0,0.0,0.0,18,2,16,1.0,0.0,1.0
9608384,6,2,4,9,2,4,7,202,6.0,2.0,4.0,9.0,2.0,4.0,6.0,11,6,5,7.0,5.0,2.0
9502227,47,7,40,189,5,42,334,53,34.0,2.0,32.0,172.0,1.0,33.0,303.0,69,47,22,46.0,30.0,16.0
9908207,13,3,10,27,8,5,8,282,10.0,1.0,9.0,26.0,10.0,0.0,0.0,19,13,6,8.0,8.0,0.0
9708291,3,1,2,2,1,2,5,183,2.0,1.0,1.0,1.0,1.0,1.0,1.0,9,3,6,1.0,0.0,1.0
111019,5,3,2,3,1,4,8,239,3.0,1.0,2.0,3.0,0.0,3.0,7.0,8,5,3,6.0,3.0,3.0
9509251,5,3,2,2,1,4,7,117,,,,,,,,8,5,3,1.0,1.0,0.0
9309,7,3,4,10,2,5,20,9,5.0,1.0,4.0,8.0,3.0,2.0,4.0,21,7,14,7.0,2.0,5.0
101297,19,8,11,29,1,18,93,8,8.0,2.0,6.0,15.0,1.0,7.0,34.0,56,19,37,6.0,5.0,1.0
9404225,16,7,9,16,12,4,4,63,7.0,3.0,4.0,5.0,6.0,1.0,1.0,19,16,3,4.0,4.0,0.0
101029,1,1,0,0,1,0,0,86,1.0,1.0,0.0,0.0,1.0,0.0,0.0,9,1,8,1.0,0.0,1.0
9610460,3,1,2,2,0,3,23,18,1.0,1.0,0.0,0.0,0.0,1.0,9.0,41,3,38,7.0,2.0,5.0
9607360,8,5,3,9,8,0,0,597,2.0,2.0,0.0,0.0,2.0,0.0,0.0,8,8,0,1.0,1.0,0.0
9404265,2,2,0,0,1,1,1,83,,,,,,,,4,2,2,1.0,0.0,1.0
9811325,2,2,0,0,2,0,0,18,0.0,0.0,0.0,0.0,0.0,0.0,0.0,9,2,7,1.0,0.0,1.0
9907562,8,5,3,3,7,1,1,46,1.0,1.0,0.0,0.0,1.0,0.0,0.0,10,8,2,1.0,1.0,0.0
9905313,4,3,1,1,0,4,12,6,0.0,0.0,0.0,0.0,0.0,0.0,0.0,17,4,13,2.0,0.0,2.0
102281,9,7,2,2,1,8,27,27,1.0,1.0,0.0,0.0,1.0,0.0,0.0,26,9,17,2.0,0.0,2.0
9602379,2,2,0,0,0,2,6,77,0.0,0.0,0.0,0.0,0.0,0.0,0.0,5,2,3,1.0,0.0,1.0
9704204,7,2,5,9,0,7,13,41,5.0,2.0,3.0,6.0,0.0,5.0,9.0,16,7,9,3.0,2.0,1.0
9901419,4,3,1,1,0,4,7,97,3.0,3.0,0.0,0.0,0.0,3.0,5.0,9,4,5,6.0,4.0,2.0
9803319,13,8,5,9,4,9,54,5,2.0,2.0,0.0,0.0,0.0,2.0,19.0,34,13,21,10.0,2.0,8.0
9406381,1,1,0,0,1,0,0,360,,,,,,,,1,1,0,1.0,1.0,0.0
9807399,19,8,11,20,9,10,15,212,8.0,1.0,7.0,11.0,2.0,6.0,6.0,22,19,3,7.0,6.0,1.0
9902406,2,2,0,0,0,2,7,56,1.0,1.0,0.0,0.0,0.0,1.0,5.0,17,2,15,2.0,0.0,2.0
9709467,5,3,2,3,0,5,14,69,2.0,1.0,1.0,1.0,0.0,2.0,8.0,10,5,5,2.0,1.0,1.0
201197,18,1,17,51,0,18,103,193,16.0,1.0,15.0,49.0,0.0,16.0,72.0,43,18,25,21.0,16.0,5.0
9903553,7,2,5,8,3,4,9,184,6.0,1.0,5.0,8.0,3.0,3.0,3.0,13,7,6,5.0,4.0,1.0
9908372,10,1,9,27,0,10,47,38,9.0,1.0,8.0,24.0,0.0,9.0,45.0,17,10,7,14.0,7.0,7.0
9808432,3,2,1,1,0,3,8,57,3.0,2.0,1.0,1.0,0.0,3.0,8.0,7,3,4,5.0,2.0,3.0
9509210,3,3,0,0,0,3,18,17,1.0,1.0,0.0,0.0,0.0,1.0,14.0,23,3,20,7.0,1.0,6.0
9309319,4,1,3,5,4,0,0,207,3.0,1.0,2.0,3.0,3.0,0.0,0.0,6,4,2,3.0,3.0,0.0
9505388,4,1,3,6,0,4,16,16,4.0,1.0,3.0,6.0,0.0,4.0,16.0,9,4,5,4.0,2.0,2.0
9912521,0,0,0,0,0,0,0,101,,,,,,,,5,0,5,,,
7005,22,6,16,67,0,22,182,8,15.0,3.0,12.0,49.0,0.0,15.0,143.0,40,22,18,30.0,14.0,16.0
9702275,7,4,3,4,2,5,5,221,5.0,3.0,2.0,2.0,1.0,4.0,4.0,10,7,3,4.0,3.0,1.0
9310310,9,4,5,10,6,3,3,70,7.0,2.0,5.0,10.0,7.0,0.0,0.0,10,9,1,3.0,3.0,0.0
103190,1,1,0,0,0,1,1,99,0.0,0.0,0.0,0.0,0.0,0.0,0.0,2,1,1,1.0,0.0,1.0
107309,3,2,1,1,0,3,9,43,0.0,0.0,0.0,0.0,0.0,0.0,0.0,12,3,9,4.0,1.0,3.0
9811268,11,3,8,15,0,11,36,122,6.0,2.0,4.0,7.0,0.0,6.0,11.0,20,11,9,7.0,5.0,2.0
102032,11,7,4,5,0,11,12,19,2.0,1.0,1.0,1.0,2.0,0.0,0.0,13,11,2,3.0,2.0,1.0
9805301,7,1,6,11,1,6,9,49,6.0,1.0,5.0,9.0,1.0,5.0,7.0,11,7,4,3.0,2.0,1.0
106104,4,3,1,1,0,4,56,34,1.0,1.0,0.0,0.0,0.0,1.0,19.0,41,4,37,26.0,1.0,25.0
9505378,4,1,3,5,0,4,8,196,1.0,1.0,0.0,0.0,0.0,1.0,1.0,9,4,5,5.0,4.0,1.0
102264,21,9,12,27,2,19,59,21,8.0,5.0,3.0,3.0,1.0,7.0,17.0,30,21,9,9.0,8.0,1.0
104186,12,4,8,29,0,12,118,73,9.0,2.0,7.0,23.0,0.0,9.0,87.0,32,12,20,13.0,7.0,6.0
9902416,3,2,1,2,0,3,21,73,3.0,2.0,1.0,2.0,0.0,3.0,10.0,14,3,11,1.0,1.0,0.0
9709323,2,2,0,0,0,2,4,1453,1.0,1.0,0.0,0.0,0.0,1.0,2.0,5,2,3,3.0,1.0,2.0
9606285,1,1,0,0,1,0,0,166,0.0,0.0,0.0,0.0,0.0,0.0,0.0,3,1,2,1.0,0.0,1.0
9710225,6,3,3,6,6,0,0,33,1.0,1.0,0.0,0.0,1.0,0.0,0.0,6,6,0,,,
9501377,3,2,1,1,3,0,0,95,2.0,1.0,1.0,1.0,2.0,0.0,0.0,3,3,0,1.0,1.0,0.0
9266,3,1,2,3,0,3,23,50,3.0,1.0,2.0,3.0,0.0,3.0,21.0,13,3,10,11.0,3.0,8.0
9706378,13,3,10,30,0,13,32,82,11.0,3.0,8.0,26.0,0.0,11.0,30.0,17,13,4,13.0,10.0,3.0
6182,5,2,3,3,0,5,25,92,1.0,1.0,0.0,0.0,0.0,1.0,3.0,21,5,16,3.0,2.0,1.0
106105,1,1,0,0,0,1,3,117,0.0,0.0,0.0,0.0,0.0,0.0,0.0,9,1,8,1.0,0.0,1.0
9912289,15,7,8,10,3,12,34,9,4.0,3.0,1.0,1.0,1.0,3.0,4.0,28,15,13,2.0,2.0,0.0
9912548,8,4,4,6,3,5,43,13,4.0,1.0,3.0,5.0,0.0,4.0,32.0,55,8,47,18.0,3.0,15.0
9705214,4,3,1,1,3,1,2,419,1.0,1.0,0.0,0.0,1.0,0.0,0.0,8,4,4,3.0,1.0,2.0
9908373,2,2,0,0,0,2,26,32,2.0,2.0,0.0,0.0,0.0,2.0,26.0,40,2,38,24.0,2.0,22.0
9311280,3,3,0,0,0,3,3,155,1.0,1.0,0.0,0.0,1.0,0.0,0.0,5,3,2,1.0,1.0,0.0
9406306,7,2,5,6,0,7,16,48,3.0,2.0,1.0,1.0,1.0,2.0,3.0,11,7,4,4.0,2.0,2.0
9701372,8,5,3,4,4,4,11,86,2.0,1.0,1.0,1.0,1.0,1.0,4.0,28,8,20,4.0,2.0,2.0
9905319,2,2,0,0,0,2,4,11,0.0,0.0,0.0,0.0,0.0,0.0,0.0,21,2,19,7.0,0.0,7.0
211022,1,1,0,0,0,1,6,131,0.0,0.0,0.0,0.0,0.0,0.0,0.0,35,1,34,12.0,0.0,12.0
9906301,14,6,8,18,2,12,79,40,11.0,6.0,5.0,11.0,0.0,11.0,62.0,46,14,32,9.0,7.0,2.0
9311375,8,4,4,8,6,2,2,26,8.0,4.0,4.0,8.0,8.0,0.0,0.0,9,8,1,7.0,6.0,1.0
105151,9,7,2,2,9,0,0,305,1.0,1.0,0.0,0.0,1.0,0.0,0.0,9,9,0,3.0,3.0,0.0
10343,10,8,2,2,4,6,13,226,3.0,3.0,0.0,0.0,2.0,1.0,1.0,18,10,8,2.0,2.0,0.0
9912328,1,1,0,0,0,1,1,17,,,,,,,,9,1,8,1.0,0.0,1.0
12257,3,2,1,1,0,3,9,143,2.0,1.0,1.0,1.0,1.0,1.0,2.0,9,3,6,3.0,2.0,1.0
9801385,6,5,1,1,4,2,8,26,2.0,2.0,0.0,0.0,0.0,2.0,8.0,19,6,13,9.0,1.0,8.0
11231,3,2,1,2,3,0,0,70,0.0,0.0,0.0,0.0,0.0,0.0,0.0,15,3,12,2.0,2.0,0.0
105163,2,1,1,1,0,2,17,0,1.0,1.0,0.0,0.0,0.0,1.0,2.0,18,2,16,7.0,1.0,6.0
9802327,1,1,0,0,0,1,3,31,0.0,0.0,0.0,0.0,0.0,0.0,0.0,4,1,3,3.0,0.0,3.0
9910204,16,2,14,57,2,14,34,201,14.0,1.0,13.0,56.0,0.0,14.0,34.0,20,16,4,17.0,14.0,3.0
9501252,2,2,0,0,2,0,0,510,2.0,2.0,0.0,0.0,2.0,0.0,0.0,2,2,0,2.0,2.0,0.0
8131,4,3,1,1,0,4,33,161,3.0,2.0,1.0,1.0,0.0,3.0,27.0,20,4,16,12.0,2.0,10.0
210342,6,6,0,0,0,6,27,3,1.0,1.0,0.0,0.0,0.0,1.0,3.0,90,6,84,24.0,0.0,24.0
108070,11,9,2,3,1,10,42,3,3.0,2.0,1.0,1.0,0.0,3.0,6.0,26,11,15,7.0,4.0,3.0
202097,7,3,4,10,0,7,58,3,6.0,2.0,4.0,10.0,1.0,5.0,29.0,24,7,17,6.0,5.0,1.0
1189,20,5,15,42,0,20,37,11,9.0,1.0,8.0,23.0,1.0,8.0,8.0,37,20,17,11.0,9.0,2.0
9901405,20,4,16,37,3,17,94,83,14.0,2.0,12.0,30.0,0.0,14.0,70.0,30,20,10,20.0,12.0,8.0
11287,5,2,3,3,0,5,17,30,3.0,2.0,1.0,1.0,0.0,3.0,6.0,12,5,7,8.0,4.0,4.0
9711221,6,3,3,6,4,2,8,205,2.0,2.0,0.0,0.0,0.0,2.0,5.0,12,6,6,5.0,2.0,3.0
9509331,10,5,5,6,1,9,10,22,4.0,2.0,2.0,2.0,4.0,0.0,0.0,12,10,2,2.0,2.0,0.0
202092,2,1,1,1,0,2,8,6,0.0,0.0,0.0,0.0,0.0,0.0,0.0,23,2,21,1.0,0.0,1.0
206156,1,1,0,0,1,0,0,23,0.0,0.0,0.0,0.0,0.0,0.0,0.0,23,1,22,1.0,0.0,1.0
9505280,4,3,1,1,1,3,7,58,1.0,1.0,0.0,0.0,0.0,1.0,2.0,10,4,6,3.0,1.0,2.0
9309309,0,0,0,0,0,0,0,208,0.0,0.0,0.0,0.0,0.0,0.0,0.0,3,0,3,1.0,0.0,1.0
106002,6,4,2,3,2,4,20,0,1.0,1.0,0.0,0.0,0.0,1.0,4.0,52,6,46,6.0,1.0,5.0
5269,11,4,7,10,0,11,22,163,5.0,2.0,3.0,3.0,0.0,5.0,10.0,20,11,9,6.0,4.0,2.0
9310333,3,2,1,2,3,0,0,407,1.0,1.0,0.0,0.0,1.0,0.0,0.0,6,3,3,2.0,2.0,0.0
9806505,9,4,5,11,2,7,46,12,7.0,3.0,4.0,10.0,0.0,7.0,46.0,25,9,16,19.0,5.0,14.0
103295,14,7,7,11,0,14,71,9,12.0,6.0,6.0,9.0,0.0,12.0,40.0,25,14,11,11.0,7.0,4.0
9912421,6,2,4,5,0,6,10,25,2.0,1.0,1.0,1.0,0.0,2.0,5.0,11,6,5,6.0,3.0,3.0
9401351,8,3,5,9,2,6,9,15,1.0,1.0,0.0,0.0,1.0,0.0,0.0,10,8,2,5.0,4.0,1.0
9505236,2,2,0,0,0,2,2,25,0.0,0.0,0.0,0.0,0.0,0.0,0.0,8,2,6,1.0,0.0,1.0
9212282,7,6,1,1,7,0,0,317,1.0,1.0,0.0,0.0,1.0,0.0,0.0,7,7,0,1.0,1.0,0.0
9904458,4,2,2,3,0,4,24,5,0.0,0.0,0.0,0.0,0.0,0.0,0.0,49,4,45,20.0,0.0,20.0
9809520,4,3,1,1,2,2,4,35,1.0,1.0,0.0,0.0,1.0,0.0,0.0,7,4,3,3.0,2.0,1.0
202087,9,4,5,6,0,9,46,4,1.0,1.0,0.0,0.0,0.0,1.0,4.0,23,9,14,4.0,1.0,3.0
1162,7,1,6,14,0,7,38,174,7.0,1.0,6.0,14.0,0.0,7.0,23.0,17,7,10,12.0,7.0,5.0
9212253,24,14,10,19,24,0,0,74,11.0,5.0,6.0,14.0,11.0,0.0,0.0,24,24,0,4.0,4.0,0.0
9707493,2,2,0,0,1,1,2,208,0.0,0.0,0.0,0.0,0.0,0.0,0.0,5,2,3,1.0,1.0,0.0
106169,18,8,10,19,3,15,79,11,8.0,2.0,6.0,15.0,0.0,8.0,58.0,41,18,23,18.0,6.0,12.0
101143,6,4,2,2,1,5,34,38,3.0,1.0,2.0,2.0,0.0,3.0,24.0,45,6,39,21.0,1.0,20.0
12043,10,3,7,28,0,10,55,2,9.0,3.0,6.0,23.0,0.0,9.0,41.0,22,10,12,14.0,10.0,4.0
201282,6,5,1,2,0,6,31,95,3.0,2.0,1.0,2.0,1.0,2.0,7.0,30,6,24,8.0,2.0,6.0
9907256,3,2,1,1,3,0,0,87,2.0,1.0,1.0,1.0,2.0,0.0,0.0,3,3,0,2.0,2.0,0.0
10131,10,6,4,4,1,9,20,126,6.0,3.0,3.0,3.0,1.0,5.0,12.0,17,10,7,7.0,4.0,3.0
9907453,1,1,0,0,0,1,4,9,0.0,0.0,0.0,0.0,0.0,0.0,0.0,16,1,15,,,
9712333,5,4,1,1,3,2,2,146,4.0,3.0,1.0,1.0,2.0,2.0,2.0,8,5,3,3.0,2.0,1.0
210140,2,2,0,0,0,2,8,0,1.0,1.0,0.0,0.0,0.0,1.0,5.0,12,2,10,1.0,1.0,0.0
106054,16,8,8,10,14,2,3,3,5.0,5.0,0.0,0.0,5.0,0.0,0.0,21,16,5,2.0,2.0,0.0
210374,2,2,0,0,0,2,9,37,1.0,1.0,0.0,0.0,0.0,1.0,1.0,21,2,19,9.0,1.0,8.0
9507270,1,1,0,0,1,0,0,94,0.0,0.0,0.0,0.0,0.0,0.0,0.0,5,1,4,,,
111472,11,5,6,7,0,11,126,9,8.0,2.0,6.0,7.0,0.0,8.0,105.0,54,11,43,34.0,5.0,29.0
12062,13,4,9,18,0,13,123,17,8.0,2.0,6.0,14.0,0.0,8.0,94.0,58,13,45,8.0,5.0,3.0
9805480,3,2,1,1,1,2,7,82,1.0,1.0,0.0,0.0,0.0,1.0,4.0,11,3,8,2.0,0.0,2.0
204108,5,3,2,3,2,3,34,37,1.0,1.0,0.0,0.0,0.0,1.0,11.0,43,5,38,5.0,0.0,5.0
9308,12,2,10,18,0,12,43,85,5.0,2.0,3.0,4.0,0.0,5.0,22.0,24,12,12,7.0,2.0,5.0
9310264,5,5,0,0,5,0,0,96,2.0,2.0,0.0,0.0,2.0,0.0,0.0,5,5,0,2.0,2.0,0.0
9508205,7,4,3,6,4,3,4,68,0.0,0.0,0.0,0.0,0.0,0.0,0.0,13,7,6,1.0,1.0,0.0
9906219,2,1,1,1,2,0,0,412,0.0,0.0,0.0,0.0,0.0,0.0,0.0,8,2,6,1.0,0.0,1.0
9409231,3,3,0,0,0,3,6,34,0.0,0.0,0.0,0.0,0.0,0.0,0.0,6,3,3,,,
110214,5,5,0,0,1,4,11,26,1.0,1.0,0.0,0.0,1.0,0.0,0.0,11,5,6,,,
9503284,0,0,0,0,0,0,0,1977,,,,,,,,2,0,2,,,
1317,4,4,0,0,0,4,11,1,0.0,0.0,0.0,0.0,0.0,0.0,0.0,52,4,48,9.0,1.0,8.0
204117,3,2,1,1,0,3,27,28,3.0,2.0,1.0,1.0,0.0,3.0,16.0,16,3,13,1.0,1.0,0.0
10350,4,4,0,0,0,4,22,39,2.0,2.0,0.0,0.0,0.0,2.0,14.0,23,4,19,18.0,1.0,17.0
9611228,5,4,1,2,0,5,32,40,4.0,3.0,1.0,2.0,0.0,4.0,26.0,16,5,11,13.0,3.0,10.0
10283,6,5,1,1,0,6,20,13,1.0,1.0,0.0,0.0,0.0,1.0,2.0,25,6,19,6.0,1.0,5.0
108234,3,3,0,0,0,3,48,2,2.0,2.0,0.0,0.0,0.0,2.0,31.0,29,3,26,3.0,1.0,2.0
9210279,7,4,3,3,7,0,0,466,3.0,3.0,0.0,0.0,3.0,0.0,0.0,7,7,0,1.0,1.0,0.0
104301,3,2,1,1,0,3,22,43,1.0,1.0,0.0,0.0,0.0,1.0,6.0,19,3,16,4.0,2.0,2.0
9809372,11,3,8,12,4,7,19,29,3.0,1.0,2.0,3.0,3.0,0.0,0.0,20,11,9,3.0,3.0,0.0
9506348,1,1,0,0,0,1,2,1956,,,,,,,,3,1,2,,,
9404222,0,0,0,0,0,0,0,1637,0.0,0.0,0.0,0.0,0.0,0.0,0.0,2,0,2,1.0,0.0,1.0
9906284,17,9,8,12,0,17,105,47,8.0,5.0,3.0,4.0,0.0,8.0,40.0,37,17,20,19.0,9.0,10.0
9505276,6,6,0,0,3,3,4,306,1.0,1.0,0.0,0.0,0.0,1.0,2.0,9,6,3,1.0,1.0,0.0
9908361,7,4,3,3,6,1,1,160,2.0,1.0,1.0,1.0,2.0,0.0,0.0,8,7,1,,,
9405311,5,3,2,5,5,0,0,292,4.0,2.0,2.0,5.0,4.0,0.0,0.0,5,5,0,4.0,4.0,0.0
202160,8,5,3,3,0,8,29,119,5.0,3.0,2.0,2.0,0.0,5.0,20.0,18,8,10,10.0,5.0,5.0
9703262,3,2,1,1,1,2,6,31,1.0,1.0,0.0,0.0,0.0,1.0,2.0,8,3,5,3.0,1.0,2.0
9606403,16,6,10,20,12,4,4,254,8.0,1.0,7.0,13.0,6.0,2.0,2.0,18,16,2,8.0,7.0,1.0
9810292,7,4,3,3,0,7,118,8,4.0,3.0,1.0,1.0,0.0,4.0,96.0,48,7,41,24.0,3.0,21.0
9607283,1,1,0,0,0,1,1,94,0.0,0.0,0.0,0.0,0.0,0.0,0.0,5,1,4,2.0,0.0,2.0
9804358,2,2,0,0,0,2,5,4,0.0,0.0,0.0,0.0,0.0,0.0,0.0,22,2,20,1.0,0.0,1.0
9810329,7,1,6,12,0,7,28,82,6.0,1.0,5.0,11.0,0.0,6.0,20.0,16,7,9,8.0,5.0,3.0
9608331,3,3,0,0,3,0,0,316,2.0,2.0,0.0,0.0,2.0,0.0,0.0,3,3,0,1.0,1.0,0.0
204156,2,2,0,0,1,1,3,11,0.0,0.0,0.0,0.0,0.0,0.0,0.0,12,2,10,1.0,0.0,1.0
1015,1,1,0,0,0,1,1,1280,,,,,,,,3,1,2,,,
9710411,0,0,0,0,0,0,0,77,0.0,0.0,0.0,0.0,0.0,0.0,0.0,3,0,3,,,
9406310,1,1,0,0,0,1,1,305,1.0,1.0,0.0,0.0,0.0,1.0,1.0,2,1,1,1.0,1.0,0.0
209165,2,1,1,1,0,2,9,66,1.0,1.0,0.0,0.0,0.0,1.0,3.0,8,2,6,3.0,2.0,1.0
107099,11,1,10,23,2,9,64,20,8.0,1.0,7.0,16.0,0.0,8.0,50.0,34,11,23,12.0,4.0,8.0
209309,6,6,0,0,0,6,21,23,0.0,0.0,0.0,0.0,0.0,0.0,0.0,39,6,33,20.0,0.0,20.0
9708330,4,2,2,3,1,3,77,36,2.0,1.0,1.0,1.0,0.0,2.0,62.0,49,4,45,32.0,2.0,30.0
203067,3,2,1,1,0,3,43,4,2.0,1.0,1.0,1.0,0.0,2.0,38.0,39,3,36,25.0,2.0,23.0
4119,3,3,0,0,0,3,11,4,1.0,1.0,0.0,0.0,0.0,1.0,5.0,20,3,17,10.0,1.0,9.0
111291,3,3,0,0,0,3,28,158,2.0,2.0,0.0,0.0,0.0,2.0,13.0,24,3,21,14.0,2.0,12.0
9805454,1,1,0,0,0,1,2,49,,,,,,,,3,1,2,,,
9910233,12,5,7,15,4,8,20,48,7.0,1.0,6.0,12.0,3.0,4.0,4.0,22,12,10,12.0,8.0,4.0
9604216,6,5,1,1,1,5,18,10,4.0,3.0,1.0,1.0,0.0,4.0,16.0,13,6,7,8.0,4.0,4.0
111210,0,0,0,0,0,0,0,47,0.0,0.0,0.0,0.0,0.0,0.0,0.0,8,0,8,6.0,0.0,6.0
103011,5,5,0,0,0,5,8,11,0.0,0.0,0.0,0.0,0.0,0.0,0.0,43,5,38,10.0,0.0,10.0
9407380,7,3,4,7,7,0,0,188,6.0,2.0,4.0,7.0,6.0,0.0,0.0,7,7,0,4.0,4.0,0.0
9710467,1,1,0,0,0,1,3,18,0.0,0.0,0.0,0.0,0.0,0.0,0.0,14,1,13,3.0,0.0,3.0
105195,10,3,7,11,0,10,65,45,6.0,1.0,5.0,9.0,0.0,6.0,35.0,33,10,23,14.0,6.0,8.0
9802278,4,3,1,1,1,3,9,127,3.0,2.0,1.0,1.0,0.0,3.0,9.0,11,4,7,3.0,2.0,1.0
107243,2,1,1,1,0,2,4,59,2.0,1.0,1.0,1.0,0.0,2.0,4.0,8,2,6,1.0,0.0,1.0
9805218,0,0,0,0,0,0,0,1571,,,,,,,,2,0,2,,,
9804444,4,4,0,0,4,0,0,143,2.0,2.0,0.0,0.0,2.0,0.0,0.0,4,4,0,2.0,2.0,0.0
204254,8,3,5,7,0,8,47,107,5.0,2.0,3.0,4.0,0.0,5.0,31.0,20,8,12,11.0,5.0,6.0
111012,4,2,2,4,0,4,25,5,4.0,2.0,2.0,4.0,0.0,4.0,18.0,17,4,13,1.0,1.0,0.0
9510356,4,4,0,0,1,3,4,124,2.0,2.0,0.0,0.0,2.0,0.0,0.0,15,4,11,6.0,1.0,5.0
9609383,2,2,0,0,0,2,4,39,0.0,0.0,0.0,0.0,0.0,0.0,0.0,5,2,3,1.0,0.0,1.0
9506298,12,10,2,2,1,11,20,78,3.0,2.0,1.0,1.0,1.0,2.0,2.0,18,12,6,3.0,2.0,1.0
9503319,5,3,2,2,0,5,15,7,1.0,1.0,0.0,0.0,0.0,1.0,1.0,17,5,12,3.0,1.0,2.0
9505227,3,3,0,0,0,3,6,399,2.0,2.0,0.0,0.0,2.0,0.0,0.0,6,3,3,3.0,2.0,1.0
9207239,7,5,2,3,7,0,0,248,4.0,2.0,2.0,3.0,4.0,0.0,0.0,7,7,0,2.0,2.0,0.0
211181,5,3,2,2,1,4,14,17,4.0,2.0,2.0,2.0,0.0,4.0,6.0,14,5,9,9.0,4.0,5.0
9710520,0,0,0,0,0,0,0,300,0.0,0.0,0.0,0.0,0.0,0.0,0.0,7,0,7,3.0,0.0,3.0
206057,24,2,22,42,0,24,114,27,21.0,2.0,19.0,34.0,0.0,21.0,98.0,34,24,10,22.0,16.0,6.0
201230,7,6,1,1,2,5,15,77,0.0,0.0,0.0,0.0,0.0,0.0,0.0,30,7,23,5.0,0.0,5.0
107100,10,8,2,2,1,9,27,32,0.0,0.0,0.0,0.0,0.0,0.0,0.0,33,10,23,2.0,0.0,2.0
9802272,2,1,1,1,0,2,15,31,2.0,1.0,1.0,1.0,0.0,2.0,11.0,13,2,11,7.0,2.0,5.0
9302266,6,5,1,1,6,0,0,214,2.0,2.0,0.0,0.0,2.0,0.0,0.0,6,6,0,2.0,2.0,0.0
9810349,6,3,3,5,0,6,13,383,5.0,2.0,3.0,5.0,0.0,5.0,9.0,9,6,3,7.0,5.0,2.0
9301279,2,2,0,0,2,0,0,324,1.0,1.0,0.0,0.0,1.0,0.0,0.0,2,2,0,1.0,1.0,0.0
9602360,4,4,0,0,1,3,5,49,1.0,1.0,0.0,0.0,1.0,0.0,0.0,7,4,3,1.0,1.0,0.0
9808406,6,4,2,2,0,6,21,12,1.0,1.0,0.0,0.0,0.0,1.0,1.0,31,6,25,11.0,0.0,11.0
9508326,8,8,0,0,2,6,6,59,4.0,4.0,0.0,0.0,0.0,4.0,4.0,9,8,1,4.0,3.0,1.0
9911353,1,1,0,0,0,1,12,8,1.0,1.0,0.0,0.0,0.0,1.0,8.0,24,1,23,16.0,1.0,15.0
9510290,3,2,1,1,3,0,0,226,1.0,1.0,0.0,0.0,1.0,0.0,0.0,3,3,0,1.0,1.0,0.0
201009,2,2,0,0,1,1,2,168,0.0,0.0,0.0,0.0,0.0,0.0,0.0,7,2,5,1.0,0.0,1.0
9910394,1,1,0,0,0,1,7,34,1.0,1.0,0.0,0.0,0.0,1.0,3.0,20,1,19,8.0,1.0,7.0
202109,9,2,7,15,0,9,32,102,8.0,2.0,6.0,13.0,0.0,8.0,21.0,21,9,12,11.0,6.0,5.0
9802234,5,2,3,4,2,3,3,24,0.0,0.0,0.0,0.0,0.0,0.0,0.0,11,5,6,2.0,0.0,2.0
9410223,3,3,0,0,3,0,0,604,3.0,3.0,0.0,0.0,3.0,0.0,0.0,3,3,0,2.0,2.0,0.0
9411408,1,1,0,0,1,0,0,933,1.0,1.0,0.0,0.0,1.0,0.0,0.0,1,1,0,,,
204129,6,2,4,5,1,5,30,165,5.0,1.0,4.0,5.0,0.0,5.0,30.0,14,6,8,13.0,5.0,8.0
101338,5,2,3,4,1,4,4,72,2.0,1.0,1.0,1.0,0.0,2.0,2.0,8,5,3,4.0,2.0,2.0
9810463,6,3,3,5,1,5,7,157,5.0,3.0,2.0,2.0,0.0,5.0,7.0,13,6,7,4.0,3.0,1.0
11322,5,4,1,1,5,0,0,64,3.0,2.0,1.0,1.0,3.0,0.0,0.0,8,5,3,1.0,1.0,0.0
8324,1,1,0,0,0,1,2,191,0.0,0.0,0.0,0.0,0.0,0.0,0.0,4,1,3,1.0,1.0,0.0
1206,9,7,2,3,2,7,8,102,2.0,2.0,0.0,0.0,0.0,2.0,2.0,13,9,4,1.0,0.0,1.0
10140,4,2,2,3,0,4,7,140,2.0,2.0,0.0,0.0,2.0,0.0,0.0,7,4,3,4.0,2.0,2.0
302092,0,0,0,0,0,0,0,46,0.0,0.0,0.0,0.0,0.0,0.0,0.0,26,0,26,14.0,0.0,14.0
9901226,6,6,0,0,1,5,8,149,5.0,5.0,0.0,0.0,0.0,5.0,5.0,10,6,4,6.0,5.0,1.0
210042,0,0,0,0,0,0,0,8,0.0,0.0,0.0,0.0,0.0,0.0,0.0,17,0,17,4.0,0.0,4.0
201198,4,1,3,4,0,4,4,146,4.0,1.0,3.0,4.0,0.0,4.0,4.0,6,4,2,,,
9801434,1,1,0,0,0,1,2,533,0.0,0.0,0.0,0.0,0.0,0.0,0.0,6,1,5,2.0,0.0,2.0
9701251,8,3,5,6,2,6,17,107,2.0,1.0,1.0,1.0,1.0,1.0,1.0,17,8,9,3.0,2.0,1.0
9812443,1,1,0,0,1,0,0,272,0.0,0.0,0.0,0.0,0.0,0.0,0.0,5,1,4,1.0,1.0,0.0
9501355,1,1,0,0,0,1,5,134,1.0,1.0,0.0,0.0,0.0,1.0,5.0,13,1,12,6.0,1.0,5.0
9707533,2,2,0,0,1,1,2,79,2.0,2.0,0.0,0.0,1.0,1.0,1.0,5,2,3,3.0,2.0,1.0
9911270,9,2,7,12,2,7,20,11,1.0,1.0,0.0,0.0,0.0,1.0,1.0,19,9,10,1.0,1.0,0.0
103130,3,2,1,1,0,3,11,103,3.0,2.0,1.0,1.0,0.0,3.0,11.0,10,3,7,8.0,3.0,5.0
9809258,1,1,0,0,0,1,1,110,1.0,1.0,0.0,0.0,0.0,1.0,1.0,2,1,1,1.0,1.0,0.0
102101,4,3,1,1,0,4,11,107,2.0,1.0,1.0,1.0,0.0,2.0,2.0,13,4,9,2.0,1.0,1.0
9910232,2,2,0,0,2,0,0,152,0.0,0.0,0.0,0.0,0.0,0.0,0.0,11,2,9,1.0,0.0,1.0
8139,4,2,2,3,1,3,13,99,3.0,1.0,2.0,2.0,0.0,3.0,10.0,22,4,18,10.0,3.0,7.0
12022,2,2,0,0,1,1,1,97,0.0,0.0,0.0,0.0,0.0,0.0,0.0,6,2,4,1.0,0.0,1.0
106191,1,1,0,0,0,1,12,9,1.0,1.0,0.0,0.0,0.0,1.0,7.0,14,1,13,8.0,1.0,7.0
9708415,1,1,0,0,0,1,13,17,1.0,1.0,0.0,0.0,0.0,1.0,10.0,20,1,19,3.0,1.0,2.0
9809476,2,2,0,0,0,2,3,89,0.0,0.0,0.0,0.0,0.0,0.0,0.0,9,2,7,2.0,0.0,2.0
9912493,1,1,0,0,0,1,1,27,0.0,0.0,0.0,0.0,0.0,0.0,0.0,17,1,16,4.0,0.0,4.0
6043,7,3,4,9,0,7,48,89,5.0,1.0,4.0,7.0,0.0,5.0,15.0,26,7,19,6.0,4.0,2.0
209081,0,0,0,0,0,0,0,20,0.0,0.0,0.0,0.0,0.0,0.0,0.0,6,0,6,2.0,0.0,2.0
2220,2,2,0,0,0,2,3,12,2.0,2.0,0.0,0.0,0.0,2.0,2.0,22,2,20,3.0,1.0,2.0
9608315,1,1,0,0,0,1,3,4,0.0,0.0,0.0,0.0,0.0,0.0,0.0,16,1,15,6.0,1.0,5.0
9608485,1,1,0,0,0,1,3,70,0.0,0.0,0.0,0.0,0.0,0.0,0.0,8,1,7,1.0,0.0,1.0
2291,2,1,1,1,2,0,0,38,,,,,,,,6,2,4,,,
105065,5,4,1,2,0,5,16,106,4.0,3.0,1.0,2.0,0.0,4.0,15.0,12,5,7,8.0,3.0,5.0
9808393,4,2,2,5,0,4,41,94,4.0,2.0,2.0,5.0,0.0,4.0,41.0,17,4,13,15.0,4.0,11.0
9911351,0,0,0,0,0,0,0,47,0.0,0.0,0.0,0.0,0.0,0.0,0.0,5,0,5,2.0,0.0,2.0
9905268,3,3,0,0,0,3,3,116,2.0,2.0,0.0,0.0,0.0,2.0,2.0,11,3,8,2.0,1.0,1.0
9407334,4,3,1,1,0,4,5,171,3.0,2.0,1.0,1.0,0.0,3.0,4.0,6,4,2,4.0,2.0,2.0
9705211,1,1,0,0,1,0,0,1674,1.0,1.0,0.0,0.0,1.0,0.0,0.0,1,1,0,,,
111032,8,6,2,2,0,8,56,26,8.0,6.0,2.0,2.0,0.0,8.0,48.0,21,8,13,11.0,5.0,6.0
9608370,1,1,0,0,0,1,1,17,1.0,1.0,0.0,0.0,1.0,0.0,0.0,9,1,8,1.0,1.0,0.0
208271,1,1,0,0,0,1,1,59,1.0,1.0,0.0,0.0,0.0,1.0,1.0,21,1,20,11.0,0.0,11.0
9606283,2,2,0,0,2,0,0,356,1.0,1.0,0.0,0.0,1.0,0.0,0.0,2,2,0,1.0,1.0,0.0
9905207,1,1,0,0,1,0,0,157,0.0,0.0,0.0,0.0,0.0,0.0,0.0,3,1,2,2.0,0.0,2.0
9347,0,0,0,0,0,0,0,24,0.0,0.0,0.0,0.0,0.0,0.0,0.0,26,0,26,19.0,0.0,19.0
9310318,4,1,3,5,4,0,0,453,4.0,1.0,3.0,5.0,4.0,0.0,0.0,5,4,1,1.0,0.0,1.0
9707310,1,1,0,0,0,1,4,9,,,,,,,,8,1,7,,,
9802257,2,1,1,1,0,2,2,23,0.0,0.0,0.0,0.0,0.0,0.0,0.0,6,2,4,1.0,0.0,1.0
9406281,6,5,1,1,2,4,6,35,2.0,2.0,0.0,0.0,0.0,2.0,3.0,9,6,3,3.0,2.0,1.0
9810234,3,2,1,1,0,3,7,33,3.0,2.0,1.0,1.0,0.0,3.0,6.0,14,3,11,6.0,1.0,5.0
212124,0,0,0,0,0,0,0,147,0.0,0.0,0.0,0.0,0.0,0.0,0.0,31,0,31,6.0,0.0,6.0
9608283,1,1,0,0,0,1,3,110,1.0,1.0,0.0,0.0,0.0,1.0,3.0,6,1,5,1.0,1.0,0.0
9907351,2,2,0,0,1,1,1,184,1.0,1.0,0.0,0.0,0.0,1.0,1.0,7,2,5,2.0,1.0,1.0
4222,2,1,1,1,0,2,8,215,2.0,1.0,1.0,1.0,0.0,2.0,3.0,14,2,12,2.0,1.0,1.0
206269,3,1,2,3,0,3,27,9,3.0,1.0,2.0,3.0,0.0,3.0,27.0,16,3,13,7.0,3.0,4.0
7321,5,4,1,1,0,5,19,2,2.0,1.0,1.0,1.0,0.0,2.0,2.0,19,5,14,4.0,2.0,2.0
208023,2,1,1,1,2,0,0,81,0.0,0.0,0.0,0.0,0.0,0.0,0.0,11,2,9,5.0,0.0,5.0
9411224,4,2,2,4,4,0,0,63,2.0,2.0,0.0,0.0,2.0,0.0,0.0,4,4,0,3.0,3.0,0.0
9608220,2,2,0,0,2,0,0,208,0.0,0.0,0.0,0.0,0.0,0.0,0.0,4,2,2,1.0,0.0,1.0
204359,4,3,1,1,0,4,16,32,1.0,1.0,0.0,0.0,1.0,0.0,0.0,16,4,12,2.0,2.0,0.0
204085,4,4,0,0,1,3,20,278,2.0,2.0,0.0,0.0,0.0,2.0,11.0,16,4,12,8.0,2.0,6.0
9308281,2,2,0,0,2,0,0,1968,,,,,,,,2,2,0,1.0,1.0,0.0
9812422,3,1,2,2,0,3,13,76,3.0,1.0,2.0,2.0,0.0,3.0,13.0,12,3,9,5.0,0.0,5.0
12138,5,1,4,5,0,5,42,124,4.0,1.0,3.0,4.0,0.0,4.0,29.0,19,5,14,12.0,3.0,9.0
9510390,1,1,0,0,0,1,1,927,1.0,1.0,0.0,0.0,1.0,0.0,0.0,3,1,2,1.0,1.0,0.0
9804304,18,1,17,77,1,17,140,53,18.0,1.0,17.0,77.0,1.0,17.0,140.0,30,18,12,28.0,16.0,12.0
9905291,14,6,8,14,0,14,76,8,6.0,2.0,4.0,7.0,0.0,6.0,13.0,35,14,21,9.0,3.0,6.0
9610336,3,1,2,3,0,3,29,90,3.0,1.0,2.0,3.0,0.0,3.0,19.0,21,3,18,13.0,3.0,10.0
205048,8,5,3,5,0,8,28,45,3.0,2.0,1.0,2.0,1.0,2.0,2.0,24,8,16,4.0,4.0,0.0
11206,6,2,4,8,3,3,12,80,6.0,2.0,4.0,8.0,3.0,3.0,5.0,16,6,10,5.0,0.0,5.0
208134,3,3,0,0,0,3,27,117,2.0,2.0,0.0,0.0,0.0,2.0,19.0,19,3,16,12.0,2.0,10.0
103209,1,1,0,0,1,0,0,153,1.0,1.0,0.0,0.0,1.0,0.0,0.0,4,1,3,1.0,0.0,1.0
9710457,1,1,0,0,1,0,0,31,,,,,,,,7,1,6,,,
103334,2,2,0,0,2,0,0,3,0.0,0.0,0.0,0.0,0.0,0.0,0.0,14,2,12,7.0,0.0,7.0
9712456,5,3,2,2,1,4,10,130,1.0,1.0,0.0,0.0,1.0,0.0,0.0,10,5,5,3.0,2.0,1.0
109212,4,1,3,4,0,4,15,215,4.0,1.0,3.0,4.0,0.0,4.0,6.0,14,4,10,7.0,4.0,3.0
111127,8,5,3,5,2,6,7,9,1.0,1.0,0.0,0.0,0.0,1.0,2.0,75,8,67,11.0,0.0,11.0
205173,0,0,0,0,0,0,0,2,0.0,0.0,0.0,0.0,0.0,0.0,0.0,17,0,17,,,
204278,4,3,1,1,1,3,15,107,0.0,0.0,0.0,0.0,0.0,0.0,0.0,16,4,12,4.0,0.0,4.0
210052,0,0,0,0,0,0,0,119,0.0,0.0,0.0,0.0,0.0,0.0,0.0,10,0,10,9.0,0.0,9.0
9211330,1,1,0,0,1,0,0,665,1.0,1.0,0.0,0.0,1.0,0.0,0.0,1,1,0,1.0,1.0,0.0
9708352,2,2,0,0,0,2,3,26,0.0,0.0,0.0,0.0,0.0,0.0,0.0,9,2,7,1.0,0.0,1.0
212374,1,1,0,0,0,1,17,53,1.0,1.0,0.0,0.0,0.0,1.0,17.0,32,1,31,28.0,1.0,27.0
6265,2,2,0,0,0,2,4,1964,0.0,0.0,0.0,0.0,0.0,0.0,0.0,10,2,8,1.0,0.0,1.0
108189,6,4,2,2,2,4,32,83,3.0,2.0,1.0,1.0,0.0,3.0,14.0,32,6,26,8.0,3.0,5.0
9907454,5,4,1,1,3,2,7,74,3.0,2.0,1.0,1.0,2.0,1.0,3.0,22,5,17,6.0,1.0,5.0
9206252,4,1,3,6,0,4,4,333,4.0,1.0,3.0,6.0,0.0,4.0,4.0,5,4,1,5.0,4.0,1.0
202244,1,1,0,0,1,0,0,380,0.0,0.0,0.0,0.0,0.0,0.0,0.0,10,1,9,4.0,0.0,4.0
205133,1,1,0,0,0,1,4,29,0.0,0.0,0.0,0.0,0.0,0.0,0.0,18,1,17,4.0,0.0,4.0
9906429,5,4,1,1,1,4,27,3,1.0,1.0,0.0,0.0,0.0,1.0,6.0,27,5,22,4.0,1.0,3.0
9808297,4,3,1,1,0,4,8,314,3.0,2.0,1.0,1.0,0.0,3.0,6.0,7,4,3,5.0,3.0,2.0
201294,10,4,6,9,0,10,53,127,6.0,3.0,3.0,5.0,0.0,6.0,35.0,40,10,30,14.0,5.0,9.0
9711495,2,1,1,1,2,0,0,67,0.0,0.0,0.0,0.0,0.0,0.0,0.0,4,2,2,,,
9605305,0,0,0,0,0,0,0,366,0.0,0.0,0.0,0.0,0.0,0.0,0.0,4,0,4,1.0,0.0,1.0
4104,3,1,2,2,3,0,0,367,2.0,1.0,1.0,1.0,2.0,0.0,0.0,3,3,0,3.0,3.0,0.0
9902227,1,1,0,0,0,1,9,15,1.0,1.0,0.0,0.0,0.0,1.0,9.0,18,1,17,1.0,0.0,1.0
3104,0,0,0,0,0,0,0,3,0.0,0.0,0.0,0.0,0.0,0.0,0.0,24,0,24,4.0,0.0,4.0
9908414,8,2,6,13,0,8,37,29,8.0,2.0,6.0,13.0,0.0,8.0,31.0,18,8,10,11.0,7.0,4.0
10339,2,2,0,0,1,1,1,48,0.0,0.0,0.0,0.0,0.0,0.0,0.0,19,2,17,2.0,0.0,2.0
103198,4,3,1,1,0,4,25,40,1.0,1.0,0.0,0.0,0.0,1.0,8.0,30,4,26,5.0,1.0,4.0
9609282,2,2,0,0,2,0,0,1860,2.0,2.0,0.0,0.0,2.0,0.0,0.0,3,2,1,1.0,1.0,0.0
208075,0,0,0,0,0,0,0,50,0.0,0.0,0.0,0.0,0.0,0.0,0.0,3,0,3,1.0,0.0,1.0
201266,1,1,0,0,0,1,7,13,1.0,1.0,0.0,0.0,0.0,1.0,4.0,38,1,37,6.0,0.0,6.0
206099,13,2,11,22,0,13,66,2,8.0,1.0,7.0,14.0,0.0,8.0,27.0,27,13,14,4.0,3.0,1.0
9807536,2,1,1,1,2,0,0,114,0.0,0.0,0.0,0.0,0.0,0.0,0.0,6,2,4,2.0,2.0,0.0
9511369,2,1,1,1,0,2,3,110,2.0,1.0,1.0,1.0,0.0,2.0,2.0,5,2,3,4.0,2.0,2.0
9905469,2,2,0,0,1,1,3,446,1.0,1.0,0.0,0.0,0.0,1.0,1.0,6,2,4,2.0,1.0,1.0
211421,2,1,1,1,0,2,10,146,2.0,1.0,1.0,1.0,0.0,2.0,10.0,14,2,12,11.0,2.0,9.0
9610434,2,2,0,0,0,2,3,43,1.0,1.0,0.0,0.0,1.0,0.0,0.0,9,2,7,1.0,1.0,0.0
3024,1,1,0,0,1,0,0,460,1.0,1.0,0.0,0.0,1.0,0.0,0.0,5,1,4,1.0,1.0,0.0
11316,2,1,1,1,0,2,12,25,1.0,1.0,0.0,0.0,0.0,1.0,3.0,9,2,7,,,
9905541,0,0,0,0,0,0,0,1,0.0,0.0,0.0,0.0,0.0,0.0,0.0,10,0,10,4.0,0.0,4.0
204113,3,2,1,2,0,3,5,442,0.0,0.0,0.0,0.0,0.0,0.0,0.0,6,3,3,3.0,0.0,3.0
212366,0,0,0,0,0,0,0,14,0.0,0.0,0.0,0.0,0.0,0.0,0.0,10,0,10,3.0,0.0,3.0
7212,4,2,2,2,0,4,10,205,2.0,1.0,1.0,1.0,0.0,2.0,4.0,13,4,9,4.0,2.0,2.0
9909344,2,2,0,0,0,2,9,130,1.0,1.0,0.0,0.0,0.0,1.0,2.0,15,2,13,3.0,1.0,2.0
9507227,1,1,0,0,0,1,2,1825,0.0,0.0,0.0,0.0,0.0,0.0,0.0,6,1,5,1.0,0.0,1.0
12383,6,4,2,4,1,5,20,20,1.0,1.0,0.0,0.0,0.0,1.0,1.0,13,6,7,3.0,3.0,0.0
9902353,3,3,0,0,3,0,0,120,2.0,2.0,0.0,0.0,2.0,0.0,0.0,3,3,0,1.0,1.0,0.0
2121,0,0,0,0,0,0,0,1,0.0,0.0,0.0,0.0,0.0,0.0,0.0,10,0,10,1.0,0.0,1.0
9710421,3,2,1,1,0,3,38,27,1.0,1.0,0.0,0.0,0.0,1.0,7.0,18,3,15,2.0,0.0,2.0
9410407,5,1,4,6,0,5,8,149,5.0,1.0,4.0,6.0,0.0,5.0,8.0,9,5,4,6.0,4.0,2.0
206033,3,3,0,0,0,3,25,20,2.0,2.0,0.0,0.0,0.0,2.0,19.0,31,3,28,23.0,1.0,22.0
3313,12,2,10,34,0,12,44,23,2.0,1.0,1.0,1.0,0.0,2.0,12.0,25,12,13,10.0,2.0,8.0
9802397,5,1,4,7,2,3,3,198,5.0,1.0,4.0,7.0,2.0,3.0,3.0,7,5,2,5.0,4.0,1.0
301026,0,0,0,0,0,0,0,129,0.0,0.0,0.0,0.0,0.0,0.0,0.0,4,0,4,1.0,0.0,1.0
9912412,1,1,0,0,1,0,0,397,1.0,1.0,0.0,0.0,1.0,0.0,0.0,1,1,0,1.0,1.0,0.0
104098,1,1,0,0,0,1,16,8,1.0,1.0,0.0,0.0,0.0,1.0,6.0,23,1,22,7.0,1.0,6.0
203040,2,2,0,0,0,2,3,220,2.0,2.0,0.0,0.0,0.0,2.0,3.0,5,2,3,5.0,2.0,3.0
9812208,1,1,0,0,1,0,0,1655,,,,,,,,1,1,0,1.0,1.0,0.0
9410308,1,1,0,0,0,1,1,14,0.0,0.0,0.0,0.0,0.0,0.0,0.0,18,1,17,2.0,0.0,2.0
203036,0,0,0,0,0,0,0,26,0.0,0.0,0.0,0.0,0.0,0.0,0.0,18,0,18,3.0,0.0,3.0
7188,0,0,0,0,0,0,0,16,0.0,0.0,0.0,0.0,0.0,0.0,0.0,14,0,14,2.0,0.0,2.0
9905429,5,4,1,1,3,2,2,408,4.0,3.0,1.0,1.0,4.0,0.0,0.0,6,5,1,4.0,4.0,0.0
9606368,7,6,1,1,4,3,3,132,7.0,6.0,1.0,1.0,4.0,3.0,3.0,8,7,1,6.0,5.0,1.0
9812310,1,1,0,0,0,1,2,111,1.0,1.0,0.0,0.0,0.0,1.0,2.0,3,1,2,1.0,0.0,1.0
205049,0,0,0,0,0,0,0,64,0.0,0.0,0.0,0.0,0.0,0.0,0.0,4,0,4,2.0,0.0,2.0
205335,1,1,0,0,1,0,0,1599,,,,,,,,1,1,0,,,
208117,2,1,1,1,0,2,37,23,0.0,0.0,0.0,0.0,0.0,0.0,0.0,37,2,35,3.0,1.0,2.0
212229,2,2,0,0,1,1,6,23,1.0,1.0,0.0,0.0,0.0,1.0,6.0,13,2,11,1.0,1.0,0.0
211261,0,0,0,0,0,0,0,24,0.0,0.0,0.0,0.0,0.0,0.0,0.0,10,0,10,1.0,0.0,1.0
9706424,0,0,0,0,0,0,0,149,0.0,0.0,0.0,0.0,0.0,0.0,0.0,3,0,3,3.0,0.0,3.0
9812288,1,1,0,0,0,1,2,296,1.0,1.0,0.0,0.0,0.0,1.0,2.0,5,1,4,3.0,1.0,2.0
9512392,0,0,0,0,0,0,0,368,0.0,0.0,0.0,0.0,0.0,0.0,0.0,1,0,1,1.0,0.0,1.0
9905534,1,1,0,0,1,0,0,16,0.0,0.0,0.0,0.0,0.0,0.0,0.0,8,1,7,,,
9317,1,1,0,0,1,0,0,313,1.0,1.0,0.0,0.0,1.0,0.0,0.0,8,1,7,4.0,0.0,4.0
9606441,2,2,0,0,2,0,0,311,1.0,1.0,0.0,0.0,1.0,0.0,0.0,2,2,0,1.0,1.0,0.0
9610435,1,1,0,0,0,1,2,134,1.0,1.0,0.0,0.0,0.0,1.0,2.0,6,1,5,3.0,1.0,2.0
9301208,2,2,0,0,2,0,0,196,1.0,1.0,0.0,0.0,1.0,0.0,0.0,3,2,1,2.0,2.0,0.0
103344,1,1,0,0,0,1,1,140,0.0,0.0,0.0,0.0,0.0,0.0,0.0,4,1,3,1.0,0.0,1.0
9609506,0,0,0,0,0,0,0,213,0.0,0.0,0.0,0.0,0.0,0.0,0.0,2,0,2,,,
302245,0,0,0,0,0,0,0,38,0.0,0.0,0.0,0.0,0.0,0.0,0.0,14,0,14,2.0,0.0,2.0
302047,0,0,0,0,0,0,0,307,0.0,0.0,0.0,0.0,0.0,0.0,0.0,11,0,11,5.0,0.0,5.0
204317,3,2,1,1,0,3,12,3,0.0,0.0,0.0,0.0,0.0,0.0,0.0,40,3,37,3.0,0.0,3.0
9409317,2,2,0,0,1,1,2,6,0.0,0.0,0.0,0.0,0.0,0.0,0.0,6,2,4,,,
9712430,0,0,0,0,0,0,0,179,0.0,0.0,0.0,0.0,0.0,0.0,0.0,10,0,10,2.0,0.0,2.0
9809391,2,1,1,1,2,0,0,664,1.0,1.0,0.0,0.0,1.0,0.0,0.0,2,2,0,1.0,1.0,0.0
212184,0,0,0,0,0,0,0,89,0.0,0.0,0.0,0.0,0.0,0.0,0.0,6,0,6,,,
9908434,0,0,0,0,0,0,0,31,0.0,0.0,0.0,0.0,0.0,0.0,0.0,5,0,5,3.0,0.0,3.0
9810365,1,1,0,0,1,0,0,70,0.0,0.0,0.0,0.0,0.0,0.0,0.0,13,1,12,1.0,1.0,0.0
9708376,0,0,0,0,0,0,0,15,0.0,0.0,0.0,0.0,0.0,0.0,0.0,45,0,45,20.0,0.0,20.0
9708331,0,0,0,0,0,0,0,39,0.0,0.0,0.0,0.0,0.0,0.0,0.0,8,0,8,1.0,0.0,1.0
211103,1,1,0,0,0,1,27,7,1.0,1.0,0.0,0.0,0.0,1.0,16.0,91,1,90,10.0,0.0,10.0
110274,1,1,0,0,1,0,0,4,0.0,0.0,0.0,0.0,0.0,0.0,0.0,9,1,8,3.0,0.0,3.0
301033,0,0,0,0,0,0,0,4,0.0,0.0,0.0,0.0,0.0,0.0,0.0,27,0,27,10.0,0.0,10.0
210175,0,0,0,0,0,0,0,185,0.0,0.0,0.0,0.0,0.0,0.0,0.0,11,0,11,7.0,0.0,7.0
9802309,0,0,0,0,0,0,0,72,0.0,0.0,0.0,0.0,0.0,0.0,0.0,6,0,6,4.0,0.0,4.0
109171,1,1,0,0,0,1,4,209,1.0,1.0,0.0,0.0,0.0,1.0,4.0,9,1,8,7.0,1.0,6.0
107125,3,2,1,2,0,3,17,2,2.0,1.0,1.0,1.0,0.0,2.0,4.0,18,3,15,9.0,2.0,7.0
9604319,0,0,0,0,0,0,0,301,,,,,,,,6,0,6,1.0,0.0,1.0
106079,1,1,0,0,1,0,0,103,0.0,0.0,0.0,0.0,0.0,0.0,0.0,10,1,9,6.0,0.0,6.0
9902245,0,0,0,0,0,0,0,139,,,,,,,,1,0,1,,,
9912225,3,1,2,3,0,3,13,0,3.0,1.0,2.0,3.0,0.0,3.0,12.0,10,3,7,8.0,3.0,5.0
212263,2,1,1,1,0,2,29,3,2.0,1.0,1.0,1.0,0.0,2.0,25.0,42,2,40,14.0,1.0,13.0
9509388,1,1,0,0,1,0,0,145,1.0,1.0,0.0,0.0,1.0,0.0,0.0,4,1,3,1.0,1.0,0.0
201283,1,1,0,0,0,1,5,612,1.0,1.0,0.0,0.0,0.0,1.0,1.0,8,1,7,2.0,1.0,1.0
302240,0,0,0,0,0,0,0,31,0.0,0.0,0.0,0.0,0.0,0.0,0.0,7,0,7,4.0,0.0,4.0
106202,7,7,0,0,4,3,9,45,4.0,4.0,0.0,0.0,2.0,2.0,4.0,16,7,9,2.0,2.0,0.0
211190,1,1,0,0,0,1,5,14,,,,,,,,8,1,7,1.0,0.0,1.0
9904242,4,3,1,1,1,3,8,157,3.0,2.0,1.0,1.0,0.0,3.0,8.0,12,4,8,6.0,3.0,3.0
104175,3,3,0,0,2,1,4,72,1.0,1.0,0.0,0.0,0.0,1.0,4.0,11,3,8,5.0,1.0,4.0
110015,2,2,0,0,1,1,5,300,1.0,1.0,0.0,0.0,0.0,1.0,2.0,9,2,7,5.0,1.0,4.0
106355,1,1,0,0,1,0,0,94,0.0,0.0,0.0,0.0,0.0,0.0,0.0,9,1,8,1.0,1.0,0.0
9807255,4,4,0,0,4,0,0,79,3.0,3.0,0.0,0.0,3.0,0.0,0.0,5,4,1,2.0,2.0,0.0
111349,1,1,0,0,1,0,0,15,0.0,0.0,0.0,0.0,0.0,0.0,0.0,48,1,47,25.0,0.0,25.0
9805237,3,2,1,1,0,3,12,3,2.0,1.0,1.0,1.0,0.0,2.0,7.0,29,3,26,17.0,0.0,17.0
103103,5,5,0,0,1,4,12,784,2.0,2.0,0.0,0.0,2.0,0.0,0.0,9,5,4,2.0,2.0,0.0
9907349,1,1,0,0,0,1,8,70,1.0,1.0,0.0,0.0,0.0,1.0,8.0,13,1,12,2.0,1.0,1.0
209287,3,3,0,0,1,2,9,20,0.0,0.0,0.0,0.0,0.0,0.0,0.0,87,3,84,36.0,0.0,36.0
9611436,1,1,0,0,0,1,2,360,0.0,0.0,0.0,0.0,0.0,0.0,0.0,18,1,17,3.0,0.0,3.0
9310289,0,0,0,0,0,0,0,363,0.0,0.0,0.0,0.0,0.0,0.0,0.0,1,0,1,1.0,0.0,1.0
9512310,1,1,0,0,0,1,1,340,1.0,1.0,0.0,0.0,0.0,1.0,1.0,2,1,1,2.0,1.0,1.0
106254,0,0,0,0,0,0,0,27,,,,,,,,6,0,6,,,
209154,0,0,0,0,0,0,0,43,0.0,0.0,0.0,0.0,0.0,0.0,0.0,7,0,7,1.0,0.0,1.0
208005,1,1,0,0,0,1,1,55,1.0,1.0,0.0,0.0,1.0,0.0,0.0,25,1,24,2.0,1.0,1.0
9606232,0,0,0,0,0,0,0,61,0.0,0.0,0.0,0.0,0.0,0.0,0.0,25,0,25,6.0,0.0,6.0
12266,3,2,1,1,2,1,3,400,2.0,1.0,1.0,1.0,2.0,0.0,0.0,15,3,12,2.0,2.0,0.0
9612452,0,0,0,0,0,0,0,5,0.0,0.0,0.0,0.0,0.0,0.0,0.0,13,0,13,1.0,0.0,1.0
9205208,1,1,0,0,1,0,0,570,1.0,1.0,0.0,0.0,1.0,0.0,0.0,1,1,0,1.0,1.0,0.0
9411309,1,1,0,0,1,0,0,213,1.0,1.0,0.0,0.0,1.0,0.0,0.0,1,1,0,1.0,1.0,0.0
110279,4,2,2,2,2,2,7,90,2.0,1.0,1.0,1.0,0.0,2.0,7.0,14,4,10,5.0,2.0,3.0
9906229,2,2,0,0,1,1,1,18,0.0,0.0,0.0,0.0,0.0,0.0,0.0,64,2,62,3.0,0.0,3.0
203057,1,1,0,0,0,1,1,246,0.0,0.0,0.0,0.0,0.0,0.0,0.0,16,1,15,3.0,0.0,3.0
9801405,3,2,1,1,2,1,2,60,2.0,1.0,1.0,1.0,2.0,0.0,0.0,14,3,11,2.0,2.0,0.0
9326,0,0,0,0,0,0,0,177,,,,,,,,2,0,2,1.0,0.0,1.0
9905574,2,2,0,0,1,1,2,57,1.0,1.0,0.0,0.0,0.0,1.0,2.0,4,2,2,3.0,1.0,2.0
11040,2,1,1,1,0,2,9,64,2.0,1.0,1.0,1.0,0.0,2.0,6.0,9,2,7,7.0,2.0,5.0
9502351,0,0,0,0,0,0,0,1327,,,,,,,,1,0,1,,,
210017,0,0,0,0,0,0,0,113,0.0,0.0,0.0,0.0,0.0,0.0,0.0,4,0,4,3.0,0.0,3.0
110349,1,1,0,0,0,1,1,42,0.0,0.0,0.0,0.0,0.0,0.0,0.0,24,1,23,6.0,0.0,6.0
9504264,2,2,0,0,2,0,0,587,2.0,2.0,0.0,0.0,2.0,0.0,0.0,3,2,1,2.0,2.0,0.0
209101,0,0,0,0,0,0,0,127,0.0,0.0,0.0,0.0,0.0,0.0,0.0,24,0,24,3.0,0.0,3.0
9607460,0,0,0,0,0,0,0,323,0.0,0.0,0.0,0.0,0.0,0.0,0.0,4,0,4,3.0,0.0,3.0
11346,0,0,0,0,0,0,0,1402,,,,,,,,1,0,1,,,
3206,2,2,0,0,2,0,0,69,0.0,0.0,0.0,0.0,0.0,0.0,0.0,6,2,4,3.0,0.0,3.0
103236,5,2,3,3,1,4,6,590,1.0,1.0,0.0,0.0,1.0,0.0,0.0,8,5,3,2.0,2.0,0.0
9709362,1,1,0,0,1,0,0,314,1.0,1.0,0.0,0.0,1.0,0.0,0.0,2,1,1,1.0,1.0,0.0
9502295,4,2,2,2,4,0,0,404,4.0,2.0,2.0,2.0,4.0,0.0,0.0,5,4,1,2.0,2.0,0.0
102040,0,0,0,0,0,0,0,15,0.0,0.0,0.0,0.0,0.0,0.0,0.0,12,0,12,1.0,0.0,1.0
7326,3,1,2,2,0,3,40,33,3.0,1.0,2.0,2.0,0.0,3.0,36.0,44,3,41,24.0,3.0,21.0
9905544,1,1,0,0,0,1,1,103,,,,,,,,5,1,4,,,
12174,0,0,0,0,0,0,0,1175,,,,,,,,3,0,3,,,
9503393,4,2,2,3,4,0,0,379,4.0,2.0,2.0,3.0,4.0,0.0,0.0,4,4,0,4.0,4.0,0.0
9803280,3,1,2,2,0,3,6,140,1.0,1.0,0.0,0.0,0.0,1.0,1.0,11,3,8,7.0,1.0,6.0
111272,2,2,0,0,1,1,1,196,0.0,0.0,0.0,0.0,0.0,0.0,0.0,7,2,5,1.0,0.0,1.0
208237,2,1,1,1,0,2,43,17,2.0,1.0,1.0,1.0,0.0,2.0,23.0,39,2,37,7.0,2.0,5.0
110103,0,0,0,0,0,0,0,90,0.0,0.0,0.0,0.0,0.0,0.0,0.0,2,0,2,1.0,0.0,1.0
211130,0,0,0,0,0,0,0,130,,,,,,,,2,0,2,,,
212294,0,0,0,0,0,0,0,25,0.0,0.0,0.0,0.0,0.0,0.0,0.0,29,0,29,14.0,0.0,14.0
208192,1,1,0,0,0,1,9,257,1.0,1.0,0.0,0.0,0.0,1.0,3.0,15,1,14,4.0,1.0,3.0
5169,2,2,0,0,0,2,6,178,1.0,1.0,0.0,0.0,0.0,1.0,4.0,9,2,7,5.0,1.0,4.0
9710315,1,1,0,0,0,1,4,119,1.0,1.0,0.0,0.0,0.0,1.0,4.0,9,1,8,1.0,1.0,0.0
107251,1,1,0,0,0,1,10,161,1.0,1.0,0.0,0.0,0.0,1.0,8.0,16,1,15,6.0,1.0,5.0
9507202,1,1,0,0,0,1,1,116,0.0,0.0,0.0,0.0,0.0,0.0,0.0,14,1,13,4.0,0.0,4.0
111463,3,3,0,0,0,3,21,47,2.0,2.0,0.0,0.0,0.0,2.0,10.0,19,3,16,9.0,2.0,7.0
207071,2,2,0,0,1,1,7,14,1.0,1.0,0.0,0.0,0.0,1.0,7.0,17,2,15,2.0,0.0,2.0
9803208,0,0,0,0,0,0,0,318,0.0,0.0,0.0,0.0,0.0,0.0,0.0,5,0,5,1.0,0.0,1.0
12228,0,0,0,0,0,0,0,13,0.0,0.0,0.0,0.0,0.0,0.0,0.0,12,0,12,,,
8050,0,0,0,0,0,0,0,12,0.0,0.0,0.0,0.0,0.0,0.0,0.0,47,0,47,14.0,0.0,14.0
106126,1,1,0,0,1,0,0,2111,,,,,,,,4,1,3,,,
302057,0,0,0,0,0,0,0,319,0.0,0.0,0.0,0.0,0.0,0.0,0.0,4,0,4,3.0,0.0,3.0
9612317,0,0,0,0,0,0,0,111,0.0,0.0,0.0,0.0,0.0,0.0,0.0,16,0,16,2.0,0.0,2.0
9412396,0,0,0,0,0,0,0,773,0.0,0.0,0.0,0.0,0.0,0.0,0.0,1,0,1,1.0,0.0,1.0
11098,1,1,0,0,1,0,0,85,0.0,0.0,0.0,0.0,0.0,0.0,0.0,5,1,4,1.0,0.0,1.0
9709359,0,0,0,0,0,0,0,200,0.0,0.0,0.0,0.0,0.0,0.0,0.0,6,0,6,5.0,0.0,5.0
206123,1,1,0,0,1,0,0,125,0.0,0.0,0.0,0.0,0.0,0.0,0.0,16,1,15,7.0,0.0,7.0
110218,1,1,0,0,0,1,10,26,1.0,1.0,0.0,0.0,0.0,1.0,7.0,25,1,24,10.0,1.0,9.0
212311,0,0,0,0,0,0,0,13,0.0,0.0,0.0,0.0,0.0,0.0,0.0,8,0,8,5.0,0.0,5.0
9809595,0,0,0,0,0,0,0,272,0.0,0.0,0.0,0.0,0.0,0.0,0.0,10,0,10,4.0,0.0,4.0
8164,1,1,0,0,0,1,1,215,1.0,1.0,0.0,0.0,0.0,1.0,1.0,11,1,10,2.0,0.0,2.0
9401240,2,2,0,0,2,0,0,265,2.0,2.0,0.0,0.0,2.0,0.0,0.0,3,2,1,2.0,2.0,0.0
11331,0,0,0,0,0,0,0,143,0.0,0.0,0.0,0.0,0.0,0.0,0.0,6,0,6,5.0,0.0,5.0
9807412,2,2,0,0,0,2,8,142,1.0,1.0,0.0,0.0,0.0,1.0,7.0,12,2,10,11.0,1.0,10.0
9711389,1,1,0,0,1,0,0,224,1.0,1.0,0.0,0.0,1.0,0.0,0.0,1,1,0,1.0,1.0,0.0
9015,0,0,0,0,0,0,0,22,0.0,0.0,0.0,0.0,0.0,0.0,0.0,6,0,6,,,
212410,0,0,0,0,0,0,0,14,,,,,,,,4,0,4,,,
109208,1,1,0,0,1,0,0,427,1.0,1.0,0.0,0.0,1.0,0.0,0.0,3,1,2,2.0,1.0,1.0
209261,0,0,0,0,0,0,0,226,0.0,0.0,0.0,0.0,0.0,0.0,0.0,1,0,1,1.0,0.0,1.0
9409398,0,0,0,0,0,0,0,958,0.0,0.0,0.0,0.0,0.0,0.0,0.0,2,0,2,2.0,0.0,2.0
301107,0,0,0,0,0,0,0,52,0.0,0.0,0.0,0.0,0.0,0.0,0.0,15,0,15,14.0,0.0,14.0
110207,4,3,1,2,4,0,0,521,3.0,2.0,1.0,2.0,3.0,0.0,0.0,4,4,0,3.0,3.0,0.0
208122,1,1,0,0,0,1,6,68,1.0,1.0,0.0,0.0,0.0,1.0,5.0,12,1,11,,,
9712420,2,2,0,0,1,1,1,212,1.0,1.0,0.0,0.0,1.0,0.0,0.0,6,2,4,1.0,1.0,0.0
9706455,0,0,0,0,0,0,0,2032,,,,,,,,2,0,2,,,
210378,1,1,0,0,0,1,6,29,1.0,1.0,0.0,0.0,0.0,1.0,4.0,21,1,20,10.0,0.0,10.0
9312261,2,2,0,0,2,0,0,74,1.0,1.0,0.0,0.0,1.0,0.0,0.0,3,2,1,1.0,1.0,0.0
9907537,2,1,1,1,0,2,6,52,2.0,1.0,1.0,1.0,0.0,2.0,6.0,6,2,4,5.0,2.0,3.0
9607228,0,0,0,0,0,0,0,160,0.0,0.0,0.0,0.0,0.0,0.0,0.0,3,0,3,1.0,0.0,1.0
9610436,0,0,0,0,0,0,0,14,0.0,0.0,0.0,0.0,0.0,0.0,0.0,10,0,10,2.0,0.0,2.0
9909483,0,0,0,0,0,0,0,88,0.0,0.0,0.0,0.0,0.0,0.0,0.0,9,0,9,8.0,0.0,8.0
9104,0,0,0,0,0,0,0,112,0.0,0.0,0.0,0.0,0.0,0.0,0.0,4,0,4,3.0,0.0,3.0
9708400,0,0,0,0,0,0,0,248,0.0,0.0,0.0,0.0,0.0,0.0,0.0,3,0,3,1.0,0.0,1.0
212346,0,0,0,0,0,0,0,9,0.0,0.0,0.0,0.0,0.0,0.0,0.0,34,0,34,8.0,0.0,8.0
210375,0,0,0,0,0,0,0,80,0.0,0.0,0.0,0.0,0.0,0.0,0.0,13,0,13,4.0,0.0,4.0
9504362,1,1,0,0,0,1,2,199,1.0,1.0,0.0,0.0,0.0,1.0,2.0,5,1,4,3.0,1.0,2.0
9911306,5,5,0,0,0,5,20,64,5.0,5.0,0.0,0.0,0.0,5.0,14.0,16,5,11,9.0,5.0,4.0
211303,1,1,0,0,0,1,15,193,1.0,1.0,0.0,0.0,0.0,1.0,6.0,17,1,16,6.0,1.0,5.0
302212,1,1,0,0,1,0,0,54,0.0,0.0,0.0,0.0,0.0,0.0,0.0,20,1,19,13.0,0.0,13.0
302030,0,0,0,0,0,0,0,221,0.0,0.0,0.0,0.0,0.0,0.0,0.0,14,0,14,5.0,0.0,5.0
207237,4,4,0,0,0,4,22,24,1.0,1.0,0.0,0.0,0.0,1.0,3.0,51,4,47,10.0,2.0,8.0
9308306,2,1,1,1,2,0,0,345,2.0,1.0,1.0,1.0,2.0,0.0,0.0,2,2,0,1.0,1.0,0.0
3095,1,1,0,0,0,1,2,97,1.0,1.0,0.0,0.0,0.0,1.0,2.0,4,1,3,1.0,1.0,0.0
109021,1,1,0,0,1,0,0,585,1.0,1.0,0.0,0.0,1.0,0.0,0.0,1,1,0,1.0,1.0,0.0
211344,1,1,0,0,0,1,22,19,1.0,1.0,0.0,0.0,0.0,1.0,21.0,41,1,40,26.0,1.0,25.0
109099,2,1,1,1,1,1,1,349,2.0,1.0,1.0,1.0,1.0,1.0,1.0,4,2,2,4.0,2.0,2.0
7249,0,0,0,0,0,0,0,547,0.0,0.0,0.0,0.0,0.0,0.0,0.0,5,0,5,2.0,0.0,2.0
101073,1,1,0,0,0,1,3,228,0.0,0.0,0.0,0.0,0.0,0.0,0.0,20,1,19,3.0,1.0,2.0
9407361,0,0,0,0,0,0,0,273,0.0,0.0,0.0,0.0,0.0,0.0,0.0,2,0,2,,,
206291,1,1,0,0,0,1,2,1,0.0,0.0,0.0,0.0,0.0,0.0,0.0,14,1,13,5.0,0.0,5.0
9611377,0,0,0,0,0,0,0,118,0.0,0.0,0.0,0.0,0.0,0.0,0.0,8,0,8,2.0,0.0,2.0
12027,1,1,0,0,0,1,1,466,0.0,0.0,0.0,0.0,0.0,0.0,0.0,9,1,8,1.0,0.0,1.0
9810436,2,1,1,1,0,2,11,2,,,,,,,,11,2,9,1.0,0.0,1.0
9909430,2,2,0,0,0,2,2,377,2.0,2.0,0.0,0.0,0.0,2.0,2.0,9,2,7,3.0,2.0,1.0
9403278,0,0,0,0,0,0,0,1992,0.0,0.0,0.0,0.0,0.0,0.0,0.0,2,0,2,1.0,0.0,1.0
211116,0,0,0,0,0,0,0,26,0.0,0.0,0.0,0.0,0.0,0.0,0.0,24,0,24,15.0,0.0,15.0
212360,1,1,0,0,0,1,3,7,1.0,1.0,0.0,0.0,0.0,1.0,3.0,44,1,43,19.0,0.0,19.0
9909493,0,0,0,0,0,0,0,87,0.0,0.0,0.0,0.0,0.0,0.0,0.0,6,0,6,1.0,0.0,1.0
212016,0,0,0,0,0,0,0,34,0.0,0.0,0.0,0.0,0.0,0.0,0.0,17,0,17,4.0,0.0,4.0
111110,2,1,1,1,0,2,3,183,2.0,1.0,1.0,1.0,2.0,0.0,0.0,4,2,2,3.0,2.0,1.0
106011,0,0,0,0,0,0,0,122,0.0,0.0,0.0,0.0,0.0,0.0,0.0,4,0,4,4.0,0.0,4.0
205182,0,0,0,0,0,0,0,259,0.0,0.0,0.0,0.0,0.0,0.0,0.0,3,0,3,1.0,0.0,1.0
204252,0,0,0,0,0,0,0,31,0.0,0.0,0.0,0.0,0.0,0.0,0.0,9,0,9,7.0,0.0,7.0
9507301,0,0,0,0,0,0,0,14,0.0,0.0,0.0,0.0,0.0,0.0,0.0,7,0,7,1.0,0.0,1.0
102088,0,0,0,0,0,0,0,715,0.0,0.0,0.0,0.0,0.0,0.0,0.0,7,0,7,1.0,0.0,1.0
9501237,0,0,0,0,0,0,0,1109,0.0,0.0,0.0,0.0,0.0,0.0,0.0,1,0,1,1.0,0.0,1.0
3126,0,0,0,0,0,0,0,72,0.0,0.0,0.0,0.0,0.0,0.0,0.0,3,0,3,,,
9710262,0,0,0,0,0,0,0,91,0.0,0.0,0.0,0.0,0.0,0.0,0.0,3,0,3,2.0,0.0,2.0
301254,0,0,0,0,0,0,0,3,0.0,0.0,0.0,0.0,0.0,0.0,0.0,19,0,19,5.0,0.0,5.0
301181,0,0,0,0,0,0,0,40,0.0,0.0,0.0,0.0,0.0,0.0,0.0,57,0,57,10.0,0.0,10.0
111251,1,1,0,0,1,0,0,166,1.0,1.0,0.0,0.0,1.0,0.0,0.0,1,1,0,1.0,1.0,0.0
210010,0,0,0,0,0,0,0,45,0.0,0.0,0.0,0.0,0.0,0.0,0.0,13,0,13,2.0,0.0,2.0
203077,1,1,0,0,0,1,3,445,0.0,0.0,0.0,0.0,0.0,0.0,0.0,9,1,8,2.0,1.0,1.0
209220,0,0,0,0,0,0,0,39,0.0,0.0,0.0,0.0,0.0,0.0,0.0,16,0,16,4.0,0.0,4.0
9812419,0,0,0,0,0,0,0,58,0.0,0.0,0.0,0.0,0.0,0.0,0.0,10,0,10,10.0,0.0,10.0
9910374,1,1,0,0,1,0,0,98,1.0,1.0,0.0,0.0,1.0,0.0,0.0,3,1,2,1.0,1.0,0.0
110288,0,0,0,0,0,0,0,355,0.0,0.0,0.0,0.0,0.0,0.0,0.0,5,0,5,1.0,0.0,1.0
9710562,0,0,0,0,0,0,0,333,0.0,0.0,0.0,0.0,0.0,0.0,0.0,2,0,2,1.0,0.0,1.0
9907541,0,0,0,0,0,0,0,111,0.0,0.0,0.0,0.0,0.0,0.0,0.0,5,0,5,1.0,0.0,1.0
207045,2,2,0,0,0,2,14,57,0.0,0.0,0.0,0.0,0.0,0.0,0.0,15,2,13,7.0,0.0,7.0
208166,0,0,0,0,0,0,0,120,0.0,0.0,0.0,0.0,0.0,0.0,0.0,5,0,5,1.0,0.0,1.0
212303,0,0,0,0,0,0,0,25,0.0,0.0,0.0,0.0,0.0,0.0,0.0,29,0,29,7.0,0.0,7.0
209315,1,1,0,0,0,1,4,77,0.0,0.0,0.0,0.0,0.0,0.0,0.0,8,1,7,5.0,0.0,5.0
105322,1,1,0,0,0,1,4,6,1.0,1.0,0.0,0.0,0.0,1.0,3.0,21,1,20,11.0,1.0,10.0
211451,0,0,0,0,0,0,0,339,0.0,0.0,0.0,0.0,0.0,0.0,0.0,3,0,3,2.0,0.0,2.0
9707471,0,0,0,0,0,0,0,1385,,,,,,,,4,0,4,,,
12322,0,0,0,0,0,0,0,274,0.0,0.0,0.0,0.0,0.0,0.0,0.0,11,0,11,1.0,0.0,1.0
109022,0,0,0,0,0,0,0,163,0.0,0.0,0.0,0.0,0.0,0.0,0.0,14,0,14,7.0,0.0,7.0
301002,0,0,0,0,0,0,0,2,0.0,0.0,0.0,0.0,0.0,0.0,0.0,22,0,22,14.0,0.0,14.0
204022,0,0,0,0,0,0,0,68,0.0,0.0,0.0,0.0,0.0,0.0,0.0,3,0,3,1.0,0.0,1.0
9807270,0,0,0,0,0,0,0,25,0.0,0.0,0.0,0.0,0.0,0.0,0.0,16,0,16,1.0,0.0,1.0
4245,0,0,0,0,0,0,0,1594,0.0,0.0,0.0,0.0,0.0,0.0,0.0,8,0,8,1.0,0.0,1.0
11278,1,1,0,0,1,0,0,722,1.0,1.0,0.0,0.0,1.0,0.0,0.0,1,1,0,1.0,1.0,0.0
9905430,1,1,0,0,0,1,1,571,0.0,0.0,0.0,0.0,0.0,0.0,0.0,3,1,2,1.0,0.0,1.0
9401355,0,0,0,0,0,0,0,147,,,,,,,,6,0,6,,,
9211241,1,1,0,0,1,0,0,350,1.0,1.0,0.0,0.0,1.0,0.0,0.0,1,1,0,1.0,1.0,0.0
207016,0,0,0,0,0,0,0,32,0.0,0.0,0.0,0.0,0.0,0.0,0.0,29,0,29,1.0,0.0,1.0
106016,0,0,0,0,0,0,0,132,0.0,0.0,0.0,0.0,0.0,0.0,0.0,2,0,2,2.0,0.0,2.0
9605290,1,1,0,0,1,0,0,395,1.0,1.0,0.0,0.0,1.0,0.0,0.0,5,1,4,2.0,1.0,1.0
103232,0,0,0,0,0,0,0,20,0.0,0.0,0.0,0.0,0.0,0.0,0.0,69,0,69,47.0,0.0,47.0
9604409,0,0,0,0,0,0,0,48,0.0,0.0,0.0,0.0,0.0,0.0,0.0,11,0,11,2.0,0.0,2.0
210388,1,1,0,0,0,1,2,261,1.0,1.0,0.0,0.0,0.0,1.0,2.0,7,1,6,6.0,1.0,5.0
208039,0,0,0,0,0,0,0,1104,,,,,,,,1,0,1,,,
210252,1,1,0,0,1,0,0,93,1.0,1.0,0.0,0.0,1.0,0.0,0.0,2,1,1,,,
111170,0,0,0,0,0,0,0,260,,,,,,,,4,0,4,,,
9906453,0,0,0,0,0,0,0,54,0.0,0.0,0.0,0.0,0.0,0.0,0.0,9,0,9,4.0,0.0,4.0
112201,0,0,0,0,0,0,0,38,0.0,0.0,0.0,0.0,0.0,0.0,0.0,28,0,28,21.0,0.0,21.0
109196,0,0,0,0,0,0,0,174,0.0,0.0,0.0,0.0,0.0,0.0,0.0,1,0,1,,,
9712312,0,0,0,0,0,0,0,151,0.0,0.0,0.0,0.0,0.0,0.0,0.0,4,0,4,1.0,0.0,1.0
9410301,0,0,0,0,0,0,0,34,,,,,,,,5,0,5,,,
9701348,0,0,0,0,0,0,0,40,0.0,0.0,0.0,0.0,0.0,0.0,0.0,11,0,11,4.0,0.0,4.0
9912332,0,0,0,0,0,0,0,31,0.0,0.0,0.0,0.0,0.0,0.0,0.0,9,0,9,2.0,0.0,2.0
302023,0,0,0,0,0,0,0,639,0.0,0.0,0.0,0.0,0.0,0.0,0.0,1,0,1,1.0,0.0,1.0
9708324,0,0,0,0,0,0,0,519,0.0,0.0,0.0,0.0,0.0,0.0,0.0,1,0,1,1.0,0.0,1.0
9810274,0,0,0,0,0,0,0,70,0.0,0.0,0.0,0.0,0.0,0.0,0.0,12,0,12,11.0,0.0,11.0
209170,1,1,0,0,0,1,4,263,0.0,0.0,0.0,0.0,0.0,0.0,0.0,14,1,13,4.0,1.0,3.0
9710558,0,0,0,0,0,0,0,254,0.0,0.0,0.0,0.0,0.0,0.0,0.0,3,0,3,,,
110054,0,0,0,0,0,0,0,231,0.0,0.0,0.0,0.0,0.0,0.0,0.0,5,0,5,2.0,0.0,2.0
8297,0,0,0,0,0,0,0,125,0.0,0.0,0.0,0.0,0.0,0.0,0.0,6,0,6,6.0,0.0,6.0
9406435,0,0,0,0,0,0,0,401,0.0,0.0,0.0,0.0,0.0,0.0,0.0,2,0,2,1.0,0.0,1.0
9806274,0,0,0,0,0,0,0,1136,,,,,,,,2,0,2,,,
104046,0,0,0,0,0,0,0,7,,,,,,,,10,0,10,,,
9811233,0,0,0,0,0,0,0,255,0.0,0.0,0.0,0.0,0.0,0.0,0.0,5,0,5,1.0,0.0,1.0
203070,0,0,0,0,0,0,0,270,0.0,0.0,0.0,0.0,0.0,0.0,0.0,2,0,2,,,
9908503,0,0,0,0,0,0,0,101,0.0,0.0,0.0,0.0,0.0,0.0,0.0,4,0,4,1.0,0.0,1.0
9912546,0,0,0,0,0,0,0,149,0.0,0.0,0.0,0.0,0.0,0.0,0.0,3,0,3,2.0,0.0,2.0
9908477,0,0,0,0,0,0,0,57,0.0,0.0,0.0,0.0,0.0,0.0,0.0,5,0,5,2.0,0.0,2.0
9808221,2,1,1,1,0,2,6,83,2.0,1.0,1.0,1.0,0.0,2.0,4.0,8,2,6,,,
9905526,0,0,0,0,0,0,0,36,0.0,0.0,0.0,0.0,0.0,0.0,0.0,32,0,32,21.0,0.0,21.0
9503218,0,0,0,0,0,0,0,173,,,,,,,,1,0,1,1.0,0.0,1.0
9602376,0,0,0,0,0,0,0,6,0.0,0.0,0.0,0.0,0.0,0.0,0.0,14,0,14,2.0,0.0,2.0
9046,0,0,0,0,0,0,0,5,0.0,0.0,0.0,0.0,0.0,0.0,0.0,45,0,45,6.0,0.0,6.0
9912314,1,1,0,0,1,0,0,735,1.0,1.0,0.0,0.0,1.0,0.0,0.0,1,1,0,1.0,1.0,0.0
209172,0,0,0,0,0,0,0,53,,,,,,,,2,0,2,1.0,0.0,1.0
9506297,0,0,0,0,0,0,0,297,0.0,0.0,0.0,0.0,0.0,0.0,0.0,1,0,1,,,
201270,1,1,0,0,1,0,0,736,1.0,1.0,0.0,0.0,1.0,0.0,0.0,1,1,0,1.0,1.0,0.0
6252,0,0,0,0,0,0,0,54,0.0,0.0,0.0,0.0,0.0,0.0,0.0,5,0,5,1.0,0.0,1.0
9710419,1,1,0,0,0,1,2,82,1.0,1.0,0.0,0.0,1.0,0.0,0.0,4,1,3,1.0,1.0,0.0
212380,0,0,0,0,0,0,0,29,0.0,0.0,0.0,0.0,0.0,0.0,0.0,135,0,135,21.0,0.0,21.0
9612370,0,0,0,0,0,0,0,40,,,,,,,,5,0,5,,,
111065,1,1,0,0,1,0,0,55,0.0,0.0,0.0,0.0,0.0,0.0,0.0,19,1,18,4.0,0.0,4.0
9605370,0,0,0,0,0,0,0,33,0.0,0.0,0.0,0.0,0.0,0.0,0.0,11,0,11,10.0,0.0,10.0
9310,0,0,0,0,0,0,0,4,0.0,0.0,0.0,0.0,0.0,0.0,0.0,11,0,11,6.0,0.0,6.0
106325,0,0,0,0,0,0,0,747,0.0,0.0,0.0,0.0,0.0,0.0,0.0,6,0,6,1.0,0.0,1.0
206107,0,0,0,0,0,0,0,116,,,,,,,,3,0,3,,,
9701259,0,0,0,0,0,0,0,69,0.0,0.0,0.0,0.0,0.0,0.0,0.0,8,0,8,1.0,0.0,1.0
211299,1,1,0,0,0,1,2,24,0.0,0.0,0.0,0.0,0.0,0.0,0.0,22,1,21,12.0,0.0,12.0
9411402,0,0,0,0,0,0,0,332,0.0,0.0,0.0,0.0,0.0,0.0,0.0,4,0,4,4.0,0.0,4.0
9707288,0,0,0,0,0,0,0,51,0.0,0.0,0.0,0.0,0.0,0.0,0.0,9,0,9,1.0,0.0,1.0
1138,0,0,0,0,0,0,0,133,,,,,,,,1,0,1,,,
108203,0,0,0,0,0,0,0,116,0.0,0.0,0.0,0.0,0.0,0.0,0.0,7,0,7,6.0,0.0,6.0
9901408,0,0,0,0,0,0,0,111,0.0,0.0,0.0,0.0,0.0,0.0,0.0,4,0,4,3.0,0.0,3.0
3227,0,0,0,0,0,0,0,1,0.0,0.0,0.0,0.0,0.0,0.0,0.0,15,0,15,4.0,0.0,4.0
9807285,0,0,0,0,0,0,0,73,0.0,0.0,0.0,0.0,0.0,0.0,0.0,10,0,10,1.0,0.0,1.0
9404231,0,0,0,0,0,0,0,997,0.0,0.0,0.0,0.0,0.0,0.0,0.0,2,0,2,,,
204019,0,0,0,0,0,0,0,384,0.0,0.0,0.0,0.0,0.0,0.0,0.0,1,0,1,1.0,0.0,1.0
208060,0,0,0,0,0,0,0,1875,0.0,0.0,0.0,0.0,0.0,0.0,0.0,8,0,8,1.0,0.0,1.0
112093,0,0,0,0,0,0,0,42,0.0,0.0,0.0,0.0,0.0,0.0,0.0,11,0,11,6.0,0.0,6.0
9408385,0,0,0,0,0,0,0,6,,,,,,,,9,0,9,,,
9804269,0,0,0,0,0,0,0,1540,,,,,,,,1,0,1,,,
102035,0,0,0,0,0,0,0,123,0.0,0.0,0.0,0.0,0.0,0.0,0.0,11,0,11,3.0,0.0,3.0
9611267,0,0,0,0,0,0,0,8,0.0,0.0,0.0,0.0,0.0,0.0,0.0,7,0,7,2.0,0.0,2.0
4025,0,0,0,0,0,0,0,55,,,,,,,,5,0,5,,,
112128,0,0,0,0,0,0,0,22,0.0,0.0,0.0,0.0,0.0,0.0,0.0,17,0,17,2.0,0.0,2.0
9501243,0,0,0,0,0,0,0,1431,,,,,,,,4,0,4,,,
211448,0,0,0,0,0,0,0,106,0.0,0.0,0.0,0.0,0.0,0.0,0.0,9,0,9,6.0,0.0,6.0
207316,0,0,0,0,0,0,0,22,0.0,0.0,0.0,0.0,0.0,0.0,0.0,26,0,26,2.0,0.0,2.0
302084,0,0,0,0,0,0,0,82,0.0,0.0,0.0,0.0,0.0,0.0,0.0,13,0,13,3.0,0.0,3.0
5137,0,0,0,0,0,0,0,182,0.0,0.0,0.0,0.0,0.0,0.0,0.0,16,0,16,7.0,0.0,7.0
105272,0,0,0,0,0,0,0,40,0.0,0.0,0.0,0.0,0.0,0.0,0.0,25,0,25,3.0,0.0,3.0
9305249,1,1,0,0,1,0,0,744,1.0,1.0,0.0,0.0,1.0,0.0,0.0,1,1,0,1.0,1.0,0.0
211093,1,1,0,0,0,1,3,9,0.0,0.0,0.0,0.0,0.0,0.0,0.0,28,1,27,4.0,0.0,4.0
9404286,0,0,0,0,0,0,0,494,0.0,0.0,0.0,0.0,0.0,0.0,0.0,2,0,2,2.0,0.0,2.0
9505291,1,1,0,0,1,0,0,1544,,,,,,,,1,1,0,1.0,1.0,0.0
208049,0,0,0,0,0,0,0,352,0.0,0.0,0.0,0.0,0.0,0.0,0.0,6,0,6,1.0,0.0,1.0
9803214,19,3,16,38,0,19,34,89,10.0,1.0,9.0,20.0,1.0,9.0,9.0,22,19,3,9.0,9.0,0.0
9805334,45,12,33,83,3,42,127,89,27.0,4.0,23.0,52.0,0.0,27.0,86.0,57,45,12,24.0,19.0,5.0
5006,40,3,37,156,0,40,201,1,29.0,1.0,28.0,114.0,0.0,29.0,99.0,57,40,17,23.0,20.0,3.0
103211,18,2,16,35,0,18,223,1,13.0,2.0,11.0,27.0,0.0,13.0,138.0,57,18,39,26.0,10.0,16.0
9911250,10,5,5,11,2,8,61,34,1.0,1.0,0.0,0.0,1.0,0.0,0.0,33,10,23,2.0,1.0,1.0
9311243,47,12,35,109,12,35,56,6,30.0,6.0,24.0,90.0,1.0,29.0,47.0,50,47,3,8.0,8.0,0.0
9411335,7,1,6,9,0,7,7,58,,,,,,,,8,7,1,1.0,1.0,0.0
102274,2,2,0,0,1,1,5,1,1.0,1.0,0.0,0.0,0.0,1.0,4.0,28,2,26,12.0,1.0,11.0
9405283,2,1,1,1,2,0,0,1363,,,,,,,,3,2,1,,,
9506477,95,12,83,703,13,82,452,15,68.0,5.0,63.0,587.0,7.0,61.0,384.0,124,95,29,49.0,39.0,10.0
9509268,48,7,41,167,24,24,33,7,30.0,3.0,27.0,126.0,17.0,13.0,13.0,54,48,6,20.0,19.0,1.0
9502254,29,9,20,46,16,13,42,34,15.0,2.0,13.0,32.0,6.0,9.0,21.0,42,29,13,7.0,4.0,3.0
9704288,9,5,4,6,3,6,17,35,0.0,0.0,0.0,0.0,0.0,0.0,0.0,40,9,31,8.0,0.0,8.0
9703412,19,13,6,6,3,16,51,4,9.0,7.0,2.0,2.0,0.0,9.0,25.0,49,19,30,7.0,2.0,5.0
9404209,96,18,78,244,33,63,126,26,25.0,5.0,20.0,49.0,1.0,24.0,74.0,100,96,4,21.0,17.0,4.0
208156,9,8,1,1,2,7,22,80,3.0,2.0,1.0,1.0,2.0,1.0,2.0,24,9,15,7.0,0.0,7.0
112169,2,2,0,0,0,2,12,2,0.0,0.0,0.0,0.0,0.0,0.0,0.0,23,2,21,3.0,0.0,3.0
2305,3,2,1,1,0,3,5,33,1.0,1.0,0.0,0.0,1.0,0.0,0.0,7,3,4,1.0,1.0,0.0
9512417,15,5,10,27,14,1,1,33,12.0,4.0,8.0,22.0,11.0,1.0,1.0,16,15,1,9.0,9.0,0.0
9702350,36,1,35,143,10,26,53,48,26.0,1.0,25.0,93.0,8.0,18.0,40.0,42,36,6,23.0,19.0,4.0
9801236,1,1,0,0,0,1,1,162,0.0,0.0,0.0,0.0,0.0,0.0,0.0,3,1,2,2.0,0.0,2.0
9811330,4,1,3,3,1,3,18,48,1.0,1.0,0.0,0.0,0.0,1.0,5.0,19,4,15,2.0,0.0,2.0
9911442,12,3,9,16,4,8,31,12,6.0,2.0,4.0,5.0,3.0,3.0,7.0,24,12,12,4.0,3.0,1.0
9905436,23,7,16,36,3,20,44,4,7.0,2.0,5.0,12.0,0.0,7.0,7.0,52,23,29,8.0,7.0,1.0
9204220,11,6,5,8,11,0,0,170,2.0,1.0,1.0,1.0,2.0,0.0,0.0,11,11,0,3.0,3.0,0.0
9506427,36,13,23,61,3,33,118,26,9.0,6.0,3.0,4.0,0.0,9.0,20.0,52,36,16,11.0,6.0,5.0
9806287,35,10,25,93,1,34,236,26,32.0,7.0,25.0,92.0,0.0,32.0,192.0,52,35,17,28.0,20.0,8.0
11078,10,9,1,1,7,3,3,56,1.0,1.0,0.0,0.0,0.0,1.0,1.0,17,10,7,1.0,1.0,0.0
6041,77,24,53,187,0,77,836,2,35.0,7.0,28.0,96.0,0.0,35.0,259.0,132,77,55,29.0,20.0,9.0
9502401,71,9,62,498,57,14,31,32,43.0,2.0,41.0,356.0,43.0,0.0,0.0,76,71,5,35.0,35.0,0.0
9511344,57,10,47,192,23,34,77,4,12.0,4.0,8.0,23.0,4.0,8.0,13.0,63,57,6,12.0,11.0,1.0
9907447,134,13,121,700,3,131,412,2,64.0,1.0,63.0,408.0,0.0,64.0,93.0,142,134,8,31.0,31.0,0.0
3180,69,13,56,241,4,65,929,32,34.0,6.0,28.0,122.0,0.0,34.0,450.0,169,69,100,47.0,21.0,26.0
111055,2,2,0,0,2,0,0,337,0.0,0.0,0.0,0.0,0.0,0.0,0.0,6,2,4,1.0,0.0,1.0
9812275,34,14,20,45,3,31,148,4,2.0,2.0,0.0,0.0,0.0,2.0,7.0,59,34,25,9.0,3.0,6.0
9709264,33,11,22,37,24,9,15,20,8.0,5.0,3.0,3.0,5.0,3.0,3.0,40,33,7,5.0,3.0,2.0
9901206,41,7,34,149,41,0,0,63,22.0,2.0,20.0,79.0,22.0,0.0,0.0,41,41,0,18.0,18.0,0.0
9209257,40,9,31,68,40,0,0,203,11.0,2.0,9.0,13.0,11.0,0.0,0.0,40,40,0,7.0,7.0,0.0
9308338,13,8,5,9,7,6,10,94,7.0,4.0,3.0,7.0,7.0,0.0,0.0,15,13,2,7.0,7.0,0.0
9608329,34,10,24,45,13,21,56,134,5.0,2.0,3.0,3.0,1.0,4.0,16.0,49,34,15,9.0,3.0,6.0
9403230,62,10,52,270,19,43,53,25,35.0,4.0,31.0,176.0,8.0,27.0,36.0,64,62,2,30.0,28.0,2.0
9601306,64,3,61,247,63,1,1,41,28.0,1.0,27.0,135.0,28.0,0.0,0.0,67,64,3,19.0,19.0,0.0
9405215,14,7,7,10,1,13,29,223,5.0,5.0,0.0,0.0,0.0,5.0,10.0,20,14,6,7.0,5.0,2.0
9501220,20,8,12,23,15,5,9,318,8.0,5.0,3.0,6.0,8.0,0.0,0.0,27,20,7,6.0,5.0,1.0
9503263,59,3,56,255,15,44,58,12,26.0,1.0,25.0,82.0,4.0,22.0,32.0,61,59,2,18.0,16.0,2.0
9510367,75,14,61,245,33,42,114,0,6.0,5.0,1.0,1.0,0.0,6.0,33.0,88,75,13,15.0,7.0,8.0
9807267,40,6,34,84,17,23,35,3,19.0,1.0,18.0,54.0,4.0,15.0,21.0,53,40,13,8.0,8.0,0.0
9904474,22,5,17,56,4,18,73,0,12.0,3.0,9.0,27.0,1.0,11.0,35.0,28,22,6,2.0,2.0,0.0
9710209,49,8,41,170,2,47,371,0,37.0,3.0,34.0,154.0,0.0,37.0,310.0,75,49,26,38.0,26.0,12.0
9705300,12,7,5,8,1,11,54,0,2.0,2.0,0.0,0.0,0.0,2.0,27.0,36,12,24,2.0,2.0,0.0
9607419,25,3,22,73,2,23,23,3,8.0,1.0,7.0,21.0,8.0,0.0,0.0,28,25,3,10.0,9.0,1.0
9901254,59,7,52,307,4,55,264,12,47.0,3.0,44.0,273.0,0.0,47.0,159.0,94,59,35,24.0,21.0,3.0
9910522,24,1,23,62,0,24,173,3,15.0,3.0,12.0,27.0,0.0,15.0,119.0,58,24,34,24.0,10.0,14.0
9505353,26,4,22,73,11,15,26,119,22.0,3.0,19.0,63.0,8.0,14.0,24.0,29,26,3,20.0,18.0,2.0
9310363,37,7,30,89,37,0,0,0,11.0,1.0,10.0,29.0,11.0,0.0,0.0,39,37,2,4.0,4.0,0.0
9808419,16,7,9,18,1,15,81,3,1.0,1.0,0.0,0.0,0.0,1.0,2.0,54,16,38,10.0,1.0,9.0
9805429,35,6,29,93,1,34,270,0,22.0,2.0,20.0,76.0,0.0,22.0,194.0,56,35,21,28.0,18.0,10.0
9602216,53,4,49,226,8,45,182,0,33.0,1.0,32.0,167.0,1.0,32.0,115.0,70,53,17,22.0,19.0,3.0
9802209,44,9,35,157,2,42,365,0,33.0,7.0,26.0,122.0,0.0,33.0,313.0,87,44,43,38.0,26.0,12.0
9801431,65,6,59,302,10,55,296,0,13.0,1.0,12.0,34.0,1.0,12.0,58.0,90,65,25,10.0,8.0,2.0
9803456,7,2,5,7,0,7,63,0,3.0,1.0,2.0,2.0,0.0,3.0,22.0,33,7,26,4.0,1.0,3.0
9306333,96,8,88,661,94,2,2,3,58.0,3.0,55.0,446.0,58.0,0.0,0.0,98,96,2,26.0,26.0,0.0
9910230,25,4,21,74,1,24,65,81,20.0,1.0,19.0,69.0,1.0,19.0,55.0,37,25,12,19.0,15.0,4.0
9205234,80,14,66,333,80,0,0,3,38.0,4.0,34.0,177.0,38.0,0.0,0.0,80,80,0,27.0,27.0,0.0
9607239,51,10,41,161,31,20,34,118,31.0,6.0,25.0,121.0,31.0,0.0,0.0,57,51,6,21.0,21.0,0.0
9511381,33,5,28,94,1,32,81,21,18.0,2.0,16.0,70.0,0.0,18.0,46.0,38,33,5,8.0,8.0,0.0
9204205,41,7,34,137,41,0,0,42,17.0,1.0,16.0,75.0,17.0,0.0,0.0,41,41,0,15.0,15.0,0.0
9506283,36,11,25,75,14,22,71,42,8.0,3.0,5.0,11.0,0.0,8.0,20.0,59,36,23,5.0,0.0,5.0
9412319,38,5,33,198,7,31,154,71,31.0,4.0,27.0,170.0,1.0,30.0,153.0,46,38,8,33.0,25.0,8.0
9809381,28,5,23,65,6,22,77,46,21.0,2.0,19.0,61.0,0.0,21.0,67.0,38,28,10,12.0,9.0,3.0
9403203,21,11,10,14,10,11,17,67,4.0,2.0,2.0,4.0,0.0,4.0,7.0,26,21,5,2.0,2.0,0.0
12313,18,5,13,32,2,16,76,0,13.0,1.0,12.0,28.0,2.0,11.0,41.0,45,18,27,12.0,1.0,11.0
9809464,3,1,2,3,1,2,15,10,2.0,1.0,1.0,1.0,0.0,2.0,5.0,19,3,16,6.0,2.0,4.0
9303274,104,27,77,453,104,0,0,10,34.0,10.0,24.0,83.0,34.0,0.0,0.0,104,104,0,13.0,13.0,0.0
9811481,50,6,44,219,5,45,233,30,41.0,4.0,37.0,195.0,2.0,39.0,187.0,67,50,17,36.0,23.0,13.0
9602207,29,12,17,32,12,17,31,12,6.0,3.0,3.0,6.0,6.0,0.0,0.0,72,29,43,3.0,0.0,3.0
9709445,18,4,14,39,2,16,47,12,6.0,1.0,5.0,8.0,6.0,0.0,0.0,24,18,6,2.0,2.0,0.0
105200,26,9,17,31,1,25,190,1,4.0,1.0,3.0,4.0,1.0,3.0,23.0,89,26,63,18.0,3.0,15.0
9409244,94,10,84,642,31,63,236,1,61.0,3.0,58.0,494.0,11.0,50.0,201.0,102,94,8,33.0,28.0,5.0
105287,1,1,0,0,0,1,2,41,0.0,0.0,0.0,0.0,0.0,0.0,0.0,12,1,11,2.0,0.0,2.0
9711469,82,2,80,651,9,73,184,1,57.0,2.0,55.0,500.0,0.0,57.0,161.0,86,82,4,42.0,39.0,3.0
9410304,64,7,57,230,39,25,32,9,16.0,2.0,14.0,38.0,6.0,10.0,10.0,67,64,3,13.0,12.0,1.0
9906286,53,7,46,154,0,53,380,7,17.0,3.0,14.0,43.0,0.0,17.0,107.0,85,53,32,12.0,6.0,6.0
9809338,12,9,3,4,3,9,36,67,5.0,4.0,1.0,1.0,1.0,4.0,15.0,19,12,7,10.0,3.0,7.0
10209,4,2,2,2,2,2,10,34,1.0,1.0,0.0,0.0,0.0,1.0,2.0,13,4,9,9.0,2.0,7.0
9605398,123,9,114,824,6,117,658,5,66.0,3.0,63.0,531.0,0.0,66.0,394.0,152,123,29,52.0,43.0,9.0
9702307,46,13,33,102,2,44,275,5,23.0,5.0,18.0,50.0,0.0,23.0,178.0,66,46,20,26.0,14.0,12.0
9709492,84,6,78,539,15,69,157,73,67.0,4.0,63.0,487.0,5.0,62.0,144.0,95,84,11,45.0,40.0,5.0
9403266,127,17,110,586,101,26,32,1,50.0,5.0,45.0,309.0,50.0,0.0,0.0,133,127,6,20.0,20.0,0.0
9504260,14,1,13,29,4,10,26,69,3.0,1.0,2.0,2.0,0.0,3.0,7.0,19,14,5,7.0,4.0,3.0
9403225,37,16,21,50,37,0,0,192,9.0,5.0,4.0,9.0,9.0,0.0,0.0,37,37,0,7.0,7.0,0.0
104126,41,9,32,74,1,40,258,1,12.0,3.0,9.0,16.0,0.0,12.0,81.0,70,41,29,6.0,5.0,1.0
109101,3,3,0,0,0,3,13,1,0.0,0.0,0.0,0.0,0.0,0.0,0.0,15,3,12,3.0,0.0,3.0
9906475,90,15,75,273,2,88,578,24,37.0,5.0,32.0,148.0,0.0,37.0,322.0,121,90,31,23.0,17.0,6.0
9507439,23,6,17,67,1,22,59,1,23.0,6.0,17.0,67.0,1.0,22.0,58.0,28,23,5,17.0,13.0,4.0
11323,10,2,8,15,0,10,332,1,6.0,1.0,5.0,9.0,0.0,6.0,176.0,113,10,103,41.0,4.0,37.0
9806278,33,6,27,84,3,30,230,1,9.0,3.0,6.0,9.0,1.0,8.0,43.0,58,33,25,12.0,7.0,5.0
9710336,50,6,44,213,1,49,413,7,37.0,4.0,33.0,151.0,0.0,37.0,289.0,72,50,22,36.0,26.0,10.0
9609530,27,6,21,41,3,24,67,7,5.0,1.0,4.0,8.0,0.0,5.0,15.0,37,27,10,8.0,3.0,5.0
9405401,47,7,40,175,47,0,0,86,23.0,2.0,21.0,99.0,23.0,0.0,0.0,47,47,0,15.0,15.0,0.0
9507213,37,9,28,57,10,27,82,61,6.0,2.0,4.0,7.0,3.0,3.0,3.0,52,37,15,8.0,5.0,3.0
9711384,41,7,34,112,2,39,258,21,26.0,5.0,21.0,76.0,1.0,25.0,69.0,69,41,28,22.0,16.0,6.0
9603237,92,8,84,516,14,78,254,7,28.0,5.0,23.0,87.0,0.0,28.0,90.0,100,92,8,20.0,15.0,5.0
9505392,10,6,4,6,3,7,18,75,4.0,1.0,3.0,5.0,4.0,0.0,0.0,31,10,21,3.0,1.0,2.0
9801356,62,6,56,351,14,48,88,24,36.0,1.0,35.0,237.0,4.0,32.0,53.0,68,62,6,24.0,23.0,1.0
9810240,25,10,15,30,2,23,135,7,3.0,2.0,1.0,1.0,0.0,3.0,37.0,50,25,25,21.0,2.0,19.0
9502245,13,7,6,7,6,7,11,237,7.0,6.0,1.0,1.0,3.0,4.0,7.0,17,13,4,5.0,4.0,1.0
9402284,15,6,9,17,5,10,21,10,3.0,2.0,1.0,2.0,0.0,3.0,6.0,23,15,8,3.0,3.0,0.0
9311298,14,2,12,34,14,0,0,256,10.0,1.0,9.0,31.0,10.0,0.0,0.0,14,14,0,10.0,10.0,0.0
9701226,18,9,9,12,13,5,9,118,2.0,2.0,0.0,0.0,1.0,1.0,1.0,22,18,4,3.0,3.0,0.0
9604323,5,4,1,1,4,1,2,88,0.0,0.0,0.0,0.0,0.0,0.0,0.0,10,5,5,2.0,0.0,2.0
9705218,17,2,15,42,1,16,56,19,11.0,1.0,10.0,29.0,0.0,11.0,22.0,24,17,7,15.0,10.0,5.0
9708344,13,4,9,22,1,12,105,19,9.0,2.0,7.0,16.0,1.0,8.0,41.0,28,13,15,20.0,8.0,12.0
9601370,4,2,2,2,1,3,11,52,3.0,1.0,2.0,2.0,0.0,3.0,11.0,9,4,5,7.0,3.0,4.0
9412322,71,19,52,212,23,48,68,5,20.0,4.0,16.0,81.0,5.0,15.0,15.0,77,71,6,18.0,17.0,1.0
9702245,108,11,97,691,23,85,86,24,58.0,4.0,54.0,510.0,12.0,46.0,47.0,112,108,4,34.0,33.0,1.0
9801352,14,5,9,25,7,7,11,127,12.0,4.0,8.0,21.0,6.0,6.0,9.0,18,14,4,10.0,8.0,2.0
9712371,15,4,11,31,5,10,19,127,11.0,2.0,9.0,23.0,3.0,8.0,9.0,28,15,13,7.0,6.0,1.0
9305228,76,10,66,221,76,0,0,9,31.0,4.0,27.0,85.0,31.0,0.0,0.0,76,76,0,13.0,13.0,0.0
5035,7,5,2,2,1,6,20,80,2.0,1.0,1.0,1.0,0.0,2.0,7.0,15,7,8,4.0,1.0,3.0
9601282,76,15,61,235,4,72,107,44,38.0,2.0,36.0,155.0,0.0,38.0,59.0,80,76,4,19.0,17.0,2.0
9908342,11,8,3,4,2,9,18,62,1.0,1.0,0.0,0.0,0.0,1.0,4.0,36,11,25,11.0,1.0,10.0
9611374,38,4,34,192,26,12,20,4,26.0,2.0,24.0,139.0,17.0,9.0,9.0,44,38,6,22.0,21.0,1.0
9912250,3,3,0,0,2,1,2,98,1.0,1.0,0.0,0.0,1.0,0.0,0.0,6,3,3,1.0,1.0,0.0
9407362,17,11,6,7,11,6,16,86,2.0,2.0,0.0,0.0,1.0,1.0,4.0,31,17,14,6.0,0.0,6.0
9307337,31,19,12,22,31,0,0,26,12.0,6.0,6.0,11.0,12.0,0.0,0.0,31,31,0,7.0,7.0,0.0
9402225,47,15,32,83,11,36,61,6,22.0,6.0,16.0,49.0,0.0,22.0,40.0,50,47,3,6.0,6.0,0.0
9405410,133,12,121,759,28,105,410,6,82.0,7.0,75.0,498.0,6.0,76.0,338.0,144,133,11,37.0,29.0,8.0
9902369,9,2,7,13,5,4,23,6,2.0,1.0,1.0,1.0,0.0,2.0,2.0,22,9,13,5.0,4.0,1.0
9308241,42,21,21,36,39,3,3,183,11.0,6.0,5.0,11.0,11.0,0.0,0.0,43,42,1,6.0,6.0,0.0
9903258,13,7,6,15,0,13,60,6,2.0,2.0,0.0,0.0,0.0,2.0,5.0,25,13,12,5.0,4.0,1.0
9511376,32,1,31,113,8,24,43,87,18.0,1.0,17.0,73.0,1.0,17.0,28.0,39,32,7,19.0,17.0,2.0
9803439,10,7,3,3,2,8,24,287,3.0,1.0,2.0,2.0,0.0,3.0,3.0,21,10,11,4.0,0.0,4.0
9601356,56,6,50,282,7,49,187,8,35.0,2.0,33.0,215.0,0.0,35.0,120.0,70,56,14,18.0,15.0,3.0
10083,17,5,12,48,1,16,32,38,11.0,2.0,9.0,33.0,9.0,2.0,2.0,32,17,15,12.0,11.0,1.0
2097,6,3,3,4,0,6,15,277,5.0,2.0,3.0,4.0,0.0,5.0,13.0,12,6,6,9.0,3.0,6.0
9612291,17,6,11,13,2,15,66,38,3.0,2.0,1.0,1.0,0.0,3.0,16.0,39,17,22,3.0,3.0,0.0
9508280,38,4,34,109,6,32,71,38,14.0,1.0,13.0,25.0,3.0,11.0,14.0,44,38,6,15.0,12.0,3.0
9607303,57,16,41,142,9,48,220,22,22.0,6.0,16.0,41.0,0.0,22.0,97.0,80,57,23,24.0,16.0,8.0
9504256,29,8,21,45,21,8,16,22,11.0,2.0,9.0,18.0,11.0,0.0,0.0,32,29,3,4.0,4.0,0.0
9906389,5,2,3,3,0,5,42,22,2.0,1.0,1.0,1.0,0.0,2.0,29.0,28,5,23,20.0,2.0,18.0
9504250,47,22,25,65,15,32,65,116,10.0,2.0,8.0,26.0,1.0,9.0,20.0,64,47,17,12.0,9.0,3.0
9907268,15,4,11,17,9,6,10,357,6.0,3.0,3.0,5.0,3.0,3.0,4.0,19,15,4,7.0,5.0,2.0
9307221,45,13,32,127,45,0,0,52,21.0,3.0,18.0,84.0,21.0,0.0,0.0,45,45,0,14.0,14.0,0.0
9903550,5,1,4,8,0,5,38,21,5.0,1.0,4.0,8.0,0.0,5.0,38.0,17,5,12,16.0,5.0,11.0
9810320,43,4,39,196,0,43,208,2,25.0,2.0,23.0,93.0,0.0,25.0,145.0,53,43,10,14.0,13.0,1.0
9501307,78,22,56,353,13,65,84,16,40.0,11.0,29.0,132.0,2.0,38.0,53.0,80,78,2,25.0,23.0,2.0
9803400,41,9,32,82,5,36,85,39,13.0,3.0,10.0,22.0,1.0,12.0,24.0,49,41,8,9.0,9.0,0.0
9903516,49,7,42,307,2,47,406,19,41.0,3.0,38.0,292.0,2.0,39.0,343.0,82,49,33,33.0,27.0,6.0
9912283,12,10,2,2,1,11,52,43,4.0,4.0,0.0,0.0,1.0,3.0,10.0,25,12,13,3.0,2.0,1.0
9411431,42,9,33,94,14,28,42,39,22.0,2.0,20.0,56.0,3.0,19.0,28.0,47,42,5,18.0,16.0,2.0
9901321,9,7,2,4,0,9,36,101,7.0,5.0,2.0,3.0,0.0,7.0,21.0,23,9,14,9.0,5.0,4.0
101025,23,3,20,46,0,23,194,20,19.0,3.0,16.0,37.0,0.0,19.0,184.0,63,23,40,42.0,9.0,33.0
9910254,41,4,37,188,0,41,506,20,36.0,2.0,34.0,177.0,0.0,36.0,481.0,65,41,24,49.0,25.0,24.0
9708256,15,6,9,17,5,10,21,104,4.0,4.0,0.0,0.0,0.0,4.0,4.0,26,15,11,6.0,1.0,5.0
9403387,78,10,68,283,55,23,25,17,48.0,2.0,46.0,208.0,27.0,21.0,21.0,80,78,2,26.0,25.0,1.0
9508245,8,7,1,1,7,1,1,449,3.0,2.0,1.0,1.0,2.0,1.0,1.0,9,8,1,2.0,1.0,1.0
9905253,5,3,2,4,0,5,23,136,4.0,2.0,2.0,3.0,0.0,4.0,13.0,20,5,15,10.0,3.0,7.0
9172,4,3,1,1,1,3,38,20,2.0,2.0,0.0,0.0,0.0,2.0,30.0,31,4,27,6.0,1.0,5.0
9712344,13,5,8,12,13,0,0,136,4.0,1.0,3.0,6.0,4.0,0.0,0.0,14,13,1,4.0,4.0,0.0
201148,19,5,14,42,3,16,24,37,4.0,1.0,3.0,6.0,0.0,4.0,4.0,30,19,11,9.0,9.0,0.0
9904485,21,7,14,44,0,21,114,2,14.0,6.0,8.0,15.0,0.0,14.0,84.0,30,21,9,7.0,5.0,2.0
9602242,21,4,17,47,4,17,26,78,12.0,2.0,10.0,30.0,3.0,9.0,9.0,25,21,4,12.0,11.0,1.0
9604349,17,4,13,26,4,13,19,78,8.0,2.0,6.0,10.0,1.0,7.0,7.0,22,17,5,6.0,5.0,1.0
9810500,39,5,34,140,3,36,325,5,14.0,3.0,11.0,34.0,0.0,14.0,122.0,88,39,49,34.0,13.0,21.0
9209250,73,26,47,116,52,21,21,10,19.0,4.0,15.0,39.0,11.0,8.0,8.0,74,73,1,6.0,6.0,0.0
9211228,39,16,23,77,24,15,19,75,16.0,10.0,6.0,26.0,7.0,9.0,9.0,41,39,2,10.0,9.0,1.0
9705444,54,19,35,123,9,45,163,18,17.0,2.0,15.0,52.0,0.0,17.0,54.0,71,54,17,8.0,5.0,3.0
9805405,41,15,26,59,17,24,33,46,13.0,2.0,11.0,16.0,4.0,9.0,9.0,48,41,7,10.0,10.0,0.0
9703232,23,3,20,60,1,22,77,42,13.0,2.0,11.0,28.0,1.0,12.0,12.0,34,23,11,11.0,10.0,1.0
9902272,4,2,2,2,0,4,9,73,1.0,1.0,0.0,0.0,0.0,1.0,2.0,12,4,8,3.0,1.0,2.0
9402282,13,3,10,23,4,9,19,163,6.0,1.0,5.0,8.0,0.0,6.0,11.0,18,13,5,5.0,4.0,1.0
9410262,18,1,17,56,17,1,1,158,14.0,1.0,13.0,44.0,14.0,0.0,0.0,21,18,3,12.0,12.0,0.0
9704217,26,17,9,13,13,13,40,35,12.0,6.0,6.0,9.0,2.0,10.0,32.0,45,26,19,8.0,0.0,8.0
9910271,22,12,10,19,12,10,19,4,3.0,3.0,0.0,0.0,3.0,0.0,0.0,28,22,6,3.0,3.0,0.0
2033,54,9,45,142,7,47,198,95,20.0,1.0,19.0,57.0,1.0,19.0,82.0,72,54,18,24.0,12.0,12.0
9808299,98,10,88,548,3,95,569,4,54.0,4.0,50.0,364.0,3.0,51.0,356.0,112,98,14,52.0,43.0,9.0
9910449,6,5,1,1,2,4,7,4,0.0,0.0,0.0,0.0,0.0,0.0,0.0,28,6,22,2.0,0.0,2.0
9703294,5,2,3,4,0,5,5,310,5.0,2.0,3.0,4.0,0.0,5.0,5.0,6,5,1,6.0,5.0,1.0
9906539,33,9,24,72,2,31,197,0,13.0,4.0,9.0,24.0,0.0,13.0,42.0,57,33,24,17.0,12.0,5.0
9810533,13,2,11,43,8,5,8,28,8.0,1.0,7.0,24.0,8.0,0.0,0.0,18,13,5,7.0,6.0,1.0
9710533,8,6,2,3,1,7,21,99,2.0,2.0,0.0,0.0,0.0,2.0,3.0,16,8,8,3.0,2.0,1.0
9903264,11,4,7,12,8,3,3,36,0.0,0.0,0.0,0.0,0.0,0.0,0.0,30,11,19,4.0,4.0,0.0
9708419,20,11,9,11,1,19,177,36,8.0,5.0,3.0,3.0,0.0,8.0,134.0,64,20,44,31.0,5.0,26.0
9909204,4,1,3,3,4,0,0,322,4.0,1.0,3.0,3.0,4.0,0.0,0.0,4,4,0,3.0,3.0,0.0
9712387,10,4,6,15,2,8,21,227,9.0,3.0,6.0,15.0,1.0,8.0,21.0,14,10,4,11.0,8.0,3.0
9409232,20,3,17,35,0,20,67,17,14.0,2.0,12.0,24.0,0.0,14.0,49.0,24,20,4,2.0,2.0,0.0
9709386,17,3,14,32,0,17,108,6,12.0,3.0,9.0,21.0,0.0,12.0,91.0,36,17,19,19.0,8.0,11.0
9911457,62,12,50,253,0,62,324,2,34.0,6.0,28.0,152.0,0.0,34.0,146.0,73,62,11,26.0,23.0,3.0
9601275,11,4,7,13,3,8,10,100,7.0,1.0,6.0,7.0,2.0,5.0,5.0,13,11,2,7.0,6.0,1.0
9504373,63,14,49,145,7,56,91,55,15.0,2.0,13.0,42.0,2.0,13.0,13.0,72,63,9,9.0,8.0,1.0
9512341,20,6,14,29,7,13,47,1,3.0,3.0,0.0,0.0,0.0,3.0,9.0,29,20,9,6.0,3.0,3.0
9305214,1,1,0,0,1,0,0,182,1.0,1.0,0.0,0.0,1.0,0.0,0.0,1,1,0,1.0,1.0,0.0
9610341,9,6,3,3,5,4,11,10,2.0,1.0,1.0,1.0,2.0,0.0,0.0,18,9,9,2.0,2.0,0.0
2147,87,18,69,218,12,75,290,0,12.0,4.0,8.0,21.0,1.0,11.0,14.0,115,87,28,8.0,8.0,0.0
9504218,10,6,4,4,3,7,11,56,4.0,2.0,2.0,2.0,0.0,4.0,8.0,12,10,2,1.0,1.0,0.0
9904245,16,7,9,14,0,16,53,0,2.0,1.0,1.0,1.0,0.0,2.0,2.0,43,16,27,2.0,1.0,1.0
9705437,53,13,40,140,11,42,127,31,35.0,9.0,26.0,94.0,2.0,33.0,113.0,63,53,10,17.0,11.0,6.0
9401209,11,2,9,38,0,11,65,124,11.0,2.0,9.0,38.0,0.0,11.0,60.0,23,11,12,18.0,11.0,7.0
9706509,66,9,57,308,4,62,322,18,44.0,5.0,39.0,201.0,1.0,43.0,177.0,97,66,31,26.0,23.0,3.0
4169,43,11,32,100,11,32,175,18,24.0,4.0,20.0,73.0,4.0,20.0,89.0,78,43,35,20.0,14.0,6.0
9906394,8,2,6,9,0,8,58,18,5.0,2.0,3.0,4.0,0.0,5.0,33.0,31,8,23,10.0,1.0,9.0
12067,15,9,6,9,7,8,10,18,2.0,2.0,0.0,0.0,2.0,0.0,0.0,19,15,4,2.0,2.0,0.0
5154,14,3,11,36,0,14,101,18,13.0,2.0,11.0,33.0,0.0,13.0,80.0,36,14,22,8.0,5.0,3.0
9606477,40,11,29,115,9,31,65,95,23.0,3.0,20.0,91.0,7.0,16.0,35.0,48,40,8,12.0,9.0,3.0
9809239,17,3,14,34,2,15,55,18,11.0,2.0,9.0,23.0,1.0,10.0,33.0,25,17,8,14.0,9.0,5.0
9611325,20,4,16,53,0,20,71,60,11.0,3.0,8.0,35.0,0.0,11.0,41.0,44,20,24,15.0,10.0,5.0
12123,10,2,8,25,0,10,121,32,8.0,2.0,6.0,18.0,0.0,8.0,109.0,47,10,37,25.0,7.0,18.0
9907444,7,5,2,5,0,7,32,5,1.0,1.0,0.0,0.0,0.0,1.0,4.0,23,7,16,8.0,4.0,4.0
7155,11,3,8,14,3,8,33,0,6.0,1.0,5.0,6.0,2.0,4.0,13.0,29,11,18,9.0,1.0,8.0
103318,17,2,15,45,5,12,46,0,13.0,2.0,11.0,38.0,4.0,9.0,24.0,35,17,18,7.0,4.0,3.0
9909408,13,4,9,22,0,13,72,50,11.0,3.0,8.0,19.0,0.0,11.0,63.0,27,13,14,19.0,7.0,12.0
9301240,15,3,12,21,15,0,0,69,6.0,1.0,5.0,10.0,6.0,0.0,0.0,15,15,0,1.0,1.0,0.0
9805247,34,7,27,70,5,29,44,118,18.0,3.0,15.0,43.0,1.0,17.0,17.0,38,34,4,15.0,14.0,1.0
9908245,29,4,25,81,1,28,181,45,19.0,3.0,16.0,56.0,4.0,15.0,50.0,69,29,40,17.0,11.0,6.0
1001,43,4,39,287,2,41,373,19,33.0,2.0,31.0,256.0,0.0,33.0,321.0,72,43,29,42.0,29.0,13.0
9706213,8,4,4,5,3,5,14,66,1.0,1.0,0.0,0.0,1.0,0.0,0.0,15,8,7,3.0,1.0,2.0
9902484,32,5,27,102,1,31,240,43,20.0,2.0,18.0,75.0,0.0,20.0,178.0,90,32,58,44.0,17.0,27.0
9611450,25,7,18,53,3,22,51,44,10.0,3.0,7.0,16.0,2.0,8.0,8.0,31,25,6,17.0,14.0,3.0
9410319,19,5,14,71,2,17,54,94,17.0,4.0,13.0,63.0,2.0,15.0,38.0,28,19,9,18.0,15.0,3.0
9602433,13,5,8,17,10,3,4,61,3.0,2.0,1.0,1.0,3.0,0.0,0.0,20,13,7,1.0,1.0,0.0
9309276,1,1,0,0,1,0,0,293,1.0,1.0,0.0,0.0,1.0,0.0,0.0,1,1,0,1.0,1.0,0.0
9806303,48,27,21,50,16,32,71,13,16.0,4.0,12.0,35.0,4.0,12.0,21.0,90,48,42,14.0,11.0,3.0
9702408,31,11,20,40,2,29,73,39,14.0,2.0,12.0,20.0,2.0,12.0,29.0,40,31,9,15.0,10.0,5.0
9501233,0,0,0,0,0,0,0,1160,0.0,0.0,0.0,0.0,0.0,0.0,0.0,1,0,1,1.0,0.0,1.0
9901404,42,12,30,57,22,20,42,50,7.0,2.0,5.0,11.0,1.0,6.0,11.0,52,42,10,4.0,1.0,3.0
3051,2,2,0,0,0,2,15,2,1.0,1.0,0.0,0.0,0.0,1.0,8.0,15,2,13,,,
8274,3,3,0,0,2,1,2,138,2.0,2.0,0.0,0.0,1.0,1.0,1.0,9,3,6,2.0,0.0,2.0
109115,48,12,36,142,0,48,915,11,38.0,8.0,30.0,132.0,0.0,38.0,826.0,100,48,52,75.0,30.0,45.0
9911371,21,9,12,34,0,21,267,11,18.0,8.0,10.0,32.0,0.0,18.0,236.0,71,21,50,30.0,12.0,18.0
211141,4,4,0,0,1,3,22,19,4.0,4.0,0.0,0.0,1.0,3.0,19.0,21,4,17,12.0,2.0,10.0
207043,10,5,5,6,0,10,106,19,10.0,5.0,5.0,6.0,0.0,10.0,85.0,38,10,28,20.0,9.0,11.0
2266,8,2,6,10,2,6,20,339,6.0,1.0,5.0,9.0,2.0,4.0,12.0,20,8,12,9.0,6.0,3.0
109178,9,6,3,4,0,9,75,16,2.0,1.0,1.0,1.0,0.0,2.0,23.0,49,9,40,26.0,2.0,24.0
108252,10,2,8,9,0,10,79,25,4.0,2.0,2.0,2.0,0.0,4.0,17.0,72,10,62,5.0,3.0,2.0
109287,45,5,40,352,0,45,443,28,42.0,3.0,39.0,346.0,0.0,42.0,263.0,70,45,25,43.0,37.0,6.0
111230,16,4,12,46,0,16,108,28,13.0,2.0,11.0,43.0,0.0,13.0,51.0,25,16,9,18.0,13.0,5.0
9904457,13,3,10,23,1,12,33,122,9.0,2.0,7.0,19.0,0.0,9.0,19.0,20,13,7,11.0,8.0,3.0
9609381,289,8,281,2557,46,243,547,9,143.0,1.0,142.0,1719.0,30.0,113.0,253.0,294,289,5,69.0,65.0,4.0
9907477,5,4,1,2,0,5,11,26,4.0,3.0,1.0,2.0,0.0,4.0,9.0,10,5,5,2.0,2.0,0.0
9411299,23,13,10,26,11,12,30,0,10.0,5.0,5.0,16.0,3.0,7.0,16.0,30,23,7,4.0,2.0,2.0
103235,27,7,20,69,0,27,98,23,14.0,5.0,9.0,38.0,0.0,14.0,32.0,43,27,16,10.0,8.0,2.0
9909454,3,2,1,1,0,3,19,2,1.0,1.0,0.0,0.0,0.0,1.0,1.0,14,3,11,1.0,1.0,0.0
9708441,5,2,3,6,1,4,11,276,4.0,2.0,2.0,3.0,0.0,4.0,10.0,10,5,5,7.0,4.0,3.0
9809250,24,7,17,43,1,23,116,10,11.0,5.0,6.0,11.0,0.0,11.0,60.0,45,24,21,12.0,6.0,6.0
9906341,13,10,3,3,1,12,175,5,1.0,1.0,0.0,0.0,0.0,1.0,9.0,121,13,108,27.0,5.0,22.0
106166,67,3,64,540,0,67,355,37,62.0,2.0,60.0,516.0,0.0,62.0,331.0,78,67,11,52.0,45.0,7.0
4031,13,7,6,8,1,12,34,87,2.0,1.0,1.0,1.0,0.0,2.0,6.0,33,13,20,7.0,3.0,4.0
9811215,3,3,0,0,0,3,13,119,2.0,2.0,0.0,0.0,0.0,2.0,8.0,13,3,10,8.0,2.0,6.0
9912397,4,4,0,0,1,3,8,2061,,,,,,,,8,4,4,1.0,1.0,0.0
9207209,25,5,20,47,25,0,0,234,12.0,2.0,10.0,20.0,12.0,0.0,0.0,25,25,0,9.0,9.0,0.0
9812528,3,2,1,1,0,3,6,107,0.0,0.0,0.0,0.0,0.0,0.0,0.0,7,3,4,3.0,0.0,3.0
9707244,30,11,19,51,2,28,112,5,17.0,6.0,11.0,28.0,0.0,17.0,45.0,44,30,14,15.0,12.0,3.0
6254,16,2,14,63,0,16,99,21,16.0,2.0,14.0,63.0,0.0,16.0,63.0,33,16,17,19.0,13.0,6.0
7018,21,11,10,17,1,20,71,55,5.0,3.0,2.0,3.0,0.0,5.0,11.0,68,21,47,8.0,6.0,2.0
9505222,16,3,13,24,0,16,57,7,6.0,2.0,4.0,8.0,0.0,6.0,14.0,24,16,8,8.0,5.0,3.0
10304,1,1,0,0,0,1,4,1,0.0,0.0,0.0,0.0,0.0,0.0,0.0,15,1,14,4.0,0.0,4.0
9705219,17,1,16,50,0,17,96,7,13.0,1.0,12.0,37.0,0.0,13.0,44.0,27,17,10,7.0,6.0,1.0
9912230,19,4,15,60,1,18,101,34,17.0,3.0,14.0,59.0,1.0,16.0,96.0,30,19,11,22.0,13.0,9.0
9401338,8,7,1,2,3,5,5,25,2.0,2.0,0.0,0.0,2.0,0.0,0.0,9,8,1,1.0,1.0,0.0
9607332,62,12,50,111,25,37,167,79,21.0,5.0,16.0,29.0,1.0,20.0,115.0,89,62,27,17.0,11.0,6.0
3203,39,3,36,236,2,37,130,9,33.0,1.0,32.0,220.0,0.0,33.0,123.0,47,39,8,22.0,22.0,0.0
9509311,106,16,90,348,20,86,155,9,27.0,7.0,20.0,55.0,3.0,24.0,35.0,118,106,12,10.0,10.0,0.0
9410237,45,12,33,129,23,22,31,17,31.0,5.0,26.0,112.0,14.0,17.0,23.0,49,45,4,20.0,18.0,2.0
9605295,43,8,35,111,3,40,156,17,22.0,4.0,18.0,55.0,0.0,22.0,75.0,55,43,12,16.0,12.0,4.0
9403325,5,3,2,2,5,0,0,183,4.0,2.0,2.0,2.0,4.0,0.0,0.0,5,5,0,4.0,4.0,0.0
9407398,16,7,9,12,11,5,5,211,6.0,4.0,2.0,2.0,4.0,2.0,2.0,18,16,2,4.0,4.0,0.0
9504332,19,7,12,16,2,17,53,26,10.0,5.0,5.0,7.0,0.0,10.0,42.0,28,19,9,15.0,9.0,6.0
9607272,11,4,7,14,0,11,27,245,8.0,4.0,4.0,6.0,0.0,8.0,8.0,15,11,4,12.0,10.0,2.0
9302238,22,15,7,14,22,0,0,104,11.0,9.0,2.0,2.0,11.0,0.0,0.0,22,22,0,3.0,3.0,0.0
9501240,44,5,39,145,38,6,8,8,10.0,3.0,7.0,11.0,10.0,0.0,0.0,47,44,3,6.0,6.0,0.0
9412236,16,5,11,21,6,10,12,8,4.0,4.0,0.0,0.0,4.0,0.0,0.0,18,16,2,6.0,5.0,1.0
209372,0,0,0,0,0,0,0,4,,,,,,,,7,0,7,1.0,0.0,1.0
9610495,21,3,18,39,12,9,12,4,7.0,1.0,6.0,11.0,7.0,0.0,0.0,26,21,5,4.0,3.0,1.0
9704404,10,7,3,3,10,0,0,309,4.0,3.0,1.0,1.0,4.0,0.0,0.0,10,10,0,2.0,2.0,0.0
9908286,20,6,14,51,0,20,384,12,17.0,4.0,13.0,47.0,0.0,17.0,335.0,82,20,62,41.0,15.0,26.0
9402280,2,2,0,0,1,1,2,129,1.0,1.0,0.0,0.0,0.0,1.0,1.0,4,2,2,2.0,1.0,1.0
9912326,13,4,9,33,13,0,0,28,10.0,2.0,8.0,31.0,10.0,0.0,0.0,13,13,0,9.0,9.0,0.0
9210239,9,5,4,7,9,0,0,414,4.0,2.0,2.0,3.0,4.0,0.0,0.0,9,9,0,2.0,2.0,0.0
9702263,21,6,15,25,1,20,79,14,7.0,2.0,5.0,8.0,0.0,7.0,42.0,37,21,16,8.0,7.0,1.0
9603405,1,1,0,0,0,1,1,101,0.0,0.0,0.0,0.0,0.0,0.0,0.0,3,1,2,1.0,0.0,1.0
1295,16,3,13,26,3,13,67,24,10.0,2.0,8.0,15.0,0.0,10.0,49.0,31,16,15,5.0,1.0,4.0
9805216,16,4,12,29,3,13,36,24,4.0,3.0,1.0,2.0,3.0,1.0,1.0,27,16,11,8.0,5.0,3.0
9603206,49,6,43,225,30,19,29,92,29.0,3.0,26.0,141.0,18.0,11.0,17.0,51,49,2,22.0,21.0,1.0
9710340,4,2,2,2,1,3,3,64,2.0,1.0,1.0,1.0,0.0,2.0,2.0,9,4,5,6.0,2.0,4.0
9406255,28,16,12,21,9,19,26,47,7.0,5.0,2.0,2.0,7.0,0.0,0.0,33,28,5,3.0,3.0,0.0
5028,18,2,16,55,0,18,146,9,18.0,2.0,16.0,55.0,0.0,18.0,142.0,38,18,20,24.0,8.0,16.0
9502261,57,15,42,93,24,33,49,14,14.0,9.0,5.0,6.0,8.0,6.0,8.0,63,57,6,7.0,7.0,0.0
9808262,18,5,13,34,2,16,94,14,9.0,4.0,5.0,14.0,2.0,7.0,38.0,38,18,20,13.0,3.0,10.0
9609515,8,2,6,10,0,8,57,14,7.0,2.0,5.0,9.0,0.0,7.0,41.0,21,8,13,2.0,1.0,1.0
2157,15,8,7,8,0,15,89,14,3.0,3.0,0.0,0.0,0.0,3.0,24.0,57,15,42,23.0,0.0,23.0
9802362,24,1,23,82,0,24,54,9,15.0,1.0,14.0,45.0,4.0,11.0,11.0,33,24,9,14.0,13.0,1.0
9506240,2,2,0,0,2,0,0,593,1.0,1.0,0.0,0.0,1.0,0.0,0.0,2,2,0,1.0,1.0,0.0
9507319,128,7,121,827,27,101,232,13,67.0,3.0,64.0,465.0,8.0,59.0,139.0,145,128,17,23.0,21.0,2.0
9906256,15,2,13,26,0,15,55,10,7.0,1.0,6.0,10.0,0.0,7.0,21.0,27,15,12,8.0,7.0,1.0
9611203,2,2,0,0,0,2,6,77,1.0,1.0,0.0,0.0,0.0,1.0,2.0,6,2,4,3.0,1.0,2.0
9706386,3,2,1,1,1,2,2,44,2.0,2.0,0.0,0.0,0.0,2.0,2.0,25,3,22,2.0,0.0,2.0
9701361,10,4,6,8,0,10,62,17,8.0,3.0,5.0,7.0,0.0,8.0,58.0,26,10,16,3.0,3.0,0.0
9601333,4,2,2,2,0,4,38,17,4.0,2.0,2.0,2.0,0.0,4.0,38.0,17,4,13,15.0,2.0,13.0
9410292,6,2,4,5,0,6,11,66,3.0,1.0,2.0,3.0,0.0,3.0,3.0,8,6,2,,,
9508270,1,1,0,0,0,1,1,66,,,,,,,,2,1,1,,,
9609439,6,2,4,13,0,6,15,16,5.0,1.0,4.0,10.0,0.0,5.0,10.0,12,6,6,2.0,0.0,2.0
9707348,5,3,2,2,1,4,23,16,1.0,1.0,0.0,0.0,0.0,1.0,1.0,22,5,17,7.0,0.0,7.0
9707291,97,17,80,410,8,89,435,13,56.0,6.0,50.0,286.0,0.0,56.0,325.0,124,97,27,32.0,23.0,9.0
9506446,7,5,2,3,1,6,7,16,0.0,0.0,0.0,0.0,0.0,0.0,0.0,11,7,4,1.0,1.0,0.0
9802416,27,7,20,34,4,23,155,8,6.0,3.0,3.0,3.0,0.0,6.0,41.0,72,27,45,18.0,10.0,8.0
9706209,25,1,24,87,11,14,42,8,12.0,1.0,11.0,33.0,6.0,6.0,10.0,31,25,6,17.0,13.0,4.0
9301285,10,7,3,5,0,10,18,15,5.0,4.0,1.0,1.0,5.0,0.0,0.0,14,10,4,3.0,3.0,0.0
9410294,4,2,2,3,1,3,8,15,2.0,1.0,1.0,1.0,2.0,0.0,0.0,8,4,4,2.0,2.0,0.0
9612212,13,2,11,48,0,13,115,15,12.0,2.0,10.0,43.0,0.0,12.0,97.0,29,13,16,21.0,12.0,9.0
9507208,1,1,0,0,0,1,1,47,0.0,0.0,0.0,0.0,0.0,0.0,0.0,4,1,3,2.0,0.0,2.0
9604417,28,4,24,121,0,28,103,60,17.0,3.0,14.0,85.0,0.0,17.0,58.0,46,28,18,22.0,18.0,4.0
4100,7,5,2,2,1,6,65,0,3.0,2.0,1.0,1.0,0.0,3.0,8.0,34,7,27,8.0,2.0,6.0
104226,23,9,14,49,3,20,88,3,12.0,5.0,7.0,16.0,0.0,12.0,22.0,35,23,12,16.0,13.0,3.0
9909390,22,5,17,77,3,19,119,0,17.0,1.0,16.0,67.0,3.0,14.0,75.0,50,22,28,25.0,16.0,9.0
9907296,10,4,6,7,2,8,45,0,0.0,0.0,0.0,0.0,0.0,0.0,0.0,54,10,44,11.0,0.0,11.0
9308362,19,12,7,14,19,0,0,214,9.0,6.0,3.0,3.0,9.0,0.0,0.0,19,19,0,4.0,4.0,0.0
9712459,24,4,20,81,0,24,59,52,21.0,2.0,19.0,77.0,0.0,21.0,42.0,28,24,4,20.0,18.0,2.0
9506276,2,1,1,1,0,2,12,71,2.0,1.0,1.0,1.0,0.0,2.0,12.0,9,2,7,9.0,2.0,7.0
9810361,22,8,14,27,4,18,100,21,9.0,2.0,7.0,10.0,0.0,9.0,31.0,43,22,21,13.0,6.0,7.0
9509428,37,4,33,100,3,34,227,1,27.0,3.0,24.0,77.0,0.0,27.0,200.0,50,37,13,24.0,13.0,11.0
5293,22,6,16,50,4,18,72,2,13.0,5.0,8.0,29.0,0.0,13.0,57.0,30,22,8,14.0,8.0,6.0
9811404,8,2,6,12,0,8,18,120,7.0,2.0,5.0,9.0,0.0,7.0,16.0,14,8,6,10.0,7.0,3.0
9804437,8,7,1,1,2,6,17,10,2.0,2.0,0.0,0.0,0.0,2.0,3.0,16,8,8,5.0,2.0,3.0
9610265,25,6,19,44,2,23,53,145,13.0,2.0,11.0,22.0,13.0,0.0,0.0,31,25,6,9.0,9.0,0.0
9602380,10,9,1,2,7,3,26,25,0.0,0.0,0.0,0.0,0.0,0.0,0.0,37,10,27,2.0,1.0,1.0
9703226,21,6,15,33,0,21,53,8,7.0,3.0,4.0,6.0,0.0,7.0,13.0,36,21,15,3.0,0.0,3.0
5196,9,5,4,4,0,9,32,92,5.0,3.0,2.0,2.0,1.0,4.0,12.0,34,9,25,4.0,3.0,1.0
12346,16,2,14,32,1,15,91,21,10.0,1.0,9.0,26.0,1.0,9.0,41.0,38,16,22,13.0,6.0,7.0
9901213,3,2,1,1,0,3,19,22,3.0,2.0,1.0,1.0,0.0,3.0,18.0,23,3,20,5.0,0.0,5.0
9402290,1,1,0,0,1,0,0,246,0.0,0.0,0.0,0.0,0.0,0.0,0.0,2,1,1,1.0,0.0,1.0
9307253,9,7,2,3,5,4,4,478,4.0,4.0,0.0,0.0,4.0,0.0,0.0,10,9,1,4.0,4.0,0.0
9407309,4,3,1,2,1,3,5,124,1.0,1.0,0.0,0.0,1.0,0.0,0.0,11,4,7,2.0,2.0,0.0
12179,4,3,1,1,1,3,4,44,1.0,1.0,0.0,0.0,0.0,1.0,2.0,17,4,13,8.0,0.0,8.0
9907394,4,3,1,1,1,3,6,44,2.0,1.0,1.0,1.0,0.0,2.0,4.0,10,4,6,2.0,1.0,1.0
9711281,12,5,7,9,6,6,8,56,10.0,3.0,7.0,9.0,5.0,5.0,5.0,14,12,2,4.0,4.0,0.0
9907436,34,3,31,124,2,32,151,30,27.0,2.0,25.0,105.0,0.0,27.0,134.0,47,34,13,24.0,15.0,9.0
9908352,41,6,35,166,1,40,475,12,23.0,3.0,20.0,81.0,0.0,23.0,309.0,94,41,53,27.0,17.0,10.0
9906507,7,3,4,4,0,7,46,60,4.0,2.0,2.0,2.0,0.0,4.0,25.0,18,7,11,12.0,4.0,8.0
9808408,8,6,2,2,0,8,55,33,2.0,2.0,0.0,0.0,0.0,2.0,14.0,81,8,73,9.0,1.0,8.0
1301,24,8,16,30,2,22,69,15,4.0,1.0,3.0,6.0,4.0,0.0,0.0,53,24,29,4.0,3.0,1.0
11026,10,5,5,7,2,8,68,13,8.0,3.0,5.0,7.0,0.0,8.0,58.0,41,10,31,14.0,5.0,9.0
9912526,3,2,1,1,0,3,37,26,3.0,2.0,1.0,1.0,0.0,3.0,27.0,23,3,20,11.0,1.0,10.0
9905358,10,2,8,20,0,10,66,131,10.0,2.0,8.0,20.0,0.0,10.0,37.0,28,10,18,11.0,6.0,5.0
9607204,6,2,4,6,0,6,10,83,4.0,1.0,3.0,5.0,2.0,2.0,2.0,11,6,5,1.0,1.0,0.0
9801293,7,2,5,13,7,0,0,64,7.0,2.0,5.0,13.0,7.0,0.0,0.0,7,7,0,7.0,7.0,0.0
9908319,4,3,1,1,2,2,3,36,0.0,0.0,0.0,0.0,0.0,0.0,0.0,9,4,5,3.0,2.0,1.0
9801406,8,4,4,4,0,8,33,58,4.0,4.0,0.0,0.0,0.0,4.0,12.0,25,8,17,8.0,2.0,6.0
9910341,13,2,11,23,5,8,35,12,9.0,1.0,8.0,18.0,2.0,7.0,10.0,22,13,9,10.0,8.0,2.0
9607423,3,2,1,1,2,1,2,12,3.0,2.0,1.0,1.0,3.0,0.0,0.0,12,3,9,4.0,1.0,3.0
9501286,3,2,1,1,2,1,1,487,,,,,,,,5,3,2,2.0,1.0,1.0
9506205,6,2,4,4,3,3,8,13,3.0,1.0,2.0,2.0,0.0,3.0,5.0,10,6,4,5.0,3.0,2.0
105222,9,2,7,12,0,9,34,24,2.0,1.0,1.0,1.0,0.0,2.0,3.0,22,9,13,6.0,4.0,2.0
9609466,4,2,2,3,0,4,6,89,0.0,0.0,0.0,0.0,0.0,0.0,0.0,6,4,2,1.0,0.0,1.0
11357,8,4,4,5,0,8,28,373,4.0,2.0,2.0,2.0,0.0,4.0,9.0,40,8,32,5.0,2.0,3.0
9610529,11,2,9,15,2,9,41,30,8.0,1.0,7.0,13.0,1.0,7.0,22.0,27,11,16,11.0,6.0,5.0
9911257,9,3,6,10,2,7,27,21,6.0,1.0,5.0,8.0,0.0,6.0,26.0,16,9,7,11.0,5.0,6.0
9412390,9,6,3,5,2,7,10,255,4.0,1.0,3.0,5.0,4.0,0.0,0.0,11,9,2,1.0,1.0,0.0
9310371,7,4,3,6,5,2,2,10,1.0,1.0,0.0,0.0,0.0,1.0,1.0,8,7,1,1.0,1.0,0.0
9610479,30,10,20,41,10,20,46,41,9.0,4.0,5.0,14.0,2.0,7.0,7.0,38,30,8,2.0,2.0,0.0
9308308,19,11,8,14,4,15,20,208,10.0,9.0,1.0,1.0,1.0,9.0,9.0,21,19,2,10.0,9.0,1.0
9605336,32,20,12,15,12,20,71,6,4.0,4.0,0.0,0.0,0.0,4.0,26.0,50,32,18,4.0,1.0,3.0
7314,6,3,3,5,0,6,24,44,4.0,2.0,2.0,3.0,0.0,4.0,11.0,25,6,19,4.0,2.0,2.0
107186,31,6,25,75,3,28,163,0,20.0,2.0,18.0,48.0,0.0,20.0,122.0,45,31,14,21.0,14.0,7.0
9305220,2,1,1,1,2,0,0,43,2.0,1.0,1.0,1.0,2.0,0.0,0.0,2,2,0,,,
9509321,11,3,8,26,4,7,7,44,10.0,3.0,7.0,21.0,4.0,6.0,6.0,12,11,1,7.0,6.0,1.0
106333,6,2,4,9,0,6,63,29,5.0,1.0,4.0,8.0,0.0,5.0,42.0,29,6,23,18.0,5.0,13.0
206252,3,3,0,0,0,3,23,29,2.0,2.0,0.0,0.0,0.0,2.0,14.0,25,3,22,12.0,2.0,10.0
9908293,4,3,1,1,1,3,6,8,1.0,1.0,0.0,0.0,0.0,1.0,4.0,17,4,13,9.0,1.0,8.0
7279,7,5,2,3,3,4,18,9,2.0,2.0,0.0,0.0,0.0,2.0,5.0,23,7,16,2.0,0.0,2.0
9811303,14,6,8,12,6,8,10,7,5.0,2.0,3.0,6.0,3.0,2.0,2.0,29,14,15,7.0,6.0,1.0
9404263,3,2,1,1,1,2,2,1900,0.0,0.0,0.0,0.0,0.0,0.0,0.0,6,3,3,1.0,0.0,1.0
9606275,16,2,14,88,0,16,56,43,16.0,2.0,14.0,88.0,0.0,16.0,54.0,23,16,7,20.0,14.0,6.0
9505282,18,11,7,13,7,11,17,281,8.0,6.0,2.0,4.0,0.0,8.0,11.0,21,18,3,6.0,4.0,2.0
9404250,1,1,0,0,1,0,0,1221,0.0,0.0,0.0,0.0,0.0,0.0,0.0,2,1,1,,,
104072,7,4,3,4,2,5,23,11,2.0,2.0,0.0,0.0,0.0,2.0,2.0,17,7,10,4.0,2.0,2.0
9608320,13,5,8,15,3,10,16,26,3.0,2.0,1.0,1.0,0.0,3.0,3.0,16,13,3,4.0,3.0,1.0
11247,26,6,20,68,0,26,196,0,22.0,5.0,17.0,58.0,0.0,22.0,167.0,46,26,20,34.0,19.0,15.0
9701366,10,7,3,3,0,10,17,57,6.0,4.0,2.0,2.0,0.0,6.0,8.0,16,10,6,2.0,2.0,0.0
9510259,24,6,18,47,3,21,38,1,14.0,2.0,12.0,30.0,0.0,14.0,14.0,31,24,7,5.0,4.0,1.0
9312337,2,1,1,1,2,0,0,126,1.0,1.0,0.0,0.0,1.0,0.0,0.0,2,2,0,2.0,2.0,0.0
9904428,17,3,14,33,1,16,72,42,5.0,1.0,4.0,8.0,0.0,5.0,25.0,35,17,18,14.0,5.0,9.0
111020,2,2,0,0,0,2,16,22,2.0,2.0,0.0,0.0,0.0,2.0,16.0,19,2,17,5.0,2.0,3.0
1264,28,19,9,13,7,21,99,0,7.0,3.0,4.0,7.0,0.0,7.0,40.0,80,28,52,3.0,1.0,2.0
205313,2,2,0,0,2,0,0,644,1.0,1.0,0.0,0.0,1.0,0.0,0.0,2,2,0,1.0,1.0,0.0
202218,16,7,9,12,3,13,50,0,5.0,2.0,3.0,3.0,0.0,5.0,26.0,47,16,31,15.0,5.0,10.0
9511223,4,2,2,2,2,2,2,122,,,,,,,,5,4,1,,,
9812519,1,1,0,0,1,0,0,136,1.0,1.0,0.0,0.0,1.0,0.0,0.0,3,1,2,1.0,1.0,0.0
11121,26,9,17,39,8,18,67,2,2.0,1.0,1.0,1.0,0.0,2.0,11.0,49,26,23,15.0,2.0,13.0
9409442,15,5,10,16,9,6,7,13,11.0,3.0,8.0,14.0,8.0,3.0,3.0,18,15,3,3.0,2.0,1.0
9507449,28,9,19,34,18,10,10,59,9.0,2.0,7.0,12.0,9.0,0.0,0.0,29,28,1,7.0,7.0,0.0
12337,11,3,8,24,0,11,92,32,0.0,0.0,0.0,0.0,0.0,0.0,0.0,33,11,22,9.0,0.0,9.0
9504354,15,4,11,15,15,0,0,222,9.0,1.0,8.0,12.0,9.0,0.0,0.0,16,15,1,7.0,7.0,0.0
103237,3,2,1,1,0,3,4,343,2.0,1.0,1.0,1.0,2.0,0.0,0.0,8,3,5,2.0,2.0,0.0
9911419,4,3,1,1,1,3,10,48,1.0,1.0,0.0,0.0,0.0,1.0,1.0,32,4,28,4.0,0.0,4.0
9509274,17,4,13,42,8,9,20,33,12.0,3.0,9.0,32.0,4.0,8.0,13.0,22,17,5,11.0,9.0,2.0
9407292,31,5,26,99,4,27,47,35,19.0,3.0,16.0,64.0,3.0,16.0,20.0,37,31,6,14.0,13.0,1.0
5236,16,9,7,12,1,15,75,2,5.0,2.0,3.0,4.0,1.0,4.0,8.0,38,16,22,7.0,4.0,3.0
9907518,14,11,3,6,3,11,27,5,1.0,1.0,0.0,0.0,0.0,1.0,1.0,24,14,10,4.0,2.0,2.0
9707237,1,1,0,0,0,1,2,16,1.0,1.0,0.0,0.0,1.0,0.0,0.0,10,1,9,1.0,0.0,1.0
203178,3,2,1,1,0,3,9,87,2.0,1.0,1.0,1.0,0.0,2.0,4.0,16,3,13,7.0,2.0,5.0
5240,2,2,0,0,0,2,6,152,0.0,0.0,0.0,0.0,0.0,0.0,0.0,14,2,12,2.0,0.0,2.0
9907460,20,7,13,44,2,18,287,15,15.0,3.0,12.0,40.0,0.0,15.0,267.0,65,20,45,36.0,8.0,28.0
9903494,3,3,0,0,2,1,2,141,0.0,0.0,0.0,0.0,0.0,0.0,0.0,8,3,5,2.0,0.0,2.0
9710351,2,2,0,0,2,0,0,33,0.0,0.0,0.0,0.0,0.0,0.0,0.0,17,2,15,,,
9508389,3,3,0,0,2,1,9,58,0.0,0.0,0.0,0.0,0.0,0.0,0.0,17,3,14,3.0,0.0,3.0
9304232,22,6,16,39,22,0,0,27,5.0,5.0,0.0,0.0,5.0,0.0,0.0,22,22,0,7.0,7.0,0.0
9610524,2,2,0,0,0,2,5,27,0.0,0.0,0.0,0.0,0.0,0.0,0.0,6,2,4,,,
110386,2,2,0,0,1,1,1,106,,,,,,,,4,2,2,,,
109017,15,6,9,18,1,14,74,0,9.0,3.0,6.0,13.0,0.0,9.0,48.0,45,15,30,7.0,2.0,5.0
9702207,10,4,6,6,6,4,14,29,2.0,2.0,0.0,0.0,0.0,2.0,6.0,28,10,18,5.0,2.0,3.0
202074,11,4,7,22,1,10,52,3,5.0,2.0,3.0,7.0,0.0,5.0,6.0,38,11,27,7.0,5.0,2.0
9708216,12,2,10,14,3,9,21,3,7.0,1.0,6.0,7.0,1.0,6.0,6.0,17,12,5,7.0,6.0,1.0
6038,1,1,0,0,1,0,0,224,1.0,1.0,0.0,0.0,1.0,0.0,0.0,4,1,3,2.0,0.0,2.0
107201,13,4,9,23,0,13,101,37,5.0,1.0,4.0,5.0,0.0,5.0,27.0,31,13,18,11.0,5.0,6.0
107216,5,5,0,0,0,5,27,5,1.0,1.0,0.0,0.0,0.0,1.0,3.0,28,5,23,6.0,1.0,5.0
110173,13,3,10,35,1,12,40,47,12.0,3.0,9.0,33.0,0.0,12.0,40.0,23,13,10,17.0,11.0,6.0
1110,2,2,0,0,0,2,4,47,0.0,0.0,0.0,0.0,0.0,0.0,0.0,17,2,15,1.0,0.0,1.0
2255,6,4,2,2,0,6,31,50,3.0,2.0,1.0,1.0,0.0,3.0,11.0,29,6,23,13.0,4.0,9.0
201250,4,3,1,1,1,3,15,3,2.0,1.0,1.0,1.0,0.0,2.0,6.0,17,4,13,6.0,2.0,4.0
9412372,6,1,5,10,0,6,17,10,6.0,1.0,5.0,10.0,0.0,6.0,10.0,13,6,7,6.0,5.0,1.0
9908257,24,6,18,42,2,22,103,50,10.0,2.0,8.0,14.0,0.0,10.0,25.0,41,24,17,15.0,11.0,4.0
9705207,9,6,3,5,1,8,16,264,5.0,3.0,2.0,2.0,0.0,5.0,11.0,13,9,4,2.0,2.0,0.0
1225,2,2,0,0,0,2,8,2,2.0,2.0,0.0,0.0,0.0,2.0,4.0,10,2,8,6.0,2.0,4.0
9601309,27,4,23,71,3,24,99,100,22.0,5.0,17.0,55.0,2.0,20.0,90.0,43,27,16,24.0,15.0,9.0
9502393,6,6,0,0,0,6,8,13,1.0,1.0,0.0,0.0,1.0,0.0,0.0,30,6,24,5.0,0.0,5.0
12372,2,2,0,0,0,2,4,126,2.0,2.0,0.0,0.0,0.0,2.0,4.0,6,2,4,4.0,1.0,3.0
112140,11,3,8,18,0,11,84,11,9.0,3.0,6.0,11.0,0.0,9.0,75.0,30,11,19,3.0,1.0,2.0
9902302,6,6,0,0,1,5,13,11,1.0,1.0,0.0,0.0,1.0,0.0,0.0,23,6,17,1.0,1.0,0.0
9709453,24,6,18,59,4,20,74,13,17.0,3.0,14.0,48.0,3.0,14.0,54.0,35,24,11,18.0,11.0,7.0
9609472,9,2,7,12,2,7,31,95,6.0,2.0,4.0,8.0,0.0,6.0,24.0,16,9,7,10.0,6.0,4.0
9802449,2,1,1,1,0,2,4,44,0.0,0.0,0.0,0.0,0.0,0.0,0.0,5,2,3,1.0,0.0,1.0
9502248,4,3,1,1,0,4,21,6,4.0,3.0,1.0,1.0,0.0,4.0,20.0,16,4,12,1.0,0.0,1.0
9409445,5,3,2,2,3,2,6,237,3.0,2.0,1.0,1.0,1.0,2.0,6.0,10,5,5,6.0,2.0,4.0
9902295,3,3,0,0,0,3,17,17,0.0,0.0,0.0,0.0,0.0,0.0,0.0,56,3,53,8.0,0.0,8.0
9708405,8,6,2,3,0,8,43,62,5.0,4.0,1.0,2.0,0.0,5.0,34.0,40,8,32,14.0,5.0,9.0
203224,5,3,2,2,1,4,25,25,2.0,1.0,1.0,1.0,0.0,2.0,15.0,25,5,20,7.0,2.0,5.0
9709208,9,5,4,8,0,9,32,102,7.0,3.0,4.0,8.0,0.0,7.0,20.0,19,9,10,11.0,7.0,4.0
9305328,3,3,0,0,3,0,0,785,1.0,1.0,0.0,0.0,1.0,0.0,0.0,3,3,0,1.0,1.0,0.0
9710547,19,7,12,14,5,14,69,57,13.0,4.0,9.0,10.0,1.0,12.0,49.0,33,19,14,13.0,9.0,4.0
1057,5,3,2,3,3,2,4,251,1.0,1.0,0.0,0.0,0.0,1.0,2.0,9,5,4,5.0,1.0,4.0
9709448,2,2,0,0,0,2,7,1,1.0,1.0,0.0,0.0,0.0,1.0,2.0,18,2,16,3.0,0.0,3.0
9410409,8,5,3,8,0,8,16,25,5.0,2.0,3.0,8.0,3.0,2.0,2.0,15,8,7,2.0,1.0,1.0
1333,5,2,3,3,1,4,15,42,1.0,1.0,0.0,0.0,0.0,1.0,3.0,14,5,9,2.0,0.0,2.0
10205,19,1,18,111,0,19,132,109,19.0,1.0,18.0,111.0,0.0,19.0,130.0,35,19,16,28.0,19.0,9.0
5301,8,6,2,5,2,6,33,109,6.0,4.0,2.0,5.0,0.0,6.0,29.0,18,8,10,2.0,0.0,2.0
9804420,10,3,7,9,5,5,19,62,6.0,2.0,4.0,5.0,3.0,3.0,6.0,19,10,9,8.0,6.0,2.0
9908258,5,2,3,6,1,4,11,12,4.0,1.0,3.0,6.0,0.0,4.0,4.0,9,5,4,7.0,4.0,3.0
9504352,11,7,4,5,11,0,0,25,5.0,4.0,1.0,1.0,5.0,0.0,0.0,11,11,0,3.0,3.0,0.0
109167,3,3,0,0,0,3,18,39,2.0,2.0,0.0,0.0,0.0,2.0,7.0,16,3,13,3.0,0.0,3.0
9809466,8,5,3,3,0,8,125,0,7.0,4.0,3.0,3.0,0.0,7.0,107.0,39,8,31,27.0,5.0,22.0
9609422,3,3,0,0,1,2,5,71,1.0,1.0,0.0,0.0,0.0,1.0,3.0,14,3,11,3.0,1.0,2.0
9406321,5,3,2,5,4,1,2,36,5.0,3.0,2.0,5.0,4.0,1.0,1.0,7,5,2,3.0,3.0,0.0
9237,45,21,24,64,9,36,163,11,18.0,4.0,14.0,43.0,0.0,18.0,101.0,60,45,15,5.0,4.0,1.0
9810407,1,1,0,0,0,1,1,6,1.0,1.0,0.0,0.0,1.0,0.0,0.0,17,1,16,4.0,0.0,4.0
9804451,22,4,18,70,0,22,122,5,17.0,3.0,14.0,50.0,0.0,17.0,64.0,52,22,30,16.0,9.0,7.0
9511421,6,4,2,3,2,4,12,75,0.0,0.0,0.0,0.0,0.0,0.0,0.0,36,6,30,11.0,0.0,11.0
9307296,7,4,3,3,7,0,0,74,2.0,1.0,1.0,1.0,2.0,0.0,0.0,7,7,0,2.0,2.0,0.0
9607306,25,6,19,49,6,19,64,41,17.0,3.0,14.0,32.0,3.0,14.0,28.0,40,25,15,16.0,11.0,5.0
9502359,21,8,13,41,3,18,24,49,9.0,3.0,6.0,24.0,3.0,6.0,6.0,31,21,10,9.0,8.0,1.0
9408223,12,7,5,7,6,6,13,116,4.0,3.0,1.0,1.0,0.0,4.0,7.0,19,12,7,4.0,4.0,0.0
9602336,20,4,16,75,2,18,43,137,18.0,3.0,15.0,73.0,0.0,18.0,43.0,23,20,3,20.0,17.0,3.0
109181,11,4,7,15,0,11,61,1,9.0,2.0,7.0,15.0,0.0,9.0,37.0,24,11,13,3.0,3.0,0.0
210399,1,1,0,0,0,1,3,24,0.0,0.0,0.0,0.0,0.0,0.0,0.0,4,1,3,4.0,1.0,3.0
9908222,14,6,8,15,7,7,10,106,4.0,1.0,3.0,5.0,0.0,4.0,4.0,16,14,2,5.0,4.0,1.0
9812346,12,2,10,22,3,9,17,121,9.0,1.0,8.0,20.0,3.0,6.0,6.0,18,12,6,9.0,8.0,1.0
9812458,7,2,5,10,3,4,7,202,5.0,1.0,4.0,9.0,2.0,3.0,5.0,21,7,14,7.0,5.0,2.0
9302274,10,5,5,19,3,7,7,124,7.0,2.0,5.0,18.0,0.0,7.0,7.0,11,10,1,8.0,7.0,1.0
106022,4,3,1,2,0,4,13,282,2.0,1.0,1.0,1.0,0.0,2.0,7.0,19,4,15,4.0,2.0,2.0
9901374,12,12,0,0,9,3,5,13,5.0,5.0,0.0,0.0,5.0,0.0,0.0,17,12,5,4.0,4.0,0.0
205012,2,1,1,1,0,2,6,239,2.0,1.0,1.0,1.0,0.0,2.0,6.0,5,2,3,5.0,2.0,3.0
9703308,4,4,0,0,1,3,10,14,1.0,1.0,0.0,0.0,1.0,0.0,0.0,11,4,7,1.0,1.0,0.0
9311,4,1,3,5,0,4,11,9,4.0,1.0,3.0,5.0,1.0,3.0,3.0,9,4,5,1.0,1.0,0.0
103164,9,5,4,4,4,5,14,8,1.0,1.0,0.0,0.0,0.0,1.0,5.0,34,9,25,10.0,0.0,10.0
9407367,1,1,0,0,0,1,2,41,0.0,0.0,0.0,0.0,0.0,0.0,0.0,4,1,3,2.0,0.0,2.0
4092,4,3,1,1,2,2,11,86,2.0,2.0,0.0,0.0,1.0,1.0,4.0,17,4,13,2.0,1.0,1.0
9807481,0,0,0,0,0,0,0,18,0.0,0.0,0.0,0.0,0.0,0.0,0.0,19,0,19,2.0,0.0,2.0
9706338,4,3,1,1,2,2,4,93,2.0,2.0,0.0,0.0,2.0,0.0,0.0,9,4,5,2.0,2.0,0.0
9605262,3,2,1,1,3,0,0,324,1.0,1.0,0.0,0.0,1.0,0.0,0.0,4,3,1,1.0,1.0,0.0
9901353,1,1,0,0,0,1,3,73,0.0,0.0,0.0,0.0,0.0,0.0,0.0,26,1,25,17.0,0.0,17.0
9908417,9,2,7,9,0,9,61,46,6.0,1.0,5.0,7.0,0.0,6.0,35.0,25,9,16,11.0,2.0,9.0
9906505,4,2,2,3,3,1,1,133,1.0,1.0,0.0,0.0,1.0,0.0,0.0,9,4,5,1.0,1.0,0.0
106206,7,2,5,9,0,7,38,27,4.0,1.0,3.0,4.0,0.0,4.0,32.0,18,7,11,10.0,5.0,5.0
9603377,35,5,30,130,9,26,39,130,27.0,3.0,24.0,101.0,6.0,21.0,32.0,37,35,2,19.0,17.0,2.0
9710461,3,2,1,1,2,1,1,516,1.0,1.0,0.0,0.0,0.0,1.0,1.0,7,3,4,3.0,2.0,1.0
9908408,4,4,0,0,2,2,15,98,1.0,1.0,0.0,0.0,0.0,1.0,10.0,17,4,13,11.0,1.0,10.0
9906432,7,3,4,7,2,5,26,175,5.0,1.0,4.0,7.0,0.0,5.0,22.0,15,7,8,11.0,5.0,6.0
101170,10,5,5,9,1,9,70,3,6.0,2.0,4.0,7.0,0.0,6.0,60.0,29,10,19,11.0,4.0,7.0
3284,4,1,3,4,0,4,19,56,4.0,1.0,3.0,4.0,0.0,4.0,17.0,24,4,20,3.0,0.0,3.0
9302287,2,1,1,1,0,2,3,56,,,,,,,,4,2,2,,,
9904488,9,1,8,11,0,9,84,69,5.0,1.0,4.0,5.0,0.0,5.0,29.0,34,9,25,13.0,5.0,8.0
202088,17,3,14,35,0,17,108,193,13.0,1.0,12.0,33.0,0.0,13.0,69.0,44,17,27,19.0,13.0,6.0
9905317,7,2,5,7,7,0,0,184,6.0,2.0,4.0,6.0,6.0,0.0,0.0,14,7,7,5.0,5.0,0.0
9302310,3,3,0,0,3,0,0,205,1.0,1.0,0.0,0.0,1.0,0.0,0.0,4,3,1,1.0,1.0,0.0
9809444,4,4,0,0,0,4,18,57,3.0,3.0,0.0,0.0,0.0,3.0,16.0,17,4,13,9.0,2.0,7.0
9509206,3,3,0,0,1,2,4,236,0.0,0.0,0.0,0.0,0.0,0.0,0.0,8,3,5,1.0,0.0,1.0
9510281,2,2,0,0,0,2,5,265,0.0,0.0,0.0,0.0,0.0,0.0,0.0,8,2,6,1.0,0.0,1.0
9512366,17,9,8,16,0,17,77,69,13.0,6.0,7.0,15.0,0.0,13.0,70.0,30,17,13,13.0,4.0,9.0
302232,0,0,0,0,0,0,0,27,0.0,0.0,0.0,0.0,0.0,0.0,0.0,13,0,13,7.0,0.0,7.0
101323,9,3,6,19,0,9,74,8,9.0,3.0,6.0,19.0,0.0,9.0,71.0,27,9,18,20.0,8.0,12.0
9703334,2,2,0,0,0,2,4,142,2.0,2.0,0.0,0.0,2.0,0.0,0.0,4,2,2,1.0,0.0,1.0
9302206,22,12,10,14,22,0,0,297,7.0,4.0,3.0,4.0,7.0,0.0,0.0,22,22,0,3.0,3.0,0.0
2154,9,6,3,3,8,1,1,99,3.0,3.0,0.0,0.0,2.0,1.0,1.0,18,9,9,3.0,2.0,1.0
108055,10,6,4,4,3,7,18,14,1.0,1.0,0.0,0.0,0.0,1.0,2.0,26,10,16,5.0,2.0,3.0
9053,17,3,14,44,3,14,26,28,10.0,1.0,9.0,27.0,2.0,8.0,16.0,27,17,10,10.0,8.0,2.0
110407,6,3,3,4,0,6,61,19,5.0,2.0,3.0,4.0,0.0,5.0,52.0,40,6,34,30.0,4.0,26.0
9809249,20,5,15,67,2,18,82,49,15.0,5.0,10.0,44.0,0.0,15.0,53.0,38,20,18,16.0,11.0,5.0
107102,4,3,1,1,1,3,5,74,2.0,2.0,0.0,0.0,0.0,2.0,4.0,13,4,9,4.0,2.0,2.0
9806419,16,8,8,10,3,13,22,217,5.0,5.0,0.0,0.0,0.0,5.0,10.0,24,16,8,7.0,7.0,0.0
103243,7,6,1,1,2,5,7,42,0.0,0.0,0.0,0.0,0.0,0.0,0.0,32,7,25,7.0,0.0,7.0
105054,3,2,1,1,0,3,25,73,2.0,2.0,0.0,0.0,0.0,2.0,9.0,17,3,14,9.0,2.0,7.0
9905208,2,2,0,0,0,2,10,42,0.0,0.0,0.0,0.0,0.0,0.0,0.0,25,2,23,14.0,0.0,14.0
9802418,9,5,4,6,4,5,12,274,3.0,2.0,1.0,1.0,3.0,0.0,0.0,13,9,4,3.0,3.0,0.0
9611241,1,1,0,0,0,1,3,23,0.0,0.0,0.0,0.0,0.0,0.0,0.0,7,1,6,1.0,0.0,1.0
9505239,9,1,8,11,2,7,20,33,7.0,1.0,6.0,9.0,1.0,6.0,17.0,15,9,6,4.0,2.0,2.0
9403248,18,5,13,28,13,5,8,163,9.0,2.0,7.0,12.0,7.0,2.0,2.0,21,18,3,6.0,6.0,0.0
11048,12,4,8,14,0,12,111,2,8.0,3.0,5.0,7.0,0.0,8.0,47.0,36,12,24,19.0,8.0,11.0
9709337,3,3,0,0,3,0,0,146,1.0,1.0,0.0,0.0,1.0,0.0,0.0,4,3,1,1.0,1.0,0.0
103009,6,2,4,5,0,6,12,92,3.0,1.0,2.0,2.0,0.0,3.0,6.0,11,6,5,6.0,3.0,3.0
101224,28,19,9,10,3,25,188,9,1.0,1.0,0.0,0.0,0.0,1.0,8.0,207,28,179,39.0,0.0,39.0
9912379,28,6,22,76,3,25,193,9,22.0,2.0,20.0,72.0,0.0,22.0,171.0,53,28,25,33.0,15.0,18.0
9805357,3,3,0,0,0,3,14,13,2.0,2.0,0.0,0.0,0.0,2.0,6.0,14,3,11,2.0,1.0,1.0
9609484,2,2,0,0,0,2,4,6,0.0,0.0,0.0,0.0,0.0,0.0,0.0,8,2,6,,,
9812210,3,2,1,1,0,3,10,18,1.0,1.0,0.0,0.0,1.0,0.0,0.0,12,3,9,1.0,0.0,1.0
9707238,1,1,0,0,1,0,0,17,0.0,0.0,0.0,0.0,0.0,0.0,0.0,24,1,23,1.0,0.0,1.0
9712349,13,9,4,5,0,13,65,1,4.0,2.0,2.0,2.0,0.0,4.0,10.0,34,13,21,11.0,2.0,9.0
9901309,3,3,0,0,1,2,7,69,2.0,2.0,0.0,0.0,0.0,2.0,7.0,8,3,5,,,
9907337,8,5,3,3,0,8,48,40,0.0,0.0,0.0,0.0,0.0,0.0,0.0,47,8,39,16.0,0.0,16.0
211281,1,1,0,0,0,1,5,22,0.0,0.0,0.0,0.0,0.0,0.0,0.0,13,1,12,7.0,1.0,6.0
9908213,4,1,3,3,0,4,21,40,4.0,1.0,3.0,3.0,0.0,4.0,20.0,22,4,18,12.0,2.0,10.0
9409340,6,6,0,0,2,4,8,25,2.0,2.0,0.0,0.0,1.0,1.0,2.0,10,6,4,5.0,2.0,3.0
9510359,21,4,17,51,4,17,36,48,18.0,4.0,14.0,40.0,1.0,17.0,33.0,26,21,5,14.0,11.0,3.0
11372,10,7,3,5,1,9,21,9,6.0,4.0,2.0,3.0,0.0,6.0,10.0,20,10,10,3.0,1.0,2.0
5218,20,5,15,37,0,20,100,8,6.0,1.0,5.0,9.0,0.0,6.0,27.0,76,20,56,14.0,2.0,12.0
9506262,7,3,4,7,7,0,0,50,5.0,3.0,2.0,4.0,5.0,0.0,0.0,7,7,0,5.0,5.0,0.0
9704417,9,4,5,8,6,3,3,141,5.0,3.0,2.0,3.0,5.0,0.0,0.0,12,9,3,6.0,6.0,0.0
9810249,5,1,4,6,1,4,10,70,4.0,1.0,3.0,4.0,1.0,3.0,5.0,17,5,12,3.0,1.0,2.0
106088,7,4,3,8,1,6,44,0,6.0,3.0,3.0,8.0,0.0,6.0,44.0,16,7,9,1.0,1.0,0.0
9812258,24,16,8,10,11,13,25,59,9.0,5.0,4.0,5.0,5.0,4.0,8.0,32,24,8,4.0,3.0,1.0
9609269,3,2,1,2,3,0,0,264,2.0,2.0,0.0,0.0,2.0,0.0,0.0,4,3,1,,,
9506472,7,6,1,1,0,7,19,35,0.0,0.0,0.0,0.0,0.0,0.0,0.0,21,7,14,5.0,0.0,5.0
9802396,5,4,1,2,1,4,13,31,4.0,3.0,1.0,2.0,0.0,4.0,8.0,10,5,5,6.0,3.0,3.0
210359,5,5,0,0,1,4,9,0,0.0,0.0,0.0,0.0,0.0,0.0,0.0,58,5,53,15.0,0.0,15.0
10026,7,3,4,5,2,5,18,381,6.0,2.0,4.0,5.0,1.0,5.0,13.0,13,7,6,8.0,4.0,4.0
203109,2,2,0,0,0,2,14,3,0.0,0.0,0.0,0.0,0.0,0.0,0.0,44,2,42,4.0,0.0,4.0
9912216,27,8,19,38,8,19,68,11,6.0,4.0,2.0,3.0,3.0,3.0,3.0,50,27,23,10.0,8.0,2.0
9902326,15,4,11,20,1,14,88,83,10.0,1.0,9.0,16.0,0.0,10.0,62.0,43,15,28,18.0,8.0,10.0
12004,8,5,3,4,0,8,32,30,1.0,1.0,0.0,0.0,0.0,1.0,5.0,25,8,17,7.0,1.0,6.0
9307362,8,7,1,1,8,0,0,418,2.0,2.0,0.0,0.0,2.0,0.0,0.0,8,8,0,2.0,2.0,0.0
207064,0,0,0,0,0,0,0,1284,0.0,0.0,0.0,0.0,0.0,0.0,0.0,3,0,3,2.0,0.0,2.0
205092,6,5,1,2,2,4,4,192,0.0,0.0,0.0,0.0,0.0,0.0,0.0,27,6,21,9.0,0.0,9.0
206226,2,1,1,1,1,1,5,17,1.0,1.0,0.0,0.0,0.0,1.0,1.0,12,2,10,2.0,0.0,2.0
211271,5,3,2,3,0,5,24,29,1.0,1.0,0.0,0.0,0.0,1.0,4.0,22,5,17,5.0,0.0,5.0
4242,1,1,0,0,1,0,0,92,0.0,0.0,0.0,0.0,0.0,0.0,0.0,9,1,8,3.0,0.0,3.0
201211,8,4,4,8,0,8,40,119,6.0,2.0,4.0,8.0,0.0,6.0,25.0,23,8,15,11.0,6.0,5.0
103155,7,2,5,9,0,7,50,30,1.0,1.0,0.0,0.0,0.0,1.0,5.0,36,7,29,9.0,3.0,6.0
9909313,5,5,0,0,2,3,4,30,0.0,0.0,0.0,0.0,0.0,0.0,0.0,10,5,5,3.0,1.0,2.0
9806222,4,3,1,1,2,2,6,55,1.0,1.0,0.0,0.0,0.0,1.0,4.0,20,4,16,2.0,0.0,2.0
106162,6,1,5,5,0,6,28,9,5.0,1.0,4.0,4.0,0.0,5.0,9.0,15,6,9,7.0,5.0,2.0
1248,5,3,2,2,1,4,12,86,1.0,1.0,0.0,0.0,0.0,1.0,1.0,15,5,10,1.0,1.0,0.0
9302314,5,4,1,1,3,2,2,15,1.0,1.0,0.0,0.0,1.0,0.0,0.0,7,5,2,1.0,1.0,0.0
9903403,11,2,9,18,1,10,26,25,5.0,1.0,4.0,9.0,0.0,5.0,17.0,19,11,8,6.0,4.0,2.0
9712275,1,1,0,0,1,0,0,36,0.0,0.0,0.0,0.0,0.0,0.0,0.0,50,1,49,38.0,0.0,38.0
9811451,5,5,0,0,0,5,18,99,1.0,1.0,0.0,0.0,0.0,1.0,2.0,22,5,17,8.0,0.0,8.0
9910206,9,1,8,13,0,9,20,30,4.0,4.0,0.0,0.0,0.0,4.0,7.0,26,9,17,12.0,9.0,3.0
12199,3,2,1,1,0,3,11,4,2.0,2.0,0.0,0.0,0.0,2.0,4.0,15,3,12,7.0,2.0,5.0
2003,6,4,2,5,1,5,33,174,5.0,3.0,2.0,5.0,0.0,5.0,22.0,25,6,19,12.0,5.0,7.0
207372,0,0,0,0,0,0,0,59,0.0,0.0,0.0,0.0,0.0,0.0,0.0,17,0,17,5.0,0.0,5.0
9403302,8,5,3,4,2,6,13,133,2.0,2.0,0.0,0.0,0.0,2.0,4.0,12,8,4,2.0,2.0,0.0
9911523,13,2,11,23,0,13,89,11,13.0,2.0,11.0,23.0,0.0,13.0,71.0,27,13,14,1.0,0.0,1.0
110267,9,5,4,6,1,8,18,20,4.0,4.0,0.0,0.0,1.0,3.0,3.0,13,9,4,3.0,2.0,1.0
103187,3,1,2,2,0,3,23,2,3.0,1.0,2.0,2.0,0.0,3.0,23.0,16,3,13,11.0,3.0,8.0
107204,4,3,1,1,0,4,64,12,3.0,2.0,1.0,1.0,0.0,3.0,36.0,59,4,55,14.0,2.0,12.0
201297,30,12,18,38,2,28,186,23,14.0,7.0,7.0,14.0,0.0,14.0,94.0,45,30,15,19.0,8.0,11.0
103037,5,3,2,3,3,2,2,126,1.0,1.0,0.0,0.0,0.0,1.0,1.0,7,5,2,1.0,1.0,0.0
9802438,4,2,2,2,0,4,13,47,4.0,2.0,2.0,2.0,1.0,3.0,10.0,14,4,10,6.0,2.0,4.0
9809380,1,1,0,0,0,1,3,22,1.0,1.0,0.0,0.0,0.0,1.0,3.0,11,1,10,6.0,1.0,5.0
210192,10,8,2,2,2,8,72,0,2.0,2.0,0.0,0.0,0.0,2.0,8.0,131,10,121,8.0,0.0,8.0
6029,5,4,1,1,0,5,18,3,0.0,0.0,0.0,0.0,0.0,0.0,0.0,21,5,16,5.0,0.0,5.0
208209,20,17,3,3,0,20,364,4,5.0,5.0,0.0,0.0,0.0,5.0,85.0,283,20,263,33.0,1.0,32.0
9612361,3,3,0,0,2,1,1,4,0.0,0.0,0.0,0.0,0.0,0.0,0.0,18,3,15,1.0,0.0,1.0
9903488,5,4,1,1,0,5,33,9,5.0,4.0,1.0,1.0,0.0,5.0,32.0,38,5,33,29.0,1.0,28.0
9710408,1,1,0,0,0,1,2,6,0.0,0.0,0.0,0.0,0.0,0.0,0.0,14,1,13,3.0,1.0,2.0
9501263,29,5,24,106,29,0,0,82,24.0,3.0,21.0,95.0,24.0,0.0,0.0,29,29,0,14.0,14.0,0.0
204135,8,5,3,4,0,8,31,18,2.0,2.0,0.0,0.0,2.0,0.0,0.0,21,8,13,3.0,3.0,0.0
12314,4,4,0,0,2,2,4,29,1.0,1.0,0.0,0.0,0.0,1.0,3.0,13,4,9,4.0,1.0,3.0
4185,5,3,2,3,2,3,5,34,1.0,1.0,0.0,0.0,1.0,0.0,0.0,7,5,2,1.0,1.0,0.0
9610487,2,2,0,0,2,0,0,68,0.0,0.0,0.0,0.0,0.0,0.0,0.0,3,2,1,1.0,0.0,1.0
9905530,3,3,0,0,0,3,13,27,0.0,0.0,0.0,0.0,0.0,0.0,0.0,15,3,12,3.0,0.0,3.0
302138,0,0,0,0,0,0,0,118,0.0,0.0,0.0,0.0,0.0,0.0,0.0,12,0,12,7.0,0.0,7.0
5069,16,8,8,20,1,15,85,7,9.0,3.0,6.0,12.0,0.0,9.0,40.0,43,16,27,12.0,6.0,6.0
9210278,3,2,1,1,0,3,5,15,1.0,1.0,0.0,0.0,0.0,1.0,1.0,6,3,3,3.0,2.0,1.0
9610318,2,2,0,0,1,1,2,365,0.0,0.0,0.0,0.0,0.0,0.0,0.0,7,2,5,2.0,0.0,2.0
104114,2,1,1,1,0,2,22,2,2.0,1.0,1.0,1.0,0.0,2.0,8.0,26,2,24,5.0,0.0,5.0
12037,2,2,0,0,0,2,10,39,1.0,1.0,0.0,0.0,0.0,1.0,3.0,11,2,9,,,
9603303,13,5,8,17,2,11,19,167,8.0,4.0,4.0,5.0,1.0,7.0,14.0,17,13,4,10.0,6.0,4.0
9410344,2,1,1,1,0,2,2,1492,,,,,,,,3,2,1,,,
109179,3,3,0,0,0,3,37,2,3.0,3.0,0.0,0.0,0.0,3.0,29.0,25,3,22,3.0,1.0,2.0
9406272,4,3,1,1,2,2,14,34,2.0,2.0,0.0,0.0,0.0,2.0,8.0,15,4,11,6.0,2.0,4.0
8108,2,2,0,0,0,2,10,14,0.0,0.0,0.0,0.0,0.0,0.0,0.0,23,2,21,4.0,0.0,4.0
9901264,6,4,2,5,0,6,40,29,1.0,1.0,0.0,0.0,0.0,1.0,7.0,29,6,23,7.0,4.0,3.0
9510227,4,2,2,2,1,3,3,7,3.0,2.0,1.0,1.0,2.0,1.0,1.0,14,4,10,4.0,2.0,2.0
210170,0,0,0,0,0,0,0,2,0.0,0.0,0.0,0.0,0.0,0.0,0.0,21,0,21,4.0,0.0,4.0
9906518,3,3,0,0,0,3,5,47,3.0,3.0,0.0,0.0,0.0,3.0,5.0,18,3,15,3.0,0.0,3.0
9703395,5,5,0,0,0,5,28,68,2.0,2.0,0.0,0.0,0.0,2.0,11.0,19,5,14,10.0,3.0,7.0
9909436,21,7,14,28,0,21,50,25,9.0,2.0,7.0,15.0,0.0,9.0,16.0,31,21,10,7.0,4.0,3.0
9707539,2,1,1,1,0,2,2,292,2.0,1.0,1.0,1.0,0.0,2.0,2.0,5,2,3,3.0,2.0,1.0
205101,1,1,0,0,0,1,7,73,0.0,0.0,0.0,0.0,0.0,0.0,0.0,19,1,18,4.0,1.0,3.0
9610440,10,2,8,12,2,8,17,31,5.0,2.0,3.0,4.0,5.0,0.0,0.0,14,10,4,4.0,4.0,0.0
9904431,6,2,4,6,6,0,0,65,6.0,2.0,4.0,6.0,6.0,0.0,0.0,6,6,0,1.0,1.0,0.0
9707400,4,3,1,1,4,0,0,332,0.0,0.0,0.0,0.0,0.0,0.0,0.0,9,4,5,2.0,0.0,2.0
9205218,1,1,0,0,1,0,0,1596,1.0,1.0,0.0,0.0,1.0,0.0,0.0,1,1,0,1.0,1.0,0.0
9306281,1,1,0,0,1,0,0,1504,,,,,,,,2,1,1,,,
5126,3,1,2,2,0,3,8,217,2.0,1.0,1.0,1.0,0.0,2.0,6.0,8,3,5,6.0,2.0,4.0
9508210,5,3,2,2,2,3,3,100,1.0,1.0,0.0,0.0,0.0,1.0,1.0,7,5,2,1.0,1.0,0.0
204165,3,3,0,0,0,3,9,106,2.0,2.0,0.0,0.0,0.0,2.0,2.0,10,3,7,4.0,2.0,2.0
9910499,7,7,0,0,0,7,42,2,2.0,2.0,0.0,0.0,0.0,2.0,4.0,29,7,22,4.0,2.0,2.0
9502368,7,2,5,6,7,0,0,77,5.0,1.0,4.0,5.0,5.0,0.0,0.0,7,7,0,5.0,5.0,0.0
9902282,5,4,1,2,0,5,9,131,3.0,3.0,0.0,0.0,0.0,3.0,5.0,15,5,10,4.0,3.0,1.0
106221,21,11,10,18,0,21,170,66,9.0,6.0,3.0,4.0,0.0,9.0,45.0,81,21,60,7.0,5.0,2.0
9806395,5,5,0,0,1,4,11,20,2.0,2.0,0.0,0.0,2.0,0.0,0.0,11,5,6,1.0,1.0,0.0
204111,8,2,6,9,1,7,26,0,2.0,2.0,0.0,0.0,0.0,2.0,7.0,26,8,18,9.0,4.0,5.0
111105,0,0,0,0,0,0,0,29,0.0,0.0,0.0,0.0,0.0,0.0,0.0,17,0,17,11.0,0.0,11.0
204280,8,2,6,15,2,6,14,4,4.0,2.0,2.0,5.0,0.0,4.0,4.0,16,8,8,8.0,6.0,2.0
12202,3,3,0,0,2,1,3,4,0.0,0.0,0.0,0.0,0.0,0.0,0.0,6,3,3,1.0,0.0,1.0
112039,5,3,2,2,0,5,57,32,4.0,2.0,2.0,2.0,0.0,4.0,45.0,35,5,30,5.0,0.0,5.0
3188,11,4,7,17,0,11,101,7,9.0,2.0,7.0,17.0,0.0,9.0,75.0,38,11,27,20.0,8.0,12.0
9607453,1,1,0,0,0,1,1,55,1.0,1.0,0.0,0.0,1.0,0.0,0.0,7,1,6,,,
103342,6,3,3,6,0,6,23,37,4.0,1.0,3.0,6.0,0.0,4.0,7.0,18,6,12,5.0,4.0,1.0
8200,4,2,2,2,1,3,4,47,3.0,1.0,2.0,2.0,1.0,2.0,2.0,9,4,5,1.0,1.0,0.0
112036,5,2,3,4,0,5,24,108,5.0,2.0,3.0,4.0,0.0,5.0,21.0,20,5,15,9.0,4.0,5.0
9505407,10,3,7,13,2,8,14,188,8.0,4.0,4.0,10.0,2.0,6.0,6.0,12,10,2,7.0,6.0,1.0
9712316,3,3,0,0,3,0,0,522,2.0,2.0,0.0,0.0,2.0,0.0,0.0,6,3,3,2.0,1.0,1.0
110221,9,4,5,5,0,9,98,45,7.0,3.0,4.0,4.0,0.0,7.0,51.0,49,9,40,19.0,6.0,13.0
9908315,4,4,0,0,1,3,8,44,1.0,1.0,0.0,0.0,1.0,0.0,0.0,11,4,7,2.0,1.0,1.0
108186,6,2,4,7,0,6,18,59,4.0,1.0,3.0,4.0,0.0,4.0,12.0,16,6,10,7.0,1.0,6.0
110282,2,1,1,1,0,2,11,10,1.0,1.0,0.0,0.0,0.0,1.0,3.0,11,2,9,6.0,1.0,5.0
9504315,2,2,0,0,1,1,1,34,1.0,1.0,0.0,0.0,1.0,0.0,0.0,10,2,8,2.0,1.0,1.0
7237,8,2,6,21,0,8,21,0,8.0,2.0,6.0,21.0,0.0,8.0,20.0,13,8,5,11.0,8.0,3.0
112210,5,5,0,0,0,5,38,5,3.0,3.0,0.0,0.0,0.0,3.0,17.0,21,5,16,9.0,3.0,6.0
102339,2,2,0,0,0,2,15,73,2.0,2.0,0.0,0.0,0.0,2.0,15.0,15,2,13,15.0,2.0,13.0
9611332,1,1,0,0,1,0,0,134,0.0,0.0,0.0,0.0,0.0,0.0,0.0,7,1,6,,,
9906504,6,2,4,5,2,4,7,133,2.0,1.0,1.0,1.0,2.0,0.0,0.0,19,6,13,3.0,2.0,1.0
9908298,7,4,3,4,3,4,18,58,1.0,1.0,0.0,0.0,0.0,1.0,1.0,22,7,15,2.0,0.0,2.0
9710481,0,0,0,0,0,0,0,41,0.0,0.0,0.0,0.0,0.0,0.0,0.0,9,0,9,1.0,0.0,1.0
9511293,3,2,1,1,3,0,0,103,2.0,1.0,1.0,1.0,2.0,0.0,0.0,5,3,2,3.0,1.0,2.0
9804455,5,2,3,3,0,5,20,17,4.0,1.0,3.0,3.0,3.0,1.0,2.0,19,5,14,8.0,4.0,4.0
9509265,3,2,1,1,3,0,0,300,2.0,1.0,1.0,1.0,2.0,0.0,0.0,5,3,2,2.0,2.0,0.0
206309,2,2,0,0,0,2,8,27,,,,,,,,7,2,5,,,
9604397,1,1,0,0,0,1,4,27,1.0,1.0,0.0,0.0,1.0,0.0,0.0,7,1,6,2.0,1.0,1.0
110183,2,2,0,0,0,2,13,69,0.0,0.0,0.0,0.0,0.0,0.0,0.0,45,2,43,19.0,0.0,19.0
205219,4,1,3,3,0,4,44,20,4.0,1.0,3.0,3.0,0.0,4.0,44.0,18,4,14,10.0,3.0,7.0
9508327,5,4,1,1,1,4,13,110,3.0,2.0,1.0,1.0,0.0,3.0,9.0,9,5,4,4.0,2.0,2.0
108039,5,1,4,5,0,5,11,750,4.0,2.0,2.0,2.0,0.0,4.0,9.0,9,5,4,6.0,3.0,3.0
9402217,3,3,0,0,3,0,0,81,2.0,2.0,0.0,0.0,2.0,0.0,0.0,3,3,0,3.0,3.0,0.0
111311,11,3,8,23,5,6,7,221,8.0,2.0,6.0,16.0,5.0,3.0,3.0,14,11,3,7.0,7.0,0.0
210373,1,1,0,0,0,1,7,5,0.0,0.0,0.0,0.0,0.0,0.0,0.0,25,1,24,8.0,0.0,8.0
9406280,0,0,0,0,0,0,0,75,0.0,0.0,0.0,0.0,0.0,0.0,0.0,16,0,16,6.0,0.0,6.0
11203,3,3,0,0,0,3,6,8,,,,,,,,12,3,9,2.0,0.0,2.0
9811279,8,4,4,4,0,8,27,117,6.0,2.0,4.0,4.0,0.0,6.0,18.0,29,8,21,8.0,3.0,5.0
9901290,1,1,0,0,0,1,4,137,1.0,1.0,0.0,0.0,0.0,1.0,3.0,6,1,5,,,
204002,7,7,0,0,0,7,60,2,6.0,6.0,0.0,0.0,0.0,6.0,40.0,46,7,39,12.0,3.0,9.0
11395,1,1,0,0,0,1,5,21,0.0,0.0,0.0,0.0,0.0,0.0,0.0,10,1,9,1.0,0.0,1.0
9709491,1,1,0,0,0,1,1,1,0.0,0.0,0.0,0.0,0.0,0.0,0.0,21,1,20,1.0,0.0,1.0
205337,0,0,0,0,0,0,0,21,0.0,0.0,0.0,0.0,0.0,0.0,0.0,12,0,12,5.0,0.0,5.0
9902247,1,1,0,0,1,0,0,41,0.0,0.0,0.0,0.0,0.0,0.0,0.0,17,1,16,9.0,0.0,9.0
207095,1,1,0,0,1,0,0,7,0.0,0.0,0.0,0.0,0.0,0.0,0.0,21,1,20,10.0,0.0,10.0
208030,2,2,0,0,2,0,0,118,1.0,1.0,0.0,0.0,1.0,0.0,0.0,5,2,3,1.0,0.0,1.0
9910484,5,5,0,0,2,3,4,106,1.0,1.0,0.0,0.0,0.0,1.0,2.0,7,5,2,3.0,1.0,2.0
9601300,8,6,2,2,7,1,5,10,0.0,0.0,0.0,0.0,0.0,0.0,0.0,44,8,36,7.0,1.0,6.0
9806497,1,1,0,0,1,0,0,108,0.0,0.0,0.0,0.0,0.0,0.0,0.0,44,1,43,2.0,0.0,2.0
204331,0,0,0,0,0,0,0,139,0.0,0.0,0.0,0.0,0.0,0.0,0.0,3,0,3,1.0,0.0,1.0
10309,2,1,1,1,0,2,4,140,0.0,0.0,0.0,0.0,0.0,0.0,0.0,5,2,3,2.0,0.0,2.0
209301,11,8,3,4,4,7,14,46,5.0,4.0,1.0,1.0,1.0,4.0,9.0,16,11,5,2.0,1.0,1.0
12367,10,3,7,17,1,9,61,11,7.0,2.0,5.0,11.0,0.0,7.0,54.0,24,10,14,17.0,6.0,11.0
201278,1,1,0,0,0,1,10,8,1.0,1.0,0.0,0.0,0.0,1.0,3.0,12,1,11,4.0,1.0,3.0
9707529,0,0,0,0,0,0,0,6,0.0,0.0,0.0,0.0,0.0,0.0,0.0,17,0,17,3.0,0.0,3.0
11142,4,1,3,3,3,1,5,48,0.0,0.0,0.0,0.0,0.0,0.0,0.0,10,4,6,2.0,0.0,2.0
9708338,1,1,0,0,0,1,5,234,0.0,0.0,0.0,0.0,0.0,0.0,0.0,9,1,8,6.0,1.0,5.0
11303,1,1,0,0,0,1,5,13,1.0,1.0,0.0,0.0,0.0,1.0,3.0,9,1,8,4.0,1.0,3.0
9406218,5,3,2,3,3,2,2,134,3.0,2.0,1.0,1.0,3.0,0.0,0.0,7,5,2,2.0,2.0,0.0
9505373,5,5,0,0,4,1,1,232,3.0,3.0,0.0,0.0,2.0,1.0,1.0,8,5,3,2.0,2.0,0.0
2100,3,2,1,2,1,2,3,106,3.0,2.0,1.0,2.0,1.0,2.0,2.0,6,3,3,1.0,0.0,1.0
107171,5,4,1,1,1,4,18,103,5.0,4.0,1.0,1.0,1.0,4.0,16.0,14,5,9,11.0,3.0,8.0
9807356,0,0,0,0,0,0,0,661,0.0,0.0,0.0,0.0,0.0,0.0,0.0,3,0,3,2.0,0.0,2.0
9711419,2,2,0,0,1,1,1,403,0.0,0.0,0.0,0.0,0.0,0.0,0.0,7,2,5,2.0,0.0,2.0
9910544,3,2,1,1,0,3,8,53,0.0,0.0,0.0,0.0,0.0,0.0,0.0,10,3,7,4.0,2.0,2.0
12361,2,2,0,0,0,2,4,99,1.0,1.0,0.0,0.0,0.0,1.0,1.0,9,2,7,2.0,1.0,1.0
106193,10,4,6,9,0,10,32,7,4.0,2.0,2.0,3.0,1.0,3.0,6.0,27,10,17,7.0,4.0,3.0
212210,0,0,0,0,0,0,0,420,0.0,0.0,0.0,0.0,0.0,0.0,0.0,4,0,4,3.0,0.0,3.0
301176,0,0,0,0,0,0,0,33,0.0,0.0,0.0,0.0,0.0,0.0,0.0,7,0,7,1.0,0.0,1.0
9811433,6,4,2,2,1,5,19,40,3.0,2.0,1.0,1.0,0.0,3.0,8.0,13,6,7,6.0,4.0,2.0
106192,9,2,7,15,0,9,58,9,8.0,2.0,6.0,14.0,0.0,8.0,56.0,23,9,14,3.0,3.0,0.0
101011,3,1,2,2,0,3,7,13,2.0,1.0,1.0,1.0,2.0,0.0,0.0,6,3,3,2.0,2.0,0.0
12051,1,1,0,0,1,0,0,508,0.0,0.0,0.0,0.0,0.0,0.0,0.0,2,1,1,1.0,0.0,1.0
207248,2,2,0,0,0,2,18,12,1.0,1.0,0.0,0.0,0.0,1.0,6.0,48,2,46,4.0,1.0,3.0
9701411,1,1,0,0,0,1,1,10,0.0,0.0,0.0,0.0,0.0,0.0,0.0,14,1,13,4.0,1.0,3.0
9611356,1,1,0,0,0,1,5,74,1.0,1.0,0.0,0.0,0.0,1.0,5.0,22,1,21,1.0,0.0,1.0
9909474,3,3,0,0,0,3,9,40,1.0,1.0,0.0,0.0,1.0,0.0,0.0,8,3,5,5.0,3.0,2.0
11167,2,1,1,1,0,2,9,106,2.0,1.0,1.0,1.0,0.0,2.0,8.0,8,2,6,6.0,2.0,4.0
9212254,1,1,0,0,1,0,0,94,,,,,,,,1,1,0,,,
11237,2,1,1,1,0,2,28,4,1.0,1.0,0.0,0.0,0.0,1.0,10.0,40,2,38,7.0,1.0,6.0
9304244,1,1,0,0,1,0,0,479,0.0,0.0,0.0,0.0,0.0,0.0,0.0,6,1,5,1.0,0.0,1.0
9711449,2,2,0,0,2,0,0,171,0.0,0.0,0.0,0.0,0.0,0.0,0.0,8,2,6,5.0,0.0,5.0
209271,1,1,0,0,0,1,1,80,1.0,1.0,0.0,0.0,0.0,1.0,1.0,14,1,13,3.0,0.0,3.0
9807380,6,4,2,2,1,5,13,90,2.0,1.0,1.0,1.0,0.0,2.0,10.0,12,6,6,3.0,3.0,0.0
106312,4,1,3,5,0,4,7,121,4.0,1.0,3.0,5.0,0.0,4.0,6.0,12,4,8,6.0,4.0,2.0
9108,4,3,1,1,1,3,17,59,2.0,1.0,1.0,1.0,0.0,2.0,12.0,18,4,14,11.0,2.0,9.0
9706246,5,2,3,4,2,3,5,282,3.0,2.0,1.0,1.0,1.0,2.0,2.0,9,5,4,4.0,2.0,2.0
9905225,1,1,0,0,0,1,1,225,0.0,0.0,0.0,0.0,0.0,0.0,0.0,11,1,10,2.0,0.0,2.0
6270,0,0,0,0,0,0,0,561,0.0,0.0,0.0,0.0,0.0,0.0,0.0,1,0,1,1.0,0.0,1.0
209376,3,3,0,0,0,3,38,4,1.0,1.0,0.0,0.0,0.0,1.0,16.0,45,3,42,12.0,1.0,11.0
9312253,0,0,0,0,0,0,0,840,,,,,,,,4,0,4,,,
9811368,1,1,0,0,0,1,3,44,0.0,0.0,0.0,0.0,0.0,0.0,0.0,9,1,8,4.0,1.0,3.0
302165,0,0,0,0,0,0,0,22,0.0,0.0,0.0,0.0,0.0,0.0,0.0,23,0,23,7.0,0.0,7.0
9709219,2,2,0,0,0,2,4,33,2.0,2.0,0.0,0.0,0.0,2.0,3.0,12,2,10,6.0,1.0,5.0
11212,2,2,0,0,1,1,1,147,0.0,0.0,0.0,0.0,0.0,0.0,0.0,8,2,6,2.0,0.0,2.0
302089,0,0,0,0,0,0,0,65,0.0,0.0,0.0,0.0,0.0,0.0,0.0,20,0,20,4.0,0.0,4.0
9911287,3,3,0,0,3,0,0,257,2.0,2.0,0.0,0.0,2.0,0.0,0.0,3,3,0,1.0,1.0,0.0
9904489,2,1,1,1,1,1,1,215,2.0,1.0,1.0,1.0,2.0,0.0,0.0,7,2,5,1.0,0.0,1.0
207047,9,4,5,7,0,9,70,9,7.0,3.0,4.0,6.0,0.0,7.0,57.0,36,9,27,8.0,4.0,4.0
9610521,1,1,0,0,0,1,2,77,0.0,0.0,0.0,0.0,0.0,0.0,0.0,6,1,5,2.0,1.0,1.0
208040,2,1,1,1,2,0,0,257,0.0,0.0,0.0,0.0,0.0,0.0,0.0,15,2,13,4.0,0.0,4.0
9509390,1,1,0,0,0,1,1,63,0.0,0.0,0.0,0.0,0.0,0.0,0.0,4,1,3,2.0,1.0,1.0
9302319,2,2,0,0,1,1,2,190,1.0,1.0,0.0,0.0,0.0,1.0,1.0,5,2,3,1.0,0.0,1.0
9509293,1,1,0,0,0,1,1,90,1.0,1.0,0.0,0.0,0.0,1.0,1.0,8,1,7,1.0,0.0,1.0
9811467,4,3,1,1,3,1,1,71,0.0,0.0,0.0,0.0,0.0,0.0,0.0,15,4,11,5.0,0.0,5.0
4180,1,1,0,0,1,0,0,1024,,,,,,,,1,1,0,,,
9901272,4,1,3,5,0,4,22,76,4.0,1.0,3.0,5.0,0.0,4.0,22.0,17,4,13,11.0,4.0,7.0
105148,5,3,2,2,0,5,39,124,3.0,2.0,1.0,1.0,0.0,3.0,25.0,22,5,17,12.0,2.0,10.0
9601264,1,1,0,0,1,0,0,1301,1.0,1.0,0.0,0.0,1.0,0.0,0.0,1,1,0,1.0,1.0,0.0
9808356,16,2,14,46,0,16,187,53,15.0,2.0,13.0,44.0,0.0,15.0,183.0,33,16,17,31.0,14.0,17.0
9812350,5,2,3,4,0,5,27,116,2.0,2.0,0.0,0.0,0.0,2.0,8.0,13,5,8,8.0,4.0,4.0
9702309,5,2,3,4,1,4,5,90,5.0,2.0,3.0,4.0,1.0,4.0,5.0,7,5,2,2.0,1.0,1.0
203208,5,1,4,6,1,4,52,11,4.0,1.0,3.0,5.0,0.0,4.0,48.0,22,5,17,9.0,2.0,7.0
207257,0,0,0,0,0,0,0,1807,0.0,0.0,0.0,0.0,0.0,0.0,0.0,5,0,5,1.0,0.0,1.0
9807407,5,4,1,1,1,4,4,117,4.0,3.0,1.0,1.0,0.0,4.0,4.0,6,5,1,2.0,2.0,0.0
9809268,1,1,0,0,1,0,0,430,1.0,1.0,0.0,0.0,1.0,0.0,0.0,3,1,2,,,
112358,0,0,0,0,0,0,0,278,0.0,0.0,0.0,0.0,0.0,0.0,0.0,1,0,1,,,
109226,2,2,0,0,1,1,1,284,2.0,2.0,0.0,0.0,1.0,1.0,1.0,6,2,4,2.0,2.0,0.0
9711243,3,3,0,0,3,0,0,351,2.0,2.0,0.0,0.0,2.0,0.0,0.0,4,3,1,2.0,2.0,0.0
103226,2,2,0,0,1,1,4,215,1.0,1.0,0.0,0.0,0.0,1.0,3.0,7,2,5,5.0,1.0,4.0
107038,4,4,0,0,0,4,18,72,3.0,3.0,0.0,0.0,0.0,3.0,9.0,18,4,14,3.0,1.0,2.0
110142,5,3,2,2,0,5,38,2,5.0,3.0,2.0,2.0,0.0,5.0,28.0,22,5,17,14.0,3.0,11.0
209347,1,1,0,0,1,0,0,107,1.0,1.0,0.0,0.0,1.0,0.0,0.0,1,1,0,,,
9809541,0,0,0,0,0,0,0,77,0.0,0.0,0.0,0.0,0.0,0.0,0.0,3,0,3,2.0,0.0,2.0
11195,7,2,5,5,4,3,8,46,2.0,1.0,1.0,1.0,0.0,2.0,2.0,21,7,14,3.0,2.0,1.0
9909409,3,1,2,2,0,3,9,35,3.0,1.0,2.0,2.0,0.0,3.0,8.0,9,3,6,2.0,0.0,2.0
301167,2,1,1,1,0,2,30,53,2.0,1.0,1.0,1.0,0.0,2.0,30.0,18,2,16,18.0,2.0,16.0
8072,1,1,0,0,0,1,7,1,1.0,1.0,0.0,0.0,0.0,1.0,7.0,13,1,12,,,
111180,4,3,1,1,1,3,22,83,2.0,2.0,0.0,0.0,0.0,2.0,7.0,40,4,36,9.0,2.0,7.0
9601227,0,0,0,0,0,0,0,517,0.0,0.0,0.0,0.0,0.0,0.0,0.0,3,0,3,3.0,0.0,3.0
9809557,3,3,0,0,3,0,0,1,0.0,0.0,0.0,0.0,0.0,0.0,0.0,20,3,17,,,
9812464,3,2,1,2,3,0,0,380,3.0,2.0,1.0,2.0,3.0,0.0,0.0,3,3,0,3.0,3.0,0.0
209164,3,3,0,0,2,1,6,78,2.0,2.0,0.0,0.0,1.0,1.0,5.0,12,3,9,6.0,1.0,5.0
9910251,12,8,4,7,3,9,19,209,6.0,4.0,2.0,5.0,3.0,3.0,3.0,16,12,4,6.0,5.0,1.0
9610378,0,0,0,0,0,0,0,41,0.0,0.0,0.0,0.0,0.0,0.0,0.0,6,0,6,3.0,0.0,3.0
202231,9,2,7,12,0,9,66,127,7.0,2.0,5.0,10.0,0.0,7.0,36.0,25,9,16,14.0,6.0,8.0
101013,1,1,0,0,0,1,1,410,0.0,0.0,0.0,0.0,0.0,0.0,0.0,3,1,2,,,
9409293,2,1,1,1,2,0,0,113,2.0,1.0,1.0,1.0,2.0,0.0,0.0,3,2,1,2.0,2.0,0.0
6020,1,1,0,0,0,1,2,367,1.0,1.0,0.0,0.0,0.0,1.0,2.0,3,1,2,2.0,1.0,1.0
9603288,0,0,0,0,0,0,0,14,0.0,0.0,0.0,0.0,0.0,0.0,0.0,4,0,4,1.0,0.0,1.0
9807551,6,3,3,5,3,3,4,3,6.0,3.0,3.0,5.0,3.0,3.0,4.0,13,6,7,3.0,3.0,0.0
9912509,4,2,2,3,0,4,8,7,1.0,1.0,0.0,0.0,1.0,0.0,0.0,16,4,12,4.0,0.0,4.0
10149,4,3,1,1,0,4,32,48,2.0,2.0,0.0,0.0,0.0,2.0,12.0,20,4,16,3.0,1.0,2.0
9209281,1,1,0,0,1,0,0,1149,1.0,1.0,0.0,0.0,1.0,0.0,0.0,1,1,0,,,
9609292,1,1,0,0,1,0,0,62,0.0,0.0,0.0,0.0,0.0,0.0,0.0,5,1,4,1.0,0.0,1.0
9712533,5,3,2,2,0,5,10,111,3.0,1.0,2.0,2.0,0.0,3.0,3.0,9,5,4,4.0,3.0,1.0
9602253,7,4,3,4,1,6,16,52,6.0,3.0,3.0,4.0,1.0,5.0,9.0,12,7,5,4.0,2.0,2.0
207013,6,2,4,9,0,6,43,37,4.0,1.0,3.0,6.0,0.0,4.0,20.0,21,6,15,5.0,1.0,4.0
207104,0,0,0,0,0,0,0,9,0.0,0.0,0.0,0.0,0.0,0.0,0.0,9,0,9,4.0,0.0,4.0
9609348,11,6,5,9,1,10,30,110,7.0,2.0,5.0,9.0,0.0,7.0,22.0,17,11,6,9.0,6.0,3.0
9905491,3,3,0,0,2,1,5,36,0.0,0.0,0.0,0.0,0.0,0.0,0.0,8,3,5,3.0,1.0,2.0
301261,1,1,0,0,0,1,12,146,1.0,1.0,0.0,0.0,0.0,1.0,11.0,13,1,12,12.0,1.0,11.0
9711502,1,1,0,0,0,1,1,10,0.0,0.0,0.0,0.0,0.0,0.0,0.0,14,1,13,1.0,1.0,0.0
9409241,2,2,0,0,0,2,5,29,2.0,2.0,0.0,0.0,1.0,1.0,1.0,9,2,7,2.0,1.0,1.0
102178,4,1,3,5,0,4,36,25,0.0,0.0,0.0,0.0,0.0,0.0,0.0,27,4,23,12.0,0.0,12.0
10098,0,0,0,0,0,0,0,1220,0.0,0.0,0.0,0.0,0.0,0.0,0.0,1,0,1,1.0,0.0,1.0
207201,2,2,0,0,0,2,3,670,1.0,1.0,0.0,0.0,1.0,0.0,0.0,4,2,2,1.0,1.0,0.0
201144,2,1,1,1,0,2,13,14,2.0,1.0,1.0,1.0,0.0,2.0,2.0,9,2,7,3.0,2.0,1.0
9351,0,0,0,0,0,0,0,22,0.0,0.0,0.0,0.0,0.0,0.0,0.0,11,0,11,5.0,0.0,5.0
9903228,10,8,2,5,4,6,10,57,2.0,2.0,0.0,0.0,0.0,2.0,4.0,37,10,27,8.0,0.0,8.0
9806474,0,0,0,0,0,0,0,194,0.0,0.0,0.0,0.0,0.0,0.0,0.0,4,0,4,1.0,0.0,1.0
9904314,0,0,0,0,0,0,0,227,,,,,,,,1,0,1,,,
9911209,1,1,0,0,0,1,1,313,0.0,0.0,0.0,0.0,0.0,0.0,0.0,11,1,10,4.0,0.0,4.0
302039,0,0,0,0,0,0,0,0,0.0,0.0,0.0,0.0,0.0,0.0,0.0,16,0,16,3.0,0.0,3.0
9710454,3,1,2,2,0,3,21,130,2.0,1.0,1.0,1.0,0.0,2.0,14.0,12,3,9,8.0,2.0,6.0
9410408,4,1,3,5,0,4,4,149,4.0,1.0,3.0,5.0,0.0,4.0,4.0,6,4,2,5.0,4.0,1.0
106324,5,3,2,2,0,5,20,20,2.0,2.0,0.0,0.0,2.0,0.0,0.0,16,5,11,3.0,2.0,1.0
12069,4,3,1,2,2,2,3,127,1.0,1.0,0.0,0.0,1.0,0.0,0.0,6,4,2,1.0,0.0,1.0
9804303,3,1,2,3,3,0,0,198,3.0,1.0,2.0,3.0,3.0,0.0,0.0,3,3,0,3.0,3.0,0.0
9412358,1,1,0,0,0,1,4,329,1.0,1.0,0.0,0.0,0.0,1.0,3.0,7,1,6,1.0,1.0,0.0
9409379,2,2,0,0,0,2,6,74,1.0,1.0,0.0,0.0,1.0,0.0,0.0,6,2,4,1.0,1.0,0.0
301231,2,2,0,0,2,0,0,82,0.0,0.0,0.0,0.0,0.0,0.0,0.0,6,2,4,2.0,1.0,1.0
9506401,0,0,0,0,0,0,0,548,0.0,0.0,0.0,0.0,0.0,0.0,0.0,1,0,1,1.0,0.0,1.0
10025,2,2,0,0,0,2,8,92,0.0,0.0,0.0,0.0,0.0,0.0,0.0,26,2,24,6.0,0.0,6.0
206106,0,0,0,0,0,0,0,1659,,,,,,,,3,0,3,,,
9911388,1,1,0,0,0,1,3,33,0.0,0.0,0.0,0.0,0.0,0.0,0.0,34,1,33,11.0,0.0,11.0
9905331,1,1,0,0,0,1,6,160,1.0,1.0,0.0,0.0,0.0,1.0,4.0,9,1,8,5.0,1.0,4.0
205298,0,0,0,0,0,0,0,66,0.0,0.0,0.0,0.0,0.0,0.0,0.0,18,0,18,3.0,0.0,3.0
9606369,9,8,1,1,3,6,6,132,8.0,7.0,1.0,1.0,4.0,4.0,4.0,11,9,2,7.0,6.0,1.0
9411226,6,5,1,2,6,0,0,111,5.0,4.0,1.0,2.0,5.0,0.0,0.0,6,6,0,2.0,2.0,0.0
104313,1,1,0,0,1,0,0,177,0.0,0.0,0.0,0.0,0.0,0.0,0.0,6,1,5,3.0,0.0,3.0
207281,1,1,0,0,0,1,8,0,0.0,0.0,0.0,0.0,0.0,0.0,0.0,9,1,8,2.0,0.0,2.0
109015,1,1,0,0,1,0,0,55,,,,,,,,3,1,2,1.0,1.0,0.0
9707378,1,1,0,0,1,0,0,1535,,,,,,,,2,1,1,,,
9408387,8,3,5,10,8,0,0,402,7.0,3.0,4.0,7.0,7.0,0.0,0.0,8,8,0,6.0,6.0,0.0
205042,0,0,0,0,0,0,0,277,0.0,0.0,0.0,0.0,0.0,0.0,0.0,2,0,2,2.0,0.0,2.0
9806483,1,1,0,0,0,1,2,121,,,,,,,,3,1,2,,,
107020,2,2,0,0,1,1,4,13,0.0,0.0,0.0,0.0,0.0,0.0,0.0,6,2,4,1.0,0.0,1.0
201187,1,1,0,0,0,1,2,97,0.0,0.0,0.0,0.0,0.0,0.0,0.0,15,1,14,6.0,0.0,6.0
9912298,0,0,0,0,0,0,0,146,0.0,0.0,0.0,0.0,0.0,0.0,0.0,4,0,4,4.0,0.0,4.0
11349,0,0,0,0,0,0,0,33,0.0,0.0,0.0,0.0,0.0,0.0,0.0,19,0,19,11.0,0.0,11.0
9403303,3,3,0,0,3,0,0,134,2.0,2.0,0.0,0.0,2.0,0.0,0.0,3,3,0,2.0,2.0,0.0
212076,1,1,0,0,0,1,12,82,1.0,1.0,0.0,0.0,0.0,1.0,12.0,14,1,13,7.0,1.0,6.0
106274,1,1,0,0,0,1,15,44,0.0,0.0,0.0,0.0,0.0,0.0,0.0,27,1,26,9.0,1.0,8.0
301125,0,0,0,0,0,0,0,20,0.0,0.0,0.0,0.0,0.0,0.0,0.0,5,0,5,1.0,0.0,1.0
103066,2,2,0,0,2,0,0,398,1.0,1.0,0.0,0.0,1.0,0.0,0.0,6,2,4,1.0,0.0,1.0
9911268,2,2,0,0,1,1,2,307,1.0,1.0,0.0,0.0,0.0,1.0,2.0,5,2,3,4.0,1.0,3.0
212105,0,0,0,0,0,0,0,52,0.0,0.0,0.0,0.0,0.0,0.0,0.0,13,0,13,6.0,0.0,6.0
9411270,3,2,1,1,3,0,0,120,2.0,1.0,1.0,1.0,2.0,0.0,0.0,3,3,0,1.0,1.0,0.0
9405321,0,0,0,0,0,0,0,62,,,,,,,,6,0,6,,,
9907330,1,1,0,0,0,1,1,664,0.0,0.0,0.0,0.0,0.0,0.0,0.0,2,1,1,1.0,0.0,1.0
203134,4,2,2,3,0,4,28,89,4.0,2.0,2.0,3.0,0.0,4.0,15.0,21,4,17,9.0,3.0,6.0
212104,0,0,0,0,0,0,0,65,0.0,0.0,0.0,0.0,0.0,0.0,0.0,4,0,4,1.0,0.0,1.0
9806229,1,1,0,0,0,1,8,5,1.0,1.0,0.0,0.0,0.0,1.0,7.0,15,1,14,9.0,1.0,8.0
9402296,1,1,0,0,1,0,0,341,0.0,0.0,0.0,0.0,0.0,0.0,0.0,4,1,3,3.0,0.0,3.0
203203,2,2,0,0,2,0,0,423,1.0,1.0,0.0,0.0,1.0,0.0,0.0,5,2,3,2.0,1.0,1.0
204263,1,1,0,0,0,1,7,85,0.0,0.0,0.0,0.0,0.0,0.0,0.0,8,1,7,1.0,0.0,1.0
110338,2,1,1,1,0,2,3,4,1.0,1.0,0.0,0.0,0.0,1.0,2.0,13,2,11,3.0,0.0,3.0
207290,1,1,0,0,0,1,1,33,0.0,0.0,0.0,0.0,0.0,0.0,0.0,25,1,24,2.0,0.0,2.0
5216,3,2,1,1,3,0,0,185,2.0,1.0,1.0,1.0,2.0,0.0,0.0,4,3,1,1.0,1.0,0.0
9712296,0,0,0,0,0,0,0,1,0.0,0.0,0.0,0.0,0.0,0.0,0.0,6,0,6,,,
203262,0,0,0,0,0,0,0,2025,,,,,,,,6,0,6,,,
9905353,1,1,0,0,1,0,0,41,0.0,0.0,0.0,0.0,0.0,0.0,0.0,7,1,6,1.0,1.0,0.0
9607422,0,0,0,0,0,0,0,25,0.0,0.0,0.0,0.0,0.0,0.0,0.0,15,0,15,1.0,0.0,1.0
207322,0,0,0,0,0,0,0,33,0.0,0.0,0.0,0.0,0.0,0.0,0.0,7,0,7,4.0,0.0,4.0
211440,1,1,0,0,0,1,1,678,1.0,1.0,0.0,0.0,0.0,1.0,1.0,4,1,3,2.0,1.0,1.0
9803444,1,1,0,0,0,1,1,15,0.0,0.0,0.0,0.0,0.0,0.0,0.0,16,1,15,7.0,0.0,7.0
206276,1,1,0,0,0,1,7,3,0.0,0.0,0.0,0.0,0.0,0.0,0.0,14,1,13,1.0,0.0,1.0
206299,0,0,0,0,0,0,0,18,0.0,0.0,0.0,0.0,0.0,0.0,0.0,34,0,34,7.0,0.0,7.0
9511339,0,0,0,0,0,0,0,228,0.0,0.0,0.0,0.0,0.0,0.0,0.0,6,0,6,4.0,0.0,4.0
5059,4,1,3,3,1,3,10,31,2.0,2.0,0.0,0.0,0.0,2.0,4.0,19,4,15,5.0,3.0,2.0
212402,0,0,0,0,0,0,0,82,0.0,0.0,0.0,0.0,0.0,0.0,0.0,24,0,24,12.0,0.0,12.0
302237,0,0,0,0,0,0,0,107,0.0,0.0,0.0,0.0,0.0,0.0,0.0,54,0,54,20.0,0.0,20.0
202220,0,0,0,0,0,0,0,293,0.0,0.0,0.0,0.0,0.0,0.0,0.0,5,0,5,2.0,0.0,2.0
111039,2,2,0,0,2,0,0,72,2.0,2.0,0.0,0.0,2.0,0.0,0.0,2,2,0,2.0,2.0,0.0
9904237,1,1,0,0,0,1,26,9,1.0,1.0,0.0,0.0,0.0,1.0,10.0,27,1,26,10.0,1.0,9.0
9712536,0,0,0,0,0,0,0,16,0.0,0.0,0.0,0.0,0.0,0.0,0.0,21,0,21,6.0,0.0,6.0
9811318,1,1,0,0,0,1,1,79,1.0,1.0,0.0,0.0,0.0,1.0,1.0,7,1,6,5.0,1.0,4.0
104163,3,3,0,0,3,0,0,54,0.0,0.0,0.0,0.0,0.0,0.0,0.0,11,3,8,4.0,0.0,4.0
11225,2,2,0,0,0,2,2,113,1.0,1.0,0.0,0.0,0.0,1.0,1.0,15,2,13,2.0,1.0,1.0
112065,1,1,0,0,1,0,0,63,0.0,0.0,0.0,0.0,0.0,0.0,0.0,15,1,14,2.0,0.0,2.0
9811322,1,1,0,0,0,1,1,119,,,,,,,,2,1,1,1.0,1.0,0.0
105245,7,7,0,0,6,1,1,361,4.0,4.0,0.0,0.0,4.0,0.0,0.0,20,7,13,4.0,2.0,2.0
9506234,0,0,0,0,0,0,0,40,0.0,0.0,0.0,0.0,0.0,0.0,0.0,6,0,6,1.0,0.0,1.0
9302294,3,3,0,0,3,0,0,363,3.0,3.0,0.0,0.0,3.0,0.0,0.0,3,3,0,2.0,2.0,0.0
9602237,1,1,0,0,1,0,0,340,1.0,1.0,0.0,0.0,1.0,0.0,0.0,1,1,0,1.0,1.0,0.0
209099,0,0,0,0,0,0,0,1092,0.0,0.0,0.0,0.0,0.0,0.0,0.0,3,0,3,,,
111363,0,0,0,0,0,0,0,20,0.0,0.0,0.0,0.0,0.0,0.0,0.0,6,0,6,1.0,0.0,1.0
9512351,0,0,0,0,0,0,0,54,0.0,0.0,0.0,0.0,0.0,0.0,0.0,7,0,7,2.0,0.0,2.0
9604365,1,1,0,0,1,0,0,26,0.0,0.0,0.0,0.0,0.0,0.0,0.0,10,1,9,1.0,0.0,1.0
7029,1,1,0,0,1,0,0,547,0.0,0.0,0.0,0.0,0.0,0.0,0.0,3,1,2,2.0,0.0,2.0
8002,0,0,0,0,0,0,0,1450,,,,,,,,2,0,2,,,
9409267,1,1,0,0,1,0,0,570,1.0,1.0,0.0,0.0,1.0,0.0,0.0,1,1,0,1.0,1.0,0.0
9906237,1,1,0,0,1,0,0,307,0.0,0.0,0.0,0.0,0.0,0.0,0.0,3,1,2,2.0,0.0,2.0
208118,1,1,0,0,0,1,2,324,0.0,0.0,0.0,0.0,0.0,0.0,0.0,7,1,6,2.0,0.0,2.0
9801312,0,0,0,0,0,0,0,36,0.0,0.0,0.0,0.0,0.0,0.0,0.0,15,0,15,11.0,0.0,11.0
9211334,10,5,5,6,10,0,0,246,6.0,4.0,2.0,2.0,6.0,0.0,0.0,12,10,2,5.0,5.0,0.0
9907329,0,0,0,0,0,0,0,1996,,,,,,,,6,0,6,3.0,0.0,3.0
9803278,2,2,0,0,0,2,3,170,0.0,0.0,0.0,0.0,0.0,0.0,0.0,13,2,11,5.0,0.0,5.0
9905575,1,1,0,0,1,0,0,115,,,,,,,,2,1,1,1.0,1.0,0.0
9909351,2,1,1,1,0,2,4,59,0.0,0.0,0.0,0.0,0.0,0.0,0.0,5,2,3,3.0,2.0,1.0
9808260,1,1,0,0,0,1,5,99,1.0,1.0,0.0,0.0,0.0,1.0,4.0,21,1,20,2.0,0.0,2.0
201268,0,0,0,0,0,0,0,2,0.0,0.0,0.0,0.0,0.0,0.0,0.0,20,0,20,5.0,0.0,5.0
9701380,0,0,0,0,0,0,0,685,0.0,0.0,0.0,0.0,0.0,0.0,0.0,1,0,1,1.0,0.0,1.0
105137,0,0,0,0,0,0,0,204,0.0,0.0,0.0,0.0,0.0,0.0,0.0,5,0,5,3.0,0.0,3.0
204153,2,2,0,0,0,2,11,26,1.0,1.0,0.0,0.0,0.0,1.0,6.0,19,2,17,2.0,0.0,2.0
9603269,1,1,0,0,0,1,1,323,1.0,1.0,0.0,0.0,0.0,1.0,1.0,3,1,2,2.0,1.0,1.0
205056,0,0,0,0,0,0,0,218,0.0,0.0,0.0,0.0,0.0,0.0,0.0,15,0,15,2.0,0.0,2.0
111277,0,0,0,0,0,0,0,40,0.0,0.0,0.0,0.0,0.0,0.0,0.0,4,0,4,2.0,0.0,2.0
109055,1,1,0,0,0,1,2,49,0.0,0.0,0.0,0.0,0.0,0.0,0.0,15,1,14,2.0,0.0,2.0
301031,0,0,0,0,0,0,0,53,0.0,0.0,0.0,0.0,0.0,0.0,0.0,7,0,7,3.0,0.0,3.0
9807240,3,3,0,0,1,2,2,404,3.0,3.0,0.0,0.0,1.0,2.0,2.0,6,3,3,3.0,2.0,1.0
2194,7,5,2,4,1,6,17,99,5.0,3.0,2.0,4.0,1.0,4.0,6.0,16,7,9,5.0,4.0,1.0
11075,4,2,2,3,2,2,9,133,1.0,1.0,0.0,0.0,1.0,0.0,0.0,9,4,5,3.0,1.0,2.0
9906227,1,1,0,0,0,1,2,130,0.0,0.0,0.0,0.0,0.0,0.0,0.0,7,1,6,1.0,1.0,0.0
9307283,0,0,0,0,0,0,0,1231,,,,,,,,1,0,1,,,
9808460,2,2,0,0,0,2,2,464,2.0,2.0,0.0,0.0,0.0,2.0,2.0,4,2,2,3.0,2.0,1.0
212191,0,0,0,0,0,0,0,33,0.0,0.0,0.0,0.0,0.0,0.0,0.0,10,0,10,7.0,0.0,7.0
205183,2,1,1,1,0,2,5,308,2.0,1.0,1.0,1.0,0.0,2.0,4.0,9,2,7,5.0,2.0,3.0
203068,0,0,0,0,0,0,0,263,0.0,0.0,0.0,0.0,0.0,0.0,0.0,1,0,1,1.0,0.0,1.0
9809428,2,2,0,0,0,2,4,54,1.0,1.0,0.0,0.0,0.0,1.0,1.0,13,2,11,3.0,1.0,2.0
202142,2,2,0,0,0,2,8,130,1.0,1.0,0.0,0.0,0.0,1.0,7.0,27,2,25,9.0,1.0,8.0
9803211,1,1,0,0,1,0,0,62,0.0,0.0,0.0,0.0,0.0,0.0,0.0,6,1,5,1.0,0.0,1.0
211341,1,1,0,0,0,1,2,381,0.0,0.0,0.0,0.0,0.0,0.0,0.0,6,1,5,1.0,0.0,1.0
9705436,0,0,0,0,0,0,0,0,0.0,0.0,0.0,0.0,0.0,0.0,0.0,25,0,25,5.0,0.0,5.0
107146,0,0,0,0,0,0,0,88,0.0,0.0,0.0,0.0,0.0,0.0,0.0,8,0,8,3.0,0.0,3.0
102183,1,1,0,0,0,1,5,21,1.0,1.0,0.0,0.0,0.0,1.0,5.0,30,1,29,8.0,0.0,8.0
111352,1,1,0,0,0,1,1,125,0.0,0.0,0.0,0.0,0.0,0.0,0.0,10,1,9,1.0,0.0,1.0
302117,0,0,0,0,0,0,0,13,0.0,0.0,0.0,0.0,0.0,0.0,0.0,28,0,28,4.0,0.0,4.0
107006,1,1,0,0,0,1,5,12,0.0,0.0,0.0,0.0,0.0,0.0,0.0,30,1,29,6.0,0.0,6.0
7140,0,0,0,0,0,0,0,43,0.0,0.0,0.0,0.0,0.0,0.0,0.0,13,0,13,1.0,0.0,1.0
9607420,2,2,0,0,1,1,1,225,2.0,2.0,0.0,0.0,2.0,0.0,0.0,3,2,1,2.0,1.0,1.0
9908444,1,1,0,0,0,1,1,137,0.0,0.0,0.0,0.0,0.0,0.0,0.0,10,1,9,2.0,0.0,2.0
204059,1,1,0,0,1,0,0,907,,,,,,,,1,1,0,,,
112067,1,1,0,0,0,1,8,301,1.0,1.0,0.0,0.0,0.0,1.0,6.0,9,1,8,6.0,1.0,5.0
9405268,4,4,0,0,1,3,3,528,3.0,3.0,0.0,0.0,0.0,3.0,3.0,5,4,1,3.0,2.0,1.0
9411359,0,0,0,0,0,0,0,440,0.0,0.0,0.0,0.0,0.0,0.0,0.0,4,0,4,3.0,0.0,3.0
9510226,0,0,0,0,0,0,0,204,,,,,,,,1,0,1,,,
9707219,1,1,0,0,1,0,0,189,0.0,0.0,0.0,0.0,0.0,0.0,0.0,3,1,2,1.0,0.0,1.0
9502212,0,0,0,0,0,0,0,164,0.0,0.0,0.0,0.0,0.0,0.0,0.0,20,0,20,10.0,0.0,10.0
12286,0,0,0,0,0,0,0,191,0.0,0.0,0.0,0.0,0.0,0.0,0.0,10,0,10,7.0,0.0,7.0
207337,1,1,0,0,0,1,4,13,1.0,1.0,0.0,0.0,0.0,1.0,4.0,29,1,28,16.0,1.0,15.0
9711494,0,0,0,0,0,0,0,82,0.0,0.0,0.0,0.0,0.0,0.0,0.0,3,0,3,3.0,0.0,3.0
9902225,0,0,0,0,0,0,0,14,0.0,0.0,0.0,0.0,0.0,0.0,0.0,6,0,6,1.0,0.0,1.0
9912466,0,0,0,0,0,0,0,32,0.0,0.0,0.0,0.0,0.0,0.0,0.0,11,0,11,1.0,0.0,1.0
9610361,1,1,0,0,0,1,1,79,1.0,1.0,0.0,0.0,0.0,1.0,1.0,2,1,1,2.0,1.0,1.0
212350,2,2,0,0,0,2,18,10,1.0,1.0,0.0,0.0,0.0,1.0,5.0,62,2,60,17.0,0.0,17.0
302107,0,0,0,0,0,0,0,4,0.0,0.0,0.0,0.0,0.0,0.0,0.0,18,0,18,7.0,0.0,7.0
210363,0,0,0,0,0,0,0,69,0.0,0.0,0.0,0.0,0.0,0.0,0.0,16,0,16,6.0,0.0,6.0
301189,1,1,0,0,0,1,24,30,1.0,1.0,0.0,0.0,0.0,1.0,7.0,26,1,25,11.0,1.0,10.0
9810251,2,2,0,0,2,0,0,427,2.0,2.0,0.0,0.0,2.0,0.0,0.0,2,2,0,1.0,1.0,0.0
9809214,1,1,0,0,0,1,7,22,1.0,1.0,0.0,0.0,0.0,1.0,5.0,12,1,11,9.0,1.0,8.0
9804315,0,0,0,0,0,0,0,156,0.0,0.0,0.0,0.0,0.0,0.0,0.0,6,0,6,5.0,0.0,5.0
205318,4,2,2,2,0,4,23,201,1.0,1.0,0.0,0.0,0.0,1.0,6.0,26,4,22,11.0,1.0,10.0
210295,0,0,0,0,0,0,0,153,0.0,0.0,0.0,0.0,0.0,0.0,0.0,8,0,8,2.0,0.0,2.0
104132,1,1,0,0,1,0,0,64,0.0,0.0,0.0,0.0,0.0,0.0,0.0,4,1,3,3.0,0.0,3.0
205346,0,0,0,0,0,0,0,125,0.0,0.0,0.0,0.0,0.0,0.0,0.0,7,0,7,3.0,0.0,3.0
302147,0,0,0,0,0,0,0,72,,,,,,,,3,0,3,,,
105038,0,0,0,0,0,0,0,8,0.0,0.0,0.0,0.0,0.0,0.0,0.0,12,0,12,5.0,0.0,5.0
11340,1,1,0,0,0,1,3,277,1.0,1.0,0.0,0.0,0.0,1.0,3.0,4,1,3,1.0,1.0,0.0
9909273,1,1,0,0,0,1,5,52,1.0,1.0,0.0,0.0,0.0,1.0,5.0,12,1,11,9.0,1.0,8.0
109215,1,1,0,0,0,1,8,171,1.0,1.0,0.0,0.0,0.0,1.0,5.0,9,1,8,7.0,1.0,6.0
211327,0,0,0,0,0,0,0,109,0.0,0.0,0.0,0.0,0.0,0.0,0.0,40,0,40,26.0,0.0,26.0
9909379,1,1,0,0,0,1,6,88,1.0,1.0,0.0,0.0,0.0,1.0,6.0,14,1,13,10.0,1.0,9.0
110222,1,1,0,0,0,1,7,7,0.0,0.0,0.0,0.0,0.0,0.0,0.0,43,1,42,10.0,1.0,9.0
211045,0,0,0,0,0,0,0,50,0.0,0.0,0.0,0.0,0.0,0.0,0.0,13,0,13,8.0,0.0,8.0
9705373,2,1,1,1,2,0,0,170,,,,,,,,2,2,0,,,
208210,2,1,1,1,1,1,5,215,2.0,1.0,1.0,1.0,1.0,1.0,1.0,16,2,14,5.0,0.0,5.0
9808209,0,0,0,0,0,0,0,13,0.0,0.0,0.0,0.0,0.0,0.0,0.0,10,0,10,1.0,0.0,1.0
207289,0,0,0,0,0,0,0,23,0.0,0.0,0.0,0.0,0.0,0.0,0.0,28,0,28,5.0,0.0,5.0
9706293,0,0,0,0,0,0,0,17,0.0,0.0,0.0,0.0,0.0,0.0,0.0,10,0,10,1.0,0.0,1.0
9712437,0,0,0,0,0,0,0,202,0.0,0.0,0.0,0.0,0.0,0.0,0.0,1,0,1,1.0,0.0,1.0
106241,0,0,0,0,0,0,0,173,0.0,0.0,0.0,0.0,0.0,0.0,0.0,9,0,9,1.0,0.0,1.0
101246,0,0,0,0,0,0,0,102,0.0,0.0,0.0,0.0,0.0,0.0,0.0,9,0,9,1.0,0.0,1.0
302219,0,0,0,0,0,0,0,362,0.0,0.0,0.0,0.0,0.0,0.0,0.0,2,0,2,2.0,0.0,2.0
9907220,2,2,0,0,0,2,22,75,0.0,0.0,0.0,0.0,0.0,0.0,0.0,51,2,49,14.0,0.0,14.0
7290,0,0,0,0,0,0,0,674,0.0,0.0,0.0,0.0,0.0,0.0,0.0,3,0,3,1.0,0.0,1.0
9402211,0,0,0,0,0,0,0,18,,,,,,,,5,0,5,1.0,0.0,1.0
9907464,2,1,1,1,1,1,1,349,2.0,1.0,1.0,1.0,1.0,1.0,1.0,3,2,1,3.0,2.0,1.0
6281,2,2,0,0,0,2,4,547,2.0,2.0,0.0,0.0,0.0,2.0,2.0,6,2,4,3.0,2.0,1.0
9409242,0,0,0,0,0,0,0,58,,,,,,,,4,0,4,,,
204261,3,3,0,0,2,1,8,37,1.0,1.0,0.0,0.0,1.0,0.0,0.0,13,3,10,1.0,1.0,0.0
9401268,1,1,0,0,1,0,0,180,,,,,,,,1,1,0,,,
205249,0,0,0,0,0,0,0,11,0.0,0.0,0.0,0.0,0.0,0.0,0.0,48,0,48,31.0,0.0,31.0
204217,2,1,1,1,0,2,2,121,2.0,1.0,1.0,1.0,2.0,0.0,0.0,12,2,10,2.0,2.0,0.0
9512376,1,1,0,0,0,1,1,14,1.0,1.0,0.0,0.0,1.0,0.0,0.0,8,1,7,1.0,0.0,1.0
9902228,3,1,2,2,3,0,0,377,3.0,1.0,2.0,2.0,3.0,0.0,0.0,6,3,3,3.0,3.0,0.0
9608474,0,0,0,0,0,0,0,149,0.0,0.0,0.0,0.0,0.0,0.0,0.0,2,0,2,2.0,0.0,2.0
9808445,0,0,0,0,0,0,0,49,,,,,,,,3,0,3,,,
109205,0,0,0,0,0,0,0,9,0.0,0.0,0.0,0.0,0.0,0.0,0.0,20,0,20,3.0,0.0,3.0
203202,0,0,0,0,0,0,0,184,0.0,0.0,0.0,0.0,0.0,0.0,0.0,3,0,3,3.0,0.0,3.0
10314,1,1,0,0,0,1,1,1,0.0,0.0,0.0,0.0,0.0,0.0,0.0,21,1,20,7.0,0.0,7.0
203145,2,2,0,0,0,2,4,31,1.0,1.0,0.0,0.0,0.0,1.0,1.0,9,2,7,7.0,2.0,5.0
210395,0,0,0,0,0,0,0,42,0.0,0.0,0.0,0.0,0.0,0.0,0.0,11,0,11,6.0,0.0,6.0
9811305,1,1,0,0,0,1,4,324,1.0,1.0,0.0,0.0,0.0,1.0,1.0,7,1,6,2.0,1.0,1.0
207021,0,0,0,0,0,0,0,9,0.0,0.0,0.0,0.0,0.0,0.0,0.0,17,0,17,4.0,0.0,4.0
9908517,0,0,0,0,0,0,0,11,0.0,0.0,0.0,0.0,0.0,0.0,0.0,5,0,5,1.0,0.0,1.0
301214,0,0,0,0,0,0,0,64,0.0,0.0,0.0,0.0,0.0,0.0,0.0,9,0,9,4.0,0.0,4.0
10311,0,0,0,0,0,0,0,178,0.0,0.0,0.0,0.0,0.0,0.0,0.0,7,0,7,,,
9707294,0,0,0,0,0,0,0,270,0.0,0.0,0.0,0.0,0.0,0.0,0.0,3,0,3,1.0,0.0,1.0
209334,0,0,0,0,0,0,0,361,0.0,0.0,0.0,0.0,0.0,0.0,0.0,4,0,4,1.0,0.0,1.0
9511291,0,0,0,0,0,0,0,451,0.0,0.0,0.0,0.0,0.0,0.0,0.0,2,0,2,1.0,0.0,1.0
104017,1,1,0,0,1,0,0,2002,0.0,0.0,0.0,0.0,0.0,0.0,0.0,3,1,2,,,
201138,1,1,0,0,0,1,1,175,1.0,1.0,0.0,0.0,0.0,1.0,1.0,5,1,4,4.0,1.0,3.0
302209,0,0,0,0,0,0,0,5,0.0,0.0,0.0,0.0,0.0,0.0,0.0,18,0,18,15.0,0.0,15.0
3173,2,2,0,0,0,2,5,445,1.0,1.0,0.0,0.0,0.0,1.0,2.0,8,2,6,1.0,1.0,0.0
5325,1,1,0,0,0,1,4,30,0.0,0.0,0.0,0.0,0.0,0.0,0.0,17,1,16,8.0,0.0,8.0
9701281,0,0,0,0,0,0,0,368,0.0,0.0,0.0,0.0,0.0,0.0,0.0,2,0,2,1.0,0.0,1.0
110286,0,0,0,0,0,0,0,36,0.0,0.0,0.0,0.0,0.0,0.0,0.0,10,0,10,5.0,0.0,5.0
204172,2,1,1,1,0,2,16,108,1.0,1.0,0.0,0.0,0.0,1.0,4.0,14,2,12,4.0,2.0,2.0
9605443,1,1,0,0,1,0,0,333,1.0,1.0,0.0,0.0,1.0,0.0,0.0,1,1,0,1.0,1.0,0.0
111201,0,0,0,0,0,0,0,166,0.0,0.0,0.0,0.0,0.0,0.0,0.0,14,0,14,3.0,0.0,3.0
9407366,1,1,0,0,1,0,0,114,1.0,1.0,0.0,0.0,1.0,0.0,0.0,3,1,2,,,
110336,0,0,0,0,0,0,0,49,0.0,0.0,0.0,0.0,0.0,0.0,0.0,7,0,7,2.0,0.0,2.0
9407305,0,0,0,0,0,0,0,592,0.0,0.0,0.0,0.0,0.0,0.0,0.0,2,0,2,2.0,0.0,2.0
101062,1,1,0,0,0,1,1,575,1.0,1.0,0.0,0.0,0.0,1.0,1.0,2,1,1,2.0,1.0,1.0
204125,1,1,0,0,0,1,5,1584,1.0,1.0,0.0,0.0,0.0,1.0,4.0,11,1,10,6.0,1.0,5.0
212221,0,0,0,0,0,0,0,1959,0.0,0.0,0.0,0.0,0.0,0.0,0.0,2,0,2,,,
9310362,0,0,0,0,0,0,0,29,0.0,0.0,0.0,0.0,0.0,0.0,0.0,11,0,11,4.0,0.0,4.0
9810231,0,0,0,0,0,0,0,1071,,,,,,,,3,0,3,,,
9506286,1,1,0,0,0,1,2,163,0.0,0.0,0.0,0.0,0.0,0.0,0.0,8,1,7,4.0,0.0,4.0
301087,0,0,0,0,0,0,0,20,0.0,0.0,0.0,0.0,0.0,0.0,0.0,8,0,8,3.0,0.0,3.0
9910549,0,0,0,0,0,0,0,385,0.0,0.0,0.0,0.0,0.0,0.0,0.0,3,0,3,1.0,0.0,1.0
9407310,2,2,0,0,2,0,0,777,2.0,2.0,0.0,0.0,2.0,0.0,0.0,2,2,0,2.0,2.0,0.0
9505237,0,0,0,0,0,0,0,1324,0.0,0.0,0.0,0.0,0.0,0.0,0.0,1,0,1,1.0,0.0,1.0
9503410,0,0,0,0,0,0,0,25,0.0,0.0,0.0,0.0,0.0,0.0,0.0,5,0,5,1.0,0.0,1.0
207292,0,0,0,0,0,0,0,236,0.0,0.0,0.0,0.0,0.0,0.0,0.0,13,0,13,6.0,0.0,6.0
9609278,1,1,0,0,0,1,5,110,1.0,1.0,0.0,0.0,0.0,1.0,5.0,7,1,6,2.0,1.0,1.0
209240,1,1,0,0,0,1,2,0,1.0,1.0,0.0,0.0,1.0,0.0,0.0,8,1,7,1.0,1.0,0.0
9611306,0,0,0,0,0,0,0,16,0.0,0.0,0.0,0.0,0.0,0.0,0.0,33,0,33,11.0,0.0,11.0
7153,0,0,0,0,0,0,0,334,0.0,0.0,0.0,0.0,0.0,0.0,0.0,2,0,2,2.0,0.0,2.0
9907325,0,0,0,0,0,0,0,1178,0.0,0.0,0.0,0.0,0.0,0.0,0.0,1,0,1,1.0,0.0,1.0
3214,1,1,0,0,0,1,5,20,,,,,,,,7,1,6,,,
9903430,0,0,0,0,0,0,0,157,0.0,0.0,0.0,0.0,0.0,0.0,0.0,12,0,12,2.0,0.0,2.0
9608390,0,0,0,0,0,0,0,724,0.0,0.0,0.0,0.0,0.0,0.0,0.0,1,0,1,1.0,0.0,1.0
9908313,1,1,0,0,0,1,3,899,1.0,1.0,0.0,0.0,0.0,1.0,2.0,4,1,3,3.0,1.0,2.0
9911472,0,0,0,0,0,0,0,40,0.0,0.0,0.0,0.0,0.0,0.0,0.0,7,0,7,1.0,0.0,1.0
109112,1,1,0,0,0,1,3,260,0.0,0.0,0.0,0.0,0.0,0.0,0.0,16,1,15,6.0,0.0,6.0
302063,0,0,0,0,0,0,0,313,0.0,0.0,0.0,0.0,0.0,0.0,0.0,9,0,9,4.0,0.0,4.0
302226,0,0,0,0,0,0,0,28,0.0,0.0,0.0,0.0,0.0,0.0,0.0,14,0,14,12.0,0.0,12.0
212118,0,0,0,0,0,0,0,91,0.0,0.0,0.0,0.0,0.0,0.0,0.0,30,0,30,6.0,0.0,6.0
12132,0,0,0,0,0,0,0,44,0.0,0.0,0.0,0.0,0.0,0.0,0.0,16,0,16,1.0,0.0,1.0
212054,0,0,0,0,0,0,0,620,0.0,0.0,0.0,0.0,0.0,0.0,0.0,4,0,4,1.0,0.0,1.0
9306249,0,0,0,0,0,0,0,1811,0.0,0.0,0.0,0.0,0.0,0.0,0.0,1,0,1,1.0,0.0,1.0
9505348,0,0,0,0,0,0,0,34,0.0,0.0,0.0,0.0,0.0,0.0,0.0,7,0,7,1.0,0.0,1.0
9708251,2,2,0,0,1,1,3,19,1.0,1.0,0.0,0.0,0.0,1.0,1.0,8,2,6,2.0,2.0,0.0
9407377,0,0,0,0,0,0,0,398,0.0,0.0,0.0,0.0,0.0,0.0,0.0,1,0,1,1.0,0.0,1.0
10168,0,0,0,0,0,0,0,666,0.0,0.0,0.0,0.0,0.0,0.0,0.0,2,0,2,1.0,0.0,1.0
204013,2,1,1,1,0,2,6,263,2.0,1.0,1.0,1.0,2.0,0.0,0.0,8,2,6,2.0,1.0,1.0
112262,0,0,0,0,0,0,0,347,0.0,0.0,0.0,0.0,0.0,0.0,0.0,3,0,3,2.0,0.0,2.0
6243,0,0,0,0,0,0,0,1625,,,,,,,,1,0,1,,,
3037,1,1,0,0,0,1,5,125,1.0,1.0,0.0,0.0,0.0,1.0,5.0,6,1,5,6.0,1.0,5.0
9706499,0,0,0,0,0,0,0,231,0.0,0.0,0.0,0.0,0.0,0.0,0.0,16,0,16,2.0,0.0,2.0
9504290,0,0,0,0,0,0,0,1836,0.0,0.0,0.0,0.0,0.0,0.0,0.0,3,0,3,1.0,0.0,1.0
302115,0,0,0,0,0,0,0,38,0.0,0.0,0.0,0.0,0.0,0.0,0.0,6,0,6,4.0,0.0,4.0
9811435,0,0,0,0,0,0,0,152,0.0,0.0,0.0,0.0,0.0,0.0,0.0,2,0,2,1.0,0.0,1.0
202263,1,1,0,0,1,0,0,270,1.0,1.0,0.0,0.0,1.0,0.0,0.0,5,1,4,3.0,0.0,3.0
5312,0,0,0,0,0,0,0,20,0.0,0.0,0.0,0.0,0.0,0.0,0.0,11,0,11,,,
9809278,0,0,0,0,0,0,0,876,0.0,0.0,0.0,0.0,0.0,0.0,0.0,2,0,2,,,
212182,0,0,0,0,0,0,0,52,0.0,0.0,0.0,0.0,0.0,0.0,0.0,5,0,5,3.0,0.0,3.0
205016,0,0,0,0,0,0,0,31,0.0,0.0,0.0,0.0,0.0,0.0,0.0,9,0,9,4.0,0.0,4.0
9707340,0,0,0,0,0,0,0,27,,,,,,,,5,0,5,1.0,0.0,1.0
9604346,0,0,0,0,0,0,0,233,0.0,0.0,0.0,0.0,0.0,0.0,0.0,2,0,2,1.0,0.0,1.0
9508218,0,0,0,0,0,0,0,86,0.0,0.0,0.0,0.0,0.0,0.0,0.0,15,0,15,6.0,0.0,6.0
9912541,0,0,0,0,0,0,0,15,0.0,0.0,0.0,0.0,0.0,0.0,0.0,23,0,23,1.0,0.0,1.0
203017,0,0,0,0,0,0,0,117,0.0,0.0,0.0,0.0,0.0,0.0,0.0,15,0,15,9.0,0.0,9.0
7089,0,0,0,0,0,0,0,1010,,,,,,,,3,0,3,,,
301034,0,0,0,0,0,0,0,10,0.0,0.0,0.0,0.0,0.0,0.0,0.0,42,0,42,4.0,0.0,4.0
109216,0,0,0,0,0,0,0,199,0.0,0.0,0.0,0.0,0.0,0.0,0.0,6,0,6,3.0,0.0,3.0
9809528,0,0,0,0,0,0,0,79,0.0,0.0,0.0,0.0,0.0,0.0,0.0,10,0,10,1.0,0.0,1.0
9810502,0,0,0,0,0,0,0,15,0.0,0.0,0.0,0.0,0.0,0.0,0.0,20,0,20,1.0,0.0,1.0
206046,1,1,0,0,0,1,4,221,0.0,0.0,0.0,0.0,0.0,0.0,0.0,7,1,6,4.0,0.0,4.0
202165,0,0,0,0,0,0,0,22,0.0,0.0,0.0,0.0,0.0,0.0,0.0,38,0,38,2.0,0.0,2.0
210067,0,0,0,0,0,0,0,7,0.0,0.0,0.0,0.0,0.0,0.0,0.0,10,0,10,7.0,0.0,7.0
9708341,0,0,0,0,0,0,0,40,0.0,0.0,0.0,0.0,0.0,0.0,0.0,8,0,8,,,
9907416,0,0,0,0,0,0,0,1863,0.0,0.0,0.0,0.0,0.0,0.0,0.0,3,0,3,1.0,0.0,1.0
301152,0,0,0,0,0,0,0,319,0.0,0.0,0.0,0.0,0.0,0.0,0.0,1,0,1,1.0,0.0,1.0
210341,1,1,0,0,0,1,4,9,1.0,1.0,0.0,0.0,1.0,0.0,0.0,9,1,8,,,
10318,0,0,0,0,0,0,0,6,0.0,0.0,0.0,0.0,0.0,0.0,0.0,24,0,24,10.0,0.0,10.0
9506365,0,0,0,0,0,0,0,156,,,,,,,,1,0,1,,,
207058,0,0,0,0,0,0,0,11,0.0,0.0,0.0,0.0,0.0,0.0,0.0,41,0,41,28.0,0.0,28.0
9612484,0,0,0,0,0,0,0,41,0.0,0.0,0.0,0.0,0.0,0.0,0.0,11,0,11,7.0,0.0,7.0
9712449,0,0,0,0,0,0,0,210,0.0,0.0,0.0,0.0,0.0,0.0,0.0,5,0,5,1.0,0.0,1.0
112307,0,0,0,0,0,0,0,43,,,,,,,,8,0,8,1.0,0.0,1.0
209345,0,0,0,0,0,0,0,112,0.0,0.0,0.0,0.0,0.0,0.0,0.0,12,0,12,7.0,0.0,7.0
9808420,0,0,0,0,0,0,0,110,,,,,,,,1,0,1,1.0,0.0,1.0
12243,0,0,0,0,0,0,0,35,0.0,0.0,0.0,0.0,0.0,0.0,0.0,8,0,8,1.0,0.0,1.0
105020,0,0,0,0,0,0,0,259,0.0,0.0,0.0,0.0,0.0,0.0,0.0,4,0,4,2.0,0.0,2.0
209076,0,0,0,0,0,0,0,1592,,,,,,,,2,0,2,,,
9811424,0,0,0,0,0,0,0,281,0.0,0.0,0.0,0.0,0.0,0.0,0.0,5,0,5,4.0,0.0,4.0
211298,0,0,0,0,0,0,0,244,0.0,0.0,0.0,0.0,0.0,0.0,0.0,5,0,5,1.0,0.0,1.0
9402261,0,0,0,0,0,0,0,1783,,,,,,,,1,0,1,,,
9707255,0,0,0,0,0,0,0,120,0.0,0.0,0.0,0.0,0.0,0.0,0.0,4,0,4,1.0,0.0,1.0
210275,0,0,0,0,0,0,0,78,0.0,0.0,0.0,0.0,0.0,0.0,0.0,13,0,13,7.0,0.0,7.0
301017,0,0,0,0,0,0,0,16,0.0,0.0,0.0,0.0,0.0,0.0,0.0,5,0,5,5.0,0.0,5.0
301249,0,0,0,0,0,0,0,21,0.0,0.0,0.0,0.0,0.0,0.0,0.0,36,0,36,4.0,0.0,4.0
9402237,0,0,0,0,0,0,0,1459,,,,,,,,1,0,1,1.0,0.0,1.0
11207,0,0,0,0,0,0,0,18,0.0,0.0,0.0,0.0,0.0,0.0,0.0,26,0,26,9.0,0.0,9.0
9906314,0,0,0,0,0,0,0,1607,,,,,,,,1,0,1,,,
2139,0,0,0,0,0,0,0,180,0.0,0.0,0.0,0.0,0.0,0.0,0.0,5,0,5,5.0,0.0,5.0
302144,0,0,0,0,0,0,0,27,0.0,0.0,0.0,0.0,0.0,0.0,0.0,14,0,14,4.0,0.0,4.0
301076,0,0,0,0,0,0,0,1455,,,,,,,,1,0,1,1.0,0.0,1.0
1126,0,0,0,0,0,0,0,32,,,,,,,,10,0,10,1.0,0.0,1.0
9603375,0,0,0,0,0,0,0,130,0.0,0.0,0.0,0.0,0.0,0.0,0.0,7,0,7,4.0,0.0,4.0
9207248,1,1,0,0,1,0,0,1984,1.0,1.0,0.0,0.0,1.0,0.0,0.0,1,1,0,1.0,1.0,0.0
9305246,1,1,0,0,1,0,0,494,1.0,1.0,0.0,0.0,1.0,0.0,0.0,1,1,0,1.0,1.0,0.0
302214,0,0,0,0,0,0,0,33,0.0,0.0,0.0,0.0,0.0,0.0,0.0,9,0,9,2.0,0.0,2.0
9307309,0,0,0,0,0,0,0,243,0.0,0.0,0.0,0.0,0.0,0.0,0.0,9,0,9,4.0,0.0,4.0
9903217,31,11,20,54,5,26,82,31,17.0,5.0,12.0,33.0,3.0,14.0,27.0,40,31,9,13.0,12.0,1.0
112133,4,4,0,0,1,3,11,1,1.0,1.0,0.0,0.0,0.0,1.0,3.0,16,4,12,3.0,0.0,3.0
6001,66,6,60,295,2,64,383,1,38.0,2.0,36.0,186.0,0.0,38.0,236.0,89,66,23,31.0,21.0,10.0
104018,3,2,1,1,0,3,10,1,1.0,1.0,0.0,0.0,0.0,1.0,5.0,22,3,19,1.0,1.0,0.0
9911427,49,6,43,179,6,43,134,7,10.0,3.0,7.0,12.0,2.0,8.0,28.0,66,49,17,13.0,7.0,6.0
9311339,103,19,84,558,39,64,142,6,39.0,7.0,32.0,226.0,4.0,35.0,82.0,107,103,4,23.0,21.0,2.0
9412324,42,11,31,125,28,14,28,6,17.0,4.0,13.0,46.0,8.0,9.0,19.0,48,42,6,14.0,11.0,3.0
102345,2,2,0,0,2,0,0,498,1.0,1.0,0.0,0.0,1.0,0.0,0.0,2,2,0,1.0,1.0,0.0
9608365,70,12,58,320,9,61,266,34,31.0,4.0,27.0,186.0,0.0,31.0,150.0,83,70,13,31.0,24.0,7.0
9603261,68,6,62,236,23,45,103,6,38.0,2.0,36.0,126.0,10.0,28.0,70.0,77,68,9,11.0,9.0,2.0
9509329,36,11,25,61,1,35,416,1,13.0,5.0,8.0,23.0,0.0,13.0,135.0,108,36,72,20.0,7.0,13.0
9304230,38,11,27,48,38,0,0,35,7.0,2.0,5.0,9.0,7.0,0.0,0.0,38,38,0,5.0,5.0,0.0
9801317,7,5,2,2,5,2,3,4,3.0,1.0,2.0,2.0,3.0,0.0,0.0,11,7,4,2.0,0.0,2.0
9805366,8,5,3,3,0,8,21,35,2.0,2.0,0.0,0.0,0.0,2.0,2.0,23,8,15,2.0,1.0,1.0
9404335,30,6,24,41,14,16,25,35,11.0,1.0,10.0,18.0,2.0,9.0,12.0,35,30,5,4.0,4.0,0.0
9203223,127,38,89,346,127,0,0,4,20.0,2.0,18.0,64.0,20.0,0.0,0.0,127,127,0,14.0,14.0,0.0
9501379,38,11,27,89,12,26,46,35,22.0,3.0,19.0,61.0,1.0,21.0,37.0,42,38,4,6.0,5.0,1.0
9301283,9,4,5,8,9,0,0,48,4.0,1.0,3.0,4.0,4.0,0.0,0.0,9,9,0,4.0,4.0,0.0
9602208,98,12,86,315,22,76,203,43,22.0,1.0,21.0,107.0,1.0,21.0,65.0,114,98,16,19.0,15.0,4.0
9703221,34,7,27,92,2,32,115,48,24.0,6.0,18.0,52.0,0.0,24.0,94.0,42,34,8,15.0,9.0,6.0
9801444,43,8,35,84,11,32,52,43,12.0,1.0,11.0,33.0,4.0,8.0,15.0,48,43,5,7.0,5.0,2.0
9811430,3,2,1,1,3,0,0,62,0.0,0.0,0.0,0.0,0.0,0.0,0.0,16,3,13,3.0,0.0,3.0
9912320,6,1,5,7,2,4,10,80,3.0,3.0,0.0,0.0,2.0,1.0,1.0,11,6,5,5.0,4.0,1.0
105325,13,6,7,9,1,12,86,4,6.0,3.0,3.0,3.0,0.0,6.0,29.0,43,13,30,8.0,0.0,8.0
9205203,18,5,13,23,18,0,0,26,12.0,3.0,9.0,14.0,12.0,0.0,0.0,18,18,0,3.0,3.0,0.0
9507438,9,4,5,8,5,4,5,26,6.0,3.0,3.0,5.0,2.0,4.0,5.0,12,9,3,4.0,3.0,1.0
9806289,9,4,5,7,0,9,32,26,8.0,3.0,5.0,6.0,0.0,8.0,28.0,19,9,10,11.0,7.0,4.0
9702325,11,6,5,7,3,8,13,170,6.0,3.0,3.0,3.0,0.0,6.0,8.0,20,11,9,9.0,6.0,3.0
6114,15,7,8,11,1,14,57,2,4.0,2.0,2.0,3.0,4.0,0.0,0.0,24,15,9,3.0,3.0,0.0
9504418,16,3,13,32,16,0,0,60,8.0,1.0,7.0,16.0,8.0,0.0,0.0,16,16,0,4.0,4.0,0.0
9603368,39,6,33,111,15,24,55,4,14.0,3.0,11.0,37.0,7.0,7.0,7.0,45,39,6,10.0,8.0,2.0
9908409,13,9,4,6,0,13,46,35,9.0,6.0,3.0,3.0,0.0,9.0,26.0,27,13,14,4.0,0.0,4.0
3246,92,19,73,339,2,90,613,4,52.0,7.0,45.0,222.0,0.0,52.0,415.0,116,92,24,46.0,31.0,15.0
111179,11,5,6,8,3,8,42,69,0.0,0.0,0.0,0.0,0.0,0.0,0.0,27,11,16,10.0,0.0,10.0
9901389,102,1,101,887,1,101,562,32,71.0,1.0,70.0,686.0,0.0,71.0,343.0,133,102,31,60.0,53.0,7.0
9711395,283,16,267,3497,229,54,60,20,172.0,1.0,171.0,2909.0,172.0,0.0,0.0,285,283,2,89.0,89.0,0.0
9303219,8,6,2,4,5,3,4,342,3.0,2.0,1.0,1.0,2.0,1.0,1.0,11,8,3,5.0,4.0,1.0
9210208,33,8,25,122,33,0,0,116,23.0,3.0,20.0,106.0,23.0,0.0,0.0,33,33,0,18.0,18.0,0.0
9405418,53,5,48,249,20,33,44,25,27.0,2.0,25.0,151.0,9.0,18.0,24.0,57,53,4,24.0,22.0,2.0
9609209,45,20,25,55,16,29,147,61,6.0,5.0,1.0,1.0,0.0,6.0,35.0,66,45,21,14.0,6.0,8.0
9410232,29,5,24,89,2,27,118,25,20.0,3.0,17.0,72.0,0.0,20.0,68.0,43,29,14,23.0,17.0,6.0
9601324,71,15,56,203,10,61,61,41,27.0,4.0,23.0,108.0,0.0,27.0,27.0,72,71,1,19.0,18.0,1.0
9503259,26,1,25,59,11,15,31,42,7.0,1.0,6.0,11.0,1.0,6.0,6.0,30,26,4,5.0,5.0,0.0
9501334,202,26,176,1101,68,134,141,55,69.0,6.0,63.0,566.0,15.0,54.0,54.0,204,202,2,43.0,42.0,1.0
9503264,80,4,76,437,20,60,108,12,37.0,3.0,34.0,141.0,3.0,34.0,63.0,84,80,4,27.0,24.0,3.0
9604218,25,10,15,24,23,2,2,0,3.0,1.0,2.0,2.0,1.0,2.0,2.0,29,25,4,3.0,3.0,0.0
9807283,81,4,77,569,2,79,220,3,66.0,4.0,62.0,511.0,2.0,64.0,171.0,90,81,9,45.0,41.0,4.0
9905240,33,2,31,200,20,13,19,0,24.0,1.0,23.0,159.0,12.0,12.0,17.0,37,33,4,20.0,20.0,0.0
9712495,100,9,91,524,28,72,197,0,48.0,2.0,46.0,308.0,20.0,28.0,40.0,121,100,21,37.0,37.0,0.0
9810328,45,11,34,128,6,39,100,3,19.0,2.0,17.0,58.0,1.0,18.0,52.0,55,45,10,13.0,12.0,1.0
9705366,57,7,50,219,13,44,129,3,15.0,1.0,14.0,53.0,5.0,10.0,10.0,70,57,13,13.0,12.0,1.0
9901318,48,11,37,125,8,40,158,3,24.0,3.0,21.0,75.0,0.0,24.0,113.0,57,48,9,24.0,18.0,6.0
9911224,11,7,4,4,1,10,43,0,6.0,3.0,3.0,3.0,0.0,6.0,24.0,108,11,97,8.0,0.0,8.0
9511220,9,2,7,11,2,7,11,119,7.0,2.0,5.0,8.0,2.0,5.0,9.0,12,9,3,9.0,6.0,3.0
9505281,27,6,21,66,19,8,14,0,10.0,5.0,5.0,8.0,8.0,2.0,2.0,34,27,7,7.0,7.0,0.0
9809501,12,5,7,15,3,9,31,0,3.0,2.0,1.0,1.0,0.0,3.0,8.0,19,12,7,7.0,4.0,3.0
9806490,1,1,0,0,0,1,7,0,0.0,0.0,0.0,0.0,0.0,0.0,0.0,12,1,11,3.0,0.0,3.0
9602386,14,7,7,11,4,10,44,0,4.0,2.0,2.0,3.0,0.0,4.0,7.0,24,14,10,3.0,2.0,1.0
9809540,13,7,6,10,13,0,0,0,2.0,2.0,0.0,0.0,2.0,0.0,0.0,13,13,0,2.0,2.0,0.0
9803440,59,6,53,191,5,54,225,0,11.0,4.0,7.0,18.0,0.0,11.0,38.0,77,59,18,9.0,7.0,2.0
9804310,20,5,15,28,4,16,103,0,8.0,2.0,6.0,10.0,0.0,8.0,41.0,45,20,25,9.0,4.0,5.0
9309223,116,12,104,799,96,20,24,3,65.0,3.0,62.0,531.0,65.0,0.0,0.0,120,116,4,25.0,25.0,0.0
4064,6,6,0,0,2,4,5,60,1.0,1.0,0.0,0.0,1.0,0.0,0.0,16,6,10,1.0,1.0,0.0
9301268,40,11,29,88,40,0,0,81,24.0,3.0,21.0,68.0,24.0,0.0,0.0,40,40,0,8.0,8.0,0.0
9607265,26,3,23,52,17,9,10,51,16.0,2.0,14.0,29.0,8.0,8.0,9.0,29,26,3,9.0,8.0,1.0
9603378,144,2,142,1306,53,91,103,21,94.0,1.0,93.0,891.0,21.0,73.0,79.0,148,144,4,50.0,49.0,1.0
9207234,232,37,195,1467,232,0,0,18,80.0,4.0,76.0,726.0,80.0,0.0,0.0,232,232,0,41.0,41.0,0.0
9510369,4,4,0,0,2,2,7,99,1.0,1.0,0.0,0.0,0.0,1.0,2.0,9,4,5,3.0,1.0,2.0
9502330,19,6,13,21,8,11,31,63,5.0,4.0,1.0,1.0,1.0,4.0,14.0,28,19,9,12.0,5.0,7.0
9811479,10,3,7,9,0,10,94,46,10.0,3.0,7.0,9.0,0.0,10.0,79.0,29,10,19,5.0,3.0,2.0
9505295,12,8,4,6,1,11,50,3,5.0,2.0,3.0,4.0,0.0,5.0,18.0,21,12,9,6.0,3.0,3.0
9809587,6,2,4,5,0,6,26,0,3.0,1.0,2.0,2.0,0.0,3.0,15.0,13,6,7,6.0,2.0,4.0
9810232,106,23,83,306,8,98,681,12,17.0,8.0,9.0,14.0,0.0,17.0,93.0,194,106,88,28.0,8.0,20.0
9206206,21,8,13,30,21,0,0,81,11.0,2.0,9.0,19.0,11.0,0.0,0.0,21,21,0,7.0,7.0,0.0
9811498,46,7,39,183,1,45,287,12,23.0,2.0,21.0,74.0,0.0,23.0,215.0,86,46,40,18.0,16.0,2.0
9607394,212,33,179,851,53,159,425,5,33.0,4.0,29.0,139.0,10.0,23.0,23.0,229,212,17,31.0,28.0,3.0
9709447,19,7,12,18,3,16,39,169,8.0,3.0,5.0,10.0,1.0,7.0,13.0,29,19,10,10.0,6.0,4.0
105213,9,4,5,5,0,9,24,1,4.0,2.0,2.0,2.0,4.0,0.0,0.0,17,9,8,4.0,3.0,1.0
9409290,33,3,30,175,3,30,113,1,28.0,2.0,26.0,159.0,4.0,24.0,96.0,43,33,10,15.0,9.0,6.0
9504387,16,6,10,32,16,0,0,48,10.0,2.0,8.0,22.0,10.0,0.0,0.0,18,16,2,10.0,10.0,0.0
9712224,95,9,86,656,2,93,596,1,60.0,2.0,58.0,459.0,1.0,59.0,405.0,114,95,19,47.0,39.0,8.0
9512219,6,6,0,0,3,3,3,436,1.0,1.0,0.0,0.0,1.0,0.0,0.0,14,6,8,2.0,1.0,1.0
9907555,49,5,44,263,2,47,520,32,19.0,3.0,16.0,70.0,0.0,19.0,320.0,95,49,46,39.0,18.0,21.0
9809594,44,6,38,217,2,42,97,34,30.0,2.0,28.0,168.0,1.0,29.0,60.0,54,44,10,20.0,17.0,3.0
12019,11,2,9,17,0,11,54,34,7.0,1.0,6.0,13.0,0.0,7.0,33.0,37,11,26,8.0,5.0,3.0
9605408,114,10,104,875,3,111,495,5,76.0,3.0,73.0,674.0,0.0,76.0,374.0,122,114,8,54.0,47.0,7.0
9702410,13,2,11,18,2,11,38,5,7.0,1.0,6.0,10.0,0.0,7.0,28.0,20,13,7,1.0,1.0,0.0
9710217,28,8,20,56,5,23,268,5,17.0,3.0,14.0,39.0,0.0,17.0,222.0,63,28,35,31.0,11.0,20.0
9412393,27,4,23,60,6,21,44,1,21.0,3.0,18.0,47.0,3.0,18.0,22.0,33,27,6,15.0,13.0,2.0
9504270,2,2,0,0,2,0,0,93,0.0,0.0,0.0,0.0,0.0,0.0,0.0,4,2,2,1.0,0.0,1.0
9606482,1,1,0,0,0,1,1,192,0.0,0.0,0.0,0.0,0.0,0.0,0.0,4,1,3,2.0,0.0,2.0
109243,1,1,0,0,0,1,6,1,0.0,0.0,0.0,0.0,0.0,0.0,0.0,35,1,34,2.0,0.0,2.0
110124,7,3,4,7,0,7,31,6,4.0,2.0,2.0,2.0,0.0,4.0,11.0,31,7,24,10.0,2.0,8.0
9907391,27,4,23,93,0,27,114,6,15.0,2.0,13.0,34.0,2.0,13.0,24.0,39,27,12,16.0,11.0,5.0
9605220,57,4,53,294,1,56,297,1,41.0,5.0,36.0,211.0,1.0,40.0,232.0,77,57,20,22.0,13.0,9.0
105003,33,5,28,125,0,33,294,1,29.0,4.0,25.0,118.0,0.0,29.0,256.0,57,33,24,35.0,23.0,12.0
9807495,9,2,7,16,1,8,25,1,4.0,1.0,3.0,5.0,0.0,4.0,6.0,15,9,6,2.0,0.0,2.0
9710438,50,8,42,204,3,47,155,4,25.0,2.0,23.0,132.0,1.0,24.0,24.0,78,50,28,8.0,7.0,1.0
9612269,120,12,108,677,24,96,254,1,40.0,6.0,34.0,215.0,5.0,35.0,106.0,138,120,18,21.0,18.0,3.0
9505249,7,5,2,2,3,4,7,134,1.0,1.0,0.0,0.0,1.0,0.0,0.0,12,7,5,3.0,1.0,2.0
9606211,267,30,237,1788,28,239,1031,4,68.0,5.0,63.0,538.0,2.0,66.0,296.0,308,267,41,41.0,35.0,6.0
9711258,20,2,18,54,0,20,103,21,16.0,2.0,14.0,44.0,2.0,14.0,26.0,43,20,23,13.0,10.0,3.0
9607473,39,8,31,109,9,30,54,7,16.0,2.0,14.0,42.0,3.0,13.0,13.0,57,39,18,10.0,9.0,1.0
9506248,82,9,73,215,34,48,146,7,15.0,2.0,13.0,29.0,8.0,7.0,17.0,94,82,12,11.0,7.0,4.0
9802299,80,11,69,249,42,38,75,9,23.0,2.0,21.0,79.0,23.0,0.0,0.0,93,80,13,9.0,3.0,6.0
9904283,44,6,38,116,0,44,284,32,29.0,3.0,26.0,82.0,1.0,28.0,148.0,68,44,24,11.0,9.0,2.0
9507426,16,4,12,21,3,13,28,12,9.0,5.0,4.0,9.0,1.0,8.0,16.0,23,16,7,5.0,5.0,0.0
9403219,71,9,62,345,3,68,181,15,44.0,3.0,41.0,277.0,1.0,43.0,111.0,81,71,10,33.0,29.0,4.0
9401331,7,4,3,4,6,1,1,69,1.0,1.0,0.0,0.0,0.0,1.0,1.0,8,7,1,3.0,2.0,1.0
9703348,29,7,22,39,7,22,52,98,18.0,2.0,16.0,31.0,5.0,13.0,24.0,37,29,8,13.0,9.0,4.0
9608437,1,1,0,0,0,1,1,771,0.0,0.0,0.0,0.0,0.0,0.0,0.0,4,1,3,2.0,0.0,2.0
9706297,48,4,44,194,1,47,195,19,21.0,3.0,18.0,60.0,1.0,20.0,47.0,58,48,10,23.0,17.0,6.0
9712269,9,1,8,10,0,9,31,62,6.0,2.0,4.0,5.0,0.0,6.0,6.0,21,9,12,5.0,3.0,2.0
9603390,15,3,12,40,9,6,13,62,10.0,1.0,9.0,30.0,6.0,4.0,10.0,20,15,5,8.0,6.0,2.0
9501228,26,6,20,67,21,5,10,95,14.0,1.0,13.0,51.0,14.0,0.0,0.0,32,26,6,11.0,11.0,0.0
9703298,58,9,49,328,6,52,126,24,33.0,1.0,32.0,245.0,5.0,28.0,47.0,63,58,5,29.0,27.0,2.0
9802290,297,22,275,1895,178,119,352,16,98.0,4.0,94.0,855.0,22.0,76.0,270.0,306,297,9,47.0,40.0,7.0
9501232,34,10,24,66,29,5,6,127,17.0,1.0,16.0,40.0,17.0,0.0,0.0,38,34,4,10.0,10.0,0.0
9407399,31,10,21,59,19,12,13,57,14.0,3.0,11.0,36.0,14.0,0.0,0.0,34,31,3,8.0,8.0,0.0
11363,81,26,55,163,37,44,100,80,24.0,5.0,19.0,65.0,8.0,16.0,41.0,110,81,29,14.0,10.0,4.0
9601371,16,11,5,7,13,3,3,302,0.0,0.0,0.0,0.0,0.0,0.0,0.0,22,16,6,2.0,2.0,0.0
9805481,8,5,3,5,2,6,42,19,4.0,2.0,2.0,4.0,0.0,4.0,23.0,38,8,30,18.0,4.0,14.0
9711244,26,2,24,124,3,23,88,4,15.0,1.0,14.0,64.0,2.0,13.0,27.0,39,26,13,11.0,11.0,0.0
9305327,6,4,2,2,6,0,0,163,1.0,1.0,0.0,0.0,1.0,0.0,0.0,6,6,0,,,
9507372,12,8,4,6,3,9,12,86,4.0,2.0,2.0,2.0,0.0,4.0,4.0,24,12,12,3.0,3.0,0.0
9308203,21,11,10,28,21,0,0,134,9.0,4.0,5.0,14.0,9.0,0.0,0.0,21,21,0,3.0,3.0,0.0
9403313,14,4,10,26,2,12,22,6,2.0,2.0,0.0,0.0,2.0,0.0,0.0,16,14,2,6.0,6.0,0.0
9601307,24,9,15,51,5,19,45,85,14.0,2.0,12.0,39.0,6.0,8.0,13.0,36,24,12,12.0,11.0,1.0
9903480,7,1,6,10,0,7,28,6,2.0,1.0,1.0,1.0,1.0,1.0,2.0,21,7,14,6.0,4.0,2.0
9308337,39,22,17,26,19,20,20,85,9.0,9.0,0.0,0.0,1.0,8.0,8.0,42,39,3,8.0,7.0,1.0
9405347,14,5,9,21,4,10,10,6,5.0,2.0,3.0,4.0,5.0,0.0,0.0,15,14,1,2.0,2.0,0.0
9511391,37,7,30,90,6,31,100,87,17.0,2.0,15.0,52.0,0.0,17.0,64.0,45,37,8,20.0,15.0,5.0
9803446,4,4,0,0,1,3,22,287,3.0,3.0,0.0,0.0,0.0,3.0,16.0,17,4,13,5.0,3.0,2.0
9703356,12,5,7,14,0,12,48,8,4.0,1.0,3.0,5.0,4.0,0.0,0.0,22,12,10,4.0,4.0,0.0
101103,53,18,35,72,7,46,371,22,12.0,6.0,6.0,7.0,0.0,12.0,118.0,174,53,121,36.0,2.0,34.0
9308243,14,5,9,16,14,0,0,355,5.0,3.0,2.0,3.0,5.0,0.0,0.0,14,14,0,4.0,4.0,0.0
9612431,20,3,17,59,4,16,16,45,9.0,2.0,7.0,20.0,2.0,7.0,7.0,21,20,1,4.0,4.0,0.0
9612286,21,15,6,7,6,15,60,15,9.0,7.0,2.0,3.0,1.0,8.0,19.0,34,21,13,9.0,2.0,7.0
9706397,31,9,22,74,2,29,116,22,10.0,3.0,7.0,14.0,0.0,10.0,39.0,49,31,18,17.0,10.0,7.0
9508202,79,8,71,469,59,20,25,22,36.0,2.0,34.0,258.0,36.0,0.0,0.0,82,79,3,20.0,20.0,0.0
9907545,36,8,28,69,2,34,214,22,16.0,3.0,13.0,39.0,0.0,16.0,142.0,59,36,23,30.0,14.0,16.0
9505257,3,2,1,1,0,3,16,88,1.0,1.0,0.0,0.0,0.0,1.0,3.0,14,3,11,8.0,1.0,7.0
9907342,12,6,6,13,4,8,37,88,7.0,1.0,6.0,13.0,1.0,6.0,23.0,24,12,12,14.0,6.0,8.0
9309263,18,11,7,9,18,0,0,52,4.0,4.0,0.0,0.0,4.0,0.0,0.0,18,18,0,5.0,5.0,0.0
9612264,23,4,19,62,4,19,65,21,13.0,3.0,10.0,28.0,3.0,10.0,20.0,34,23,11,12.0,10.0,2.0
9812289,24,9,15,23,2,22,107,21,11.0,6.0,5.0,9.0,0.0,11.0,49.0,43,24,19,9.0,2.0,7.0
9505225,34,8,26,86,7,27,100,94,15.0,3.0,12.0,43.0,4.0,11.0,49.0,50,34,16,18.0,9.0,9.0
9803475,15,4,11,29,1,14,71,19,6.0,4.0,2.0,3.0,0.0,6.0,14.0,28,15,13,6.0,3.0,3.0
9904332,3,3,0,0,0,3,7,66,0.0,0.0,0.0,0.0,0.0,0.0,0.0,11,3,8,1.0,1.0,0.0
9912329,59,4,55,552,4,55,196,19,50.0,4.0,46.0,501.0,1.0,49.0,178.0,66,59,7,46.0,41.0,5.0
9503291,56,16,40,124,56,0,0,77,17.0,2.0,15.0,48.0,17.0,0.0,0.0,56,56,0,8.0,8.0,0.0
9211202,24,6,18,54,24,0,0,101,14.0,3.0,11.0,36.0,14.0,0.0,0.0,24,24,0,5.0,5.0,0.0
101067,24,3,21,91,0,24,198,20,22.0,2.0,20.0,88.0,0.0,22.0,190.0,44,24,20,11.0,11.0,0.0
9910491,78,2,76,617,1,77,584,20,73.0,2.0,71.0,589.0,1.0,72.0,563.0,96,78,18,58.0,44.0,14.0
6106,8,6,2,3,0,8,59,20,7.0,5.0,2.0,3.0,0.0,7.0,44.0,21,8,13,5.0,2.0,3.0
9403401,56,3,53,277,6,50,120,17,41.0,2.0,39.0,230.0,3.0,38.0,71.0,63,56,7,14.0,12.0,2.0
9704394,16,4,12,28,2,14,58,136,14.0,3.0,11.0,26.0,0.0,14.0,58.0,24,16,8,20.0,12.0,8.0
9908320,10,4,6,10,0,10,35,136,10.0,4.0,6.0,10.0,0.0,10.0,35.0,20,10,10,15.0,6.0,9.0
9173,18,7,11,16,0,18,263,20,13.0,4.0,9.0,14.0,0.0,13.0,230.0,49,18,31,40.0,10.0,30.0
9905377,12,5,7,15,2,10,36,122,9.0,2.0,7.0,15.0,0.0,9.0,22.0,20,12,8,11.0,8.0,3.0
202093,13,2,11,31,0,13,19,37,9.0,1.0,8.0,24.0,0.0,9.0,9.0,15,13,2,11.0,10.0,1.0
9904495,23,4,19,65,1,22,123,2,12.0,3.0,9.0,18.0,0.0,12.0,75.0,31,23,8,11.0,7.0,4.0
9403253,21,9,12,21,8,13,23,6,4.0,2.0,2.0,3.0,4.0,0.0,0.0,27,21,6,4.0,3.0,1.0
9303291,71,16,55,240,62,9,9,18,13.0,2.0,11.0,56.0,13.0,0.0,0.0,72,71,1,13.0,13.0,0.0
9811386,25,9,16,37,0,25,156,7,6.0,3.0,3.0,7.0,0.0,6.0,36.0,91,25,66,14.0,7.0,7.0
9608449,18,8,10,17,1,17,67,7,6.0,4.0,2.0,4.0,0.0,6.0,29.0,25,18,7,1.0,1.0,0.0
9309281,1,1,0,0,0,1,2,10,0.0,0.0,0.0,0.0,0.0,0.0,0.0,4,1,3,1.0,0.0,1.0
9711492,4,4,0,0,1,3,4,25,0.0,0.0,0.0,0.0,0.0,0.0,0.0,31,4,27,8.0,0.0,8.0
9807265,5,1,4,6,0,5,51,5,1.0,1.0,0.0,0.0,0.0,1.0,16.0,44,5,39,11.0,0.0,11.0
9703443,12,4,8,20,0,12,33,42,9.0,2.0,7.0,17.0,0.0,9.0,28.0,16,12,4,11.0,8.0,3.0
9311346,17,11,6,8,5,12,22,15,5.0,5.0,0.0,0.0,2.0,3.0,4.0,24,17,7,3.0,2.0,1.0
9403358,17,9,8,13,3,14,19,35,5.0,1.0,4.0,8.0,0.0,5.0,6.0,23,17,6,4.0,3.0,1.0
9608275,22,6,16,34,1,21,174,5,12.0,2.0,10.0,21.0,0.0,12.0,90.0,46,22,24,3.0,2.0,1.0
9704457,60,6,54,234,24,36,85,5,27.0,3.0,24.0,100.0,14.0,13.0,20.0,70,60,10,21.0,15.0,6.0
9401311,57,15,42,92,41,16,29,162,7.0,2.0,5.0,8.0,5.0,2.0,2.0,63,57,6,6.0,6.0,0.0
9302281,31,7,24,79,31,0,0,94,16.0,4.0,12.0,31.0,16.0,0.0,0.0,31,31,0,8.0,8.0,0.0
9809590,12,6,6,9,1,11,19,48,2.0,1.0,1.0,1.0,0.0,2.0,7.0,18,12,6,3.0,3.0,0.0
9910357,4,1,3,4,0,4,8,70,0.0,0.0,0.0,0.0,0.0,0.0,0.0,21,4,17,2.0,0.0,2.0
9705362,3,1,2,3,0,3,7,310,3.0,1.0,2.0,3.0,0.0,3.0,7.0,7,3,4,6.0,3.0,3.0
9907400,21,3,18,46,0,21,174,3,21.0,3.0,18.0,46.0,0.0,21.0,172.0,46,21,25,8.0,6.0,2.0
9910349,3,3,0,0,2,1,1,263,1.0,1.0,0.0,0.0,1.0,0.0,0.0,6,3,3,1.0,1.0,0.0
9711438,13,3,10,21,2,11,15,191,6.0,1.0,5.0,9.0,0.0,6.0,9.0,15,13,2,7.0,6.0,1.0
9903476,30,8,22,43,13,17,68,41,11.0,2.0,9.0,20.0,1.0,10.0,43.0,55,30,25,14.0,7.0,7.0
9710353,14,8,6,7,3,11,136,36,6.0,4.0,2.0,2.0,0.0,6.0,107.0,66,14,52,44.0,3.0,41.0
9604310,7,6,1,1,4,3,3,89,2.0,2.0,0.0,0.0,2.0,0.0,0.0,8,7,1,2.0,2.0,0.0
9902203,6,1,5,8,2,4,7,227,5.0,1.0,4.0,7.0,2.0,3.0,4.0,11,6,5,9.0,6.0,3.0
9409353,1,1,0,0,0,1,5,49,0.0,0.0,0.0,0.0,0.0,0.0,0.0,7,1,6,3.0,0.0,3.0
9906300,6,6,0,0,0,6,48,6,1.0,1.0,0.0,0.0,0.0,1.0,9.0,50,6,44,17.0,3.0,14.0
9612293,8,4,4,8,0,8,38,6,4.0,1.0,3.0,6.0,0.0,4.0,30.0,34,8,26,7.0,3.0,4.0
9604279,38,11,27,60,10,28,76,13,10.0,3.0,7.0,13.0,0.0,10.0,28.0,56,38,18,4.0,4.0,0.0
9702431,12,6,6,9,0,12,62,10,0.0,0.0,0.0,0.0,0.0,0.0,0.0,69,12,57,10.0,1.0,9.0
9512398,15,5,10,19,0,15,57,10,5.0,1.0,4.0,7.0,1.0,4.0,9.0,32,15,17,4.0,1.0,3.0
103065,57,8,49,269,8,49,343,55,27.0,4.0,23.0,93.0,0.0,27.0,217.0,89,57,32,39.0,21.0,18.0
9703259,62,9,53,179,7,55,276,5,21.0,5.0,16.0,62.0,8.0,13.0,22.0,80,62,18,22.0,15.0,7.0
2186,29,7,22,40,0,29,139,0,12.0,5.0,7.0,11.0,0.0,12.0,45.0,45,29,16,12.0,7.0,5.0
9504311,9,6,3,3,4,5,5,56,3.0,2.0,1.0,1.0,3.0,0.0,0.0,10,9,1,1.0,1.0,0.0
9908429,32,8,24,109,0,32,256,3,25.0,5.0,20.0,97.0,0.0,25.0,209.0,49,32,17,12.0,4.0,8.0
9709437,2,2,0,0,0,2,12,124,0.0,0.0,0.0,0.0,0.0,0.0,0.0,46,2,44,21.0,0.0,21.0
9402205,14,3,11,52,0,14,59,124,13.0,2.0,11.0,52.0,0.0,13.0,53.0,21,14,7,17.0,12.0,5.0
9810360,87,9,78,524,30,57,212,18,51.0,2.0,49.0,361.0,10.0,41.0,149.0,99,87,12,40.0,36.0,4.0
8102,39,15,24,64,1,38,402,24,19.0,8.0,11.0,32.0,0.0,19.0,245.0,87,39,48,25.0,12.0,13.0
9908531,33,2,31,185,0,33,228,23,27.0,1.0,26.0,163.0,1.0,26.0,100.0,75,33,42,29.0,25.0,4.0
12192,4,4,0,0,1,3,10,5,0.0,0.0,0.0,0.0,0.0,0.0,0.0,19,4,15,2.0,0.0,2.0
11214,5,3,2,2,2,3,17,152,2.0,1.0,1.0,1.0,0.0,2.0,10.0,20,5,15,8.0,2.0,6.0
9701219,45,8,37,118,3,42,167,18,22.0,1.0,21.0,80.0,1.0,21.0,53.0,67,45,22,8.0,4.0,4.0
9908390,29,1,28,116,7,22,57,32,16.0,1.0,15.0,55.0,0.0,16.0,48.0,35,29,6,21.0,17.0,4.0
9207233,13,2,11,22,13,0,0,58,2.0,2.0,0.0,0.0,2.0,0.0,0.0,13,13,0,4.0,4.0,0.0
101106,36,10,26,54,4,32,227,32,12.0,3.0,9.0,25.0,0.0,12.0,111.0,75,36,39,14.0,4.0,10.0
9908223,17,5,12,35,2,15,56,73,8.0,1.0,7.0,19.0,0.0,8.0,10.0,31,17,14,13.0,10.0,3.0
9044,4,2,2,2,4,0,0,2018,,,,,,,,4,4,0,1.0,1.0,0.0
104095,9,4,5,8,1,8,60,0,5.0,2.0,3.0,6.0,0.0,5.0,46.0,34,9,25,12.0,2.0,10.0
9910444,25,5,20,85,0,25,118,50,19.0,1.0,18.0,80.0,0.0,19.0,110.0,37,25,12,27.0,17.0,10.0
9406302,32,16,16,26,20,12,33,7,1.0,1.0,0.0,0.0,0.0,1.0,6.0,53,32,21,10.0,2.0,8.0
9907332,10,4,6,11,0,10,14,118,10.0,4.0,6.0,11.0,0.0,10.0,14.0,14,10,4,11.0,9.0,2.0
2163,20,6,14,26,0,20,108,118,7.0,2.0,5.0,9.0,0.0,7.0,26.0,69,20,49,14.0,7.0,7.0
2132,11,7,4,6,1,10,60,43,5.0,3.0,2.0,2.0,0.0,5.0,26.0,38,11,27,6.0,4.0,2.0
9706225,19,9,10,36,8,11,29,30,13.0,4.0,9.0,31.0,4.0,9.0,9.0,25,19,6,12.0,10.0,2.0
9903361,4,3,1,1,1,3,20,19,2.0,2.0,0.0,0.0,0.0,2.0,14.0,15,4,11,5.0,2.0,3.0
9704324,27,6,21,65,4,23,51,44,10.0,3.0,7.0,20.0,10.0,0.0,0.0,33,27,6,17.0,14.0,3.0
9412311,30,4,26,89,8,22,51,94,23.0,2.0,21.0,71.0,7.0,16.0,29.0,46,30,16,20.0,18.0,2.0
9703224,22,6,16,40,1,21,39,33,12.0,2.0,10.0,26.0,0.0,12.0,23.0,29,22,7,12.0,10.0,2.0
9503374,7,5,2,4,2,5,7,293,3.0,2.0,1.0,2.0,3.0,0.0,0.0,9,7,2,2.0,2.0,0.0
9807229,37,10,27,69,2,35,141,9,7.0,3.0,4.0,6.0,2.0,5.0,16.0,60,37,23,8.0,7.0,1.0
9907507,10,3,7,22,2,8,28,192,10.0,3.0,7.0,22.0,2.0,8.0,15.0,18,10,8,10.0,7.0,3.0
10117,15,5,10,16,0,15,171,2,14.0,5.0,9.0,14.0,0.0,14.0,97.0,38,15,23,26.0,10.0,16.0
9905423,23,3,20,88,0,23,511,2,22.0,3.0,19.0,86.0,0.0,22.0,499.0,61,23,38,44.0,14.0,30.0
9812221,48,5,43,160,0,48,438,2,29.0,3.0,26.0,103.0,0.0,29.0,349.0,97,48,49,21.0,15.0,6.0
10315,11,9,2,2,6,5,8,138,3.0,3.0,0.0,0.0,3.0,0.0,0.0,21,11,10,2.0,2.0,0.0
9403256,172,32,140,877,172,0,0,11,58.0,5.0,53.0,286.0,58.0,0.0,0.0,172,172,0,23.0,23.0,0.0
9503399,8,7,1,1,8,0,0,57,1.0,1.0,0.0,0.0,1.0,0.0,0.0,18,8,10,2.0,1.0,1.0
211144,2,2,0,0,1,1,7,19,2.0,2.0,0.0,0.0,1.0,1.0,7.0,17,2,15,,,
7172,18,3,15,64,4,14,66,80,13.0,3.0,10.0,39.0,2.0,11.0,43.0,33,18,15,20.0,13.0,7.0
9407234,9,5,4,5,3,6,6,25,3.0,3.0,0.0,0.0,2.0,1.0,1.0,10,9,1,1.0,1.0,0.0
110123,5,4,1,1,1,4,19,66,3.0,2.0,1.0,1.0,0.0,3.0,14.0,15,5,10,10.0,2.0,8.0
209193,4,3,1,1,0,4,65,19,4.0,3.0,1.0,1.0,0.0,4.0,62.0,35,4,31,29.0,2.0,27.0
110127,36,0,36,222,0,36,273,28,33.0,0.0,33.0,212.0,0.0,33.0,162.0,50,36,14,33.0,27.0,6.0
112186,21,3,18,82,0,21,239,28,20.0,2.0,18.0,82.0,0.0,20.0,171.0,42,21,21,29.0,17.0,12.0
1285,1,1,0,0,0,1,13,2,0.0,0.0,0.0,0.0,0.0,0.0,0.0,21,1,20,7.0,0.0,7.0
9702379,59,5,54,282,0,59,272,9,41.0,2.0,39.0,223.0,0.0,41.0,183.0,77,59,18,35.0,28.0,7.0
9308339,14,8,6,8,14,0,0,63,7.0,2.0,5.0,7.0,7.0,0.0,0.0,14,14,0,5.0,5.0,0.0
9404299,8,3,5,8,6,2,3,91,5.0,3.0,2.0,3.0,5.0,0.0,0.0,10,8,2,6.0,6.0,0.0
103248,6,6,0,0,1,5,23,21,0.0,0.0,0.0,0.0,0.0,0.0,0.0,27,6,21,3.0,2.0,1.0
9911231,4,3,1,1,0,4,91,2,3.0,3.0,0.0,0.0,0.0,3.0,84.0,59,4,55,44.0,3.0,41.0
9808357,5,2,3,6,0,5,15,276,3.0,2.0,1.0,1.0,1.0,2.0,8.0,18,5,13,8.0,3.0,5.0
9902290,14,6,8,10,0,14,123,10,8.0,2.0,6.0,8.0,0.0,8.0,76.0,41,14,27,12.0,7.0,5.0
9906508,18,7,11,17,1,17,88,5,4.0,3.0,1.0,1.0,0.0,4.0,37.0,43,18,25,6.0,1.0,5.0
107039,55,5,50,353,0,55,369,37,48.0,3.0,45.0,318.0,2.0,46.0,308.0,71,55,16,46.0,37.0,9.0
9512415,15,4,11,15,2,13,31,10,2.0,1.0,1.0,1.0,2.0,0.0,0.0,22,15,7,8.0,6.0,2.0
9904298,4,2,2,2,0,4,22,119,4.0,2.0,2.0,2.0,0.0,4.0,21.0,11,4,7,10.0,4.0,6.0
9712362,13,1,12,22,1,12,106,12,12.0,1.0,11.0,19.0,0.0,12.0,95.0,25,13,12,19.0,11.0,8.0
9207269,41,10,31,151,41,0,0,164,28.0,5.0,23.0,108.0,28.0,0.0,0.0,41,41,0,21.0,21.0,0.0
9903253,6,2,4,4,0,6,13,63,4.0,1.0,3.0,3.0,2.0,2.0,2.0,17,6,11,2.0,1.0,1.0
9803210,39,14,25,76,4,35,155,5,10.0,4.0,6.0,19.0,0.0,10.0,59.0,60,39,21,16.0,9.0,7.0
9806509,6,4,2,3,2,4,14,20,2.0,1.0,1.0,1.0,2.0,0.0,0.0,11,6,5,2.0,2.0,0.0
12118,4,4,0,0,0,4,13,376,0.0,0.0,0.0,0.0,0.0,0.0,0.0,18,4,14,7.0,1.0,6.0
9911347,5,5,0,0,3,2,4,6,0.0,0.0,0.0,0.0,0.0,0.0,0.0,61,5,56,2.0,0.0,2.0
11017,3,2,1,1,1,2,24,34,1.0,1.0,0.0,0.0,0.0,1.0,15.0,41,3,38,4.0,0.0,4.0
9706501,28,6,22,56,1,27,171,6,2.0,2.0,0.0,0.0,0.0,2.0,16.0,61,28,33,10.0,6.0,4.0
9912369,6,5,1,1,0,6,107,1,0.0,0.0,0.0,0.0,0.0,0.0,0.0,128,6,122,23.0,0.0,23.0
9407246,15,6,9,32,11,4,6,134,10.0,2.0,8.0,25.0,8.0,2.0,2.0,18,15,3,9.0,9.0,0.0
9806242,2,2,0,0,2,0,0,781,1.0,1.0,0.0,0.0,1.0,0.0,0.0,2,2,0,1.0,1.0,0.0
3233,36,9,27,53,4,32,129,9,6.0,4.0,2.0,3.0,0.0,6.0,10.0,55,36,19,15.0,8.0,7.0
9509362,26,12,14,31,23,3,3,45,10.0,6.0,4.0,9.0,10.0,0.0,0.0,28,26,2,5.0,5.0,0.0
9601349,56,3,53,214,2,54,371,17,47.0,3.0,44.0,194.0,0.0,47.0,339.0,68,56,12,43.0,32.0,11.0
9606410,30,13,17,41,0,30,185,17,14.0,5.0,9.0,20.0,0.0,14.0,129.0,46,30,16,10.0,6.0,4.0
111316,1,1,0,0,0,1,5,26,1.0,1.0,0.0,0.0,0.0,1.0,4.0,18,1,17,4.0,0.0,4.0
9408225,8,4,4,6,8,0,0,211,4.0,3.0,1.0,1.0,4.0,0.0,0.0,8,8,0,3.0,3.0,0.0
9801403,13,5,8,18,13,0,0,168,5.0,2.0,3.0,6.0,5.0,0.0,0.0,16,13,3,4.0,4.0,0.0
9406287,37,8,29,132,23,14,15,24,16.0,2.0,14.0,53.0,16.0,0.0,0.0,39,37,2,15.0,15.0,0.0
9302239,44,17,27,83,44,0,0,104,21.0,7.0,14.0,38.0,21.0,0.0,0.0,44,44,0,12.0,12.0,0.0
9511258,13,7,6,14,3,10,17,8,7.0,3.0,4.0,10.0,7.0,0.0,0.0,24,13,11,3.0,3.0,0.0
9602245,16,4,12,27,1,15,41,8,10.0,2.0,8.0,22.0,0.0,10.0,17.0,33,16,17,12.0,10.0,2.0
106027,18,4,14,36,1,17,187,4,13.0,3.0,10.0,28.0,0.0,13.0,145.0,45,18,27,8.0,4.0,4.0
9612333,31,14,17,35,5,26,91,4,7.0,3.0,4.0,6.0,1.0,6.0,6.0,56,31,25,4.0,2.0,2.0
9705358,11,1,10,24,1,10,32,1,4.0,1.0,3.0,4.0,4.0,0.0,0.0,22,11,11,6.0,5.0,1.0
9909429,44,11,33,120,0,44,513,12,30.0,5.0,25.0,94.0,0.0,30.0,377.0,104,44,60,29.0,17.0,12.0
9802256,1,1,0,0,0,1,3,88,1.0,1.0,0.0,0.0,0.0,1.0,3.0,5,1,4,,,
7178,6,5,1,1,0,6,46,2,4.0,3.0,1.0,1.0,0.0,4.0,33.0,25,6,19,3.0,3.0,0.0
9508243,9,3,6,10,7,2,3,54,5.0,1.0,4.0,8.0,5.0,0.0,0.0,11,9,2,5.0,5.0,0.0
9710374,21,9,12,20,2,19,73,14,10.0,3.0,7.0,14.0,1.0,9.0,41.0,35,21,14,9.0,7.0,2.0
9604210,4,4,0,0,1,3,34,14,0.0,0.0,0.0,0.0,0.0,0.0,0.0,32,4,28,8.0,0.0,8.0
7251,16,3,13,37,0,16,189,24,16.0,3.0,13.0,37.0,0.0,16.0,158.0,40,16,24,21.0,9.0,12.0
9504273,31,7,24,81,17,14,14,24,5.0,2.0,3.0,5.0,5.0,0.0,0.0,32,31,1,4.0,4.0,0.0
9605340,20,4,16,50,3,17,34,92,12.0,3.0,9.0,32.0,1.0,11.0,11.0,29,20,9,11.0,10.0,1.0
9711285,3,2,1,1,3,0,0,118,1.0,1.0,0.0,0.0,1.0,0.0,0.0,6,3,3,1.0,1.0,0.0
9301216,4,3,1,1,4,0,0,139,1.0,1.0,0.0,0.0,1.0,0.0,0.0,4,4,0,1.0,1.0,0.0
5318,17,5,12,17,1,16,129,9,6.0,2.0,4.0,4.0,0.0,6.0,33.0,63,17,46,12.0,6.0,6.0
9604423,36,9,27,101,0,36,119,68,14.0,6.0,8.0,23.0,0.0,14.0,34.0,49,36,13,16.0,12.0,4.0
9810270,61,28,33,69,7,54,365,14,18.0,4.0,14.0,31.0,0.0,18.0,108.0,194,61,133,20.0,9.0,11.0
9610214,5,2,3,5,1,4,24,14,4.0,1.0,3.0,5.0,0.0,4.0,22.0,15,5,10,2.0,2.0,0.0
4217,11,6,5,6,0,11,49,27,10.0,5.0,5.0,6.0,0.0,10.0,36.0,34,11,23,4.0,4.0,0.0
9802406,33,8,25,69,9,24,45,9,13.0,2.0,11.0,28.0,0.0,13.0,24.0,43,33,10,13.0,11.0,2.0
9706435,2,2,0,0,1,1,1,286,1.0,1.0,0.0,0.0,1.0,0.0,0.0,3,2,1,1.0,1.0,0.0
9510254,12,2,10,33,1,11,28,13,11.0,1.0,10.0,31.0,1.0,10.0,25.0,16,12,4,11.0,9.0,2.0
9907204,11,1,10,20,1,10,35,10,5.0,1.0,4.0,4.0,0.0,5.0,13.0,25,11,14,6.0,4.0,2.0
9611221,2,1,1,1,0,2,7,77,2.0,1.0,1.0,1.0,0.0,2.0,7.0,10,2,8,2.0,0.0,2.0
211314,1,1,0,0,0,1,4,45,1.0,1.0,0.0,0.0,0.0,1.0,1.0,17,1,16,3.0,1.0,2.0
9703280,19,5,14,40,0,19,175,17,15.0,2.0,13.0,39.0,0.0,15.0,142.0,46,19,27,3.0,3.0,0.0
9901214,9,7,2,3,4,5,14,244,4.0,2.0,2.0,3.0,2.0,2.0,3.0,16,9,7,3.0,1.0,2.0
9501289,9,5,4,5,3,6,7,66,3.0,1.0,2.0,3.0,0.0,3.0,3.0,13,9,4,1.0,1.0,0.0
9612226,17,13,4,6,17,0,0,11,1.0,1.0,0.0,0.0,1.0,0.0,0.0,21,17,4,3.0,3.0,0.0
9610205,7,5,2,2,2,5,25,14,2.0,1.0,1.0,1.0,0.0,2.0,8.0,22,7,15,6.0,1.0,5.0
9707383,2,2,0,0,0,2,5,16,1.0,1.0,0.0,0.0,1.0,0.0,0.0,6,2,4,,,
9802338,7,4,3,5,0,7,45,13,6.0,3.0,3.0,5.0,0.0,6.0,38.0,18,7,11,14.0,6.0,8.0
9606254,33,10,23,48,1,32,108,14,10.0,2.0,8.0,15.0,0.0,10.0,10.0,42,33,9,8.0,6.0,2.0
9804419,13,10,3,3,1,12,36,97,5.0,5.0,0.0,0.0,0.0,5.0,11.0,20,13,7,7.0,3.0,4.0
9706457,10,5,5,8,1,9,64,8,5.0,3.0,2.0,2.0,0.0,5.0,45.0,32,10,22,9.0,2.0,7.0
9302258,13,1,12,31,1,12,13,15,1.0,1.0,0.0,0.0,1.0,0.0,0.0,15,13,2,3.0,3.0,0.0
9410295,1,1,0,0,0,1,3,15,,,,,,,,5,1,4,1.0,0.0,1.0
9509294,18,4,14,75,0,18,48,36,15.0,3.0,12.0,69.0,0.0,15.0,40.0,30,18,12,8.0,4.0,4.0
9407217,4,2,2,3,4,0,0,609,3.0,2.0,1.0,1.0,3.0,0.0,0.0,4,4,0,1.0,1.0,0.0
9607403,10,6,4,5,1,9,32,60,4.0,2.0,2.0,3.0,0.0,4.0,12.0,29,10,19,10.0,4.0,6.0
6171,9,3,6,15,0,9,48,0,8.0,3.0,5.0,13.0,0.0,8.0,31.0,24,9,15,9.0,3.0,6.0
9301222,19,10,9,13,19,0,0,210,6.0,3.0,3.0,4.0,6.0,0.0,0.0,19,19,0,4.0,4.0,0.0
9910213,8,4,4,4,1,7,30,63,3.0,2.0,1.0,1.0,0.0,3.0,12.0,52,8,44,14.0,2.0,12.0
9211307,12,4,8,23,12,0,0,50,8.0,2.0,6.0,14.0,8.0,0.0,0.0,12,12,0,4.0,4.0,0.0
9312243,8,4,4,6,8,0,0,52,4.0,3.0,1.0,2.0,4.0,0.0,0.0,9,8,1,1.0,1.0,0.0
9802239,26,5,21,66,3,23,61,52,21.0,4.0,17.0,53.0,0.0,21.0,57.0,29,26,3,19.0,16.0,3.0
9309202,10,4,6,13,4,6,7,93,0.0,0.0,0.0,0.0,0.0,0.0,0.0,13,10,3,3.0,3.0,0.0
9811369,23,6,17,47,0,23,253,15,14.0,3.0,11.0,28.0,0.0,14.0,189.0,73,23,50,28.0,7.0,21.0
9710342,16,8,8,17,2,14,27,1,5.0,3.0,2.0,3.0,3.0,2.0,2.0,21,16,5,3.0,3.0,0.0
104274,4,4,0,0,1,3,19,2,1.0,1.0,0.0,0.0,0.0,1.0,3.0,33,4,29,4.0,1.0,3.0
9811406,7,1,6,13,2,5,11,120,7.0,1.0,6.0,13.0,2.0,5.0,11.0,11,7,4,9.0,7.0,2.0
9905349,19,8,11,25,1,18,114,2,5.0,2.0,3.0,4.0,0.0,5.0,47.0,42,19,23,6.0,4.0,2.0
9704378,19,8,11,29,1,18,63,145,9.0,6.0,3.0,8.0,0.0,9.0,10.0,35,19,16,8.0,7.0,1.0
9510216,6,2,4,7,0,6,8,75,3.0,1.0,2.0,2.0,0.0,3.0,3.0,8,6,2,4.0,3.0,1.0
9801432,9,2,7,15,0,9,45,25,7.0,2.0,5.0,10.0,0.0,7.0,27.0,18,9,9,10.0,5.0,5.0
11092,17,5,12,32,3,14,24,95,12.0,4.0,8.0,19.0,2.0,10.0,11.0,20,17,3,7.0,7.0,0.0
102152,7,3,4,7,2,5,17,21,5.0,4.0,1.0,3.0,0.0,5.0,13.0,12,7,5,6.0,4.0,2.0
9901304,29,1,28,123,1,28,99,22,27.0,1.0,26.0,116.0,1.0,26.0,80.0,36,29,7,24.0,20.0,4.0
9907533,11,3,8,24,1,10,21,21,10.0,3.0,7.0,21.0,1.0,9.0,18.0,16,11,5,11.0,9.0,2.0
9508383,7,3,4,5,6,1,1,123,5.0,3.0,2.0,2.0,5.0,0.0,0.0,8,7,1,4.0,4.0,0.0
9506405,10,5,5,7,0,10,32,49,2.0,1.0,1.0,1.0,0.0,2.0,8.0,43,10,33,10.0,6.0,4.0
102014,8,1,7,11,0,8,13,14,7.0,1.0,6.0,10.0,0.0,7.0,7.0,11,8,3,7.0,6.0,1.0
9907467,11,9,2,2,5,6,13,14,2.0,1.0,1.0,1.0,0.0,2.0,4.0,17,11,6,1.0,1.0,0.0
9810534,12,5,7,10,1,11,45,56,9.0,3.0,6.0,9.0,0.0,9.0,32.0,25,12,13,7.0,1.0,6.0
9908486,17,5,12,40,0,17,85,30,17.0,5.0,12.0,40.0,0.0,17.0,85.0,27,17,10,20.0,11.0,9.0
9602238,40,19,21,36,15,25,99,4,0.0,0.0,0.0,0.0,0.0,0.0,0.0,107,40,67,9.0,0.0,9.0
9812501,5,3,2,4,1,4,16,69,2.0,1.0,1.0,1.0,0.0,2.0,6.0,12,5,7,9.0,3.0,6.0
110192,3,2,1,1,2,1,59,18,1.0,1.0,0.0,0.0,0.0,1.0,21.0,91,3,88,22.0,1.0,21.0
9809517,8,2,6,10,0,8,32,15,3.0,2.0,1.0,1.0,0.0,3.0,13.0,31,8,23,8.0,1.0,7.0
101194,15,7,8,17,1,14,50,23,2.0,2.0,0.0,0.0,0.0,2.0,7.0,25,15,10,6.0,3.0,3.0
105037,21,5,16,31,2,19,209,23,13.0,3.0,10.0,20.0,0.0,13.0,162.0,51,21,30,32.0,13.0,19.0
9906241,6,2,4,8,0,6,66,131,6.0,2.0,4.0,8.0,0.0,6.0,44.0,31,6,25,13.0,5.0,8.0
9607223,2,1,1,1,0,2,8,14,2.0,1.0,1.0,1.0,0.0,2.0,8.0,9,2,7,,,
9806240,8,3,5,7,3,5,5,64,8.0,3.0,5.0,7.0,3.0,5.0,5.0,9,8,1,8.0,7.0,1.0
9911281,1,1,0,0,0,1,1,162,0.0,0.0,0.0,0.0,0.0,0.0,0.0,8,1,7,3.0,0.0,3.0
9406347,13,6,7,15,13,0,0,206,12.0,5.0,7.0,15.0,12.0,0.0,0.0,13,13,0,6.0,6.0,0.0
106255,14,10,4,6,0,14,154,4,4.0,3.0,1.0,1.0,0.0,4.0,69.0,108,14,94,34.0,3.0,31.0
206148,8,6,2,4,0,8,72,55,5.0,3.0,2.0,4.0,0.0,5.0,33.0,47,8,39,18.0,3.0,15.0
3271,5,2,3,5,0,5,16,36,5.0,2.0,3.0,5.0,0.0,5.0,6.0,16,5,11,8.0,5.0,3.0
9302203,44,12,32,85,44,0,0,13,10.0,4.0,6.0,16.0,10.0,0.0,0.0,44,44,0,6.0,6.0,0.0
107124,12,5,7,8,4,8,23,67,3.0,3.0,0.0,0.0,0.0,3.0,7.0,22,12,10,3.0,3.0,0.0
9607378,11,1,10,15,6,5,6,89,6.0,3.0,3.0,5.0,6.0,0.0,0.0,17,11,6,5.0,4.0,1.0
103202,9,6,3,5,1,8,25,3,4.0,3.0,1.0,1.0,0.0,4.0,7.0,28,9,19,3.0,2.0,1.0
9705294,8,4,4,5,0,8,29,30,5.0,2.0,3.0,4.0,0.0,5.0,10.0,15,8,7,5.0,4.0,1.0
3018,8,6,2,2,1,7,40,21,2.0,2.0,0.0,0.0,0.0,2.0,15.0,23,8,15,2.0,0.0,2.0
9705237,2,2,0,0,0,2,8,10,2.0,2.0,0.0,0.0,0.0,2.0,4.0,15,2,13,4.0,1.0,3.0
9401227,4,3,1,1,4,0,0,168,2.0,1.0,1.0,1.0,2.0,0.0,0.0,4,4,0,2.0,2.0,0.0
9612344,3,3,0,0,2,1,1,279,1.0,1.0,0.0,0.0,0.0,1.0,1.0,4,3,1,1.0,1.0,0.0
9308371,23,15,8,14,8,15,20,208,11.0,10.0,1.0,1.0,2.0,9.0,9.0,25,23,2,10.0,9.0,1.0
9605337,12,4,8,17,12,0,0,58,5.0,2.0,3.0,6.0,5.0,0.0,0.0,14,12,2,5.0,5.0,0.0
10012,7,2,5,6,1,6,15,80,3.0,1.0,2.0,2.0,0.0,3.0,3.0,23,7,16,2.0,2.0,0.0
9411414,3,3,0,0,3,0,0,164,1.0,1.0,0.0,0.0,1.0,0.0,0.0,3,3,0,1.0,1.0,0.0
9412289,4,3,1,1,3,1,1,360,2.0,1.0,1.0,1.0,2.0,0.0,0.0,7,4,3,1.0,0.0,1.0
9610489,8,4,4,7,1,7,24,44,5.0,2.0,3.0,5.0,0.0,5.0,18.0,13,8,5,8.0,4.0,4.0
9211209,16,9,7,9,16,0,0,298,4.0,2.0,2.0,3.0,4.0,0.0,0.0,16,16,0,3.0,3.0,0.0
207183,10,8,2,2,3,7,32,25,2.0,2.0,0.0,0.0,0.0,2.0,6.0,27,10,17,4.0,2.0,2.0
9908439,4,4,0,0,1,3,4,218,1.0,1.0,0.0,0.0,1.0,0.0,0.0,13,4,9,1.0,1.0,0.0
9509267,9,4,5,5,4,5,11,9,3.0,1.0,2.0,2.0,1.0,2.0,2.0,13,9,4,2.0,2.0,0.0
9901395,3,3,0,0,1,2,11,29,1.0,1.0,0.0,0.0,0.0,1.0,5.0,10,3,7,1.0,0.0,1.0
9512212,6,2,4,5,2,4,11,43,0.0,0.0,0.0,0.0,0.0,0.0,0.0,13,6,7,1.0,1.0,0.0
9606474,13,1,12,64,1,12,79,43,13.0,1.0,12.0,64.0,1.0,12.0,79.0,31,13,18,24.0,13.0,11.0
9310341,15,6,9,12,15,0,0,43,4.0,4.0,0.0,0.0,4.0,0.0,0.0,15,15,0,4.0,4.0,0.0
211075,0,0,0,0,0,0,0,22,0.0,0.0,0.0,0.0,0.0,0.0,0.0,11,0,11,9.0,0.0,9.0
104235,3,2,1,1,0,3,11,88,0.0,0.0,0.0,0.0,0.0,0.0,0.0,17,3,14,1.0,0.0,1.0
9309210,6,2,4,6,6,0,0,319,5.0,2.0,3.0,5.0,5.0,0.0,0.0,7,6,1,6.0,6.0,0.0
105029,20,11,9,17,4,16,96,0,14.0,5.0,9.0,15.0,1.0,13.0,83.0,44,20,24,21.0,7.0,14.0
9803497,47,11,36,112,16,31,104,11,12.0,3.0,9.0,18.0,7.0,5.0,8.0,59,47,12,16.0,13.0,3.0
9501221,14,4,10,24,10,4,5,1,5.0,2.0,3.0,6.0,3.0,2.0,3.0,21,14,7,8.0,8.0,0.0
9402304,6,3,3,7,5,1,1,126,2.0,2.0,0.0,0.0,2.0,0.0,0.0,7,6,1,5.0,4.0,1.0
9906366,26,2,24,75,0,26,179,46,15.0,2.0,13.0,39.0,0.0,15.0,102.0,46,26,20,8.0,6.0,2.0
107168,2,1,1,1,0,2,17,22,2.0,1.0,1.0,1.0,0.0,2.0,17.0,14,2,12,5.0,2.0,3.0
10193,17,6,11,18,1,16,41,63,5.0,3.0,2.0,2.0,0.0,5.0,6.0,36,17,19,11.0,1.0,10.0
9903517,12,6,6,9,1,11,38,0,5.0,2.0,3.0,5.0,1.0,4.0,11.0,27,12,15,4.0,4.0,0.0
202269,6,5,1,1,0,6,65,0,3.0,2.0,1.0,1.0,0.0,3.0,40.0,47,6,41,22.0,4.0,18.0
9910296,6,4,2,3,0,6,83,12,5.0,3.0,2.0,3.0,0.0,5.0,70.0,41,6,35,22.0,1.0,21.0
9807486,8,3,5,8,1,7,17,136,6.0,1.0,5.0,7.0,0.0,6.0,16.0,12,8,4,4.0,3.0,1.0
9603372,22,9,13,24,1,21,106,3,10.0,3.0,7.0,14.0,0.0,10.0,43.0,51,22,29,16.0,10.0,6.0
9507418,33,9,24,81,7,26,57,13,24.0,7.0,17.0,60.0,3.0,21.0,37.0,40,33,7,14.0,12.0,2.0
9703273,2,2,0,0,1,1,4,59,1.0,1.0,0.0,0.0,0.0,1.0,2.0,6,2,4,3.0,1.0,2.0
101090,4,2,2,2,4,0,0,1296,,,,,,,,4,4,0,1.0,1.0,0.0
9707476,10,4,6,10,1,9,41,48,6.0,2.0,4.0,6.0,0.0,6.0,18.0,32,10,22,9.0,3.0,6.0
12220,3,2,1,1,1,2,4,9,0.0,0.0,0.0,0.0,0.0,0.0,0.0,14,3,11,5.0,0.0,5.0
9612265,14,3,11,25,2,12,23,299,7.0,1.0,6.0,10.0,1.0,6.0,10.0,22,14,8,10.0,8.0,2.0
9308240,1,1,0,0,1,0,0,1554,,,,,,,,1,1,0,,,
9703207,4,2,2,3,0,4,8,755,3.0,1.0,2.0,2.0,0.0,3.0,4.0,7,4,3,6.0,3.0,3.0
9904253,4,4,0,0,1,3,8,283,1.0,1.0,0.0,0.0,1.0,0.0,0.0,9,4,5,1.0,1.0,0.0
9908341,3,3,0,0,2,1,4,1,1.0,1.0,0.0,0.0,1.0,0.0,0.0,8,3,5,1.0,1.0,0.0
9506453,1,1,0,0,0,1,4,302,0.0,0.0,0.0,0.0,0.0,0.0,0.0,5,1,4,4.0,1.0,3.0
204099,1,1,0,0,0,1,2,34,0.0,0.0,0.0,0.0,0.0,0.0,0.0,25,1,24,5.0,0.0,5.0
101113,10,2,8,16,0,10,92,12,9.0,1.0,8.0,16.0,0.0,9.0,38.0,32,10,22,18.0,9.0,9.0
9911214,21,2,19,66,0,21,103,50,19.0,1.0,18.0,63.0,0.0,19.0,101.0,29,21,8,22.0,14.0,8.0
5112,2,2,0,0,0,2,18,39,1.0,1.0,0.0,0.0,0.0,1.0,14.0,34,2,32,20.0,1.0,19.0
9807316,3,3,0,0,0,3,9,43,,,,,,,,8,3,5,,,
9606213,13,3,10,23,0,13,28,58,10.0,2.0,8.0,18.0,0.0,10.0,21.0,17,13,4,10.0,7.0,3.0
9408257,25,3,22,55,13,12,12,27,17.0,1.0,16.0,45.0,17.0,0.0,0.0,26,25,1,8.0,7.0,1.0
1119,19,3,16,58,0,19,120,27,15.0,2.0,13.0,46.0,0.0,15.0,78.0,36,19,17,15.0,7.0,8.0
105166,6,3,3,4,1,5,34,140,4.0,2.0,2.0,2.0,0.0,4.0,20.0,28,6,22,7.0,1.0,6.0
109120,8,4,4,7,0,8,43,3,0.0,0.0,0.0,0.0,0.0,0.0,0.0,70,8,62,16.0,0.0,16.0
9711369,15,4,11,20,9,6,10,101,4.0,1.0,3.0,4.0,2.0,2.0,2.0,18,15,3,4.0,3.0,1.0
202086,26,10,16,39,0,26,288,3,6.0,3.0,3.0,4.0,0.0,6.0,86.0,98,26,72,23.0,7.0,16.0
9807214,3,2,1,1,0,3,15,3,3.0,2.0,1.0,1.0,0.0,3.0,12.0,11,3,8,8.0,2.0,6.0
9801429,2,2,0,0,1,1,1,224,2.0,2.0,0.0,0.0,2.0,0.0,0.0,11,2,9,2.0,2.0,0.0
108003,17,2,15,75,0,17,151,37,17.0,2.0,15.0,75.0,0.0,17.0,146.0,36,17,19,26.0,16.0,10.0
107325,10,7,3,4,0,10,111,32,4.0,2.0,2.0,2.0,0.0,4.0,67.0,66,10,56,40.0,2.0,38.0
203267,10,2,8,18,0,10,75,47,9.0,2.0,7.0,17.0,0.0,9.0,51.0,30,10,20,14.0,8.0,6.0
10303,4,1,3,4,4,0,0,47,3.0,1.0,2.0,3.0,3.0,0.0,0.0,4,4,0,,,
10087,19,5,14,49,0,19,303,3,10.0,4.0,6.0,17.0,0.0,10.0,146.0,82,19,63,18.0,8.0,10.0
202018,10,4,6,11,2,8,77,1,6.0,3.0,3.0,8.0,0.0,6.0,62.0,29,10,19,16.0,5.0,11.0
2262,2,2,0,0,0,2,18,5,1.0,1.0,0.0,0.0,0.0,1.0,7.0,35,2,33,18.0,1.0,17.0
9909279,2,2,0,0,0,2,6,55,0.0,0.0,0.0,0.0,0.0,0.0,0.0,37,2,35,9.0,0.0,9.0
9802273,25,10,15,38,7,18,50,264,4.0,1.0,3.0,5.0,0.0,4.0,14.0,36,25,11,10.0,7.0,3.0
9307,2,2,0,0,0,2,9,2,2.0,2.0,0.0,0.0,2.0,0.0,0.0,14,2,12,1.0,0.0,1.0
9602338,9,1,8,16,4,5,5,100,2.0,2.0,0.0,0.0,0.0,2.0,2.0,10,9,1,3.0,2.0,1.0
9511412,8,6,2,2,1,7,16,13,1.0,1.0,0.0,0.0,0.0,1.0,3.0,22,8,14,3.0,2.0,1.0
1327,12,5,7,16,11,1,1,126,6.0,4.0,2.0,5.0,5.0,1.0,1.0,13,12,1,7.0,6.0,1.0
101275,29,1,28,141,0,29,418,11,28.0,1.0,27.0,138.0,0.0,28.0,389.0,52,29,23,47.0,27.0,20.0
7133,18,2,16,66,0,18,201,11,17.0,1.0,16.0,66.0,0.0,17.0,191.0,40,18,22,28.0,14.0,14.0
9908261,9,8,1,2,1,8,24,13,4.0,3.0,1.0,2.0,0.0,4.0,11.0,25,9,16,4.0,2.0,2.0
9612436,23,6,17,52,3,20,94,12,12.0,1.0,11.0,38.0,0.0,12.0,58.0,41,23,18,4.0,1.0,3.0
9501225,3,2,1,1,3,0,0,471,2.0,1.0,1.0,1.0,2.0,0.0,0.0,3,3,0,2.0,2.0,0.0
9312353,2,1,1,1,1,1,1,29,2.0,1.0,1.0,1.0,2.0,0.0,0.0,7,2,5,1.0,0.0,1.0
9606348,9,4,5,8,4,5,9,96,8.0,4.0,4.0,6.0,3.0,5.0,9.0,11,9,2,7.0,5.0,2.0
9708212,8,2,6,9,0,8,31,39,6.0,2.0,4.0,6.0,0.0,6.0,21.0,19,8,11,12.0,5.0,7.0
9712547,2,2,0,0,0,2,6,62,1.0,1.0,0.0,0.0,0.0,1.0,5.0,14,2,12,5.0,1.0,4.0
204134,9,4,5,7,2,7,19,239,5.0,1.0,4.0,4.0,1.0,4.0,10.0,15,9,6,6.0,3.0,3.0
9802341,16,1,15,31,11,5,6,25,4.0,3.0,1.0,1.0,4.0,0.0,0.0,18,16,2,6.0,6.0,0.0
9607207,11,4,7,9,0,11,35,41,8.0,4.0,4.0,6.0,0.0,8.0,28.0,17,11,6,8.0,4.0,4.0
9712216,28,9,19,40,8,20,78,115,12.0,2.0,10.0,18.0,1.0,11.0,48.0,41,28,13,13.0,6.0,7.0
110375,3,1,2,3,0,3,33,6,1.0,1.0,0.0,0.0,0.0,1.0,12.0,31,3,28,9.0,1.0,8.0
9805287,9,4,5,13,6,3,10,6,2.0,2.0,0.0,0.0,0.0,2.0,5.0,22,9,13,6.0,6.0,0.0
9502257,3,2,1,1,0,3,6,25,2.0,1.0,1.0,1.0,0.0,2.0,4.0,7,3,4,1.0,1.0,0.0
103045,5,2,3,3,0,5,33,42,4.0,1.0,3.0,3.0,0.0,4.0,13.0,24,5,19,13.0,3.0,10.0
12157,25,6,19,133,0,25,214,109,25.0,6.0,19.0,133.0,0.0,25.0,199.0,42,25,17,36.0,25.0,11.0
6009,7,2,5,11,1,6,27,109,6.0,1.0,5.0,11.0,0.0,6.0,27.0,13,7,6,11.0,6.0,5.0
9707413,2,2,0,0,0,2,13,5,1.0,1.0,0.0,0.0,0.0,1.0,10.0,18,2,16,1.0,0.0,1.0
3212,16,10,6,8,4,12,61,0,3.0,2.0,1.0,1.0,0.0,3.0,27.0,85,16,69,6.0,5.0,1.0
5263,14,2,12,31,0,14,51,28,13.0,2.0,11.0,28.0,0.0,13.0,39.0,25,14,11,15.0,11.0,4.0
9901348,7,3,4,5,0,7,34,17,1.0,1.0,0.0,0.0,0.0,1.0,2.0,21,7,14,2.0,2.0,0.0
9812232,9,5,4,5,1,8,36,42,5.0,5.0,0.0,0.0,0.0,5.0,19.0,15,9,6,8.0,4.0,4.0
9712418,9,2,7,10,0,9,16,19,5.0,1.0,4.0,7.0,0.0,5.0,9.0,16,9,7,6.0,4.0,2.0
9701352,3,3,0,0,3,0,0,359,1.0,1.0,0.0,0.0,1.0,0.0,0.0,5,3,2,1.0,0.0,1.0
9272,5,3,2,2,2,3,31,8,2.0,1.0,1.0,1.0,0.0,2.0,10.0,21,5,16,7.0,2.0,5.0
9509408,17,10,7,19,1,16,32,6,9.0,4.0,5.0,10.0,9.0,0.0,0.0,28,17,11,7.0,7.0,0.0
9807230,5,1,4,6,1,4,17,92,3.0,1.0,2.0,3.0,1.0,2.0,4.0,11,5,6,3.0,3.0,0.0
9801377,12,2,10,16,2,10,14,127,6.0,2.0,4.0,6.0,0.0,6.0,10.0,16,12,4,6.0,4.0,2.0
9402269,1,1,0,0,0,1,1,75,0.0,0.0,0.0,0.0,0.0,0.0,0.0,6,1,5,1.0,0.0,1.0
9612304,6,2,4,5,2,4,12,41,2.0,2.0,0.0,0.0,0.0,2.0,8.0,15,6,9,11.0,3.0,8.0
9506307,5,3,2,2,0,5,26,17,1.0,1.0,0.0,0.0,0.0,1.0,5.0,27,5,22,6.0,1.0,5.0
9710409,4,2,2,2,1,3,9,3,3.0,1.0,2.0,2.0,0.0,3.0,8.0,13,4,9,2.0,0.0,2.0
9605284,1,1,0,0,0,1,1,137,0.0,0.0,0.0,0.0,0.0,0.0,0.0,5,1,4,,,
9609436,24,5,19,46,5,19,30,85,13.0,1.0,12.0,30.0,4.0,9.0,9.0,27,24,3,11.0,10.0,1.0
104253,6,1,5,10,3,3,4,24,4.0,1.0,3.0,5.0,4.0,0.0,0.0,9,6,3,5.0,5.0,0.0
9803345,13,6,7,10,7,6,6,177,6.0,2.0,4.0,5.0,1.0,5.0,5.0,15,13,2,6.0,5.0,1.0
9812370,10,7,3,4,2,8,33,23,2.0,1.0,1.0,1.0,0.0,2.0,12.0,26,10,16,11.0,2.0,9.0
4066,21,7,14,30,7,14,30,106,13.0,3.0,10.0,24.0,1.0,12.0,21.0,27,21,6,13.0,11.0,2.0
9405297,8,3,5,8,0,8,31,124,6.0,2.0,4.0,7.0,0.0,6.0,23.0,17,8,9,9.0,4.0,5.0
9612302,11,2,9,21,5,6,12,222,7.0,1.0,6.0,17.0,2.0,5.0,10.0,22,11,11,9.0,7.0,2.0
9610384,14,6,8,13,4,10,16,117,5.0,1.0,4.0,6.0,5.0,0.0,0.0,18,14,4,6.0,6.0,0.0
205001,4,4,0,0,1,3,28,41,1.0,1.0,0.0,0.0,0.0,1.0,12.0,30,4,26,14.0,2.0,12.0
9710309,6,4,2,3,1,5,15,150,3.0,2.0,1.0,2.0,0.0,3.0,6.0,14,6,8,5.0,3.0,2.0
103080,4,2,2,2,0,4,21,9,3.0,1.0,2.0,2.0,0.0,3.0,7.0,19,4,15,8.0,1.0,7.0
9805482,10,7,3,4,2,8,25,10,3.0,3.0,0.0,0.0,0.0,3.0,14.0,20,10,10,8.0,2.0,6.0
9509339,3,3,0,0,0,3,6,190,1.0,1.0,0.0,0.0,1.0,0.0,0.0,9,3,6,3.0,1.0,2.0
9512312,1,1,0,0,1,0,0,1111,,,,,,,,2,1,1,1.0,1.0,0.0
9804459,5,3,2,2,1,4,11,18,2.0,2.0,0.0,0.0,2.0,0.0,0.0,9,5,4,1.0,1.0,0.0
9907473,2,1,1,1,0,2,26,86,2.0,1.0,1.0,1.0,0.0,2.0,20.0,21,2,19,13.0,2.0,11.0
9609252,4,2,2,2,4,0,0,291,1.0,1.0,0.0,0.0,1.0,0.0,0.0,6,4,2,2.0,2.0,0.0
9902380,5,4,1,1,0,5,12,42,0.0,0.0,0.0,0.0,0.0,0.0,0.0,20,5,15,4.0,2.0,2.0
9908421,2,2,0,0,0,2,5,15,1.0,1.0,0.0,0.0,0.0,1.0,3.0,17,2,15,2.0,1.0,1.0
9909406,13,3,10,29,2,11,37,49,9.0,3.0,6.0,19.0,1.0,8.0,28.0,25,13,12,13.0,7.0,6.0
109094,3,2,1,1,0,3,22,41,2.0,2.0,0.0,0.0,0.0,2.0,18.0,17,3,14,8.0,2.0,6.0
9703236,5,3,2,2,2,3,9,14,0.0,0.0,0.0,0.0,0.0,0.0,0.0,12,5,7,3.0,1.0,2.0
9711431,2,2,0,0,2,0,0,1222,,,,,,,,2,2,0,,,
9911240,3,3,0,0,1,2,3,97,1.0,1.0,0.0,0.0,0.0,1.0,2.0,8,3,5,3.0,1.0,2.0
9910483,15,8,7,13,1,14,75,12,3.0,2.0,1.0,1.0,1.0,2.0,8.0,34,15,19,2.0,1.0,1.0
10079,10,3,7,23,1,9,109,3,8.0,2.0,6.0,19.0,0.0,8.0,100.0,44,10,34,14.0,5.0,9.0
7010,14,5,9,27,0,14,86,56,8.0,5.0,3.0,3.0,0.0,8.0,64.0,35,14,21,15.0,4.0,11.0
9405405,5,5,0,0,5,0,0,317,2.0,2.0,0.0,0.0,2.0,0.0,0.0,5,5,0,2.0,2.0,0.0
9809446,11,6,5,7,0,11,53,13,9.0,4.0,5.0,7.0,0.0,9.0,47.0,28,11,17,18.0,5.0,13.0
205117,5,2,3,5,0,5,35,193,5.0,2.0,3.0,5.0,0.0,5.0,32.0,14,5,9,12.0,5.0,7.0
9705269,8,4,4,5,0,8,29,260,4.0,3.0,1.0,1.0,0.0,4.0,11.0,19,8,11,7.0,4.0,3.0
9708244,1,1,0,0,0,1,6,38,1.0,1.0,0.0,0.0,0.0,1.0,5.0,9,1,8,2.0,0.0,2.0
9710296,7,3,4,5,2,5,10,202,2.0,1.0,1.0,1.0,0.0,2.0,2.0,11,7,4,1.0,1.0,0.0
9407352,1,1,0,0,1,0,0,116,0.0,0.0,0.0,0.0,0.0,0.0,0.0,2,1,1,,,
9705202,6,2,4,6,0,6,28,10,4.0,1.0,3.0,4.0,0.0,4.0,9.0,16,6,10,9.0,4.0,5.0
9611261,0,0,0,0,0,0,0,284,0.0,0.0,0.0,0.0,0.0,0.0,0.0,4,0,4,4.0,0.0,4.0
212300,1,1,0,0,0,1,7,27,1.0,1.0,0.0,0.0,0.0,1.0,7.0,26,1,25,13.0,1.0,12.0
102343,16,6,10,26,2,14,107,8,11.0,2.0,9.0,19.0,0.0,11.0,93.0,47,16,31,29.0,8.0,21.0
9707428,6,5,1,1,0,6,6,91,1.0,1.0,0.0,0.0,0.0,1.0,1.0,7,6,1,1.0,1.0,0.0
9801234,4,2,2,3,0,4,24,5,3.0,2.0,1.0,1.0,0.0,3.0,13.0,22,4,18,14.0,2.0,12.0
9807428,5,5,0,0,5,0,0,99,3.0,3.0,0.0,0.0,3.0,0.0,0.0,5,5,0,2.0,2.0,0.0
109233,16,9,7,16,0,16,34,45,6.0,4.0,2.0,5.0,6.0,0.0,0.0,40,16,24,4.0,3.0,1.0
104275,4,4,0,0,0,4,20,28,2.0,2.0,0.0,0.0,0.0,2.0,7.0,24,4,20,3.0,2.0,1.0
9903380,4,3,1,2,2,2,2,19,,,,,,,,7,4,3,1.0,1.0,0.0
9809386,5,2,3,5,3,2,4,49,0.0,0.0,0.0,0.0,0.0,0.0,0.0,14,5,9,1.0,0.0,1.0
108155,1,1,0,0,0,1,13,34,0.0,0.0,0.0,0.0,0.0,0.0,0.0,44,1,43,32.0,0.0,32.0
9809254,10,6,4,5,0,10,38,78,6.0,4.0,2.0,2.0,0.0,6.0,23.0,35,10,25,6.0,3.0,3.0
105236,8,2,6,8,0,8,47,21,0.0,0.0,0.0,0.0,0.0,0.0,0.0,33,8,25,12.0,1.0,11.0
105134,2,1,1,1,0,2,8,73,0.0,0.0,0.0,0.0,0.0,0.0,0.0,8,2,6,2.0,0.0,2.0
9909420,1,1,0,0,0,1,1,73,0.0,0.0,0.0,0.0,0.0,0.0,0.0,2,1,1,1.0,0.0,1.0
9704344,1,1,0,0,0,1,2,8,,,,,,,,5,1,4,1.0,0.0,1.0
9609410,16,5,11,17,1,15,19,12,5.0,1.0,4.0,4.0,0.0,5.0,8.0,19,16,3,7.0,5.0,2.0
9903306,9,3,6,10,1,8,26,44,5.0,3.0,2.0,4.0,0.0,5.0,15.0,17,9,8,6.0,2.0,4.0
9407370,6,3,3,6,1,5,5,163,6.0,3.0,3.0,6.0,1.0,5.0,5.0,7,6,1,5.0,4.0,1.0
11310,12,6,6,13,0,12,81,28,6.0,3.0,3.0,6.0,0.0,6.0,21.0,37,12,25,9.0,3.0,6.0
9711249,11,6,5,10,3,8,14,50,2.0,1.0,1.0,1.0,2.0,0.0,0.0,14,11,3,3.0,2.0,1.0
203031,11,6,5,6,3,8,123,4,5.0,3.0,2.0,2.0,0.0,5.0,37.0,89,11,78,21.0,3.0,18.0
9807394,1,1,0,0,0,1,1,117,1.0,1.0,0.0,0.0,1.0,0.0,0.0,5,1,4,2.0,0.0,2.0
9805416,26,8,18,26,15,11,31,53,4.0,3.0,1.0,1.0,0.0,4.0,19.0,39,26,13,7.0,7.0,0.0
9805500,15,9,6,14,2,13,86,13,9.0,5.0,4.0,12.0,0.0,9.0,62.0,70,15,55,21.0,7.0,14.0
9609501,1,1,0,0,0,1,6,29,0.0,0.0,0.0,0.0,0.0,0.0,0.0,12,1,11,6.0,0.0,6.0
9903467,1,1,0,0,0,1,6,18,0.0,0.0,0.0,0.0,0.0,0.0,0.0,13,1,12,1.0,0.0,1.0
9707465,8,4,4,5,4,4,6,209,4.0,3.0,1.0,1.0,4.0,0.0,0.0,11,8,3,2.0,2.0,0.0
9212234,3,2,1,1,3,0,0,297,3.0,2.0,1.0,1.0,3.0,0.0,0.0,4,3,1,2.0,2.0,0.0
205148,6,1,5,8,1,5,42,6,4.0,1.0,3.0,4.0,1.0,3.0,6.0,23,6,17,4.0,4.0,0.0
9403323,15,9,6,13,3,12,21,96,10.0,4.0,6.0,13.0,2.0,8.0,15.0,20,15,5,11.0,9.0,2.0
9903291,8,5,3,4,1,7,15,22,5.0,3.0,2.0,2.0,1.0,4.0,9.0,15,8,7,1.0,1.0,0.0
9909261,2,1,1,1,0,2,3,112,0.0,0.0,0.0,0.0,0.0,0.0,0.0,9,2,7,4.0,0.0,4.0
9307219,5,4,1,1,5,0,0,26,4.0,3.0,1.0,1.0,4.0,0.0,0.0,5,5,0,1.0,1.0,0.0
9804368,6,4,2,3,4,2,4,48,2.0,1.0,1.0,1.0,0.0,2.0,3.0,10,6,4,1.0,1.0,0.0
101162,10,3,7,10,1,9,29,273,6.0,5.0,1.0,1.0,0.0,6.0,17.0,20,10,10,5.0,4.0,1.0
9403379,13,7,6,12,13,0,0,306,6.0,2.0,4.0,9.0,6.0,0.0,0.0,13,13,0,5.0,5.0,0.0
206292,24,14,10,14,2,22,66,107,12.0,8.0,4.0,4.0,0.0,12.0,41.0,36,24,12,7.0,5.0,2.0
9907542,12,3,9,30,0,12,49,4,6.0,2.0,4.0,11.0,0.0,6.0,9.0,31,12,19,6.0,5.0,1.0
208163,6,3,3,6,0,6,83,0,5.0,2.0,3.0,6.0,0.0,5.0,58.0,43,6,37,22.0,2.0,20.0
107231,3,2,1,2,0,3,30,0,1.0,1.0,0.0,0.0,0.0,1.0,11.0,30,3,27,5.0,2.0,3.0
9903396,15,6,9,20,6,9,36,59,9.0,2.0,7.0,16.0,1.0,8.0,35.0,23,15,8,8.0,5.0,3.0
9902279,23,11,12,21,9,14,15,174,7.0,7.0,0.0,0.0,1.0,6.0,6.0,26,23,3,9.0,8.0,1.0
9506411,7,4,3,4,0,7,29,26,3.0,2.0,1.0,1.0,0.0,3.0,22.0,17,7,10,12.0,3.0,9.0
9902260,20,11,9,13,5,15,49,31,10.0,6.0,4.0,6.0,0.0,10.0,38.0,30,20,10,3.0,3.0,0.0
211074,5,3,2,4,0,5,34,3,0.0,0.0,0.0,0.0,0.0,0.0,0.0,25,5,20,11.0,2.0,9.0
104116,6,3,3,4,4,2,3,3,0.0,0.0,0.0,0.0,0.0,0.0,0.0,22,6,16,3.0,2.0,1.0
207096,7,6,1,1,3,4,25,3,1.0,1.0,0.0,0.0,0.0,1.0,6.0,24,7,17,2.0,1.0,1.0
12035,12,2,10,25,1,11,52,45,8.0,2.0,6.0,18.0,0.0,8.0,31.0,21,12,9,13.0,8.0,5.0
9905350,8,3,5,5,1,7,41,83,6.0,2.0,4.0,4.0,0.0,6.0,35.0,27,8,19,15.0,5.0,10.0
111070,0,0,0,0,0,0,0,39,0.0,0.0,0.0,0.0,0.0,0.0,0.0,8,0,8,5.0,0.0,5.0
9905400,0,0,0,0,0,0,0,1803,0.0,0.0,0.0,0.0,0.0,0.0,0.0,1,0,1,,,
104173,1,1,0,0,1,0,0,49,0.0,0.0,0.0,0.0,0.0,0.0,0.0,13,1,12,2.0,0.0,2.0
205163,5,4,1,1,2,3,3,6,0.0,0.0,0.0,0.0,0.0,0.0,0.0,36,5,31,4.0,0.0,4.0
207075,1,1,0,0,1,0,0,347,0.0,0.0,0.0,0.0,0.0,0.0,0.0,9,1,8,3.0,0.0,3.0
9901431,16,7,9,23,2,14,53,29,5.0,3.0,2.0,3.0,0.0,5.0,24.0,39,16,23,9.0,2.0,7.0
3291,7,5,2,2,0,7,37,92,2.0,2.0,0.0,0.0,0.0,2.0,3.0,22,7,15,6.0,4.0,2.0
101005,11,4,7,12,1,10,45,3,7.0,4.0,3.0,6.0,0.0,7.0,20.0,48,11,37,3.0,2.0,1.0
104057,11,5,6,10,0,11,103,30,6.0,2.0,4.0,6.0,0.0,6.0,55.0,38,11,27,8.0,3.0,5.0
9806457,5,4,1,1,3,2,3,101,1.0,1.0,0.0,0.0,1.0,0.0,0.0,9,5,4,,,
9709490,4,3,1,1,3,1,4,25,2.0,2.0,0.0,0.0,1.0,1.0,4.0,25,4,21,3.0,1.0,2.0
111244,22,5,17,34,0,22,224,11,12.0,3.0,9.0,20.0,0.0,12.0,177.0,51,22,29,30.0,9.0,21.0
9801427,2,2,0,0,1,1,2,172,0.0,0.0,0.0,0.0,0.0,0.0,0.0,4,2,2,,,
9406301,2,2,0,0,1,1,1,15,,,,,,,,7,2,5,,,
9707520,3,2,1,1,2,1,4,582,1.0,1.0,0.0,0.0,0.0,1.0,2.0,8,3,5,2.0,1.0,1.0
9312263,2,1,1,1,2,0,0,2091,0.0,0.0,0.0,0.0,0.0,0.0,0.0,3,2,1,,,
9610403,4,2,2,2,0,4,14,60,3.0,2.0,1.0,1.0,0.0,3.0,7.0,15,4,11,9.0,2.0,7.0
9609453,7,5,2,4,0,7,19,33,1.0,1.0,0.0,0.0,0.0,1.0,2.0,14,7,7,5.0,1.0,4.0
112112,4,3,1,1,0,4,35,23,1.0,1.0,0.0,0.0,0.0,1.0,17.0,33,4,29,17.0,1.0,16.0
5302,2,1,1,1,0,2,10,174,2.0,1.0,1.0,1.0,0.0,2.0,7.0,12,2,10,8.0,2.0,6.0
1011,3,2,1,1,2,1,2,59,3.0,2.0,1.0,1.0,2.0,1.0,2.0,5,3,2,3.0,2.0,1.0
9907486,4,2,2,3,0,4,4,262,3.0,1.0,2.0,3.0,0.0,3.0,3.0,5,4,1,4.0,3.0,1.0
9705280,3,2,1,1,0,3,3,397,2.0,1.0,1.0,1.0,2.0,0.0,0.0,7,3,4,3.0,2.0,1.0
202098,6,3,3,6,0,6,18,20,1.0,1.0,0.0,0.0,1.0,0.0,0.0,12,6,6,3.0,2.0,1.0
12259,18,2,16,42,3,15,225,2,12.0,1.0,11.0,29.0,0.0,12.0,205.0,67,18,49,30.0,8.0,22.0
9502229,9,1,8,16,9,0,0,503,7.0,1.0,6.0,13.0,7.0,0.0,0.0,9,9,0,7.0,7.0,0.0
202047,1,1,0,0,0,1,1,23,,,,,,,,3,1,2,,,
9801384,5,4,1,1,1,4,8,126,5.0,4.0,1.0,1.0,1.0,4.0,8.0,8,5,3,6.0,4.0,2.0
9709312,5,1,4,7,0,5,13,47,5.0,1.0,4.0,7.0,0.0,5.0,9.0,9,5,4,7.0,5.0,2.0
1291,1,1,0,0,0,1,5,88,1.0,1.0,0.0,0.0,0.0,1.0,5.0,6,1,5,1.0,0.0,1.0
211300,4,4,0,0,0,4,39,0,3.0,3.0,0.0,0.0,0.0,3.0,29.0,48,4,44,14.0,3.0,11.0
106125,5,3,2,2,0,5,44,3,3.0,2.0,1.0,1.0,0.0,3.0,27.0,39,5,34,4.0,1.0,3.0
5050,2,2,0,0,0,2,15,4,1.0,1.0,0.0,0.0,0.0,1.0,5.0,16,2,14,3.0,1.0,2.0
9704263,3,3,0,0,0,3,7,4,0.0,0.0,0.0,0.0,0.0,0.0,0.0,20,3,17,5.0,0.0,5.0
9910460,1,1,0,0,0,1,11,9,1.0,1.0,0.0,0.0,0.0,1.0,10.0,19,1,18,1.0,0.0,1.0
10217,9,4,5,8,0,9,42,17,6.0,2.0,4.0,7.0,0.0,6.0,20.0,23,9,14,9.0,5.0,4.0
9510213,13,5,8,23,1,12,22,82,10.0,4.0,6.0,17.0,0.0,10.0,19.0,15,13,2,6.0,5.0,1.0
204152,2,2,0,0,0,2,11,95,0.0,0.0,0.0,0.0,0.0,0.0,0.0,30,2,28,9.0,0.0,9.0
104264,11,6,5,9,0,11,54,85,3.0,2.0,1.0,1.0,0.0,3.0,9.0,32,11,21,8.0,0.0,8.0
7137,4,3,1,1,0,4,49,34,3.0,2.0,1.0,1.0,0.0,3.0,45.0,32,4,28,24.0,3.0,21.0
9709259,5,1,4,7,0,5,21,68,4.0,1.0,3.0,5.0,0.0,4.0,13.0,12,5,7,1.0,0.0,1.0
9808202,14,7,7,11,0,14,92,68,4.0,3.0,1.0,1.0,0.0,4.0,21.0,44,14,30,13.0,2.0,11.0
103337,6,2,4,7,2,4,5,118,5.0,1.0,4.0,7.0,5.0,0.0,0.0,9,6,3,3.0,3.0,0.0
12218,3,3,0,0,3,0,0,1683,1.0,1.0,0.0,0.0,1.0,0.0,0.0,7,3,4,1.0,1.0,0.0
111237,4,3,1,1,0,4,8,183,1.0,1.0,0.0,0.0,0.0,1.0,1.0,12,4,8,3.0,3.0,0.0
9609454,1,1,0,0,0,1,3,365,1.0,1.0,0.0,0.0,0.0,1.0,3.0,5,1,4,2.0,1.0,1.0
3152,3,2,1,1,0,3,9,143,2.0,1.0,1.0,1.0,2.0,0.0,0.0,10,3,7,2.0,2.0,0.0
106120,19,11,8,14,1,18,190,17,6.0,2.0,4.0,9.0,0.0,6.0,114.0,116,19,97,42.0,1.0,41.0
9612231,8,2,6,9,0,8,58,40,7.0,2.0,5.0,7.0,0.0,7.0,53.0,26,8,18,16.0,4.0,12.0
9508340,8,4,4,6,5,3,7,53,0.0,0.0,0.0,0.0,0.0,0.0,0.0,19,8,11,3.0,0.0,3.0
110202,2,2,0,0,0,2,20,2,0.0,0.0,0.0,0.0,0.0,0.0,0.0,17,2,15,1.0,0.0,1.0
9602406,5,4,1,1,2,3,3,173,2.0,1.0,1.0,1.0,2.0,0.0,0.0,6,5,1,2.0,1.0,1.0
9911471,4,2,2,3,0,4,9,43,3.0,2.0,1.0,1.0,3.0,0.0,0.0,8,4,4,4.0,4.0,0.0
9903206,11,4,7,8,1,10,32,29,3.0,2.0,1.0,1.0,1.0,2.0,2.0,24,11,13,3.0,1.0,2.0
9503262,6,5,1,1,2,4,38,34,0.0,0.0,0.0,0.0,0.0,0.0,0.0,46,6,40,6.0,0.0,6.0
106343,2,2,0,0,0,2,7,2,,,,,,,,12,2,10,,,
9907221,7,4,3,3,1,6,27,47,2.0,1.0,1.0,1.0,0.0,2.0,8.0,34,7,27,4.0,0.0,4.0
9704320,4,2,2,4,0,4,5,68,4.0,2.0,2.0,4.0,1.0,3.0,3.0,7,4,3,4.0,3.0,1.0
101322,12,7,5,10,2,10,37,133,1.0,1.0,0.0,0.0,0.0,1.0,4.0,39,12,27,9.0,1.0,8.0
207301,1,1,0,0,1,0,0,327,1.0,1.0,0.0,0.0,1.0,0.0,0.0,8,1,7,4.0,1.0,3.0
207211,5,1,4,6,1,4,20,15,1.0,1.0,0.0,0.0,0.0,1.0,4.0,24,5,19,2.0,1.0,1.0
9612238,4,2,2,3,0,4,8,31,3.0,2.0,1.0,1.0,0.0,3.0,3.0,7,4,3,4.0,3.0,1.0
9907445,4,4,0,0,0,4,11,254,3.0,3.0,0.0,0.0,0.0,3.0,7.0,11,4,7,6.0,3.0,3.0
9711211,11,4,7,8,0,11,41,58,7.0,1.0,6.0,7.0,0.0,7.0,26.0,30,11,19,13.0,6.0,7.0
9701317,0,0,0,0,0,0,0,61,0.0,0.0,0.0,0.0,0.0,0.0,0.0,4,0,4,3.0,0.0,3.0
9501295,10,4,6,10,6,4,9,1,0.0,0.0,0.0,0.0,0.0,0.0,0.0,16,10,6,1.0,1.0,0.0
9812506,6,6,0,0,0,6,31,217,5.0,5.0,0.0,0.0,0.0,5.0,16.0,13,6,7,10.0,5.0,5.0
9802236,5,4,1,1,5,0,0,387,5.0,4.0,1.0,1.0,5.0,0.0,0.0,5,5,0,3.0,3.0,0.0
9911221,4,4,0,0,0,4,28,44,2.0,2.0,0.0,0.0,0.0,2.0,6.0,26,4,22,8.0,1.0,7.0
9411297,3,3,0,0,3,0,0,94,,,,,,,,3,3,0,,,
9905224,0,0,0,0,0,0,0,149,0.0,0.0,0.0,0.0,0.0,0.0,0.0,4,0,4,4.0,0.0,4.0
9903227,11,4,7,10,1,10,21,131,6.0,2.0,4.0,6.0,0.0,6.0,11.0,23,11,12,8.0,7.0,1.0
105215,1,1,0,0,0,1,6,6,1.0,1.0,0.0,0.0,0.0,1.0,4.0,17,1,16,8.0,1.0,7.0
9912446,7,4,3,7,0,7,11,20,1.0,1.0,0.0,0.0,0.0,1.0,1.0,11,7,4,5.0,4.0,1.0
208089,6,2,4,10,0,6,97,0,4.0,1.0,3.0,6.0,0.0,4.0,53.0,32,6,26,18.0,4.0,14.0
7317,4,1,3,4,0,4,38,29,4.0,1.0,3.0,4.0,0.0,4.0,31.0,34,4,30,18.0,3.0,15.0
209305,4,2,2,3,0,4,52,4,3.0,2.0,1.0,2.0,0.0,3.0,33.0,44,4,40,12.0,1.0,11.0
101172,3,2,1,1,1,2,10,4,0.0,0.0,0.0,0.0,0.0,0.0,0.0,11,3,8,1.0,0.0,1.0
112343,2,2,0,0,0,2,34,2,1.0,1.0,0.0,0.0,0.0,1.0,17.0,19,2,17,16.0,2.0,14.0
5056,5,2,3,6,0,5,18,49,4.0,1.0,3.0,4.0,0.0,4.0,15.0,24,5,19,3.0,2.0,1.0
9404266,6,6,0,0,6,0,0,71,3.0,3.0,0.0,0.0,3.0,0.0,0.0,6,6,0,2.0,2.0,0.0
108049,1,1,0,0,0,1,3,37,,,,,,,,5,1,4,,,
111090,4,2,2,2,0,4,27,16,3.0,1.0,2.0,2.0,0.0,3.0,10.0,30,4,26,8.0,3.0,5.0
204014,6,5,1,1,1,5,25,11,0.0,0.0,0.0,0.0,0.0,0.0,0.0,27,6,21,5.0,1.0,4.0
9708460,5,3,2,2,0,5,21,188,5.0,3.0,2.0,2.0,0.0,5.0,17.0,12,5,7,7.0,3.0,4.0
9710477,2,1,1,1,0,2,3,18,2.0,1.0,1.0,1.0,0.0,2.0,3.0,31,2,29,5.0,0.0,5.0
9305238,7,3,4,8,7,0,0,45,4.0,1.0,3.0,5.0,4.0,0.0,0.0,7,7,0,1.0,1.0,0.0
9909230,4,4,0,0,2,2,2,658,1.0,1.0,0.0,0.0,1.0,0.0,0.0,7,4,3,2.0,1.0,1.0
110059,3,2,1,1,3,0,0,31,0.0,0.0,0.0,0.0,0.0,0.0,0.0,17,3,14,7.0,0.0,7.0
202100,8,5,3,5,0,8,22,32,1.0,1.0,0.0,0.0,0.0,1.0,1.0,56,8,48,7.0,4.0,3.0
9901423,1,1,0,0,0,1,2,143,1.0,1.0,0.0,0.0,0.0,1.0,2.0,6,1,5,3.0,1.0,2.0
202214,2,2,0,0,0,2,3,46,0.0,0.0,0.0,0.0,0.0,0.0,0.0,14,2,12,4.0,0.0,4.0
205103,1,1,0,0,0,1,9,5,1.0,1.0,0.0,0.0,0.0,1.0,9.0,17,1,16,1.0,0.0,1.0
209231,1,1,0,0,1,0,0,351,0.0,0.0,0.0,0.0,0.0,0.0,0.0,10,1,9,4.0,0.0,4.0
9811278,3,3,0,0,0,3,10,43,2.0,2.0,0.0,0.0,0.0,2.0,6.0,17,3,14,5.0,2.0,3.0
9907557,3,3,0,0,0,3,15,6,2.0,2.0,0.0,0.0,0.0,2.0,6.0,21,3,18,7.0,2.0,5.0
9912497,2,2,0,0,0,2,16,58,0.0,0.0,0.0,0.0,0.0,0.0,0.0,24,2,22,4.0,0.0,4.0
3067,2,2,0,0,0,2,8,105,2.0,2.0,0.0,0.0,0.0,2.0,8.0,9,2,7,4.0,2.0,2.0
9703340,1,1,0,0,1,0,0,1100,,,,,,,,1,1,0,,,
9704364,7,3,4,4,0,7,19,17,4.0,2.0,2.0,2.0,0.0,4.0,4.0,19,7,12,7.0,4.0,3.0
9608363,2,2,0,0,0,2,7,300,2.0,2.0,0.0,0.0,0.0,2.0,3.0,8,2,6,3.0,1.0,2.0
9601255,1,1,0,0,0,1,2,27,0.0,0.0,0.0,0.0,0.0,0.0,0.0,6,1,5,2.0,0.0,2.0
9501367,1,1,0,0,1,0,0,130,,,,,,,,3,1,2,,,
202044,1,1,0,0,1,0,0,7,,,,,,,,7,1,6,4.0,0.0,4.0
205098,2,1,1,1,0,2,13,20,2.0,1.0,1.0,1.0,0.0,2.0,13.0,11,2,9,8.0,2.0,6.0
9510440,1,1,0,0,0,1,6,110,1.0,1.0,0.0,0.0,0.0,1.0,4.0,8,1,7,3.0,0.0,3.0
9603224,1,1,0,0,0,1,1,237,0.0,0.0,0.0,0.0,0.0,0.0,0.0,5,1,4,2.0,0.0,2.0
9408211,3,3,0,0,0,3,3,81,2.0,2.0,0.0,0.0,2.0,0.0,0.0,4,3,1,3.0,3.0,0.0
9907345,1,1,0,0,0,1,2,91,0.0,0.0,0.0,0.0,0.0,0.0,0.0,5,1,4,1.0,0.0,1.0
212180,3,1,2,2,0,3,28,1,2.0,1.0,1.0,1.0,0.0,2.0,9.0,30,3,27,10.0,2.0,8.0
9912350,0,0,0,0,0,0,0,39,0.0,0.0,0.0,0.0,0.0,0.0,0.0,10,0,10,2.0,0.0,2.0
101262,3,1,2,3,0,3,15,4,1.0,1.0,0.0,0.0,0.0,1.0,4.0,13,3,10,8.0,2.0,6.0
203140,2,1,1,1,0,2,18,19,2.0,1.0,1.0,1.0,0.0,2.0,13.0,12,2,10,10.0,1.0,9.0
9811298,7,2,5,9,1,6,36,137,6.0,2.0,4.0,8.0,0.0,6.0,33.0,19,7,12,13.0,4.0,9.0
9410300,0,0,0,0,0,0,0,34,,,,,,,,6,0,6,,,
9807403,3,2,1,1,3,0,0,610,2.0,2.0,0.0,0.0,2.0,0.0,0.0,3,3,0,1.0,1.0,0.0
9504365,2,2,0,0,0,2,5,238,1.0,1.0,0.0,0.0,0.0,1.0,1.0,7,2,5,3.0,1.0,2.0
202041,1,1,0,0,0,1,8,21,1.0,1.0,0.0,0.0,0.0,1.0,5.0,12,1,11,4.0,1.0,3.0
9804246,0,0,0,0,0,0,0,38,,,,,,,,4,0,4,,,
111115,15,4,11,36,2,13,20,165,14.0,3.0,11.0,36.0,1.0,13.0,20.0,21,15,6,16.0,13.0,3.0
209149,1,1,0,0,1,0,0,354,0.0,0.0,0.0,0.0,0.0,0.0,0.0,4,1,3,1.0,1.0,0.0
9304283,16,4,12,28,16,0,0,106,10.0,3.0,7.0,20.0,10.0,0.0,0.0,16,16,0,9.0,9.0,0.0
9510320,1,1,0,0,1,0,0,12,1.0,1.0,0.0,0.0,1.0,0.0,0.0,5,1,4,,,
9612319,4,2,2,3,0,4,28,14,3.0,2.0,1.0,2.0,0.0,3.0,26.0,17,4,13,7.0,3.0,4.0
108014,6,3,3,4,2,4,11,139,4.0,2.0,2.0,2.0,1.0,3.0,5.0,11,6,5,6.0,3.0,3.0
9606457,3,2,1,1,3,0,0,140,3.0,2.0,1.0,1.0,3.0,0.0,0.0,5,3,2,1.0,1.0,0.0
211001,9,4,5,7,0,9,106,46,6.0,3.0,3.0,5.0,0.0,6.0,78.0,70,9,61,28.0,4.0,24.0
202012,12,6,6,22,1,11,190,11,8.0,2.0,6.0,17.0,0.0,8.0,96.0,69,12,57,26.0,7.0,19.0
203103,2,2,0,0,0,2,11,8,0.0,0.0,0.0,0.0,0.0,0.0,0.0,23,2,21,4.0,0.0,4.0
9410334,1,1,0,0,0,1,2,133,1.0,1.0,0.0,0.0,1.0,0.0,0.0,9,1,8,1.0,0.0,1.0
9708307,1,1,0,0,1,0,0,399,0.0,0.0,0.0,0.0,0.0,0.0,0.0,4,1,3,1.0,0.0,1.0
9706431,3,3,0,0,0,3,9,30,1.0,1.0,0.0,0.0,0.0,1.0,2.0,10,3,7,2.0,1.0,1.0
1118,3,3,0,0,1,2,3,67,0.0,0.0,0.0,0.0,0.0,0.0,0.0,42,3,39,11.0,0.0,11.0
9410288,5,2,3,4,1,4,17,134,4.0,2.0,2.0,3.0,0.0,4.0,14.0,12,5,7,6.0,4.0,2.0
9508248,6,5,1,3,1,5,5,79,5.0,4.0,1.0,3.0,1.0,4.0,4.0,8,6,2,6.0,5.0,1.0
9911225,3,2,1,1,0,3,15,115,2.0,1.0,1.0,1.0,0.0,2.0,10.0,16,3,13,9.0,2.0,7.0
107230,3,2,1,1,0,3,12,103,3.0,2.0,1.0,1.0,0.0,3.0,12.0,10,3,7,8.0,3.0,5.0
9211264,1,1,0,0,1,0,0,661,1.0,1.0,0.0,0.0,1.0,0.0,0.0,1,1,0,1.0,1.0,0.0
9307224,1,1,0,0,1,0,0,2016,1.0,1.0,0.0,0.0,1.0,0.0,0.0,1,1,0,1.0,1.0,0.0
9912530,2,1,1,1,1,1,1,199,0.0,0.0,0.0,0.0,0.0,0.0,0.0,8,2,6,2.0,1.0,1.0
6130,3,2,1,2,0,3,8,3,0.0,0.0,0.0,0.0,0.0,0.0,0.0,33,3,30,9.0,0.0,9.0
112063,3,1,2,2,0,3,16,7,0.0,0.0,0.0,0.0,0.0,0.0,0.0,16,3,13,3.0,2.0,1.0
3274,2,2,0,0,1,1,1,420,2.0,2.0,0.0,0.0,1.0,1.0,1.0,4,2,2,3.0,2.0,1.0
9605361,5,3,2,3,1,4,24,33,4.0,2.0,2.0,3.0,0.0,4.0,20.0,16,5,11,14.0,4.0,10.0
9901223,1,1,0,0,0,1,1,195,0.0,0.0,0.0,0.0,0.0,0.0,0.0,6,1,5,1.0,0.0,1.0
106115,10,1,9,25,0,10,118,9,10.0,1.0,9.0,25.0,0.0,10.0,108.0,35,10,25,26.0,6.0,20.0
102161,2,2,0,0,0,2,6,13,1.0,1.0,0.0,0.0,0.0,1.0,1.0,14,2,12,2.0,1.0,1.0
9903313,1,1,0,0,1,0,0,508,1.0,1.0,0.0,0.0,1.0,0.0,0.0,2,1,1,2.0,1.0,1.0
9908231,11,4,7,13,0,11,89,12,4.0,1.0,3.0,3.0,0.0,4.0,29.0,60,11,49,21.0,2.0,19.0
4081,1,1,0,0,0,1,5,72,1.0,1.0,0.0,0.0,0.0,1.0,2.0,6,1,5,4.0,1.0,3.0
102293,0,0,0,0,0,0,0,1934,0.0,0.0,0.0,0.0,0.0,0.0,0.0,4,0,4,1.0,0.0,1.0
9705459,1,1,0,0,0,1,3,130,0.0,0.0,0.0,0.0,0.0,0.0,0.0,8,1,7,2.0,0.0,2.0
9810498,2,1,1,1,1,1,1,106,2.0,1.0,1.0,1.0,1.0,1.0,1.0,5,2,3,2.0,0.0,2.0
9512224,1,1,0,0,0,1,7,94,1.0,1.0,0.0,0.0,0.0,1.0,6.0,9,1,8,7.0,1.0,6.0
7199,0,0,0,0,0,0,0,84,0.0,0.0,0.0,0.0,0.0,0.0,0.0,5,0,5,3.0,0.0,3.0
9605381,1,1,0,0,1,0,0,161,0.0,0.0,0.0,0.0,0.0,0.0,0.0,2,1,1,1.0,0.0,1.0
9806438,5,1,4,10,0,5,34,142,5.0,1.0,4.0,10.0,0.0,5.0,31.0,14,5,9,8.0,5.0,3.0
9902480,1,1,0,0,0,1,4,25,0.0,0.0,0.0,0.0,0.0,0.0,0.0,14,1,13,1.0,0.0,1.0
9023,1,1,0,0,1,0,0,7,0.0,0.0,0.0,0.0,0.0,0.0,0.0,13,1,12,1.0,1.0,0.0
9803448,2,1,1,1,0,2,12,14,0.0,0.0,0.0,0.0,0.0,0.0,0.0,13,2,11,5.0,0.0,5.0
12235,7,6,1,1,4,3,13,59,2.0,1.0,1.0,1.0,0.0,2.0,8.0,18,7,11,9.0,2.0,7.0
10284,0,0,0,0,0,0,0,58,0.0,0.0,0.0,0.0,0.0,0.0,0.0,9,0,9,3.0,0.0,3.0
9908422,2,1,1,1,1,1,3,160,0.0,0.0,0.0,0.0,0.0,0.0,0.0,7,2,5,2.0,0.0,2.0
2289,1,1,0,0,1,0,0,561,1.0,1.0,0.0,0.0,1.0,0.0,0.0,3,1,2,2.0,1.0,1.0
203090,8,3,5,10,0,8,32,4,5.0,1.0,4.0,8.0,0.0,5.0,21.0,22,8,14,1.0,0.0,1.0
9708401,2,2,0,0,1,1,1,90,0.0,0.0,0.0,0.0,0.0,0.0,0.0,6,2,4,1.0,1.0,0.0
9811423,5,4,1,1,1,4,5,16,1.0,1.0,0.0,0.0,0.0,1.0,1.0,12,5,7,8.0,1.0,7.0
205058,3,3,0,0,0,3,9,172,1.0,1.0,0.0,0.0,0.0,1.0,6.0,15,3,12,8.0,1.0,7.0
202222,2,2,0,0,1,1,9,1,1.0,1.0,0.0,0.0,1.0,0.0,0.0,15,2,13,5.0,1.0,4.0
102335,3,1,2,3,0,3,10,147,3.0,1.0,2.0,3.0,0.0,3.0,5.0,8,3,5,6.0,3.0,3.0
1326,6,5,1,1,1,5,6,84,0.0,0.0,0.0,0.0,0.0,0.0,0.0,23,6,17,7.0,0.0,7.0
9710556,6,1,5,5,4,2,2,184,4.0,1.0,3.0,3.0,4.0,0.0,0.0,8,6,2,4.0,4.0,0.0
3250,2,2,0,0,2,0,0,263,1.0,1.0,0.0,0.0,1.0,0.0,0.0,4,2,2,1.0,1.0,0.0
207153,4,3,1,1,0,4,55,9,4.0,3.0,1.0,1.0,0.0,4.0,55.0,42,4,38,23.0,0.0,23.0
10269,0,0,0,0,0,0,0,416,0.0,0.0,0.0,0.0,0.0,0.0,0.0,2,0,2,2.0,0.0,2.0
107059,5,2,3,4,1,4,4,30,1.0,1.0,0.0,0.0,0.0,1.0,1.0,10,5,5,5.0,4.0,1.0
9809532,4,3,1,1,4,0,0,28,1.0,1.0,0.0,0.0,1.0,0.0,0.0,19,4,15,2.0,2.0,0.0
9409395,6,4,2,2,6,0,0,470,2.0,2.0,0.0,0.0,2.0,0.0,0.0,6,6,0,1.0,1.0,0.0
9506267,2,2,0,0,2,0,0,90,,,,,,,,2,2,0,1.0,1.0,0.0
9505231,5,3,2,2,0,5,6,157,1.0,1.0,0.0,0.0,0.0,1.0,1.0,8,5,3,4.0,3.0,1.0
9810207,3,2,1,1,1,2,4,33,0.0,0.0,0.0,0.0,0.0,0.0,0.0,8,3,5,1.0,0.0,1.0
9904306,1,1,0,0,0,1,4,76,0.0,0.0,0.0,0.0,0.0,0.0,0.0,9,1,8,3.0,0.0,3.0
106096,2,2,0,0,0,2,17,124,1.0,1.0,0.0,0.0,0.0,1.0,11.0,18,2,16,12.0,1.0,11.0
9608339,7,2,5,10,1,6,12,31,6.0,1.0,5.0,10.0,0.0,6.0,6.0,9,7,2,7.0,6.0,1.0
9901383,1,1,0,0,1,0,0,132,1.0,1.0,0.0,0.0,1.0,0.0,0.0,2,1,1,1.0,1.0,0.0
6164,0,0,0,0,0,0,0,2,0.0,0.0,0.0,0.0,0.0,0.0,0.0,22,0,22,8.0,0.0,8.0
9611461,3,2,1,1,0,3,23,15,2.0,1.0,1.0,1.0,0.0,2.0,18.0,32,3,29,11.0,1.0,10.0
203213,6,2,4,4,0,6,59,11,4.0,1.0,3.0,3.0,0.0,4.0,52.0,59,6,53,28.0,2.0,26.0
9512424,1,1,0,0,1,0,0,491,1.0,1.0,0.0,0.0,1.0,0.0,0.0,3,1,2,2.0,1.0,1.0
3217,2,2,0,0,0,2,7,117,2.0,2.0,0.0,0.0,0.0,2.0,7.0,10,2,8,1.0,0.0,1.0
9901414,1,1,0,0,1,0,0,316,1.0,1.0,0.0,0.0,1.0,0.0,0.0,3,1,2,1.0,1.0,0.0
9408206,3,3,0,0,0,3,3,114,2.0,2.0,0.0,0.0,0.0,2.0,2.0,4,3,1,3.0,2.0,1.0
9804417,3,2,1,1,0,3,8,284,2.0,1.0,1.0,1.0,0.0,2.0,7.0,9,3,6,7.0,2.0,5.0
8094,7,3,4,7,0,7,27,201,6.0,2.0,4.0,7.0,0.0,6.0,22.0,19,7,12,10.0,4.0,6.0
105055,1,1,0,0,0,1,2,215,0.0,0.0,0.0,0.0,0.0,0.0,0.0,10,1,9,7.0,0.0,7.0
11149,1,1,0,0,1,0,0,58,0.0,0.0,0.0,0.0,0.0,0.0,0.0,3,1,2,2.0,0.0,2.0
9906499,2,2,0,0,0,2,8,14,1.0,1.0,0.0,0.0,0.0,1.0,3.0,19,2,17,10.0,1.0,9.0
9907316,5,4,1,1,1,4,16,107,2.0,2.0,0.0,0.0,0.0,2.0,14.0,22,5,17,9.0,2.0,7.0
103013,3,3,0,0,0,3,9,56,1.0,1.0,0.0,0.0,0.0,1.0,1.0,9,3,6,2.0,1.0,1.0
109183,2,2,0,0,2,0,0,159,2.0,2.0,0.0,0.0,2.0,0.0,0.0,7,2,5,1.0,0.0,1.0
9307361,1,1,0,0,0,1,1,407,0.0,0.0,0.0,0.0,0.0,0.0,0.0,4,1,3,1.0,0.0,1.0
301187,2,1,1,1,0,2,28,53,2.0,1.0,1.0,1.0,0.0,2.0,28.0,19,2,17,17.0,2.0,15.0
203147,4,3,1,1,0,4,22,181,2.0,2.0,0.0,0.0,0.0,2.0,8.0,16,4,12,6.0,2.0,4.0
2165,5,4,1,1,0,5,10,83,3.0,2.0,1.0,1.0,0.0,3.0,3.0,9,5,4,4.0,3.0,1.0
9507279,3,2,1,1,1,2,2,517,2.0,1.0,1.0,1.0,0.0,2.0,2.0,4,3,1,3.0,2.0,1.0
105077,4,3,1,1,0,4,117,23,3.0,2.0,1.0,1.0,0.0,3.0,87.0,84,4,80,33.0,3.0,30.0
4211,2,2,0,0,2,0,0,9,0.0,0.0,0.0,0.0,0.0,0.0,0.0,27,2,25,12.0,0.0,12.0
210028,2,2,0,0,0,2,25,1,2.0,2.0,0.0,0.0,0.0,2.0,17.0,38,2,36,17.0,1.0,16.0
9908263,1,1,0,0,1,0,0,209,,,,,,,,1,1,0,,,
9811277,0,0,0,0,0,0,0,113,,,,,,,,1,0,1,,,
206270,3,1,2,2,0,3,29,127,3.0,1.0,2.0,2.0,0.0,3.0,19.0,15,3,12,10.0,3.0,7.0
9504271,0,0,0,0,0,0,0,208,0.0,0.0,0.0,0.0,0.0,0.0,0.0,4,0,4,3.0,0.0,3.0
9405317,2,2,0,0,2,0,0,134,1.0,1.0,0.0,0.0,1.0,0.0,0.0,5,2,3,1.0,1.0,0.0
202156,5,4,1,1,1,4,9,376,1.0,1.0,0.0,0.0,0.0,1.0,1.0,21,5,16,3.0,1.0,2.0
9906482,0,0,0,0,0,0,0,202,0.0,0.0,0.0,0.0,0.0,0.0,0.0,3,0,3,1.0,0.0,1.0
9804267,3,2,1,1,0,3,8,3,3.0,2.0,1.0,1.0,0.0,3.0,8.0,6,3,3,6.0,3.0,3.0
8300,4,3,1,1,0,4,17,6,1.0,1.0,0.0,0.0,0.0,1.0,3.0,38,4,34,6.0,1.0,5.0
103257,3,2,1,1,2,1,2,138,1.0,1.0,0.0,0.0,0.0,1.0,1.0,12,3,9,4.0,1.0,3.0
9805227,3,2,1,1,0,3,6,40,1.0,1.0,0.0,0.0,0.0,1.0,1.0,15,3,12,3.0,1.0,2.0
9506434,3,2,1,1,2,1,1,588,3.0,2.0,1.0,1.0,3.0,0.0,0.0,4,3,1,3.0,3.0,0.0
9710517,5,2,3,8,0,5,9,111,5.0,2.0,3.0,8.0,1.0,4.0,5.0,8,5,3,7.0,5.0,2.0
12049,10,7,3,3,1,9,45,83,8.0,5.0,3.0,3.0,0.0,8.0,43.0,23,10,13,16.0,6.0,10.0
207079,9,6,3,5,0,9,97,37,8.0,5.0,3.0,4.0,0.0,8.0,91.0,27,9,18,22.0,6.0,16.0
9506327,3,2,1,1,0,3,3,163,2.0,1.0,1.0,1.0,2.0,0.0,0.0,6,3,3,2.0,2.0,0.0
9710528,4,2,2,2,0,4,19,110,4.0,2.0,2.0,2.0,0.0,4.0,18.0,11,4,7,6.0,3.0,3.0
9909290,2,2,0,0,0,2,2,2,1.0,1.0,0.0,0.0,1.0,0.0,0.0,14,2,12,1.0,1.0,0.0
206113,2,2,0,0,0,2,7,146,1.0,1.0,0.0,0.0,0.0,1.0,4.0,23,2,21,12.0,1.0,11.0
9608326,0,0,0,0,0,0,0,10,0.0,0.0,0.0,0.0,0.0,0.0,0.0,15,0,15,6.0,0.0,6.0
9309265,6,4,2,2,6,0,0,78,3.0,1.0,2.0,2.0,3.0,0.0,0.0,6,6,0,3.0,3.0,0.0
108224,11,6,5,15,0,11,157,66,7.0,2.0,5.0,15.0,0.0,7.0,86.0,90,11,79,24.0,7.0,17.0
9608428,0,0,0,0,0,0,0,72,0.0,0.0,0.0,0.0,0.0,0.0,0.0,6,0,6,2.0,0.0,2.0
208143,3,2,1,1,0,3,18,19,0.0,0.0,0.0,0.0,0.0,0.0,0.0,15,3,12,10.0,1.0,9.0
211046,1,1,0,0,0,1,8,14,1.0,1.0,0.0,0.0,0.0,1.0,2.0,10,1,9,3.0,1.0,2.0
9502382,2,2,0,0,2,0,0,1958,,,,,,,,2,2,0,,,
9703384,4,4,0,0,0,4,9,130,2.0,2.0,0.0,0.0,1.0,1.0,1.0,9,4,5,3.0,2.0,1.0
10020,0,0,0,0,0,0,0,111,0.0,0.0,0.0,0.0,0.0,0.0,0.0,10,0,10,3.0,0.0,3.0
9701232,0,0,0,0,0,0,0,265,0.0,0.0,0.0,0.0,0.0,0.0,0.0,4,0,4,4.0,0.0,4.0
9707487,5,1,4,6,0,5,22,157,2.0,1.0,1.0,1.0,0.0,2.0,4.0,22,5,17,6.0,2.0,4.0
209103,5,5,0,0,2,3,12,0,1.0,1.0,0.0,0.0,0.0,1.0,7.0,17,5,12,1.0,1.0,0.0
9710530,1,1,0,0,0,1,6,27,0.0,0.0,0.0,0.0,0.0,0.0,0.0,17,1,16,8.0,0.0,8.0
9502342,4,2,2,2,0,4,12,149,4.0,2.0,2.0,2.0,0.0,4.0,12.0,9,4,5,7.0,3.0,4.0
110150,3,3,0,0,2,1,12,20,1.0,1.0,0.0,0.0,0.0,1.0,11.0,25,3,22,2.0,2.0,0.0
106132,11,2,9,29,1,10,63,23,9.0,1.0,8.0,28.0,0.0,9.0,47.0,26,11,15,10.0,6.0,4.0
9812436,5,2,3,6,2,3,8,198,4.0,1.0,3.0,6.0,1.0,3.0,8.0,9,5,4,7.0,4.0,3.0
6297,0,0,0,0,0,0,0,104,0.0,0.0,0.0,0.0,0.0,0.0,0.0,4,0,4,2.0,0.0,2.0
9807441,1,1,0,0,0,1,3,29,0.0,0.0,0.0,0.0,0.0,0.0,0.0,8,1,7,4.0,0.0,4.0
110066,2,1,1,1,1,1,1,82,1.0,1.0,0.0,0.0,1.0,0.0,0.0,3,2,1,1.0,1.0,0.0
209286,0,0,0,0,0,0,0,64,0.0,0.0,0.0,0.0,0.0,0.0,0.0,22,0,22,3.0,0.0,3.0
106177,4,4,0,0,1,3,3,0,0.0,0.0,0.0,0.0,0.0,0.0,0.0,72,4,68,3.0,1.0,2.0
1066,1,1,0,0,0,1,1,13,1.0,1.0,0.0,0.0,1.0,0.0,0.0,18,1,17,3.0,1.0,2.0
9905510,1,1,0,0,1,0,0,5,0.0,0.0,0.0,0.0,0.0,0.0,0.0,11,1,10,1.0,0.0,1.0
206084,0,0,0,0,0,0,0,3,0.0,0.0,0.0,0.0,0.0,0.0,0.0,15,0,15,3.0,0.0,3.0
9712444,3,3,0,0,1,2,3,204,1.0,1.0,0.0,0.0,1.0,0.0,0.0,17,3,14,1.0,0.0,1.0
9911415,3,3,0,0,0,3,6,18,0.0,0.0,0.0,0.0,0.0,0.0,0.0,12,3,9,3.0,1.0,2.0
9912416,4,2,2,2,1,3,3,400,4.0,2.0,2.0,2.0,4.0,0.0,0.0,6,4,2,4.0,3.0,1.0
111214,2,2,0,0,1,1,1,64,1.0,1.0,0.0,0.0,1.0,0.0,0.0,7,2,5,1.0,1.0,0.0
210113,2,2,0,0,1,1,1,0,,,,,,,,7,2,5,,,
208001,2,1,1,1,2,0,0,262,0.0,0.0,0.0,0.0,0.0,0.0,0.0,8,2,6,2.0,0.0,2.0
9309201,0,0,0,0,0,0,0,164,0.0,0.0,0.0,0.0,0.0,0.0,0.0,5,0,5,1.0,0.0,1.0
9810420,5,2,3,3,1,4,5,402,3.0,2.0,1.0,1.0,0.0,3.0,4.0,8,5,3,5.0,3.0,2.0
201102,1,1,0,0,0,1,1,277,1.0,1.0,0.0,0.0,0.0,1.0,1.0,2,1,1,2.0,1.0,1.0
9501396,1,1,0,0,1,0,0,379,1.0,1.0,0.0,0.0,1.0,0.0,0.0,2,1,1,1.0,1.0,0.0
9308297,0,0,0,0,0,0,0,655,0.0,0.0,0.0,0.0,0.0,0.0,0.0,1,0,1,1.0,0.0,1.0
207284,0,0,0,0,0,0,0,198,0.0,0.0,0.0,0.0,0.0,0.0,0.0,5,0,5,1.0,0.0,1.0
203096,0,0,0,0,0,0,0,302,0.0,0.0,0.0,0.0,0.0,0.0,0.0,6,0,6,1.0,0.0,1.0
9510394,2,2,0,0,1,1,5,77,0.0,0.0,0.0,0.0,0.0,0.0,0.0,24,2,22,3.0,0.0,3.0
9809395,0,0,0,0,0,0,0,22,0.0,0.0,0.0,0.0,0.0,0.0,0.0,11,0,11,9.0,0.0,9.0
201188,2,1,1,1,0,2,12,82,2.0,1.0,1.0,1.0,0.0,2.0,12.0,16,2,14,10.0,2.0,8.0
112231,1,1,0,0,0,1,14,44,0.0,0.0,0.0,0.0,0.0,0.0,0.0,18,1,17,3.0,0.0,3.0
202236,4,3,1,1,0,4,21,20,1.0,1.0,0.0,0.0,0.0,1.0,1.0,13,4,9,1.0,1.0,0.0
112178,2,2,0,0,0,2,3,64,2.0,2.0,0.0,0.0,0.0,2.0,3.0,6,2,4,1.0,1.0,0.0
9905303,2,2,0,0,1,1,1,67,0.0,0.0,0.0,0.0,0.0,0.0,0.0,9,2,7,1.0,0.0,1.0
208095,1,1,0,0,0,1,6,52,0.0,0.0,0.0,0.0,0.0,0.0,0.0,24,1,23,9.0,0.0,9.0
211363,2,2,0,0,0,2,29,11,1.0,1.0,0.0,0.0,0.0,1.0,25.0,37,2,35,29.0,1.0,28.0
104297,2,2,0,0,2,0,0,361,2.0,2.0,0.0,0.0,2.0,0.0,0.0,3,2,1,1.0,1.0,0.0
12246,0,0,0,0,0,0,0,249,0.0,0.0,0.0,0.0,0.0,0.0,0.0,6,0,6,1.0,0.0,1.0
206238,5,3,2,3,2,3,20,89,2.0,1.0,1.0,1.0,0.0,2.0,14.0,25,5,20,13.0,1.0,12.0
201173,4,4,0,0,2,2,8,65,1.0,1.0,0.0,0.0,1.0,0.0,0.0,20,4,16,2.0,1.0,1.0
9903463,0,0,0,0,0,0,0,4,0.0,0.0,0.0,0.0,0.0,0.0,0.0,7,0,7,6.0,0.0,6.0
9703457,1,1,0,0,0,1,1,1232,,,,,,,,2,1,1,,,
12287,1,1,0,0,0,1,1,423,1.0,1.0,0.0,0.0,1.0,0.0,0.0,5,1,4,1.0,0.0,1.0
209191,1,1,0,0,0,1,22,7,0.0,0.0,0.0,0.0,0.0,0.0,0.0,24,1,23,8.0,1.0,7.0
110364,1,1,0,0,0,1,2,1767,0.0,0.0,0.0,0.0,0.0,0.0,0.0,5,1,4,,,
211145,3,3,0,0,1,2,6,4,1.0,1.0,0.0,0.0,0.0,1.0,1.0,42,3,39,9.0,0.0,9.0
103114,2,1,1,1,2,0,0,185,2.0,1.0,1.0,1.0,2.0,0.0,0.0,2,2,0,2.0,2.0,0.0
202137,0,0,0,0,0,0,0,72,0.0,0.0,0.0,0.0,0.0,0.0,0.0,3,0,3,,,
7253,2,2,0,0,0,2,9,5,2.0,2.0,0.0,0.0,0.0,2.0,9.0,11,2,9,4.0,0.0,4.0
301012,0,0,0,0,0,0,0,282,0.0,0.0,0.0,0.0,0.0,0.0,0.0,11,0,11,6.0,0.0,6.0
1029,1,1,0,0,1,0,0,34,0.0,0.0,0.0,0.0,0.0,0.0,0.0,39,1,38,2.0,0.0,2.0
9611329,2,2,0,0,0,2,7,100,2.0,2.0,0.0,0.0,0.0,2.0,3.0,11,2,9,6.0,1.0,5.0
207271,3,2,1,1,1,2,3,678,2.0,1.0,1.0,1.0,2.0,0.0,0.0,7,3,4,2.0,2.0,0.0
212150,0,0,0,0,0,0,0,4,0.0,0.0,0.0,0.0,0.0,0.0,0.0,68,0,68,8.0,0.0,8.0
211378,3,1,2,3,0,3,121,3,3.0,1.0,2.0,3.0,0.0,3.0,94.0,73,3,70,20.0,2.0,18.0
103097,1,1,0,0,0,1,10,60,1.0,1.0,0.0,0.0,0.0,1.0,6.0,19,1,18,11.0,1.0,10.0
9705468,1,1,0,0,0,1,1,238,1.0,1.0,0.0,0.0,0.0,1.0,1.0,4,1,3,1.0,1.0,0.0
109050,1,1,0,0,1,0,0,31,0.0,0.0,0.0,0.0,0.0,0.0,0.0,11,1,10,2.0,0.0,2.0
6204,1,1,0,0,0,1,1,82,,,,,,,,3,1,2,1.0,0.0,1.0
205294,2,1,1,1,0,2,4,28,2.0,1.0,1.0,1.0,0.0,2.0,2.0,10,2,8,1.0,0.0,1.0
9608431,0,0,0,0,0,0,0,140,0.0,0.0,0.0,0.0,0.0,0.0,0.0,2,0,2,2.0,0.0,2.0
111136,2,2,0,0,2,0,0,72,1.0,1.0,0.0,0.0,1.0,0.0,0.0,6,2,4,3.0,0.0,3.0
3048,0,0,0,0,0,0,0,917,0.0,0.0,0.0,0.0,0.0,0.0,0.0,1,0,1,,,
9712408,2,2,0,0,0,2,13,16,1.0,1.0,0.0,0.0,0.0,1.0,6.0,16,2,14,5.0,1.0,4.0
11071,3,3,0,0,1,2,4,85,0.0,0.0,0.0,0.0,0.0,0.0,0.0,18,3,15,3.0,2.0,1.0
209031,0,0,0,0,0,0,0,201,0.0,0.0,0.0,0.0,0.0,0.0,0.0,6,0,6,5.0,0.0,5.0
9602261,1,1,0,0,0,1,4,134,0.0,0.0,0.0,0.0,0.0,0.0,0.0,8,1,7,2.0,0.0,2.0
106068,4,3,1,1,0,4,12,63,2.0,2.0,0.0,0.0,0.0,2.0,3.0,9,4,5,2.0,1.0,1.0
211411,1,1,0,0,0,1,2,31,0.0,0.0,0.0,0.0,0.0,0.0,0.0,20,1,19,4.0,0.0,4.0
107065,3,2,1,1,1,2,10,7,0.0,0.0,0.0,0.0,0.0,0.0,0.0,20,3,17,3.0,0.0,3.0
9502394,1,1,0,0,1,0,0,1476,1.0,1.0,0.0,0.0,1.0,0.0,0.0,1,1,0,1.0,1.0,0.0
201092,2,2,0,0,1,1,2,41,0.0,0.0,0.0,0.0,0.0,0.0,0.0,14,2,12,6.0,0.0,6.0
5036,0,0,0,0,0,0,0,246,0.0,0.0,0.0,0.0,0.0,0.0,0.0,3,0,3,1.0,0.0,1.0
9702268,1,1,0,0,0,1,2,29,0.0,0.0,0.0,0.0,0.0,0.0,0.0,10,1,9,3.0,1.0,2.0
110046,2,2,0,0,0,2,12,20,1.0,1.0,0.0,0.0,0.0,1.0,9.0,23,2,21,2.0,1.0,1.0
9704373,0,0,0,0,0,0,0,211,0.0,0.0,0.0,0.0,0.0,0.0,0.0,4,0,4,1.0,0.0,1.0
9710320,0,0,0,0,0,0,0,104,0.0,0.0,0.0,0.0,0.0,0.0,0.0,8,0,8,1.0,0.0,1.0
11220,3,1,2,3,0,3,8,216,3.0,1.0,2.0,3.0,0.0,3.0,7.0,7,3,4,6.0,3.0,3.0
107132,3,1,2,3,0,3,30,50,3.0,1.0,2.0,3.0,0.0,3.0,20.0,27,3,24,17.0,3.0,14.0
103254,1,1,0,0,0,1,1,72,1.0,1.0,0.0,0.0,1.0,0.0,0.0,4,1,3,1.0,0.0,1.0
9912299,1,1,0,0,1,0,0,213,1.0,1.0,0.0,0.0,1.0,0.0,0.0,1,1,0,1.0,1.0,0.0
209221,1,1,0,0,0,1,1,90,0.0,0.0,0.0,0.0,0.0,0.0,0.0,8,1,7,4.0,0.0,4.0
101193,1,1,0,0,0,1,4,96,1.0,1.0,0.0,0.0,0.0,1.0,2.0,5,1,4,1.0,1.0,0.0
9504266,2,2,0,0,1,1,1,246,0.0,0.0,0.0,0.0,0.0,0.0,0.0,8,2,6,2.0,0.0,2.0
9510307,0,0,0,0,0,0,0,322,0.0,0.0,0.0,0.0,0.0,0.0,0.0,1,0,1,1.0,0.0,1.0
9607356,0,0,0,0,0,0,0,298,0.0,0.0,0.0,0.0,0.0,0.0,0.0,5,0,5,1.0,0.0,1.0
212009,0,0,0,0,0,0,0,40,0.0,0.0,0.0,0.0,0.0,0.0,0.0,7,0,7,3.0,0.0,3.0
9802402,0,0,0,0,0,0,0,1,0.0,0.0,0.0,0.0,0.0,0.0,0.0,7,0,7,1.0,0.0,1.0
206049,0,0,0,0,0,0,0,684,0.0,0.0,0.0,0.0,0.0,0.0,0.0,2,0,2,1.0,0.0,1.0
101223,5,3,2,2,0,5,36,18,5.0,3.0,2.0,2.0,0.0,5.0,34.0,26,5,21,9.0,1.0,8.0
9701326,1,1,0,0,1,0,0,685,1.0,1.0,0.0,0.0,1.0,0.0,0.0,1,1,0,1.0,1.0,0.0
205097,2,1,1,1,0,2,12,23,2.0,1.0,1.0,1.0,0.0,2.0,12.0,8,2,6,7.0,2.0,5.0
207086,1,1,0,0,0,1,9,215,1.0,1.0,0.0,0.0,0.0,1.0,5.0,10,1,9,5.0,1.0,4.0
206002,2,2,0,0,1,1,1,179,1.0,1.0,0.0,0.0,0.0,1.0,1.0,5,2,3,2.0,0.0,2.0
9607456,0,0,0,0,0,0,0,153,0.0,0.0,0.0,0.0,0.0,0.0,0.0,3,0,3,3.0,0.0,3.0
9911515,2,2,0,0,2,0,0,689,2.0,2.0,0.0,0.0,2.0,0.0,0.0,2,2,0,1.0,1.0,0.0
103225,2,2,0,0,1,1,6,590,1.0,1.0,0.0,0.0,0.0,1.0,2.0,8,2,6,2.0,2.0,0.0
109024,1,1,0,0,0,1,2,53,1.0,1.0,0.0,0.0,0.0,1.0,1.0,4,1,3,3.0,1.0,2.0
9506402,1,1,0,0,0,1,3,43,0.0,0.0,0.0,0.0,0.0,0.0,0.0,19,1,18,4.0,1.0,3.0
9804409,7,1,6,10,2,5,6,99,5.0,1.0,4.0,8.0,5.0,0.0,0.0,14,7,7,5.0,5.0,0.0
11321,3,2,1,1,0,3,64,33,3.0,2.0,1.0,1.0,0.0,3.0,40.0,45,3,42,19.0,3.0,16.0
212392,0,0,0,0,0,0,0,136,0.0,0.0,0.0,0.0,0.0,0.0,0.0,9,0,9,8.0,0.0,8.0
9709276,0,0,0,0,0,0,0,108,,,,,,,,3,0,3,,,
1315,0,0,0,0,0,0,0,948,,,,,,,,2,0,2,1.0,0.0,1.0
208079,3,1,2,3,0,3,10,33,3.0,1.0,2.0,3.0,0.0,3.0,10.0,9,3,6,4.0,3.0,1.0
301208,1,1,0,0,0,1,4,308,1.0,1.0,0.0,0.0,0.0,1.0,3.0,8,1,7,4.0,1.0,3.0
111183,1,1,0,0,0,1,4,117,0.0,0.0,0.0,0.0,0.0,0.0,0.0,17,1,16,2.0,1.0,1.0
2136,2,2,0,0,1,1,6,297,1.0,1.0,0.0,0.0,0.0,1.0,5.0,9,2,7,6.0,1.0,5.0
9705283,0,0,0,0,0,0,0,47,,,,,,,,3,0,3,,,
9911450,0,0,0,0,0,0,0,289,0.0,0.0,0.0,0.0,0.0,0.0,0.0,3,0,3,2.0,0.0,2.0
8299,1,1,0,0,1,0,0,11,1.0,1.0,0.0,0.0,1.0,0.0,0.0,13,1,12,1.0,1.0,0.0
9512349,2,2,0,0,0,2,2,1930,,,,,,,,6,2,4,3.0,2.0,1.0
9704397,2,2,0,0,2,0,0,594,1.0,1.0,0.0,0.0,1.0,0.0,0.0,4,2,2,1.0,1.0,0.0
302161,0,0,0,0,0,0,0,62,0.0,0.0,0.0,0.0,0.0,0.0,0.0,25,0,25,4.0,0.0,4.0
201178,2,2,0,0,1,1,2,18,0.0,0.0,0.0,0.0,0.0,0.0,0.0,10,2,8,1.0,0.0,1.0
110261,5,1,4,5,0,5,8,13,1.0,1.0,0.0,0.0,1.0,0.0,0.0,7,5,2,2.0,2.0,0.0
109138,0,0,0,0,0,0,0,842,0.0,0.0,0.0,0.0,0.0,0.0,0.0,1,0,1,1.0,0.0,1.0
9912244,0,0,0,0,0,0,0,389,0.0,0.0,0.0,0.0,0.0,0.0,0.0,2,0,2,2.0,0.0,2.0
203015,0,0,0,0,0,0,0,417,0.0,0.0,0.0,0.0,0.0,0.0,0.0,1,0,1,1.0,0.0,1.0
9707324,2,2,0,0,0,2,2,137,1.0,1.0,0.0,0.0,0.0,1.0,1.0,3,2,1,1.0,1.0,0.0
210197,1,1,0,0,0,1,5,3,1.0,1.0,0.0,0.0,0.0,1.0,5.0,22,1,21,4.0,1.0,3.0
201200,0,0,0,0,0,0,0,362,0.0,0.0,0.0,0.0,0.0,0.0,0.0,4,0,4,3.0,0.0,3.0
9707261,0,0,0,0,0,0,0,114,0.0,0.0,0.0,0.0,0.0,0.0,0.0,21,0,21,13.0,0.0,13.0
9512210,0,0,0,0,0,0,0,138,0.0,0.0,0.0,0.0,0.0,0.0,0.0,4,0,4,1.0,0.0,1.0
9812386,0,0,0,0,0,0,0,136,,,,,,,,1,0,1,,,
9407275,2,2,0,0,2,0,0,189,1.0,1.0,0.0,0.0,1.0,0.0,0.0,3,2,1,1.0,1.0,0.0
112301,0,0,0,0,0,0,0,10,0.0,0.0,0.0,0.0,0.0,0.0,0.0,32,0,32,8.0,0.0,8.0
208138,0,0,0,0,0,0,0,30,0.0,0.0,0.0,0.0,0.0,0.0,0.0,17,0,17,10.0,0.0,10.0
9810202,0,0,0,0,0,0,0,394,0.0,0.0,0.0,0.0,0.0,0.0,0.0,3,0,3,1.0,0.0,1.0
9806245,0,0,0,0,0,0,0,14,0.0,0.0,0.0,0.0,0.0,0.0,0.0,12,0,12,,,
201288,0,0,0,0,0,0,0,351,0.0,0.0,0.0,0.0,0.0,0.0,0.0,5,0,5,3.0,0.0,3.0
9710480,0,0,0,0,0,0,0,22,0.0,0.0,0.0,0.0,0.0,0.0,0.0,33,0,33,2.0,0.0,2.0
9278,1,1,0,0,0,1,4,103,0.0,0.0,0.0,0.0,0.0,0.0,0.0,6,1,5,3.0,1.0,2.0
204246,1,1,0,0,0,1,4,10,0.0,0.0,0.0,0.0,0.0,0.0,0.0,11,1,10,5.0,0.0,5.0
210335,1,1,0,0,0,1,5,4,1.0,1.0,0.0,0.0,0.0,1.0,5.0,46,1,45,11.0,0.0,11.0
208182,0,0,0,0,0,0,0,118,0.0,0.0,0.0,0.0,0.0,0.0,0.0,7,0,7,7.0,0.0,7.0
210330,2,1,1,1,0,2,7,4,2.0,1.0,1.0,1.0,0.0,2.0,4.0,11,2,9,6.0,2.0,4.0
302167,0,0,0,0,0,0,0,20,0.0,0.0,0.0,0.0,0.0,0.0,0.0,14,0,14,6.0,0.0,6.0
9708276,1,1,0,0,0,1,8,38,1.0,1.0,0.0,0.0,0.0,1.0,5.0,16,1,15,5.0,1.0,4.0
9809295,0,0,0,0,0,0,0,52,0.0,0.0,0.0,0.0,0.0,0.0,0.0,6,0,6,3.0,0.0,3.0
210178,1,1,0,0,0,1,6,52,1.0,1.0,0.0,0.0,0.0,1.0,6.0,8,1,7,7.0,1.0,6.0
7225,0,0,0,0,0,0,0,211,0.0,0.0,0.0,0.0,0.0,0.0,0.0,13,0,13,2.0,0.0,2.0
9608442,0,0,0,0,0,0,0,38,,,,,,,,4,0,4,,,
9908279,0,0,0,0,0,0,0,196,0.0,0.0,0.0,0.0,0.0,0.0,0.0,4,0,4,1.0,0.0,1.0
112309,1,1,0,0,0,1,1,9,0.0,0.0,0.0,0.0,0.0,0.0,0.0,42,1,41,9.0,0.0,9.0
8067,1,1,0,0,0,1,2,16,1.0,1.0,0.0,0.0,0.0,1.0,2.0,19,1,18,6.0,1.0,5.0
212313,0,0,0,0,0,0,0,189,0.0,0.0,0.0,0.0,0.0,0.0,0.0,1,0,1,1.0,0.0,1.0
210368,0,0,0,0,0,0,0,95,0.0,0.0,0.0,0.0,0.0,0.0,0.0,17,0,17,1.0,0.0,1.0
212029,1,1,0,0,1,0,0,779,1.0,1.0,0.0,0.0,1.0,0.0,0.0,3,1,2,1.0,1.0,0.0
111283,2,1,1,1,0,2,8,163,0.0,0.0,0.0,0.0,0.0,0.0,0.0,8,2,6,5.0,0.0,5.0
9309295,1,1,0,0,1,0,0,124,0.0,0.0,0.0,0.0,0.0,0.0,0.0,2,1,1,,,
105248,2,1,1,1,0,2,14,79,0.0,0.0,0.0,0.0,0.0,0.0,0.0,16,2,14,12.0,2.0,10.0
210393,1,1,0,0,0,1,1,50,1.0,1.0,0.0,0.0,1.0,0.0,0.0,9,1,8,2.0,0.0,2.0
9812367,0,0,0,0,0,0,0,141,0.0,0.0,0.0,0.0,0.0,0.0,0.0,13,0,13,1.0,0.0,1.0
208077,1,1,0,0,1,0,0,107,0.0,0.0,0.0,0.0,0.0,0.0,0.0,15,1,14,2.0,0.0,2.0
9505342,0,0,0,0,0,0,0,231,0.0,0.0,0.0,0.0,0.0,0.0,0.0,1,0,1,1.0,0.0,1.0
101317,1,1,0,0,0,1,3,201,1.0,1.0,0.0,0.0,0.0,1.0,2.0,8,1,7,3.0,1.0,2.0
11022,0,0,0,0,0,0,0,400,0.0,0.0,0.0,0.0,0.0,0.0,0.0,4,0,4,2.0,0.0,2.0
9701407,3,3,0,0,2,1,3,202,2.0,2.0,0.0,0.0,2.0,0.0,0.0,6,3,3,3.0,3.0,0.0
11197,4,4,0,0,0,4,16,46,1.0,1.0,0.0,0.0,0.0,1.0,2.0,16,4,12,2.0,1.0,1.0
11305,2,2,0,0,0,2,4,102,1.0,1.0,0.0,0.0,0.0,1.0,1.0,6,2,4,1.0,1.0,0.0
9404251,1,1,0,0,1,0,0,362,1.0,1.0,0.0,0.0,1.0,0.0,0.0,1,1,0,1.0,1.0,0.0
9911285,0,0,0,0,0,0,0,13,,,,,,,,4,0,4,,,
9709314,0,0,0,0,0,0,0,58,0.0,0.0,0.0,0.0,0.0,0.0,0.0,8,0,8,5.0,0.0,5.0
9703309,0,0,0,0,0,0,0,355,0.0,0.0,0.0,0.0,0.0,0.0,0.0,1,0,1,,,
112084,1,1,0,0,1,0,0,2034,1.0,1.0,0.0,0.0,1.0,0.0,0.0,2,1,1,1.0,1.0,0.0
9406361,0,0,0,0,0,0,0,824,,,,,,,,3,0,3,,,
9502231,0,0,0,0,0,0,0,426,0.0,0.0,0.0,0.0,0.0,0.0,0.0,1,0,1,1.0,0.0,1.0
9607471,0,0,0,0,0,0,0,1049,0.0,0.0,0.0,0.0,0.0,0.0,0.0,1,0,1,1.0,0.0,1.0
9401293,1,1,0,0,1,0,0,180,,,,,,,,1,1,0,,,
9611338,0,0,0,0,0,0,0,155,0.0,0.0,0.0,0.0,0.0,0.0,0.0,8,0,8,,,
212031,0,0,0,0,0,0,0,43,0.0,0.0,0.0,0.0,0.0,0.0,0.0,5,0,5,2.0,0.0,2.0
104241,0,0,0,0,0,0,0,51,0.0,0.0,0.0,0.0,0.0,0.0,0.0,5,0,5,2.0,0.0,2.0
111470,1,1,0,0,1,0,0,113,1.0,1.0,0.0,0.0,1.0,0.0,0.0,7,1,6,1.0,1.0,0.0
9311223,0,0,0,0,0,0,0,1027,0.0,0.0,0.0,0.0,0.0,0.0,0.0,1,0,1,1.0,0.0,1.0
301082,0,0,0,0,0,0,0,7,0.0,0.0,0.0,0.0,0.0,0.0,0.0,34,0,34,14.0,0.0,14.0
211235,0,0,0,0,0,0,0,153,0.0,0.0,0.0,0.0,0.0,0.0,0.0,9,0,9,2.0,0.0,2.0
9303208,0,0,0,0,0,0,0,1901,,,,,,,,1,0,1,,,
301248,0,0,0,0,0,0,0,92,0.0,0.0,0.0,0.0,0.0,0.0,0.0,24,0,24,10.0,0.0,10.0
211222,0,0,0,0,0,0,0,27,0.0,0.0,0.0,0.0,0.0,0.0,0.0,14,0,14,2.0,0.0,2.0
1067,0,0,0,0,0,0,0,91,0.0,0.0,0.0,0.0,0.0,0.0,0.0,11,0,11,5.0,0.0,5.0
101238,0,0,0,0,0,0,0,189,0.0,0.0,0.0,0.0,0.0,0.0,0.0,1,0,1,1.0,0.0,1.0
111168,1,1,0,0,1,0,0,178,1.0,1.0,0.0,0.0,1.0,0.0,0.0,5,1,4,,,
302056,0,0,0,0,0,0,0,261,0.0,0.0,0.0,0.0,0.0,0.0,0.0,17,0,17,6.0,0.0,6.0
9908406,0,0,0,0,0,0,0,55,0.0,0.0,0.0,0.0,0.0,0.0,0.0,11,0,11,2.0,0.0,2.0
210163,0,0,0,0,0,0,0,38,0.0,0.0,0.0,0.0,0.0,0.0,0.0,14,0,14,12.0,0.0,12.0
9710524,0,0,0,0,0,0,0,78,0.0,0.0,0.0,0.0,0.0,0.0,0.0,6,0,6,,,
202005,1,1,0,0,1,0,0,144,0.0,0.0,0.0,0.0,0.0,0.0,0.0,8,1,7,2.0,0.0,2.0
9509202,1,1,0,0,1,0,0,451,1.0,1.0,0.0,0.0,1.0,0.0,0.0,1,1,0,1.0,1.0,0.0
204170,1,1,0,0,0,1,2,31,0.0,0.0,0.0,0.0,0.0,0.0,0.0,16,1,15,6.0,0.0,6.0
9507360,1,1,0,0,1,0,0,175,1.0,1.0,0.0,0.0,1.0,0.0,0.0,1,1,0,1.0,1.0,0.0
301163,1,1,0,0,0,1,3,5,1.0,1.0,0.0,0.0,0.0,1.0,3.0,33,1,32,12.0,1.0,11.0
9912418,0,0,0,0,0,0,0,426,0.0,0.0,0.0,0.0,0.0,0.0,0.0,5,0,5,2.0,0.0,2.0
9098,0,0,0,0,0,0,0,251,0.0,0.0,0.0,0.0,0.0,0.0,0.0,6,0,6,5.0,0.0,5.0
202183,0,0,0,0,0,0,0,85,,,,,,,,1,0,1,,,
11018,0,0,0,0,0,0,0,377,0.0,0.0,0.0,0.0,0.0,0.0,0.0,14,0,14,2.0,0.0,2.0
5016,0,0,0,0,0,0,0,269,0.0,0.0,0.0,0.0,0.0,0.0,0.0,5,0,5,3.0,0.0,3.0
9706245,0,0,0,0,0,0,0,6,0.0,0.0,0.0,0.0,0.0,0.0,0.0,8,0,8,,,
204026,0,0,0,0,0,0,0,104,0.0,0.0,0.0,0.0,0.0,0.0,0.0,5,0,5,3.0,0.0,3.0
9809326,0,0,0,0,0,0,0,229,0.0,0.0,0.0,0.0,0.0,0.0,0.0,10,0,10,4.0,0.0,4.0
5239,0,0,0,0,0,0,0,3,0.0,0.0,0.0,0.0,0.0,0.0,0.0,35,0,35,24.0,0.0,24.0
9812405,0,0,0,0,0,0,0,85,0.0,0.0,0.0,0.0,0.0,0.0,0.0,6,0,6,5.0,0.0,5.0
12126,2,1,1,1,2,0,0,575,2.0,1.0,1.0,1.0,2.0,0.0,0.0,2,2,0,2.0,2.0,0.0
209050,1,1,0,0,0,1,16,81,1.0,1.0,0.0,0.0,0.0,1.0,15.0,24,1,23,14.0,1.0,13.0
110068,0,0,0,0,0,0,0,65,0.0,0.0,0.0,0.0,0.0,0.0,0.0,5,0,5,,,
9503440,0,0,0,0,0,0,0,35,0.0,0.0,0.0,0.0,0.0,0.0,0.0,6,0,6,,,
211280,0,0,0,0,0,0,0,25,0.0,0.0,0.0,0.0,0.0,0.0,0.0,12,0,12,9.0,0.0,9.0
9604386,1,1,0,0,1,0,0,72,1.0,1.0,0.0,0.0,1.0,0.0,0.0,2,1,1,,,
203098,0,0,0,0,0,0,0,230,0.0,0.0,0.0,0.0,0.0,0.0,0.0,4,0,4,3.0,0.0,3.0
105257,0,0,0,0,0,0,0,249,0.0,0.0,0.0,0.0,0.0,0.0,0.0,2,0,2,1.0,0.0,1.0
9702233,1,1,0,0,0,1,1,382,1.0,1.0,0.0,0.0,0.0,1.0,1.0,2,1,1,1.0,1.0,0.0
9512205,0,0,0,0,0,0,0,1206,,,,,,,,1,0,1,,,
109086,0,0,0,0,0,0,0,27,0.0,0.0,0.0,0.0,0.0,0.0,0.0,11,0,11,5.0,0.0,5.0
9510321,0,0,0,0,0,0,0,49,0.0,0.0,0.0,0.0,0.0,0.0,0.0,7,0,7,1.0,0.0,1.0
9605341,0,0,0,0,0,0,0,97,0.0,0.0,0.0,0.0,0.0,0.0,0.0,2,0,2,,,
10185,0,0,0,0,0,0,0,350,0.0,0.0,0.0,0.0,0.0,0.0,0.0,3,0,3,2.0,0.0,2.0
204177,0,0,0,0,0,0,0,541,0.0,0.0,0.0,0.0,0.0,0.0,0.0,4,0,4,1.0,0.0,1.0
9506363,0,0,0,0,0,0,0,221,0.0,0.0,0.0,0.0,0.0,0.0,0.0,5,0,5,1.0,0.0,1.0
110086,0,0,0,0,0,0,0,227,0.0,0.0,0.0,0.0,0.0,0.0,0.0,7,0,7,3.0,0.0,3.0
9002,1,1,0,0,1,0,0,34,0.0,0.0,0.0,0.0,0.0,0.0,0.0,16,1,15,1.0,0.0,1.0
9711490,0,0,0,0,0,0,0,110,0.0,0.0,0.0,0.0,0.0,0.0,0.0,5,0,5,2.0,0.0,2.0
9509417,1,1,0,0,1,0,0,724,1.0,1.0,0.0,0.0,1.0,0.0,0.0,1,1,0,1.0,1.0,0.0
110230,0,0,0,0,0,0,0,83,,,,,,,,4,0,4,,,
105309,0,0,0,0,0,0,0,1525,,,,,,,,1,0,1,,,
205189,0,0,0,0,0,0,0,1883,,,,,,,,6,0,6,1.0,0.0,1.0
9807372,0,0,0,0,0,0,0,248,0.0,0.0,0.0,0.0,0.0,0.0,0.0,2,0,2,2.0,0.0,2.0
211043,1,1,0,0,0,1,8,28,1.0,1.0,0.0,0.0,0.0,1.0,6.0,41,1,40,24.0,1.0,23.0
9809432,0,0,0,0,0,0,0,315,0.0,0.0,0.0,0.0,0.0,0.0,0.0,9,0,9,5.0,0.0,5.0
9706460,0,0,0,0,0,0,0,279,0.0,0.0,0.0,0.0,0.0,0.0,0.0,3,0,3,1.0,0.0,1.0
202260,0,0,0,0,0,0,0,931,,,,,,,,2,0,2,,,
212224,0,0,0,0,0,0,0,49,0.0,0.0,0.0,0.0,0.0,0.0,0.0,12,0,12,1.0,0.0,1.0
9708293,0,0,0,0,0,0,0,148,0.0,0.0,0.0,0.0,0.0,0.0,0.0,3,0,3,2.0,0.0,2.0
301273,0,0,0,0,0,0,0,128,0.0,0.0,0.0,0.0,0.0,0.0,0.0,19,0,19,3.0,0.0,3.0
9706495,0,0,0,0,0,0,0,10,0.0,0.0,0.0,0.0,0.0,0.0,0.0,16,0,16,5.0,0.0,5.0
301195,0,0,0,0,0,0,0,45,0.0,0.0,0.0,0.0,0.0,0.0,0.0,14,0,14,13.0,0.0,13.0
205025,1,1,0,0,0,1,3,263,1.0,1.0,0.0,0.0,0.0,1.0,1.0,11,1,10,2.0,0.0,2.0
108007,0,0,0,0,0,0,0,173,0.0,0.0,0.0,0.0,0.0,0.0,0.0,7,0,7,5.0,0.0,5.0
9507468,0,0,0,0,0,0,0,945,,,,,,,,1,0,1,,,
210246,0,0,0,0,0,0,0,280,0.0,0.0,0.0,0.0,0.0,0.0,0.0,6,0,6,4.0,0.0,4.0
207267,0,0,0,0,0,0,0,137,0.0,0.0,0.0,0.0,0.0,0.0,0.0,14,0,14,3.0,0.0,3.0
9408263,0,0,0,0,0,0,0,275,0.0,0.0,0.0,0.0,0.0,0.0,0.0,4,0,4,1.0,0.0,1.0
1125,0,0,0,0,0,0,0,71,0.0,0.0,0.0,0.0,0.0,0.0,0.0,9,0,9,1.0,0.0,1.0
3182,0,0,0,0,0,0,0,349,0.0,0.0,0.0,0.0,0.0,0.0,0.0,1,0,1,1.0,0.0,1.0
210340,0,0,0,0,0,0,0,55,0.0,0.0,0.0,0.0,0.0,0.0,0.0,6,0,6,,,
206225,0,0,0,0,0,0,0,40,0.0,0.0,0.0,0.0,0.0,0.0,0.0,23,0,23,13.0,0.0,13.0
7077,1,1,0,0,0,1,10,212,0.0,0.0,0.0,0.0,0.0,0.0,0.0,13,1,12,6.0,1.0,5.0
210151,1,1,0,0,0,1,2,52,1.0,1.0,0.0,0.0,0.0,1.0,1.0,7,1,6,3.0,1.0,2.0
9503361,0,0,0,0,0,0,0,1000,0.0,0.0,0.0,0.0,0.0,0.0,0.0,3,0,3,1.0,0.0,1.0
5143,0,0,0,0,0,0,0,117,0.0,0.0,0.0,0.0,0.0,0.0,0.0,4,0,4,1.0,0.0,1.0
9808441,0,0,0,0,0,0,0,100,0.0,0.0,0.0,0.0,0.0,0.0,0.0,3,0,3,1.0,0.0,1.0
9505255,1,1,0,0,1,0,0,1859,,,,,,,,1,1,0,,,
3046,0,0,0,0,0,0,0,2,0.0,0.0,0.0,0.0,0.0,0.0,0.0,13,0,13,1.0,0.0,1.0
204065,0,0,0,0,0,0,0,133,0.0,0.0,0.0,0.0,0.0,0.0,0.0,6,0,6,2.0,0.0,2.0
9507417,0,0,0,0,0,0,0,1660,,,,,,,,1,0,1,,,
9410314,0,0,0,0,0,0,0,74,0.0,0.0,0.0,0.0,0.0,0.0,0.0,8,0,8,1.0,0.0,1.0
110058,0,0,0,0,0,0,0,65,0.0,0.0,0.0,0.0,0.0,0.0,0.0,2,0,2,2.0,0.0,2.0
207317,0,0,0,0,0,0,0,9,0.0,0.0,0.0,0.0,0.0,0.0,0.0,14,0,14,7.0,0.0,7.0
210029,0,0,0,0,0,0,0,143,0.0,0.0,0.0,0.0,0.0,0.0,0.0,8,0,8,5.0,0.0,5.0
11279,1,1,0,0,1,0,0,221,1.0,1.0,0.0,0.0,1.0,0.0,0.0,1,1,0,,,
7147,0,0,0,0,0,0,0,72,0.0,0.0,0.0,0.0,0.0,0.0,0.0,4,0,4,2.0,0.0,2.0
105068,0,0,0,0,0,0,0,2,0.0,0.0,0.0,0.0,0.0,0.0,0.0,7,0,7,,,
9801452,0,0,0,0,0,0,0,5,0.0,0.0,0.0,0.0,0.0,0.0,0.0,30,0,30,2.0,0.0,2.0
210030,0,0,0,0,0,0,0,140,0.0,0.0,0.0,0.0,0.0,0.0,0.0,7,0,7,2.0,0.0,2.0
9605374,0,0,0,0,0,0,0,61,0.0,0.0,0.0,0.0,0.0,0.0,0.0,6,0,6,1.0,0.0,1.0
9802398,0,0,0,0,0,0,0,459,0.0,0.0,0.0,0.0,0.0,0.0,0.0,1,0,1,1.0,0.0,1.0
9601366,0,0,0,0,0,0,0,829,,,,,,,,1,0,1,,,
301182,0,0,0,0,0,0,0,9,0.0,0.0,0.0,0.0,0.0,0.0,0.0,20,0,20,4.0,0.0,4.0
9906407,0,0,0,0,0,0,0,44,0.0,0.0,0.0,0.0,0.0,0.0,0.0,12,0,12,5.0,0.0,5.0
9702439,0,0,0,0,0,0,0,186,0.0,0.0,0.0,0.0,0.0,0.0,0.0,4,0,4,1.0,0.0,1.0
205004,0,0,0,0,0,0,0,111,,,,,,,,1,0,1,,,
2247,0,0,0,0,0,0,0,65,0.0,0.0,0.0,0.0,0.0,0.0,0.0,14,0,14,3.0,0.0,3.0
3083,0,0,0,0,0,0,0,1851,,,,,,,,2,0,2,,,
9902358,0,0,0,0,0,0,0,255,0.0,0.0,0.0,0.0,0.0,0.0,0.0,12,0,12,3.0,0.0,3.0
4022,0,0,0,0,0,0,0,45,0.0,0.0,0.0,0.0,0.0,0.0,0.0,15,0,15,,,
210184,0,0,0,0,0,0,0,9,0.0,0.0,0.0,0.0,0.0,0.0,0.0,11,0,11,1.0,0.0,1.0
9604447,0,0,0,0,0,0,0,140,0.0,0.0,0.0,0.0,0.0,0.0,0.0,2,0,2,2.0,0.0,2.0
9510214,0,0,0,0,0,0,0,307,0.0,0.0,0.0,0.0,0.0,0.0,0.0,4,0,4,1.0,0.0,1.0
9709370,0,0,0,0,0,0,0,126,0.0,0.0,0.0,0.0,0.0,0.0,0.0,2,0,2,1.0,0.0,1.0
9910487,0,0,0,0,0,0,0,130,0.0,0.0,0.0,0.0,0.0,0.0,0.0,7,0,7,4.0,0.0,4.0
112348,0,0,0,0,0,0,0,121,0.0,0.0,0.0,0.0,0.0,0.0,0.0,3,0,3,1.0,0.0,1.0
9505437,0,0,0,0,0,0,0,1649,,,,,,,,1,0,1,1.0,0.0,1.0
107273,0,0,0,0,0,0,0,4,0.0,0.0,0.0,0.0,0.0,0.0,0.0,15,0,15,5.0,0.0,5.0
9510379,0,0,0,0,0,0,0,1694,0.0,0.0,0.0,0.0,0.0,0.0,0.0,1,0,1,1.0,0.0,1.0
110302,0,0,0,0,0,0,0,23,0.0,0.0,0.0,0.0,0.0,0.0,0.0,38,0,38,4.0,0.0,4.0
9239,0,0,0,0,0,0,0,147,0.0,0.0,0.0,0.0,0.0,0.0,0.0,4,0,4,2.0,0.0,2.0
9706243,0,0,0,0,0,0,0,1732,,,,,,,,2,0,2,,,
209011,0,0,0,0,0,0,0,54,0.0,0.0,0.0,0.0,0.0,0.0,0.0,40,0,40,12.0,0.0,12.0
9801250,0,0,0,0,0,0,0,114,0.0,0.0,0.0,0.0,0.0,0.0,0.0,12,0,12,7.0,0.0,7.0
9805401,0,0,0,0,0,0,0,6,0.0,0.0,0.0,0.0,0.0,0.0,0.0,19,0,19,1.0,0.0,1.0
301145,0,0,0,0,0,0,0,1312,,,,,,,,3,0,3,,,
9408405,0,0,0,0,0,0,0,183,0.0,0.0,0.0,0.0,0.0,0.0,0.0,3,0,3,2.0,0.0,2.0
11224,0,0,0,0,0,0,0,108,0.0,0.0,0.0,0.0,0.0,0.0,0.0,7,0,7,6.0,0.0,6.0
9508385,0,0,0,0,0,0,0,476,0.0,0.0,0.0,0.0,0.0,0.0,0.0,2,0,2,1.0,0.0,1.0
112038,0,0,0,0,0,0,0,183,0.0,0.0,0.0,0.0,0.0,0.0,0.0,5,0,5,1.0,0.0,1.0
9710497,0,0,0,0,0,0,0,157,0.0,0.0,0.0,0.0,0.0,0.0,0.0,4,0,4,3.0,0.0,3.0
9311274,100,26,74,293,100,0,0,13,33.0,3.0,30.0,148.0,33.0,0.0,0.0,100,100,0,19.0,19.0,0.0
2171,44,18,26,80,27,17,27,1,16.0,4.0,12.0,37.0,4.0,12.0,20.0,49,44,5,14.0,12.0,2.0
6022,46,7,39,133,1,45,262,1,27.0,3.0,24.0,78.0,0.0,27.0,108.0,68,46,22,25.0,20.0,5.0
9309283,82,6,76,606,82,0,0,1,59.0,6.0,53.0,463.0,59.0,0.0,0.0,82,82,0,30.0,30.0,0.0
9911528,18,3,15,41,2,16,58,1,7.0,1.0,6.0,14.0,0.0,7.0,11.0,33,18,15,9.0,6.0,3.0
9311345,229,43,186,1305,181,48,79,7,67.0,4.0,63.0,520.0,58.0,9.0,9.0,232,229,3,29.0,29.0,0.0
9412375,29,6,23,51,21,8,12,34,4.0,3.0,1.0,1.0,4.0,0.0,0.0,32,29,3,4.0,4.0,0.0
103197,22,4,18,44,1,21,53,1,4.0,2.0,2.0,3.0,0.0,4.0,7.0,42,22,20,11.0,5.0,6.0
9610455,20,8,12,17,3,17,78,6,3.0,2.0,1.0,1.0,0.0,3.0,32.0,78,20,58,23.0,0.0,23.0
9603414,39,11,28,55,3,36,194,6,16.0,5.0,11.0,18.0,0.0,16.0,81.0,55,39,16,11.0,6.0,5.0
9512225,71,12,59,193,6,65,180,7,13.0,1.0,12.0,26.0,1.0,12.0,12.0,87,71,16,6.0,5.0,1.0
9307274,22,10,12,21,22,0,0,7,4.0,3.0,1.0,1.0,4.0,0.0,0.0,22,22,0,2.0,2.0,0.0
9903229,50,13,37,140,9,41,184,4,13.0,3.0,10.0,23.0,1.0,12.0,47.0,68,50,18,20.0,14.0,6.0
9904236,57,9,48,180,12,45,125,2,20.0,3.0,17.0,50.0,4.0,16.0,63.0,75,57,18,12.0,12.0,0.0
9405322,52,19,33,101,36,16,26,33,14.0,5.0,9.0,26.0,14.0,0.0,0.0,55,52,3,6.0,6.0,0.0
9302272,42,21,21,44,42,0,0,4,12.0,5.0,7.0,17.0,12.0,0.0,0.0,42,42,0,2.0,2.0,0.0
9606417,20,12,8,16,7,13,36,35,9.0,4.0,5.0,8.0,0.0,9.0,28.0,27,20,7,5.0,3.0,2.0
9302291,18,10,8,23,18,0,0,33,7.0,6.0,1.0,3.0,7.0,0.0,0.0,18,18,0,5.0,5.0,0.0
9603333,22,9,13,31,2,20,50,33,13.0,5.0,8.0,20.0,0.0,13.0,29.0,30,22,8,12.0,9.0,3.0
9703450,26,2,24,86,3,23,110,48,22.0,2.0,20.0,66.0,3.0,19.0,51.0,44,26,18,22.0,19.0,3.0
9802241,63,9,54,162,8,55,191,23,18.0,3.0,15.0,48.0,4.0,14.0,21.0,75,63,12,19.0,17.0,2.0
9811482,12,5,7,13,4,8,25,133,2.0,1.0,1.0,1.0,1.0,1.0,8.0,23,12,11,8.0,1.0,7.0
9912391,69,20,49,154,2,67,382,24,31.0,5.0,26.0,101.0,0.0,31.0,168.0,95,69,26,23.0,17.0,6.0
203056,32,19,13,26,0,32,599,4,9.0,6.0,3.0,4.0,0.0,9.0,168.0,211,32,179,33.0,5.0,28.0
9205204,5,4,1,2,5,0,0,26,1.0,1.0,0.0,0.0,1.0,0.0,0.0,5,5,0,1.0,1.0,0.0
9509255,14,9,5,8,11,3,5,229,6.0,6.0,0.0,0.0,5.0,1.0,2.0,26,14,12,6.0,4.0,2.0
9806292,289,7,282,2825,25,264,807,2,128.0,1.0,127.0,1816.0,0.0,128.0,464.0,303,289,14,54.0,50.0,4.0
9704229,10,8,2,2,3,7,19,170,3.0,3.0,0.0,0.0,0.0,3.0,10.0,16,10,6,7.0,3.0,4.0
7335,13,5,8,14,0,13,59,30,4.0,3.0,1.0,1.0,0.0,4.0,17.0,35,13,22,7.0,4.0,3.0
9506386,14,5,9,13,7,7,7,60,6.0,1.0,5.0,7.0,1.0,5.0,5.0,15,14,1,5.0,4.0,1.0
9605339,53,6,47,176,20,33,75,4,15.0,2.0,13.0,49.0,15.0,0.0,0.0,71,53,18,10.0,9.0,1.0
9909255,91,11,80,381,1,90,601,2,35.0,3.0,32.0,166.0,0.0,35.0,81.0,113,91,22,18.0,17.0,1.0
5024,36,11,25,61,9,27,160,4,10.0,6.0,4.0,7.0,0.0,10.0,41.0,77,36,41,13.0,5.0,8.0
111226,2,2,0,0,0,2,11,19,0.0,0.0,0.0,0.0,0.0,0.0,0.0,27,2,25,5.0,0.0,5.0
9901427,3,3,0,0,1,2,4,10,0.0,0.0,0.0,0.0,0.0,0.0,0.0,46,3,43,9.0,0.0,9.0
9711396,266,15,251,3321,243,23,30,20,168.0,1.0,167.0,2793.0,168.0,0.0,0.0,269,266,3,88.0,88.0,0.0
9306251,28,7,21,57,28,0,0,55,5.0,2.0,3.0,3.0,5.0,0.0,0.0,28,28,0,5.0,5.0,0.0
9205210,34,14,20,57,34,0,0,58,16.0,6.0,10.0,27.0,16.0,0.0,0.0,34,34,0,5.0,5.0,0.0
9405423,24,5,19,55,7,17,30,25,15.0,4.0,11.0,33.0,4.0,11.0,23.0,27,24,3,13.0,11.0,2.0
9609488,17,14,3,3,3,14,88,134,3.0,3.0,0.0,0.0,0.0,3.0,34.0,36,17,19,18.0,3.0,15.0
9411260,94,22,72,210,60,34,71,25,11.0,3.0,8.0,22.0,0.0,11.0,25.0,103,94,9,12.0,10.0,2.0
9208210,11,5,6,12,11,0,0,26,5.0,1.0,4.0,7.0,5.0,0.0,0.0,11,11,0,5.0,5.0,0.0
9503303,106,10,96,368,49,57,108,73,23.0,1.0,22.0,103.0,23.0,0.0,0.0,112,106,6,14.0,14.0,0.0
9504292,100,10,90,418,3,97,417,3,45.0,5.0,40.0,158.0,0.0,45.0,205.0,111,100,11,30.0,24.0,6.0
9505248,149,11,138,1337,111,38,74,12,90.0,3.0,87.0,977.0,90.0,0.0,0.0,159,149,10,45.0,45.0,0.0
9606411,112,11,101,706,14,98,409,0,68.0,5.0,63.0,510.0,5.0,63.0,259.0,144,112,32,52.0,46.0,6.0
9807310,98,6,92,682,81,17,17,3,76.0,5.0,71.0,588.0,59.0,17.0,17.0,99,98,1,38.0,37.0,1.0
9906297,55,13,42,155,0,55,327,3,34.0,7.0,27.0,98.0,0.0,34.0,232.0,74,55,19,27.0,11.0,16.0
9909254,61,5,56,387,4,57,277,0,43.0,1.0,42.0,305.0,1.0,42.0,150.0,83,61,22,40.0,34.0,6.0
9811495,47,7,40,158,5,42,159,3,27.0,3.0,24.0,102.0,0.0,27.0,104.0,75,47,28,7.0,1.0,6.0
9709271,5,1,4,9,4,1,1,3,,,,,,,,7,5,2,,,
9902204,38,7,31,98,6,32,71,3,13.0,1.0,12.0,42.0,13.0,0.0,0.0,48,38,10,11.0,11.0,0.0
9911238,9,5,4,5,2,7,18,3,2.0,1.0,1.0,1.0,1.0,1.0,1.0,20,9,11,3.0,0.0,3.0
9512220,50,5,45,173,11,39,93,119,33.0,4.0,29.0,102.0,6.0,27.0,64.0,61,50,11,29.0,25.0,4.0
9505301,33,7,26,99,22,11,16,0,11.0,1.0,10.0,31.0,9.0,2.0,2.0,35,33,2,4.0,4.0,0.0
9810309,33,5,28,44,5,28,230,3,11.0,3.0,8.0,17.0,0.0,11.0,135.0,61,33,28,25.0,9.0,16.0
9807484,2,2,0,0,0,2,16,0,1.0,1.0,0.0,0.0,0.0,1.0,7.0,20,2,18,,,
9305257,16,6,10,19,16,0,0,0,4.0,3.0,1.0,1.0,4.0,0.0,0.0,16,16,0,4.0,4.0,0.0
9812361,26,2,24,100,6,20,32,0,18.0,1.0,17.0,77.0,16.0,2.0,2.0,38,26,12,15.0,14.0,1.0
9805249,4,2,2,3,1,3,3,431,1.0,1.0,0.0,0.0,1.0,0.0,0.0,5,4,1,1.0,1.0,0.0
9805305,4,3,1,1,0,4,12,0,0.0,0.0,0.0,0.0,0.0,0.0,0.0,14,4,10,5.0,1.0,4.0
9310331,21,5,16,35,21,0,0,3,4.0,1.0,3.0,3.0,4.0,0.0,0.0,21,21,0,2.0,2.0,0.0
9210235,279,64,215,1223,262,17,17,10,57.0,13.0,44.0,276.0,57.0,0.0,0.0,280,279,1,22.0,22.0,0.0
9612442,32,5,27,63,1,31,181,3,10.0,3.0,7.0,10.0,0.0,10.0,70.0,55,32,23,22.0,8.0,14.0
9607285,21,1,20,44,0,21,50,51,16.0,1.0,15.0,33.0,0.0,16.0,41.0,29,21,8,8.0,5.0,3.0
9604444,22,2,20,75,0,22,85,21,18.0,2.0,16.0,63.0,0.0,18.0,74.0,30,22,8,17.0,12.0,5.0
9311225,24,6,18,48,13,11,14,10,3.0,1.0,2.0,2.0,3.0,0.0,0.0,28,24,4,6.0,6.0,0.0
9207237,24,11,13,34,24,0,0,75,9.0,4.0,5.0,7.0,9.0,0.0,0.0,25,24,1,6.0,6.0,0.0
9503276,40,8,32,98,7,33,62,30,22.0,4.0,18.0,51.0,3.0,19.0,27.0,47,40,7,9.0,8.0,1.0
9812202,16,6,10,36,0,16,114,71,9.0,3.0,6.0,18.0,0.0,9.0,88.0,52,16,36,31.0,6.0,25.0
9510340,3,1,2,2,0,3,29,3,0.0,0.0,0.0,0.0,0.0,0.0,0.0,37,3,34,7.0,0.0,7.0
9811205,8,4,4,5,0,8,30,0,5.0,2.0,3.0,4.0,0.0,5.0,21.0,17,8,9,8.0,3.0,5.0
9203220,63,11,52,173,63,0,0,10,15.0,1.0,14.0,40.0,15.0,0.0,0.0,63,63,0,10.0,10.0,0.0
9405420,12,2,10,31,1,11,29,60,8.0,1.0,7.0,24.0,0.0,8.0,20.0,18,12,6,11.0,8.0,3.0
9901260,34,9,25,76,2,32,191,12,25.0,3.0,22.0,70.0,0.0,25.0,146.0,62,34,28,27.0,17.0,10.0
9608209,6,4,2,2,1,5,29,46,2.0,2.0,0.0,0.0,1.0,1.0,1.0,17,6,11,7.0,2.0,5.0
9712219,9,6,3,3,1,8,117,36,3.0,3.0,0.0,0.0,0.0,3.0,60.0,79,9,70,52.0,3.0,49.0
105308,16,9,7,12,0,16,54,1,8.0,2.0,6.0,10.0,0.0,8.0,24.0,24,16,8,5.0,3.0,2.0
9410406,90,10,80,492,89,1,1,1,31.0,3.0,28.0,147.0,31.0,0.0,0.0,91,90,1,4.0,4.0,0.0
9608430,101,13,88,495,30,71,198,1,42.0,3.0,39.0,236.0,9.0,33.0,60.0,132,101,31,15.0,14.0,1.0
9712287,85,6,79,545,3,82,339,1,56.0,4.0,52.0,402.0,0.0,56.0,203.0,98,85,13,43.0,38.0,5.0
9809329,59,8,51,200,11,48,193,1,18.0,4.0,14.0,41.0,1.0,17.0,68.0,77,59,18,12.0,12.0,0.0
9907572,42,6,36,121,0,42,272,32,20.0,4.0,16.0,50.0,0.0,20.0,103.0,69,42,27,19.0,15.0,4.0
9812471,51,5,46,329,6,45,100,34,42.0,3.0,39.0,289.0,6.0,36.0,79.0,57,51,6,18.0,15.0,3.0
12221,19,7,12,28,0,19,124,13,10.0,4.0,6.0,13.0,0.0,10.0,77.0,52,19,33,20.0,12.0,8.0
9606203,52,8,44,265,4,48,154,5,35.0,4.0,31.0,190.0,0.0,35.0,116.0,60,52,8,16.0,16.0,0.0
9703211,51,11,40,169,0,51,644,5,31.0,6.0,25.0,105.0,0.0,31.0,529.0,96,51,45,52.0,22.0,30.0
9711216,12,2,10,28,0,12,192,5,11.0,1.0,10.0,28.0,0.0,11.0,183.0,43,12,31,41.0,11.0,30.0
9510368,8,5,3,3,3,5,5,210,2.0,1.0,1.0,1.0,2.0,0.0,0.0,10,8,2,2.0,2.0,0.0
9504424,20,6,14,41,3,17,66,93,5.0,3.0,2.0,2.0,0.0,5.0,25.0,33,20,13,9.0,3.0,6.0
9908386,9,5,4,5,4,5,14,34,2.0,1.0,1.0,1.0,2.0,0.0,0.0,15,9,6,1.0,0.0,1.0
109260,27,11,16,29,0,27,233,1,19.0,6.0,13.0,24.0,0.0,19.0,172.0,64,27,37,26.0,7.0,19.0
110317,16,9,7,9,3,13,53,74,7.0,4.0,3.0,3.0,0.0,7.0,38.0,31,16,15,14.0,3.0,11.0
9909404,31,4,27,104,1,30,214,6,18.0,3.0,15.0,35.0,3.0,15.0,35.0,55,31,24,19.0,11.0,8.0
9605221,47,3,44,242,5,42,106,1,31.0,1.0,30.0,151.0,3.0,28.0,57.0,56,47,9,4.0,3.0,1.0
107320,8,5,3,3,0,8,74,1,8.0,5.0,3.0,3.0,0.0,8.0,74.0,27,8,19,13.0,4.0,9.0
9811249,31,7,24,57,7,24,115,1,0.0,0.0,0.0,0.0,0.0,0.0,0.0,67,31,36,15.0,4.0,11.0
9711401,33,17,16,33,6,27,109,5,1.0,1.0,0.0,0.0,0.0,1.0,3.0,95,33,62,13.0,0.0,13.0
9704274,50,2,48,147,6,44,137,1,13.0,1.0,12.0,27.0,1.0,12.0,43.0,58,50,8,16.0,13.0,3.0
9611345,9,3,6,7,9,0,0,141,4.0,2.0,2.0,2.0,4.0,0.0,0.0,9,9,0,3.0,3.0,0.0
9701392,21,10,11,14,1,20,99,61,6.0,1.0,5.0,6.0,0.0,6.0,23.0,40,21,19,10.0,5.0,5.0
9801453,9,8,1,1,2,7,47,21,3.0,3.0,0.0,0.0,0.0,3.0,22.0,35,9,26,11.0,4.0,7.0
9611393,25,6,19,62,2,23,67,7,15.0,2.0,13.0,39.0,0.0,15.0,26.0,37,25,12,11.0,9.0,2.0
9506264,47,9,38,137,13,34,99,7,20.0,3.0,17.0,75.0,12.0,8.0,16.0,59,47,12,15.0,13.0,2.0
9803363,65,1,64,409,6,59,268,24,41.0,1.0,40.0,291.0,2.0,39.0,196.0,79,65,14,33.0,25.0,8.0
9905437,38,17,21,50,3,35,529,1,4.0,4.0,0.0,0.0,0.0,4.0,62.0,167,38,129,18.0,4.0,14.0
9508271,75,6,69,516,8,67,104,12,57.0,3.0,54.0,472.0,7.0,50.0,63.0,89,75,14,28.0,27.0,1.0
9407229,14,6,8,14,5,9,20,10,5.0,4.0,1.0,1.0,0.0,5.0,9.0,28,14,14,4.0,2.0,2.0
9406303,31,6,25,86,1,30,64,69,18.0,2.0,16.0,58.0,0.0,18.0,29.0,40,31,9,10.0,9.0,1.0
9704383,41,12,29,97,41,0,0,98,21.0,4.0,17.0,61.0,21.0,0.0,0.0,41,41,0,13.0,13.0,0.0
9612331,12,4,8,16,4,8,8,383,7.0,2.0,5.0,10.0,2.0,5.0,5.0,14,12,2,7.0,6.0,1.0
9706325,6,1,5,9,3,3,3,80,5.0,2.0,3.0,4.0,5.0,0.0,0.0,7,6,1,2.0,2.0,0.0
9603411,4,3,1,1,1,3,14,30,2.0,2.0,0.0,0.0,0.0,2.0,7.0,13,4,9,1.0,1.0,0.0
9605463,18,3,15,49,0,18,81,62,15.0,2.0,13.0,44.0,0.0,15.0,60.0,35,18,17,15.0,9.0,6.0
9503454,15,7,8,9,10,5,6,5,4.0,3.0,1.0,1.0,4.0,0.0,0.0,20,15,5,2.0,2.0,0.0
9706449,13,5,8,17,1,12,18,24,3.0,3.0,0.0,0.0,1.0,2.0,2.0,16,13,3,3.0,2.0,1.0
9803389,213,26,187,1186,0,213,591,16,85.0,6.0,79.0,646.0,0.0,85.0,383.0,230,213,17,48.0,37.0,11.0
9506245,7,6,1,1,4,3,3,115,4.0,3.0,1.0,1.0,2.0,2.0,2.0,8,7,1,2.0,2.0,0.0
9602363,53,16,37,107,18,35,75,57,20.0,5.0,15.0,51.0,10.0,10.0,10.0,61,53,8,13.0,12.0,1.0
105230,3,2,1,1,2,1,3,98,0.0,0.0,0.0,0.0,0.0,0.0,0.0,7,3,4,2.0,1.0,1.0
9609445,46,7,39,121,6,40,81,108,34.0,4.0,30.0,102.0,2.0,32.0,69.0,53,46,7,24.0,21.0,3.0
9605462,9,6,3,6,1,8,71,17,7.0,4.0,3.0,5.0,0.0,7.0,69.0,40,9,31,30.0,4.0,26.0
9808371,64,17,47,96,30,34,51,4,4.0,2.0,2.0,3.0,2.0,2.0,2.0,71,64,7,6.0,6.0,0.0
9402298,26,5,21,72,22,4,4,30,16.0,2.0,14.0,46.0,16.0,0.0,0.0,27,26,1,10.0,10.0,0.0
9805445,22,5,17,38,9,13,19,30,1.0,1.0,0.0,0.0,1.0,0.0,0.0,27,22,5,6.0,3.0,3.0
9311323,5,5,0,0,5,0,0,331,1.0,1.0,0.0,0.0,1.0,0.0,0.0,5,5,0,1.0,1.0,0.0
9407344,80,11,69,276,15,65,182,6,26.0,2.0,24.0,84.0,26.0,0.0,0.0,93,80,13,24.0,22.0,2.0
9602262,44,5,39,147,1,43,291,6,30.0,3.0,27.0,99.0,0.0,30.0,251.0,69,44,25,34.0,15.0,19.0
9903518,10,4,6,9,2,8,49,6,4.0,2.0,2.0,2.0,0.0,4.0,34.0,34,10,24,3.0,3.0,0.0
9312227,21,5,16,64,5,16,29,85,14.0,2.0,12.0,38.0,7.0,7.0,7.0,28,21,7,12.0,12.0,0.0
9407353,11,2,9,21,1,10,24,6,9.0,2.0,7.0,17.0,0.0,9.0,22.0,16,11,5,1.0,1.0,0.0
9209296,36,12,24,107,35,1,1,12,18.0,2.0,16.0,78.0,18.0,0.0,0.0,37,36,1,3.0,3.0,0.0
9804381,2,2,0,0,0,2,9,8,1.0,1.0,0.0,0.0,0.0,1.0,4.0,19,2,17,7.0,1.0,6.0
9211319,9,6,3,3,9,0,0,8,1.0,1.0,0.0,0.0,1.0,0.0,0.0,9,9,0,2.0,2.0,0.0
101168,3,1,2,3,0,3,9,38,0.0,0.0,0.0,0.0,0.0,0.0,0.0,25,3,22,16.0,0.0,16.0
9311329,40,3,37,127,40,0,0,22,21.0,1.0,20.0,67.0,21.0,0.0,0.0,41,40,1,15.0,15.0,0.0
9701227,21,7,14,28,2,19,76,45,15.0,3.0,12.0,21.0,0.0,15.0,58.0,31,21,10,17.0,12.0,5.0
9704416,34,11,23,49,3,31,94,38,15.0,5.0,10.0,15.0,3.0,12.0,20.0,59,34,25,12.0,9.0,3.0
9708426,30,5,25,107,4,26,109,38,23.0,2.0,21.0,90.0,2.0,21.0,84.0,41,30,11,25.0,18.0,7.0
9509333,24,10,14,42,7,17,17,22,6.0,2.0,4.0,6.0,1.0,5.0,5.0,26,24,2,7.0,6.0,1.0
9909369,22,4,18,29,0,22,155,22,6.0,2.0,4.0,4.0,0.0,6.0,31.0,78,22,56,14.0,4.0,10.0
9506399,15,4,11,30,7,8,14,88,11.0,2.0,9.0,26.0,5.0,6.0,7.0,23,15,8,11.0,10.0,1.0
9907502,23,4,19,48,6,17,37,88,11.0,1.0,10.0,26.0,1.0,10.0,23.0,32,23,9,16.0,9.0,7.0
9403224,141,43,98,269,116,25,28,52,19.0,3.0,16.0,47.0,6.0,13.0,15.0,143,141,2,10.0,9.0,1.0
9705357,43,10,33,132,1,42,236,21,28.0,5.0,23.0,95.0,0.0,28.0,195.0,63,43,20,32.0,16.0,16.0
9812342,3,2,1,1,1,2,4,21,1.0,1.0,0.0,0.0,1.0,0.0,0.0,9,3,6,1.0,1.0,0.0
9506233,40,10,30,118,5,35,125,16,24.0,6.0,18.0,77.0,0.0,24.0,92.0,48,40,8,17.0,13.0,4.0
9805283,6,6,0,0,1,5,10,287,0.0,0.0,0.0,0.0,0.0,0.0,0.0,10,6,4,4.0,0.0,4.0
9904344,41,7,34,145,7,34,57,66,19.0,4.0,15.0,63.0,2.0,17.0,17.0,46,41,5,13.0,12.0,1.0
9912355,34,7,27,85,3,31,111,19,17.0,3.0,14.0,47.0,0.0,17.0,56.0,45,34,11,17.0,11.0,6.0
9802350,94,8,86,263,51,43,110,77,22.0,1.0,21.0,58.0,7.0,15.0,41.0,115,94,21,15.0,12.0,3.0
9311260,51,9,42,171,45,6,6,39,25.0,3.0,22.0,87.0,25.0,0.0,0.0,52,51,1,12.0,12.0,0.0
101326,17,1,16,68,0,17,113,20,16.0,1.0,15.0,67.0,0.0,16.0,110.0,34,17,17,12.0,11.0,1.0
9910550,43,2,41,321,0,43,770,20,42.0,2.0,40.0,315.0,0.0,42.0,745.0,88,43,45,70.0,36.0,34.0
9912409,45,5,40,179,0,45,565,20,41.0,5.0,36.0,172.0,0.0,41.0,547.0,72,45,27,52.0,25.0,27.0
9405209,23,8,15,39,4,19,29,29,8.0,1.0,7.0,18.0,0.0,8.0,8.0,26,23,3,9.0,8.0,1.0
9707432,8,4,4,6,2,6,16,136,5.0,3.0,2.0,2.0,0.0,5.0,14.0,12,8,4,8.0,4.0,4.0
9802284,14,1,13,38,2,12,23,20,5.0,3.0,2.0,3.0,5.0,0.0,0.0,16,14,2,3.0,3.0,0.0
10274,12,1,11,29,0,12,81,20,11.0,1.0,10.0,27.0,0.0,11.0,77.0,27,12,15,2.0,2.0,0.0
8217,8,3,5,5,3,5,6,153,3.0,1.0,2.0,2.0,0.0,3.0,3.0,10,8,2,4.0,3.0,1.0
204109,4,3,1,1,0,4,19,37,2.0,2.0,0.0,0.0,1.0,1.0,3.0,17,4,13,7.0,2.0,5.0
9905204,28,9,19,60,1,27,137,2,10.0,2.0,8.0,14.0,0.0,10.0,73.0,47,28,19,9.0,5.0,4.0
9307216,15,9,6,11,3,12,36,6,1.0,1.0,0.0,0.0,1.0,0.0,0.0,22,15,7,3.0,2.0,1.0
9407291,83,11,72,285,64,19,19,10,14.0,3.0,11.0,41.0,14.0,0.0,0.0,84,83,1,12.0,12.0,0.0
9905292,43,5,38,120,0,43,319,5,10.0,2.0,8.0,20.0,0.0,10.0,84.0,96,43,53,29.0,10.0,19.0
9308271,251,34,217,1167,187,64,70,60,39.0,6.0,33.0,179.0,14.0,25.0,29.0,253,251,2,24.0,23.0,1.0
9310215,8,2,6,13,0,8,21,10,7.0,2.0,5.0,12.0,0.0,7.0,7.0,15,8,7,6.0,6.0,0.0
9408202,1,1,0,0,0,1,1,991,,,,,,,,2,1,1,,,
9810334,5,3,2,2,1,4,37,99,3.0,2.0,1.0,1.0,0.0,3.0,19.0,18,5,13,9.0,3.0,6.0
9704388,9,3,6,11,4,5,10,42,5.0,2.0,3.0,4.0,0.0,5.0,10.0,14,9,5,4.0,3.0,1.0
9312355,39,2,37,144,8,31,57,15,11.0,7.0,4.0,6.0,9.0,2.0,2.0,44,39,5,15.0,14.0,1.0
9405212,17,7,10,20,10,7,8,190,5.0,2.0,3.0,6.0,3.0,2.0,2.0,22,17,5,6.0,5.0,1.0
9609524,34,3,31,84,9,25,134,5,16.0,2.0,14.0,23.0,0.0,16.0,92.0,44,34,10,12.0,12.0,0.0
9304281,18,6,12,23,8,10,23,35,8.0,2.0,6.0,12.0,0.0,8.0,21.0,22,18,4,12.0,8.0,4.0
9707535,26,6,20,38,3,23,133,61,10.0,5.0,5.0,5.0,0.0,10.0,43.0,51,26,25,16.0,9.0,7.0
9303293,17,2,15,33,7,10,10,4,3.0,1.0,2.0,3.0,3.0,0.0,0.0,18,17,1,3.0,3.0,0.0
9810289,21,13,8,20,7,14,89,4,3.0,1.0,2.0,2.0,0.0,3.0,14.0,43,21,22,2.0,2.0,0.0
9707207,22,10,12,24,4,18,61,107,4.0,1.0,3.0,4.0,4.0,0.0,0.0,33,22,11,4.0,3.0,1.0
9708359,3,1,2,2,0,3,5,310,3.0,1.0,2.0,2.0,0.0,3.0,5.0,5,3,2,5.0,3.0,2.0
9907421,43,20,23,47,15,28,88,0,9.0,4.0,5.0,13.0,2.0,7.0,11.0,54,43,11,6.0,5.0,1.0
9906345,10,5,5,7,1,9,45,81,4.0,2.0,2.0,4.0,0.0,4.0,29.0,29,10,19,5.0,3.0,2.0
9802382,15,1,14,37,15,0,0,28,9.0,1.0,8.0,19.0,9.0,0.0,0.0,15,15,0,2.0,2.0,0.0
9905568,50,6,44,131,29,21,35,2,8.0,1.0,7.0,17.0,8.0,0.0,0.0,56,50,6,8.0,8.0,0.0
10153,16,11,5,6,11,5,5,121,3.0,3.0,0.0,0.0,3.0,0.0,0.0,18,16,2,4.0,3.0,1.0
9609389,8,7,1,1,7,1,1,343,1.0,1.0,0.0,0.0,0.0,1.0,1.0,12,8,4,4.0,1.0,3.0
9902243,11,3,8,16,1,10,29,227,8.0,1.0,7.0,13.0,0.0,8.0,22.0,21,11,10,14.0,7.0,7.0
9410214,10,4,6,12,3,7,11,17,1.0,1.0,0.0,0.0,1.0,0.0,0.0,13,10,3,2.0,2.0,0.0
9503208,29,7,22,66,3,26,117,6,20.0,5.0,15.0,48.0,1.0,19.0,101.0,47,29,18,10.0,8.0,2.0
9704445,13,5,8,25,3,10,32,6,9.0,2.0,7.0,19.0,4.0,5.0,5.0,27,13,14,9.0,8.0,1.0
9608318,68,8,60,226,45,23,66,67,12.0,1.0,11.0,26.0,4.0,8.0,31.0,75,68,7,6.0,2.0,4.0
9505428,75,18,57,149,4,71,254,10,14.0,4.0,10.0,20.0,7.0,7.0,8.0,94,75,19,10.0,9.0,1.0
9604336,10,8,2,3,3,7,62,1,8.0,6.0,2.0,2.0,1.0,7.0,62.0,26,10,16,14.0,4.0,10.0
5159,14,6,8,19,0,14,204,55,6.0,1.0,5.0,12.0,0.0,6.0,84.0,88,14,74,22.0,6.0,16.0
9703434,33,3,30,113,4,29,59,87,23.0,2.0,21.0,86.0,2.0,21.0,45.0,37,33,4,20.0,17.0,3.0
3038,12,3,9,13,1,11,40,0,3.0,3.0,0.0,0.0,0.0,3.0,8.0,20,12,8,6.0,2.0,4.0
9505300,4,4,0,0,1,3,3,56,1.0,1.0,0.0,0.0,1.0,0.0,0.0,5,4,1,1.0,1.0,0.0
9910231,51,4,47,181,2,49,390,3,32.0,2.0,30.0,114.0,0.0,32.0,308.0,82,51,31,21.0,18.0,3.0
9712231,15,7,8,25,6,9,10,31,12.0,5.0,7.0,23.0,3.0,9.0,10.0,17,15,2,8.0,7.0,1.0
9402310,24,5,19,56,1,23,52,124,15.0,4.0,11.0,41.0,0.0,15.0,39.0,30,24,6,16.0,12.0,4.0
9812235,12,8,4,5,3,9,27,5,0.0,0.0,0.0,0.0,0.0,0.0,0.0,78,12,66,2.0,2.0,0.0
11313,6,2,4,5,0,6,52,18,3.0,3.0,0.0,0.0,0.0,3.0,28.0,56,6,50,6.0,0.0,6.0
9912324,11,7,4,6,4,7,29,18,5.0,2.0,3.0,3.0,1.0,4.0,13.0,25,11,14,5.0,3.0,2.0
105004,17,4,13,28,0,17,214,18,14.0,4.0,10.0,24.0,0.0,14.0,90.0,48,17,31,20.0,12.0,8.0
9502388,13,7,6,8,1,12,48,18,1.0,1.0,0.0,0.0,0.0,1.0,6.0,28,13,15,9.0,1.0,8.0
9903468,19,7,12,35,1,18,57,18,12.0,4.0,8.0,28.0,0.0,12.0,42.0,29,19,10,4.0,4.0,0.0
9908397,26,5,21,75,0,26,245,32,13.0,3.0,10.0,33.0,0.0,13.0,175.0,67,26,41,34.0,14.0,20.0
9302304,9,4,5,10,9,0,0,58,1.0,1.0,0.0,0.0,1.0,0.0,0.0,10,9,1,4.0,4.0,0.0
103320,53,16,37,103,3,50,346,32,19.0,5.0,14.0,37.0,0.0,19.0,190.0,109,53,56,24.0,7.0,17.0
8183,8,4,4,5,0,8,42,10,0.0,0.0,0.0,0.0,0.0,0.0,0.0,70,8,62,12.0,0.0,12.0
10009,29,2,27,87,1,28,149,0,10.0,1.0,9.0,28.0,0.0,10.0,62.0,58,29,29,18.0,6.0,12.0
106168,7,1,6,14,0,7,60,0,7.0,1.0,6.0,14.0,0.0,7.0,48.0,26,7,19,8.0,1.0,7.0
9610339,11,1,10,31,7,4,8,0,0.0,0.0,0.0,0.0,0.0,0.0,0.0,18,11,7,6.0,6.0,0.0
9503323,9,2,7,12,1,8,43,10,5.0,1.0,4.0,8.0,0.0,5.0,14.0,23,9,14,3.0,2.0,1.0
9907352,13,3,10,28,0,13,21,118,11.0,2.0,9.0,26.0,0.0,11.0,17.0,21,13,8,13.0,11.0,2.0
1244,21,1,20,68,12,9,17,65,18.0,1.0,17.0,62.0,9.0,9.0,9.0,27,21,6,13.0,12.0,1.0
2138,11,7,4,5,1,10,45,163,4.0,3.0,1.0,1.0,0.0,4.0,20.0,23,11,12,8.0,2.0,6.0
9706529,31,6,25,51,2,29,133,16,16.0,4.0,12.0,22.0,0.0,16.0,48.0,55,31,24,19.0,13.0,6.0
9903397,11,6,5,8,1,10,30,106,5.0,2.0,3.0,4.0,1.0,4.0,8.0,23,11,12,4.0,1.0,3.0
9605375,4,3,1,1,0,4,37,8,3.0,2.0,1.0,1.0,0.0,3.0,27.0,25,4,21,3.0,2.0,1.0
9501392,12,3,9,34,0,12,46,94,11.0,3.0,8.0,28.0,1.0,10.0,40.0,20,12,8,17.0,10.0,7.0
9709450,32,17,15,30,3,29,169,5,5.0,3.0,2.0,4.0,0.0,5.0,27.0,88,32,56,2.0,1.0,1.0
9612233,3,3,0,0,1,2,5,293,1.0,1.0,0.0,0.0,0.0,1.0,1.0,8,3,5,2.0,1.0,1.0
9808229,8,4,4,4,4,4,8,9,1.0,1.0,0.0,0.0,1.0,0.0,0.0,13,8,5,1.0,1.0,0.0
9910210,6,3,3,4,2,4,10,16,6.0,3.0,3.0,4.0,2.0,4.0,7.0,10,6,4,1.0,1.0,0.0
2199,78,10,68,360,1,77,394,2,43.0,3.0,40.0,241.0,3.0,40.0,66.0,95,78,17,40.0,36.0,4.0
9906431,25,5,20,52,0,25,522,2,20.0,3.0,17.0,48.0,0.0,20.0,459.0,91,25,66,35.0,14.0,21.0
9812489,102,7,95,555,7,95,680,2,42.0,3.0,39.0,243.0,0.0,42.0,475.0,132,102,30,39.0,29.0,10.0
10345,11,7,4,4,5,6,13,11,2.0,2.0,0.0,0.0,1.0,1.0,1.0,17,11,6,2.0,1.0,1.0
9408245,129,17,112,832,129,0,0,11,51.0,3.0,48.0,256.0,51.0,0.0,0.0,129,129,0,36.0,36.0,0.0
9505396,4,4,0,0,3,1,1,138,1.0,1.0,0.0,0.0,1.0,0.0,0.0,7,4,3,1.0,1.0,0.0
211156,2,2,0,0,0,2,24,19,1.0,1.0,0.0,0.0,0.0,1.0,16.0,33,2,31,25.0,1.0,24.0
12191,10,3,7,15,1,9,11,19,2.0,1.0,1.0,1.0,2.0,0.0,0.0,12,10,2,4.0,3.0,1.0
9412356,19,3,16,36,1,18,56,25,7.0,1.0,6.0,9.0,1.0,6.0,22.0,31,19,12,8.0,7.0,1.0
110213,12,5,7,12,0,12,156,8,8.0,1.0,7.0,10.0,0.0,8.0,114.0,55,12,43,26.0,4.0,22.0
209219,7,4,3,5,1,6,26,19,4.0,3.0,1.0,2.0,0.0,4.0,13.0,31,7,24,9.0,3.0,6.0
111042,48,4,44,371,0,48,686,28,45.0,4.0,41.0,359.0,0.0,45.0,405.0,102,48,54,49.0,38.0,11.0
9801362,6,1,5,10,3,3,3,28,4.0,1.0,3.0,5.0,1.0,3.0,3.0,7,6,1,1.0,1.0,0.0
1320,10,5,5,6,0,10,98,2,4.0,3.0,1.0,1.0,0.0,4.0,51.0,37,10,27,20.0,2.0,18.0
9703365,2,1,1,1,0,2,3,9,0.0,0.0,0.0,0.0,0.0,0.0,0.0,11,2,9,2.0,0.0,2.0
9908238,3,3,0,0,2,1,1,466,0.0,0.0,0.0,0.0,0.0,0.0,0.0,5,3,2,2.0,1.0,1.0
9605350,3,3,0,0,3,0,0,283,1.0,1.0,0.0,0.0,1.0,0.0,0.0,7,3,4,1.0,1.0,0.0
103312,3,3,0,0,0,3,42,2,1.0,1.0,0.0,0.0,0.0,1.0,13.0,31,3,28,20.0,1.0,19.0
7226,37,20,17,26,3,34,323,2,18.0,7.0,11.0,15.0,0.0,18.0,266.0,89,37,52,32.0,8.0,24.0
9812233,21,9,12,16,4,17,56,5,3.0,2.0,1.0,1.0,3.0,0.0,0.0,31,21,10,5.0,3.0,2.0
10037,15,6,9,14,11,4,11,184,4.0,3.0,1.0,1.0,1.0,3.0,8.0,24,15,9,9.0,3.0,6.0
9908524,3,2,1,1,0,3,10,131,2.0,1.0,1.0,1.0,0.0,2.0,6.0,20,3,17,5.0,2.0,3.0
9803258,8,6,2,2,0,8,15,5,3.0,3.0,0.0,0.0,3.0,0.0,0.0,22,8,14,4.0,3.0,1.0
9602337,9,3,6,7,0,9,19,10,2.0,1.0,1.0,1.0,2.0,0.0,0.0,15,9,6,8.0,7.0,1.0
2053,23,10,13,29,5,18,47,120,9.0,3.0,6.0,20.0,3.0,6.0,15.0,36,23,13,12.0,7.0,5.0
9601269,19,7,12,31,3,16,47,164,6.0,3.0,3.0,3.0,1.0,5.0,24.0,27,19,8,12.0,4.0,8.0
9205220,20,5,15,32,20,0,0,164,10.0,2.0,8.0,12.0,10.0,0.0,0.0,21,20,1,6.0,6.0,0.0
9203213,6,4,2,3,6,0,0,242,2.0,1.0,1.0,1.0,2.0,0.0,0.0,6,6,0,2.0,2.0,0.0
9808466,4,3,1,1,0,4,27,10,1.0,1.0,0.0,0.0,0.0,1.0,7.0,31,4,27,4.0,0.0,4.0
9906538,24,8,16,56,2,22,97,21,17.0,3.0,14.0,51.0,2.0,15.0,45.0,43,24,19,12.0,11.0,1.0
9701269,2,1,1,1,2,0,0,300,1.0,1.0,0.0,0.0,1.0,0.0,0.0,2,2,0,1.0,1.0,0.0
10326,9,7,2,2,0,9,119,1,4.0,3.0,1.0,1.0,0.0,4.0,37.0,62,9,53,9.0,6.0,3.0
11021,1,1,0,0,0,1,4,74,0.0,0.0,0.0,0.0,0.0,0.0,0.0,13,1,12,3.0,0.0,3.0
9707243,19,4,15,53,0,19,76,58,8.0,1.0,7.0,17.0,0.0,8.0,24.0,29,19,10,14.0,9.0,5.0
9912430,17,4,13,25,1,16,162,7,6.0,2.0,4.0,6.0,0.0,6.0,48.0,50,17,33,10.0,3.0,7.0
9406374,14,8,6,16,4,10,40,5,5.0,2.0,3.0,7.0,1.0,4.0,10.0,30,14,16,2.0,0.0,2.0
9505226,21,6,15,23,19,2,2,9,8.0,1.0,7.0,8.0,7.0,1.0,1.0,22,21,1,5.0,5.0,0.0
4059,37,3,34,165,0,37,281,9,34.0,2.0,32.0,156.0,0.0,34.0,255.0,59,37,22,27.0,13.0,14.0
9511228,86,14,72,240,18,68,80,9,30.0,2.0,28.0,102.0,2.0,28.0,28.0,90,86,4,11.0,11.0,0.0
9603266,41,1,40,141,1,40,230,17,33.0,1.0,32.0,122.0,0.0,33.0,206.0,52,41,11,35.0,26.0,9.0
9608296,8,3,5,11,0,8,55,17,6.0,2.0,4.0,10.0,0.0,6.0,42.0,16,8,8,13.0,5.0,8.0
108258,6,6,0,0,1,5,23,56,2.0,2.0,0.0,0.0,0.0,2.0,7.0,24,6,18,7.0,3.0,4.0
9408389,6,4,2,4,1,5,5,229,4.0,3.0,1.0,2.0,0.0,4.0,4.0,8,6,2,4.0,3.0,1.0
9903449,15,10,5,5,11,4,5,23,0.0,0.0,0.0,0.0,0.0,0.0,0.0,38,15,23,6.0,0.0,6.0
9606344,49,7,42,197,17,32,47,24,19.0,1.0,18.0,54.0,6.0,13.0,13.0,60,49,11,23.0,21.0,2.0
9307356,24,6,18,64,24,0,0,108,14.0,2.0,12.0,42.0,14.0,0.0,0.0,24,24,0,3.0,3.0,0.0
9609215,12,4,8,13,1,11,72,8,7.0,1.0,6.0,9.0,0.0,7.0,48.0,28,12,16,3.0,2.0,1.0
9808425,15,2,13,53,1,14,89,12,14.0,1.0,13.0,48.0,1.0,13.0,81.0,26,15,11,4.0,2.0,2.0
203121,13,9,4,7,1,12,88,4,7.0,4.0,3.0,6.0,0.0,7.0,56.0,73,13,60,26.0,2.0,24.0
7280,9,3,6,9,0,9,91,12,3.0,3.0,0.0,0.0,0.0,3.0,20.0,60,9,51,24.0,1.0,23.0
9707242,14,7,7,15,1,13,127,5,3.0,3.0,0.0,0.0,0.0,3.0,16.0,52,14,38,15.0,5.0,10.0
9910320,36,8,28,98,3,33,354,12,26.0,4.0,22.0,82.0,0.0,26.0,296.0,76,36,40,25.0,16.0,9.0
9208206,35,12,23,72,35,0,0,88,9.0,4.0,5.0,8.0,9.0,0.0,0.0,35,35,0,5.0,5.0,0.0
11138,3,1,2,2,0,3,5,28,0.0,0.0,0.0,0.0,0.0,0.0,0.0,13,3,10,3.0,3.0,0.0
9609498,13,2,11,29,5,8,11,101,8.0,2.0,6.0,14.0,7.0,1.0,1.0,18,13,5,7.0,6.0,1.0
9807211,16,2,14,60,10,6,10,45,13.0,1.0,12.0,51.0,9.0,4.0,4.0,19,16,3,12.0,12.0,0.0
9604230,5,5,0,0,1,4,14,14,3.0,3.0,0.0,0.0,0.0,3.0,8.0,14,5,9,6.0,2.0,4.0
101305,24,7,17,58,3,21,242,24,18.0,3.0,15.0,54.0,0.0,18.0,190.0,56,24,32,30.0,14.0,16.0
9605424,8,3,5,10,0,8,16,24,0.0,0.0,0.0,0.0,0.0,0.0,0.0,11,8,3,3.0,2.0,1.0
9501292,23,10,13,35,23,0,0,92,10.0,2.0,8.0,19.0,10.0,0.0,0.0,24,23,1,4.0,3.0,1.0
9807346,8,7,1,1,3,5,19,64,3.0,2.0,1.0,1.0,0.0,3.0,14.0,17,8,9,9.0,2.0,7.0
9306253,29,7,22,67,29,0,0,47,15.0,3.0,12.0,43.0,15.0,0.0,0.0,29,29,0,12.0,12.0,0.0
7277,5,3,2,2,0,5,38,9,4.0,4.0,0.0,0.0,0.0,4.0,12.0,24,5,19,3.0,1.0,2.0
9607315,18,4,14,31,14,4,6,286,8.0,2.0,6.0,7.0,8.0,0.0,0.0,21,18,3,6.0,5.0,1.0
9904320,15,8,7,12,3,12,54,14,2.0,1.0,1.0,1.0,0.0,2.0,3.0,32,15,17,3.0,2.0,1.0
9610238,12,3,9,19,1,11,74,14,7.0,1.0,6.0,13.0,0.0,7.0,46.0,46,12,34,4.0,3.0,1.0
5320,1,1,0,0,0,1,9,14,0.0,0.0,0.0,0.0,0.0,0.0,0.0,15,1,14,3.0,0.0,3.0
9802432,25,3,22,83,2,23,70,68,17.0,1.0,16.0,65.0,0.0,17.0,40.0,34,25,9,18.0,15.0,3.0
9409416,13,3,10,23,5,8,23,14,10.0,2.0,8.0,20.0,4.0,6.0,14.0,26,13,13,7.0,7.0,0.0
9511397,146,22,124,811,30,116,243,13,71.0,6.0,65.0,471.0,4.0,67.0,165.0,152,146,6,28.0,24.0,4.0
9606323,22,5,17,47,3,19,27,10,10.0,1.0,9.0,19.0,1.0,9.0,14.0,25,22,3,7.0,5.0,2.0
9705250,25,14,11,22,5,20,41,77,6.0,1.0,5.0,11.0,6.0,0.0,0.0,38,25,13,4.0,3.0,1.0
4176,13,3,10,19,0,13,87,45,12.0,2.0,10.0,19.0,0.0,12.0,73.0,38,13,25,17.0,7.0,10.0
9706270,40,7,33,91,2,38,191,17,29.0,4.0,25.0,75.0,0.0,29.0,167.0,56,40,16,11.0,8.0,3.0
9512370,19,5,14,36,3,16,21,244,9.0,4.0,5.0,8.0,2.0,7.0,8.0,25,19,6,7.0,6.0,1.0
9410279,16,7,9,14,16,0,0,115,6.0,3.0,3.0,4.0,6.0,0.0,0.0,16,16,0,4.0,4.0,0.0
9402330,1,1,0,0,1,0,0,1223,,,,,,,,1,1,0,,,
9610334,23,7,16,57,3,20,93,16,12.0,5.0,7.0,23.0,2.0,10.0,58.0,38,23,15,16.0,8.0,8.0
9707420,2,2,0,0,1,1,21,36,1.0,1.0,0.0,0.0,0.0,1.0,6.0,50,2,48,8.0,1.0,7.0
9605436,10,3,7,19,0,10,30,13,10.0,3.0,7.0,19.0,0.0,10.0,30.0,15,10,5,11.0,8.0,3.0
9609351,4,4,0,0,0,4,15,39,2.0,2.0,0.0,0.0,0.0,2.0,7.0,16,4,12,2.0,1.0,1.0
9805228,19,5,14,43,14,5,7,97,15.0,3.0,12.0,36.0,15.0,0.0,0.0,22,19,3,7.0,7.0,0.0
9707532,58,6,52,323,7,51,293,8,45.0,2.0,43.0,293.0,3.0,42.0,264.0,69,58,11,47.0,37.0,10.0
9303282,4,2,2,2,1,3,9,15,0.0,0.0,0.0,0.0,0.0,0.0,0.0,11,4,7,2.0,0.0,2.0
9411217,36,2,34,144,9,27,51,108,30.0,1.0,29.0,122.0,7.0,23.0,40.0,45,36,9,24.0,22.0,2.0
9601338,7,3,4,6,4,3,8,36,5.0,1.0,4.0,6.0,2.0,3.0,8.0,11,7,4,3.0,0.0,3.0
9408340,14,5,9,20,7,7,8,47,5.0,4.0,1.0,1.0,5.0,0.0,0.0,17,14,3,3.0,3.0,0.0
9609286,7,4,3,4,1,6,20,10,3.0,1.0,2.0,3.0,3.0,0.0,0.0,22,7,15,1.0,0.0,1.0
9356,34,5,29,104,8,26,47,0,15.0,1.0,14.0,58.0,0.0,15.0,30.0,40,34,6,16.0,14.0,2.0
9911481,18,5,13,21,0,18,168,3,15.0,5.0,10.0,17.0,0.0,15.0,156.0,37,18,19,13.0,4.0,9.0
9910246,11,8,3,3,4,7,31,0,4.0,3.0,1.0,1.0,1.0,3.0,7.0,46,11,35,10.0,0.0,10.0
9301213,9,6,3,6,2,7,10,50,3.0,1.0,2.0,3.0,1.0,2.0,3.0,11,9,2,1.0,1.0,0.0
9403223,28,3,25,103,21,7,10,100,19.0,1.0,18.0,86.0,19.0,0.0,0.0,30,28,2,17.0,17.0,0.0
9804376,8,1,7,19,0,8,24,52,8.0,1.0,7.0,19.0,0.0,8.0,24.0,11,8,3,11.0,8.0,3.0
9510393,22,7,15,59,0,22,93,71,16.0,4.0,12.0,47.0,0.0,16.0,82.0,30,22,8,23.0,15.0,8.0
9702237,22,1,21,63,20,2,2,60,13.0,1.0,12.0,36.0,13.0,0.0,0.0,24,22,2,11.0,11.0,0.0
10237,15,4,11,19,5,10,36,74,2.0,1.0,1.0,1.0,0.0,2.0,8.0,33,15,18,11.0,3.0,8.0
112059,11,3,8,27,11,0,0,146,11.0,3.0,8.0,27.0,11.0,0.0,0.0,11,11,0,10.0,10.0,0.0
9812353,2,1,1,1,0,2,4,120,2.0,1.0,1.0,1.0,0.0,2.0,4.0,8,2,6,4.0,2.0,2.0
8110,5,1,4,9,0,5,13,376,3.0,1.0,2.0,3.0,0.0,3.0,7.0,11,5,6,7.0,4.0,3.0
9805484,12,9,3,3,1,11,136,8,6.0,5.0,1.0,1.0,0.0,6.0,107.0,51,12,39,22.0,4.0,18.0
9511266,24,7,17,30,11,13,62,75,4.0,2.0,2.0,4.0,0.0,4.0,7.0,55,24,31,8.0,3.0,5.0
9803493,25,9,16,45,10,15,30,25,4.0,1.0,3.0,6.0,0.0,4.0,15.0,33,25,8,9.0,3.0,6.0
101086,15,2,13,33,0,15,141,92,8.0,3.0,5.0,9.0,0.0,8.0,47.0,55,15,40,18.0,8.0,10.0
103049,29,6,23,70,4,25,81,21,19.0,2.0,17.0,55.0,0.0,19.0,54.0,40,29,11,19.0,14.0,5.0
9903462,16,1,15,54,0,16,101,22,15.0,1.0,14.0,51.0,0.0,15.0,98.0,26,16,10,23.0,13.0,10.0
9206232,8,4,4,6,8,0,0,103,1.0,1.0,0.0,0.0,1.0,0.0,0.0,8,8,0,3.0,3.0,0.0
9707351,22,3,19,61,1,21,106,22,16.0,2.0,14.0,40.0,0.0,16.0,84.0,33,22,11,17.0,8.0,9.0
9507220,8,1,7,20,2,6,14,49,7.0,1.0,6.0,17.0,1.0,6.0,12.0,19,8,11,10.0,7.0,3.0
103137,8,5,3,5,0,8,36,14,6.0,3.0,3.0,4.0,0.0,6.0,27.0,20,8,12,10.0,5.0,5.0
9911413,11,3,8,11,3,8,16,44,5.0,2.0,3.0,3.0,0.0,5.0,12.0,19,11,8,9.0,4.0,5.0
9903432,8,1,7,15,0,8,14,56,7.0,1.0,6.0,12.0,0.0,7.0,13.0,20,8,12,4.0,4.0,0.0
9909214,11,5,6,16,1,10,42,30,5.0,2.0,3.0,8.0,0.0,5.0,13.0,20,11,9,8.0,5.0,3.0
9902273,26,6,20,126,0,26,263,2,21.0,2.0,19.0,125.0,0.0,21.0,241.0,54,26,28,33.0,20.0,13.0
9403235,14,8,6,8,14,0,0,58,5.0,3.0,2.0,3.0,5.0,0.0,0.0,14,14,0,2.0,2.0,0.0
7304,22,13,9,15,6,16,146,26,8.0,3.0,5.0,9.0,0.0,8.0,108.0,58,22,36,18.0,8.0,10.0
9811289,7,3,4,7,4,3,9,96,2.0,2.0,0.0,0.0,0.0,2.0,3.0,13,7,6,3.0,2.0,1.0
101264,8,6,2,2,1,7,20,13,1.0,1.0,0.0,0.0,0.0,1.0,8.0,31,8,23,11.0,1.0,10.0
105283,17,10,7,12,7,10,32,23,1.0,1.0,0.0,0.0,0.0,1.0,4.0,35,17,18,7.0,0.0,7.0
9603337,14,3,11,25,9,5,7,275,0.0,0.0,0.0,0.0,0.0,0.0,0.0,31,14,17,5.0,4.0,1.0
9607336,11,4,7,25,1,10,23,150,6.0,2.0,4.0,11.0,0.0,6.0,11.0,15,11,4,9.0,6.0,3.0
9806241,9,5,4,6,2,7,14,64,7.0,3.0,4.0,6.0,0.0,7.0,12.0,16,9,7,8.0,6.0,2.0
102316,9,2,7,18,1,8,40,7,1.0,1.0,0.0,0.0,0.0,1.0,2.0,21,9,12,6.0,1.0,5.0
9409201,8,4,4,7,2,6,9,206,6.0,2.0,4.0,7.0,0.0,6.0,6.0,15,8,7,5.0,4.0,1.0
9703338,27,1,26,157,0,27,130,36,27.0,1.0,26.0,157.0,0.0,27.0,129.0,37,27,10,30.0,25.0,5.0
206310,11,4,7,15,2,9,55,55,4.0,2.0,2.0,2.0,0.0,4.0,26.0,37,11,26,4.0,4.0,0.0
9904334,9,2,7,14,2,7,21,36,8.0,2.0,6.0,13.0,7.0,1.0,1.0,16,9,7,8.0,6.0,2.0
9306224,12,4,8,12,12,0,0,13,4.0,4.0,0.0,0.0,4.0,0.0,0.0,12,12,0,2.0,2.0,0.0
108017,10,1,9,16,1,9,37,25,2.0,1.0,1.0,1.0,0.0,2.0,14.0,27,10,17,8.0,1.0,7.0
9711257,5,3,2,2,1,4,22,6,0.0,0.0,0.0,0.0,0.0,0.0,0.0,22,5,17,5.0,2.0,3.0
9903509,17,7,10,22,2,15,27,373,7.0,4.0,3.0,6.0,7.0,0.0,0.0,20,17,3,6.0,6.0,0.0
9706388,2,1,1,1,0,2,5,30,0.0,0.0,0.0,0.0,0.0,0.0,0.0,10,2,8,3.0,0.0,3.0
9912515,12,4,8,20,0,12,35,21,8.0,4.0,4.0,10.0,8.0,0.0,0.0,21,12,9,9.0,7.0,2.0
9508344,7,3,4,5,2,5,5,50,2.0,1.0,1.0,1.0,2.0,0.0,0.0,8,7,1,4.0,3.0,1.0
9703235,5,5,0,0,0,5,23,81,3.0,3.0,0.0,0.0,0.0,3.0,17.0,13,5,8,1.0,1.0,0.0
9608230,1,1,0,0,0,1,5,5,1.0,1.0,0.0,0.0,0.0,1.0,4.0,17,1,16,2.0,0.0,2.0
9704412,71,3,68,390,23,48,69,1,40.0,1.0,39.0,226.0,13.0,27.0,27.0,85,71,14,27.0,26.0,1.0
9606217,21,3,18,51,2,19,57,1,7.0,3.0,4.0,5.0,0.0,7.0,10.0,31,21,10,8.0,7.0,1.0
9606454,14,10,4,7,14,0,0,80,3.0,1.0,2.0,2.0,3.0,0.0,0.0,14,14,0,2.0,2.0,0.0
108228,0,0,0,0,0,0,0,232,0.0,0.0,0.0,0.0,0.0,0.0,0.0,2,0,2,1.0,0.0,1.0
9505203,17,5,12,39,5,12,16,43,2.0,1.0,1.0,1.0,2.0,0.0,0.0,19,17,2,5.0,4.0,1.0
9610317,3,2,1,1,1,2,2,207,0.0,0.0,0.0,0.0,0.0,0.0,0.0,7,3,4,1.0,1.0,0.0
9410201,2,2,0,0,1,1,2,63,1.0,1.0,0.0,0.0,0.0,1.0,2.0,7,2,5,6.0,1.0,5.0
207191,7,6,1,2,4,3,5,257,2.0,2.0,0.0,0.0,1.0,1.0,1.0,24,7,17,2.0,0.0,2.0
9910339,3,3,0,0,1,2,11,25,0.0,0.0,0.0,0.0,0.0,0.0,0.0,12,3,9,2.0,0.0,2.0
9902375,36,16,20,45,19,17,49,9,12.0,1.0,11.0,33.0,1.0,11.0,19.0,44,36,8,13.0,12.0,1.0
9903326,11,5,6,10,0,11,38,78,5.0,2.0,3.0,4.0,0.0,5.0,14.0,23,11,12,5.0,3.0,2.0
9601326,19,4,15,27,2,17,47,61,11.0,3.0,8.0,10.0,0.0,11.0,21.0,30,19,11,9.0,5.0,4.0
9705258,31,6,25,103,6,25,41,47,20.0,4.0,16.0,85.0,5.0,15.0,26.0,38,31,7,21.0,18.0,3.0
9412294,20,6,14,30,11,9,14,281,11.0,2.0,9.0,15.0,7.0,4.0,6.0,23,20,3,7.0,6.0,1.0
109064,21,3,18,51,1,20,104,22,16.0,2.0,14.0,44.0,0.0,16.0,66.0,43,21,22,18.0,12.0,6.0
9404325,12,7,5,6,7,5,6,88,4.0,1.0,3.0,3.0,3.0,1.0,1.0,14,12,2,4.0,4.0,0.0
9411243,10,10,0,0,4,6,6,190,3.0,3.0,0.0,0.0,2.0,1.0,1.0,15,10,5,2.0,1.0,1.0
4085,37,5,32,128,1,36,273,0,28.0,4.0,24.0,110.0,0.0,28.0,234.0,54,37,17,31.0,17.0,14.0
9902440,18,10,8,14,1,17,89,14,14.0,8.0,6.0,10.0,1.0,13.0,46.0,39,18,21,17.0,8.0,9.0
9601213,4,3,1,1,1,3,3,1381,2.0,2.0,0.0,0.0,1.0,1.0,1.0,7,4,3,1.0,1.0,0.0
9508284,1,1,0,0,1,0,0,126,1.0,1.0,0.0,0.0,1.0,0.0,0.0,1,1,0,1.0,1.0,0.0
9502358,3,3,0,0,3,0,0,221,2.0,2.0,0.0,0.0,2.0,0.0,0.0,5,3,2,1.0,1.0,0.0
9306210,7,6,1,1,7,0,0,22,1.0,1.0,0.0,0.0,1.0,0.0,0.0,7,7,0,2.0,2.0,0.0
105159,21,5,16,45,0,21,95,0,2.0,2.0,0.0,0.0,0.0,2.0,23.0,61,21,40,22.0,1.0,21.0
10198,12,6,6,13,1,11,160,11,8.0,5.0,3.0,6.0,0.0,8.0,119.0,63,12,51,27.0,4.0,23.0
9908357,4,2,2,3,0,4,14,0,3.0,1.0,2.0,3.0,0.0,3.0,5.0,37,4,33,2.0,0.0,2.0
9911394,5,4,1,1,1,4,16,122,3.0,3.0,0.0,0.0,0.0,3.0,11.0,11,5,6,7.0,3.0,4.0
9511471,3,3,0,0,2,1,1,38,1.0,1.0,0.0,0.0,0.0,1.0,1.0,6,3,3,1.0,1.0,0.0
9905275,5,1,4,9,0,5,62,3,4.0,1.0,3.0,6.0,0.0,4.0,32.0,27,5,22,12.0,4.0,8.0
9510409,2,2,0,0,1,1,2,270,1.0,1.0,0.0,0.0,0.0,1.0,2.0,8,2,6,4.0,1.0,3.0
9708498,6,4,2,3,1,5,15,83,4.0,3.0,1.0,2.0,2.0,2.0,4.0,13,6,7,5.0,3.0,2.0
102270,17,5,12,25,0,17,142,18,6.0,1.0,5.0,9.0,0.0,6.0,43.0,51,17,34,14.0,7.0,7.0
9411204,9,4,5,6,6,3,17,53,3.0,2.0,1.0,1.0,1.0,2.0,15.0,18,9,9,1.0,1.0,0.0
8005,7,6,1,1,0,7,69,9,4.0,4.0,0.0,0.0,0.0,4.0,53.0,36,7,29,24.0,4.0,20.0
9502238,22,10,12,22,12,10,13,74,10.0,5.0,5.0,13.0,2.0,8.0,11.0,24,22,2,8.0,7.0,1.0
9509209,3,3,0,0,3,0,0,204,2.0,2.0,0.0,0.0,2.0,0.0,0.0,8,3,5,2.0,2.0,0.0
102027,2,2,0,0,0,2,7,26,0.0,0.0,0.0,0.0,0.0,0.0,0.0,14,2,12,4.0,0.0,4.0
9510347,10,7,3,3,8,2,2,94,1.0,1.0,0.0,0.0,0.0,1.0,1.0,14,10,4,2.0,1.0,1.0
9909398,2,1,1,1,2,0,0,296,1.0,1.0,0.0,0.0,1.0,0.0,0.0,5,2,3,2.0,2.0,0.0
9501290,2,1,1,1,0,2,6,44,1.0,1.0,0.0,0.0,1.0,0.0,0.0,8,2,6,4.0,2.0,2.0
205082,4,3,1,1,0,4,13,87,3.0,2.0,1.0,1.0,0.0,3.0,4.0,19,4,15,6.0,1.0,5.0
105057,7,5,2,2,0,7,36,12,3.0,2.0,1.0,1.0,0.0,3.0,6.0,34,7,27,4.0,2.0,2.0
1087,16,6,10,20,0,16,256,15,13.0,4.0,9.0,18.0,0.0,13.0,232.0,49,16,33,31.0,8.0,23.0
109062,11,5,6,8,0,11,94,30,4.0,2.0,2.0,3.0,0.0,4.0,25.0,44,11,33,12.0,5.0,7.0
9606287,15,5,10,24,4,11,11,140,8.0,2.0,6.0,11.0,2.0,6.0,6.0,16,15,1,8.0,7.0,1.0
9609314,12,4,8,18,2,10,56,169,3.0,1.0,2.0,3.0,0.0,3.0,11.0,38,12,26,10.0,5.0,5.0
9412283,42,2,40,163,13,29,41,27,32.0,1.0,31.0,141.0,8.0,24.0,36.0,45,42,3,18.0,17.0,1.0
1196,15,5,10,31,0,15,69,27,13.0,3.0,10.0,28.0,0.0,13.0,54.0,27,15,12,9.0,7.0,2.0
9606291,1,1,0,0,1,0,0,2085,,,,,,,,4,1,3,2.0,0.0,2.0
109172,24,6,18,45,1,23,136,0,12.0,2.0,10.0,21.0,0.0,12.0,90.0,55,24,31,18.0,9.0,9.0
9812432,2,2,0,0,1,1,5,799,1.0,1.0,0.0,0.0,1.0,0.0,0.0,8,2,6,1.0,1.0,0.0
202239,21,5,16,47,1,20,203,46,17.0,4.0,13.0,37.0,1.0,16.0,145.0,56,21,35,21.0,9.0,12.0
9903428,15,5,10,28,0,15,53,3,8.0,4.0,4.0,11.0,2.0,6.0,9.0,29,15,14,9.0,7.0,2.0
9909510,5,5,0,0,0,5,10,118,1.0,1.0,0.0,0.0,0.0,1.0,3.0,13,5,8,2.0,1.0,1.0
108094,15,10,5,10,0,15,109,37,7.0,4.0,3.0,7.0,1.0,6.0,69.0,42,15,27,24.0,6.0,18.0
204071,7,2,5,6,0,7,36,32,3.0,2.0,1.0,1.0,0.0,3.0,21.0,36,7,29,3.0,0.0,3.0
205332,7,1,6,10,0,7,58,47,7.0,1.0,6.0,10.0,0.0,7.0,57.0,21,7,14,18.0,7.0,11.0
9602420,2,2,0,0,1,1,2,47,1.0,1.0,0.0,0.0,1.0,0.0,0.0,5,2,3,2.0,1.0,1.0
107264,16,5,11,34,0,16,128,0,2.0,2.0,0.0,0.0,0.0,2.0,21.0,60,16,44,10.0,7.0,3.0
202143,10,3,7,23,0,10,26,107,10.0,3.0,7.0,23.0,0.0,10.0,19.0,16,10,6,11.0,9.0,2.0
9812290,6,5,1,1,1,5,38,5,2.0,2.0,0.0,0.0,0.0,2.0,14.0,31,6,25,10.0,1.0,9.0
9503230,10,10,0,0,4,6,9,35,1.0,1.0,0.0,0.0,1.0,0.0,0.0,34,10,24,4.0,0.0,4.0
9807492,8,5,3,4,0,8,21,17,3.0,1.0,2.0,3.0,0.0,3.0,3.0,17,8,9,4.0,3.0,1.0
102010,22,3,19,58,4,18,57,2,14.0,2.0,12.0,43.0,1.0,13.0,22.0,30,22,8,13.0,11.0,2.0
9605422,8,2,6,9,2,6,9,100,0.0,0.0,0.0,0.0,0.0,0.0,0.0,10,8,2,2.0,0.0,2.0
9709381,0,0,0,0,0,0,0,755,0.0,0.0,0.0,0.0,0.0,0.0,0.0,7,0,7,,,
9506231,1,1,0,0,0,1,2,126,0.0,0.0,0.0,0.0,0.0,0.0,0.0,3,1,2,1.0,0.0,1.0
110325,36,11,25,77,1,35,586,11,24.0,4.0,20.0,71.0,0.0,24.0,459.0,94,36,58,52.0,19.0,33.0
9512427,37,3,34,93,5,32,89,115,23.0,2.0,21.0,53.0,0.0,23.0,64.0,45,37,8,19.0,17.0,2.0
9411382,11,1,10,19,9,2,2,13,9.0,1.0,8.0,17.0,9.0,0.0,0.0,12,11,1,5.0,4.0,1.0
9705471,5,4,1,1,0,5,23,4,2.0,2.0,0.0,0.0,0.0,2.0,10.0,19,5,14,2.0,0.0,2.0
9504366,1,1,0,0,1,0,0,141,,,,,,,,2,1,1,,,
9411236,2,2,0,0,2,0,0,72,1.0,1.0,0.0,0.0,1.0,0.0,0.0,3,2,1,1.0,1.0,0.0
9808295,3,1,2,2,0,3,5,96,2.0,1.0,1.0,1.0,0.0,2.0,2.0,5,3,2,3.0,3.0,0.0
9701334,6,2,4,5,2,4,6,135,3.0,1.0,2.0,3.0,3.0,0.0,0.0,20,6,14,2.0,1.0,1.0
9812340,4,3,1,1,2,2,9,62,1.0,1.0,0.0,0.0,0.0,1.0,7.0,14,4,10,9.0,1.0,8.0
9804211,36,8,28,91,18,18,56,102,16.0,1.0,15.0,53.0,6.0,10.0,25.0,42,36,6,16.0,13.0,3.0
9812412,7,1,6,20,0,7,42,102,7.0,1.0,6.0,20.0,0.0,7.0,39.0,20,7,13,15.0,7.0,8.0
9608274,3,3,0,0,1,2,2,41,2.0,2.0,0.0,0.0,0.0,2.0,2.0,7,3,4,7.0,3.0,4.0
9807488,16,6,10,18,1,15,54,115,10.0,4.0,6.0,12.0,0.0,10.0,41.0,28,16,12,11.0,3.0,8.0
9601209,5,4,1,1,4,1,1,320,2.0,1.0,1.0,1.0,2.0,0.0,0.0,11,5,6,4.0,1.0,3.0
9805508,3,2,1,1,0,3,7,2097,2.0,1.0,1.0,1.0,2.0,0.0,0.0,9,3,6,1.0,0.0,1.0
9603313,13,5,8,22,3,10,30,25,9.0,3.0,6.0,20.0,0.0,9.0,28.0,19,13,6,10.0,7.0,3.0
9805510,7,5,2,2,6,1,1,128,2.0,2.0,0.0,0.0,2.0,0.0,0.0,9,7,2,2.0,2.0,0.0
102097,13,1,12,42,0,13,115,109,13.0,1.0,12.0,42.0,0.0,13.0,105.0,28,13,15,22.0,13.0,9.0
104127,14,4,10,31,0,14,126,109,14.0,4.0,10.0,31.0,0.0,14.0,125.0,27,14,13,26.0,14.0,12.0
9712315,13,5,8,16,1,12,32,92,7.0,3.0,4.0,7.0,0.0,7.0,9.0,28,13,15,6.0,4.0,2.0
9511343,14,3,11,16,2,12,75,3,9.0,2.0,7.0,10.0,0.0,9.0,40.0,37,14,23,11.0,7.0,4.0
112014,5,3,2,2,0,5,11,28,4.0,2.0,2.0,2.0,0.0,4.0,10.0,9,5,4,7.0,4.0,3.0
9701328,12,4,8,13,3,9,56,17,4.0,1.0,3.0,6.0,0.0,4.0,30.0,43,12,31,4.0,1.0,3.0
9907485,3,2,1,1,0,3,51,0,2.0,1.0,1.0,1.0,0.0,2.0,46.0,38,3,35,33.0,2.0,31.0
4030,2,2,0,0,2,0,0,30,0.0,0.0,0.0,0.0,0.0,0.0,0.0,15,2,13,2.0,0.0,2.0
9709319,8,2,6,10,0,8,107,36,5.0,2.0,3.0,5.0,0.0,5.0,73.0,42,8,34,26.0,4.0,22.0
9605228,2,2,0,0,1,1,1,1729,1.0,1.0,0.0,0.0,1.0,0.0,0.0,4,2,2,1.0,1.0,0.0
9510415,16,3,13,33,9,7,14,194,12.0,2.0,10.0,23.0,12.0,0.0,0.0,22,16,6,7.0,7.0,0.0
9807309,4,4,0,0,0,4,11,107,1.0,1.0,0.0,0.0,1.0,0.0,0.0,12,4,8,,,
9812336,16,4,12,28,4,12,13,127,9.0,3.0,6.0,11.0,5.0,4.0,5.0,20,16,4,5.0,3.0,2.0
9409221,9,6,3,7,2,7,19,179,6.0,3.0,3.0,7.0,1.0,5.0,11.0,17,9,8,6.0,4.0,2.0
9904272,9,3,6,7,0,9,55,2,5.0,2.0,3.0,3.0,0.0,5.0,44.0,24,9,15,4.0,4.0,0.0
9803343,17,9,8,15,0,17,78,7,3.0,1.0,2.0,2.0,0.0,3.0,14.0,42,17,25,11.0,3.0,8.0
2204,12,5,7,11,3,9,19,8,5.0,2.0,3.0,6.0,2.0,3.0,3.0,19,12,7,1.0,1.0,0.0
3315,2,1,1,1,0,2,2,121,0.0,0.0,0.0,0.0,0.0,0.0,0.0,8,2,6,5.0,0.0,5.0
9705223,13,5,8,18,0,13,49,85,8.0,2.0,6.0,13.0,0.0,8.0,21.0,19,13,6,9.0,4.0,5.0
105273,8,3,5,7,3,5,13,24,5.0,3.0,2.0,2.0,2.0,3.0,3.0,19,8,11,5.0,4.0,1.0
10100,8,6,2,3,0,8,33,177,7.0,5.0,2.0,3.0,0.0,7.0,29.0,18,8,10,10.0,5.0,5.0
210219,1,1,0,0,0,1,2,154,0.0,0.0,0.0,0.0,0.0,0.0,0.0,6,1,5,1.0,0.0,1.0
4078,4,3,1,1,4,0,0,213,1.0,1.0,0.0,0.0,1.0,0.0,0.0,14,4,10,3.0,0.0,3.0
9406338,8,4,4,7,2,6,16,124,5.0,2.0,3.0,6.0,0.0,5.0,8.0,18,8,10,3.0,2.0,1.0
9901439,10,3,7,11,0,10,29,110,8.0,2.0,6.0,10.0,0.0,8.0,16.0,20,10,10,12.0,8.0,4.0
9712318,32,14,18,34,15,17,39,85,12.0,3.0,9.0,20.0,6.0,6.0,16.0,49,32,17,10.0,7.0,3.0
2166,17,7,10,26,2,15,152,8,6.0,3.0,3.0,9.0,0.0,6.0,53.0,45,17,28,16.0,7.0,9.0
9710345,1,1,0,0,0,1,4,14,0.0,0.0,0.0,0.0,0.0,0.0,0.0,12,1,11,1.0,0.0,1.0
108061,4,2,2,2,0,4,23,9,4.0,2.0,2.0,2.0,0.0,4.0,11.0,21,4,17,7.0,3.0,4.0
9909374,3,1,2,2,0,3,9,8,3.0,1.0,2.0,2.0,0.0,3.0,7.0,10,3,7,8.0,3.0,5.0
9512311,6,4,2,2,3,3,3,41,6.0,4.0,2.0,2.0,3.0,3.0,3.0,11,6,5,8.0,6.0,2.0
9605426,2,2,0,0,2,0,0,2013,,,,,,,,2,2,0,1.0,1.0,0.0
9411314,10,9,1,1,3,7,19,62,4.0,4.0,0.0,0.0,0.0,4.0,16.0,23,10,13,9.0,2.0,7.0
9801417,9,7,2,2,4,5,25,5,0.0,0.0,0.0,0.0,0.0,0.0,0.0,105,9,96,20.0,0.0,20.0
9709274,17,10,7,13,2,15,31,31,9.0,6.0,3.0,7.0,0.0,9.0,24.0,22,17,5,8.0,7.0,1.0
9904481,9,6,3,3,3,6,9,18,1.0,1.0,0.0,0.0,0.0,1.0,2.0,16,9,7,2.0,2.0,0.0
9909477,16,1,15,64,0,16,108,46,14.0,1.0,13.0,60.0,0.0,14.0,84.0,49,16,33,21.0,14.0,7.0
207054,0,0,0,0,0,0,0,14,0.0,0.0,0.0,0.0,0.0,0.0,0.0,9,0,9,6.0,0.0,6.0
109114,1,1,0,0,1,0,0,52,0.0,0.0,0.0,0.0,0.0,0.0,0.0,5,1,4,3.0,0.0,3.0
9609329,7,3,4,5,1,6,14,14,3.0,2.0,1.0,1.0,0.0,3.0,6.0,13,7,6,2.0,2.0,0.0
9802266,1,1,0,0,1,0,0,413,0.0,0.0,0.0,0.0,0.0,0.0,0.0,4,1,3,3.0,0.0,3.0
6165,2,2,0,0,0,2,11,143,1.0,1.0,0.0,0.0,0.0,1.0,6.0,14,2,12,7.0,1.0,6.0
9811334,16,1,15,32,0,16,79,4,8.0,1.0,7.0,18.0,0.0,8.0,27.0,57,16,41,11.0,8.0,3.0
10325,24,13,11,17,1,23,254,12,11.0,5.0,6.0,9.0,0.0,11.0,181.0,80,24,56,24.0,5.0,19.0
8196,5,4,1,1,0,5,26,56,4.0,3.0,1.0,1.0,0.0,4.0,24.0,19,5,14,2.0,0.0,2.0
9803362,11,10,1,1,5,6,13,164,0.0,0.0,0.0,0.0,0.0,0.0,0.0,22,11,11,9.0,0.0,9.0
9607245,28,8,20,58,4,24,37,13,21.0,6.0,15.0,45.0,1.0,20.0,33.0,31,28,3,14.0,12.0,2.0
205289,9,7,2,4,0,9,71,193,9.0,7.0,2.0,4.0,0.0,9.0,61.0,25,9,16,18.0,9.0,9.0
9910273,2,1,1,1,0,2,8,184,2.0,1.0,1.0,1.0,0.0,2.0,7.0,9,2,7,6.0,2.0,4.0
9808480,4,3,1,2,1,3,25,38,3.0,2.0,1.0,2.0,0.0,3.0,25.0,18,4,14,13.0,3.0,10.0
9805321,1,1,0,0,0,1,1,202,,,,,,,,3,1,2,,,
9509231,6,4,2,2,2,4,8,67,4.0,2.0,2.0,2.0,1.0,3.0,4.0,14,6,8,4.0,3.0,1.0
9412218,1,1,0,0,1,0,0,87,1.0,1.0,0.0,0.0,1.0,0.0,0.0,4,1,3,,,
9306285,6,1,5,10,3,3,3,284,6.0,1.0,5.0,10.0,3.0,3.0,3.0,7,6,1,7.0,6.0,1.0
102278,9,5,4,7,0,9,53,27,7.0,4.0,3.0,4.0,0.0,7.0,49.0,26,9,17,8.0,3.0,5.0
111157,8,4,4,5,0,8,135,8,7.0,3.0,4.0,5.0,0.0,7.0,109.0,47,8,39,35.0,3.0,32.0
9707536,9,1,8,16,0,9,52,158,8.0,1.0,7.0,15.0,0.0,8.0,43.0,22,9,13,16.0,8.0,8.0
9801394,9,6,3,5,3,6,8,308,5.0,2.0,3.0,5.0,0.0,5.0,7.0,13,9,4,4.0,2.0,2.0
9811311,10,4,6,15,2,8,9,103,6.0,1.0,5.0,14.0,2.0,4.0,4.0,13,10,3,7.0,6.0,1.0
10208,19,8,11,20,3,16,121,8,4.0,1.0,3.0,6.0,0.0,4.0,33.0,109,19,90,21.0,3.0,18.0
9804301,7,2,5,8,0,7,11,28,6.0,1.0,5.0,8.0,0.0,6.0,7.0,13,7,6,2.0,1.0,1.0
9911377,0,0,0,0,0,0,0,79,0.0,0.0,0.0,0.0,0.0,0.0,0.0,8,0,8,,,
9809555,6,1,5,7,0,6,25,49,5.0,1.0,4.0,6.0,0.0,5.0,14.0,15,6,9,7.0,5.0,2.0
108164,1,1,0,0,0,1,1,152,0.0,0.0,0.0,0.0,0.0,0.0,0.0,12,1,11,7.0,0.0,7.0
9810515,5,2,3,3,1,4,20,196,0.0,0.0,0.0,0.0,0.0,0.0,0.0,19,5,14,6.0,3.0,3.0
107239,6,2,4,6,1,5,40,42,0.0,0.0,0.0,0.0,0.0,0.0,0.0,33,6,27,9.0,0.0,9.0
109080,2,1,1,1,1,1,10,73,1.0,1.0,0.0,0.0,0.0,1.0,10.0,15,2,13,3.0,1.0,2.0
9909467,10,1,9,21,2,8,31,21,4.0,1.0,3.0,5.0,2.0,2.0,3.0,22,10,12,1.0,1.0,0.0
9807272,2,1,1,1,1,1,1,153,2.0,1.0,1.0,1.0,1.0,1.0,1.0,3,2,1,2.0,2.0,0.0
9804464,4,4,0,0,2,2,2,141,1.0,1.0,0.0,0.0,0.0,1.0,1.0,5,4,1,3.0,2.0,1.0
9607377,18,9,9,11,14,4,4,106,5.0,2.0,3.0,5.0,5.0,0.0,0.0,22,18,4,3.0,2.0,1.0
9304239,9,3,6,10,9,0,0,163,5.0,2.0,3.0,5.0,5.0,0.0,0.0,9,9,0,3.0,3.0,0.0
12194,4,2,2,3,0,4,27,50,4.0,2.0,2.0,3.0,0.0,4.0,26.0,15,4,11,13.0,4.0,9.0
9712284,11,5,6,17,1,10,30,50,2.0,1.0,1.0,1.0,0.0,2.0,8.0,20,11,9,8.0,2.0,6.0
205281,12,7,5,8,3,9,37,4,5.0,4.0,1.0,1.0,1.0,4.0,14.0,27,12,15,4.0,1.0,3.0
1329,4,4,0,0,1,3,7,68,1.0,1.0,0.0,0.0,0.0,1.0,2.0,11,4,7,1.0,0.0,1.0
9806381,14,8,6,7,6,8,11,53,4.0,4.0,0.0,0.0,4.0,0.0,0.0,17,14,3,7.0,6.0,1.0
9908377,4,2,2,2,0,4,11,13,1.0,1.0,0.0,0.0,1.0,0.0,0.0,8,4,4,1.0,1.0,0.0
9605201,8,5,3,4,1,7,69,6,3.0,3.0,0.0,0.0,0.0,3.0,34.0,31,8,23,10.0,4.0,6.0
9809417,5,5,0,0,3,2,3,67,2.0,2.0,0.0,0.0,0.0,2.0,3.0,12,5,7,3.0,2.0,1.0
9712339,19,6,13,29,10,9,22,209,9.0,2.0,7.0,21.0,9.0,0.0,0.0,24,19,5,7.0,7.0,0.0
12034,0,0,0,0,0,0,0,183,0.0,0.0,0.0,0.0,0.0,0.0,0.0,10,0,10,7.0,0.0,7.0
103002,9,4,5,10,1,8,47,6,7.0,2.0,5.0,9.0,1.0,6.0,15.0,30,9,21,15.0,6.0,9.0
9508330,2,1,1,1,0,2,3,15,1.0,1.0,0.0,0.0,1.0,0.0,0.0,6,2,4,1.0,0.0,1.0
9306215,3,2,1,1,3,0,0,355,1.0,1.0,0.0,0.0,1.0,0.0,0.0,3,3,0,1.0,1.0,0.0
9402306,10,6,4,6,8,2,2,270,4.0,4.0,0.0,0.0,4.0,0.0,0.0,12,10,2,3.0,3.0,0.0
9405356,3,2,1,1,0,3,11,26,2.0,2.0,0.0,0.0,0.0,2.0,10.0,10,3,7,3.0,2.0,1.0
3064,7,2,5,6,2,5,20,48,2.0,2.0,0.0,0.0,0.0,2.0,9.0,35,7,28,5.0,0.0,5.0
9610369,14,11,3,4,4,10,28,9,7.0,6.0,1.0,1.0,7.0,0.0,0.0,20,14,6,7.0,7.0,0.0
3213,14,9,5,9,11,3,3,226,7.0,3.0,4.0,6.0,7.0,0.0,0.0,17,14,3,5.0,5.0,0.0
207334,10,7,3,5,0,10,91,12,6.0,4.0,2.0,3.0,0.0,6.0,61.0,42,10,32,23.0,3.0,20.0
9602430,1,1,0,0,1,0,0,141,1.0,1.0,0.0,0.0,1.0,0.0,0.0,8,1,7,1.0,1.0,0.0
9091,11,4,7,13,0,11,74,0,10.0,4.0,6.0,12.0,0.0,10.0,65.0,29,11,18,20.0,7.0,13.0
112297,7,3,4,5,0,7,57,0,5.0,2.0,3.0,3.0,0.0,5.0,49.0,27,7,20,19.0,3.0,16.0
101104,2,2,0,0,1,1,1,89,,,,,,,,3,2,1,1.0,1.0,0.0
4021,10,3,7,12,1,9,29,65,9.0,3.0,6.0,10.0,1.0,8.0,16.0,23,10,13,7.0,4.0,3.0
9507448,1,1,0,0,1,0,0,419,0.0,0.0,0.0,0.0,0.0,0.0,0.0,4,1,3,2.0,0.0,2.0
9905259,2,2,0,0,1,1,2,31,0.0,0.0,0.0,0.0,0.0,0.0,0.0,10,2,8,2.0,1.0,1.0
211236,1,1,0,0,0,1,4,3,0.0,0.0,0.0,0.0,0.0,0.0,0.0,43,1,42,11.0,0.0,11.0
202189,5,3,2,3,1,4,10,3,3.0,1.0,2.0,3.0,0.0,3.0,3.0,19,5,14,3.0,1.0,2.0
208062,1,1,0,0,0,1,5,56,0.0,0.0,0.0,0.0,0.0,0.0,0.0,15,1,14,2.0,0.0,2.0
9412344,10,2,8,11,6,4,5,45,5.0,2.0,3.0,3.0,5.0,0.0,0.0,14,10,4,2.0,2.0,0.0
5152,36,6,30,83,10,26,54,108,18.0,1.0,17.0,53.0,6.0,12.0,17.0,52,36,16,11.0,8.0,3.0
9701279,7,6,1,1,7,0,0,228,3.0,3.0,0.0,0.0,3.0,0.0,0.0,8,7,1,2.0,2.0,0.0
9602329,9,6,3,4,0,9,92,17,9.0,6.0,3.0,4.0,0.0,9.0,92.0,28,9,19,2.0,1.0,1.0
109268,11,8,3,3,5,6,12,31,7.0,7.0,0.0,0.0,1.0,6.0,11.0,18,11,7,6.0,3.0,3.0
206045,6,3,3,3,0,6,28,1,1.0,1.0,0.0,0.0,0.0,1.0,3.0,15,6,9,4.0,1.0,3.0
207121,1,1,0,0,1,0,0,7,0.0,0.0,0.0,0.0,0.0,0.0,0.0,28,1,27,1.0,0.0,1.0
9412228,2,2,0,0,1,1,3,29,1.0,1.0,0.0,0.0,0.0,1.0,3.0,15,2,13,5.0,1.0,4.0
3292,2,1,1,1,1,1,1,95,2.0,1.0,1.0,1.0,2.0,0.0,0.0,6,2,4,2.0,2.0,0.0
108136,9,3,6,10,4,5,23,165,5.0,2.0,3.0,5.0,0.0,5.0,20.0,19,9,10,9.0,4.0,5.0
110402,3,2,1,1,0,3,50,30,3.0,2.0,1.0,1.0,0.0,3.0,38.0,26,3,23,12.0,2.0,10.0
203204,1,1,0,0,0,1,6,76,1.0,1.0,0.0,0.0,0.0,1.0,4.0,8,1,7,6.0,1.0,5.0
9606393,5,5,0,0,0,5,18,23,2.0,2.0,0.0,0.0,0.0,2.0,13.0,19,5,14,2.0,1.0,1.0
202270,31,11,20,47,2,29,402,11,17.0,4.0,13.0,35.0,0.0,17.0,345.0,93,31,62,61.0,10.0,51.0
9601247,11,3,8,16,5,6,9,172,3.0,1.0,2.0,2.0,0.0,3.0,6.0,14,11,3,5.0,3.0,2.0
9405378,3,3,0,0,3,0,0,223,2.0,2.0,0.0,0.0,2.0,0.0,0.0,4,3,1,2.0,1.0,1.0
9805364,2,1,1,1,0,2,3,23,0.0,0.0,0.0,0.0,0.0,0.0,0.0,13,2,11,2.0,0.0,2.0
9703460,6,2,4,10,6,0,0,36,,,,,,,,6,6,0,,,
9805449,5,1,4,4,1,4,12,99,0.0,0.0,0.0,0.0,0.0,0.0,0.0,16,5,11,1.0,1.0,0.0
9610373,12,6,6,14,3,9,25,33,3.0,2.0,1.0,1.0,0.0,3.0,10.0,26,12,14,15.0,3.0,12.0
9603398,8,5,3,3,8,0,0,102,3.0,1.0,2.0,2.0,3.0,0.0,0.0,8,8,0,2.0,2.0,0.0
6063,2,1,1,1,0,2,14,174,2.0,1.0,1.0,1.0,0.0,2.0,10.0,18,2,16,10.0,2.0,8.0
5193,2,1,1,1,0,2,13,59,2.0,1.0,1.0,1.0,1.0,1.0,5.0,13,2,11,5.0,1.0,4.0
9803483,8,3,5,12,8,0,0,262,6.0,2.0,4.0,11.0,6.0,0.0,0.0,8,8,0,6.0,6.0,0.0
9706306,6,4,2,3,4,2,2,106,4.0,2.0,2.0,3.0,4.0,0.0,0.0,10,6,4,4.0,4.0,0.0
103271,12,5,7,20,0,12,53,20,9.0,2.0,7.0,20.0,0.0,9.0,49.0,24,12,12,11.0,6.0,5.0
102019,6,2,4,4,0,6,54,2,6.0,2.0,4.0,4.0,0.0,6.0,51.0,30,6,24,17.0,6.0,11.0
10124,6,3,3,4,1,5,13,73,1.0,1.0,0.0,0.0,1.0,0.0,0.0,12,6,6,,,
203243,4,2,2,2,0,4,24,23,3.0,2.0,1.0,1.0,0.0,3.0,23.0,25,4,21,15.0,2.0,13.0
9910523,6,4,2,2,2,4,16,105,2.0,1.0,1.0,1.0,0.0,2.0,7.0,13,6,7,6.0,2.0,4.0
9710205,2,2,0,0,1,1,1,47,0.0,0.0,0.0,0.0,0.0,0.0,0.0,6,2,4,3.0,0.0,3.0
9809318,3,3,0,0,2,1,2,45,0.0,0.0,0.0,0.0,0.0,0.0,0.0,11,3,8,4.0,0.0,4.0
209094,2,1,1,1,0,2,18,0,2.0,1.0,1.0,1.0,0.0,2.0,14.0,18,2,16,3.0,0.0,3.0
201152,13,7,6,11,0,13,72,181,5.0,2.0,3.0,3.0,0.0,5.0,13.0,36,13,23,11.0,6.0,5.0
11271,12,2,10,15,2,10,71,93,4.0,2.0,2.0,2.0,0.0,4.0,18.0,49,12,37,9.0,0.0,9.0
9603383,3,1,2,2,3,0,0,30,,,,,,,,7,3,4,,,
9707504,7,3,4,6,0,7,15,13,6.0,3.0,3.0,3.0,0.0,6.0,11.0,12,7,5,6.0,4.0,2.0
9806455,14,2,12,29,0,14,54,17,11.0,2.0,9.0,26.0,0.0,11.0,17.0,26,14,12,13.0,11.0,2.0
9609476,7,2,5,11,1,6,6,82,5.0,1.0,4.0,7.0,0.0,5.0,5.0,8,7,1,2.0,2.0,0.0
208113,9,1,8,16,0,9,51,25,6.0,1.0,5.0,10.0,0.0,6.0,31.0,20,9,11,11.0,5.0,6.0
9610412,4,2,2,2,1,3,4,29,1.0,1.0,0.0,0.0,1.0,0.0,0.0,8,4,4,1.0,1.0,0.0
9906403,5,3,2,2,0,5,26,34,4.0,2.0,2.0,2.0,0.0,4.0,17.0,24,5,19,7.0,0.0,7.0
9809593,1,1,0,0,0,1,3,68,1.0,1.0,0.0,0.0,0.0,1.0,3.0,9,1,8,1.0,0.0,1.0
1159,1,1,0,0,0,1,2,39,0.0,0.0,0.0,0.0,0.0,0.0,0.0,17,1,16,2.0,0.0,2.0
107136,4,2,2,3,0,4,20,118,4.0,2.0,2.0,3.0,0.0,4.0,18.0,14,4,10,4.0,2.0,2.0
101201,6,2,4,7,0,6,17,7,3.0,1.0,2.0,3.0,0.0,3.0,6.0,14,6,8,8.0,4.0,4.0
9704420,8,4,4,4,3,5,5,334,7.0,3.0,4.0,4.0,2.0,5.0,5.0,9,8,1,6.0,5.0,1.0
9507411,2,2,0,0,0,2,4,364,0.0,0.0,0.0,0.0,0.0,0.0,0.0,10,2,8,2.0,0.0,2.0
9910346,3,1,2,2,0,3,75,2,3.0,1.0,2.0,2.0,0.0,3.0,75.0,39,3,36,32.0,3.0,29.0
106229,3,2,1,1,1,2,2,39,2.0,1.0,1.0,1.0,0.0,2.0,2.0,5,3,2,4.0,2.0,2.0
9508368,10,6,4,5,0,10,22,40,10.0,6.0,4.0,5.0,0.0,10.0,20.0,14,10,4,4.0,3.0,1.0
9604205,2,1,1,1,2,0,0,13,,,,,,,,4,2,2,1.0,0.0,1.0
110217,2,2,0,0,0,2,7,2,1.0,1.0,0.0,0.0,1.0,0.0,0.0,18,2,16,2.0,1.0,1.0
9508335,2,2,0,0,0,2,19,7,1.0,1.0,0.0,0.0,0.0,1.0,1.0,35,2,33,6.0,0.0,6.0
9304320,5,2,3,3,5,0,0,241,4.0,2.0,2.0,2.0,4.0,0.0,0.0,6,5,1,5.0,4.0,1.0
9909371,4,2,2,3,1,3,12,29,1.0,1.0,0.0,0.0,0.0,1.0,5.0,12,4,8,9.0,2.0,7.0
9502249,3,3,0,0,1,2,3,85,1.0,1.0,0.0,0.0,1.0,0.0,0.0,10,3,7,4.0,1.0,3.0
9502226,3,1,2,3,3,0,0,263,3.0,1.0,2.0,3.0,3.0,0.0,0.0,5,3,2,3.0,3.0,0.0
9908411,6,5,1,2,0,6,11,11,2.0,1.0,1.0,1.0,0.0,2.0,2.0,12,6,6,4.0,2.0,2.0
9711326,3,2,1,1,0,3,31,68,2.0,1.0,1.0,1.0,0.0,2.0,10.0,27,3,24,8.0,2.0,6.0
107248,2,1,1,1,0,2,4,339,2.0,1.0,1.0,1.0,0.0,2.0,3.0,7,2,5,5.0,2.0,3.0
9032,2,2,0,0,2,0,0,327,1.0,1.0,0.0,0.0,1.0,0.0,0.0,3,2,1,,,
209093,3,2,1,1,0,3,9,46,0.0,0.0,0.0,0.0,0.0,0.0,0.0,16,3,13,2.0,0.0,2.0
9311379,5,1,4,6,1,4,4,35,3.0,3.0,0.0,0.0,1.0,2.0,2.0,6,5,1,4.0,3.0,1.0
9508235,3,3,0,0,1,2,2,1663,1.0,1.0,0.0,0.0,1.0,0.0,0.0,5,3,2,1.0,1.0,0.0
9612412,6,4,2,2,1,5,14,58,2.0,1.0,1.0,1.0,0.0,2.0,9.0,14,6,8,5.0,1.0,4.0
9502235,4,2,2,4,4,0,0,343,4.0,2.0,2.0,4.0,4.0,0.0,0.0,4,4,0,4.0,4.0,0.0
9504329,1,1,0,0,1,0,0,199,0.0,0.0,0.0,0.0,0.0,0.0,0.0,4,1,3,2.0,0.0,2.0
106350,4,2,2,3,1,3,3,215,3.0,1.0,2.0,3.0,3.0,0.0,0.0,7,4,3,3.0,3.0,0.0
9603331,8,6,2,5,3,5,6,411,4.0,2.0,2.0,5.0,0.0,4.0,4.0,10,8,2,5.0,4.0,1.0
9905348,8,4,4,9,0,8,33,44,5.0,4.0,1.0,1.0,0.0,5.0,18.0,18,8,10,14.0,7.0,7.0
9407271,4,3,1,2,3,1,5,94,0.0,0.0,0.0,0.0,0.0,0.0,0.0,9,4,5,3.0,0.0,3.0
9608327,5,2,3,5,5,0,0,149,4.0,1.0,3.0,5.0,4.0,0.0,0.0,7,5,2,4.0,4.0,0.0
9801371,3,2,1,1,3,0,0,349,3.0,2.0,1.0,1.0,3.0,0.0,0.0,4,3,1,3.0,3.0,0.0
9906246,1,1,0,0,1,0,0,52,0.0,0.0,0.0,0.0,0.0,0.0,0.0,6,1,5,1.0,1.0,0.0
103141,3,1,2,3,0,3,12,20,0.0,0.0,0.0,0.0,0.0,0.0,0.0,31,3,28,2.0,0.0,2.0
209192,3,2,1,1,1,2,22,0,1.0,1.0,0.0,0.0,0.0,1.0,9.0,33,3,30,9.0,0.0,9.0
106186,3,3,0,0,0,3,25,29,3.0,3.0,0.0,0.0,0.0,3.0,19.0,16,3,13,11.0,2.0,9.0
211204,8,4,4,11,0,8,81,4,4.0,3.0,1.0,3.0,0.0,4.0,52.0,46,8,38,8.0,5.0,3.0
9512307,9,7,2,2,4,5,9,69,3.0,3.0,0.0,0.0,3.0,0.0,0.0,17,9,8,4.0,4.0,0.0
9803339,3,2,1,1,1,2,2,137,0.0,0.0,0.0,0.0,0.0,0.0,0.0,7,3,4,4.0,0.0,4.0
9133,15,2,13,22,0,15,111,7,13.0,3.0,10.0,16.0,0.0,13.0,90.0,35,15,20,21.0,8.0,13.0
9405344,12,7,5,11,10,2,5,75,3.0,3.0,0.0,0.0,3.0,0.0,0.0,16,12,4,2.0,2.0,0.0
102001,8,3,5,13,0,8,35,82,8.0,3.0,5.0,13.0,0.0,8.0,34.0,18,8,10,10.0,6.0,4.0
9912539,3,1,2,3,0,3,13,47,2.0,1.0,1.0,1.0,0.0,2.0,9.0,10,3,7,7.0,2.0,5.0
12024,3,2,1,1,0,3,7,13,0.0,0.0,0.0,0.0,0.0,0.0,0.0,45,3,42,3.0,0.0,3.0
9809565,3,3,0,0,2,1,8,188,1.0,1.0,0.0,0.0,0.0,1.0,7.0,11,3,8,7.0,1.0,6.0
9810279,2,2,0,0,1,1,2,18,0.0,0.0,0.0,0.0,0.0,0.0,0.0,27,2,25,9.0,0.0,9.0
9905447,5,4,1,2,0,5,13,45,0.0,0.0,0.0,0.0,0.0,0.0,0.0,17,5,12,4.0,0.0,4.0
9706291,1,1,0,0,1,0,0,371,0.0,0.0,0.0,0.0,0.0,0.0,0.0,3,1,2,1.0,0.0,1.0
201006,9,5,4,6,2,7,31,31,3.0,1.0,2.0,2.0,0.0,3.0,6.0,34,9,25,5.0,1.0,4.0
9405372,4,4,0,0,4,0,0,399,3.0,3.0,0.0,0.0,3.0,0.0,0.0,4,4,0,2.0,2.0,0.0
106030,1,1,0,0,0,1,1,350,1.0,1.0,0.0,0.0,0.0,1.0,1.0,3,1,2,2.0,1.0,1.0
203214,15,2,13,33,0,15,159,0,5.0,1.0,4.0,9.0,0.0,5.0,68.0,61,15,46,24.0,5.0,19.0
208214,2,1,1,1,0,2,41,5,2.0,1.0,1.0,1.0,0.0,2.0,34.0,66,2,64,20.0,2.0,18.0
207122,3,3,0,0,1,2,5,6,1.0,1.0,0.0,0.0,0.0,1.0,2.0,15,3,12,6.0,1.0,5.0
9905545,3,3,0,0,2,1,5,39,0.0,0.0,0.0,0.0,0.0,0.0,0.0,13,3,10,7.0,0.0,7.0
9909278,5,1,4,5,0,5,24,78,4.0,1.0,3.0,4.0,0.0,4.0,19.0,23,5,18,9.0,4.0,5.0
8008,2,2,0,0,0,2,2,34,0.0,0.0,0.0,0.0,0.0,0.0,0.0,5,2,3,1.0,0.0,1.0
9706516,14,7,7,27,8,6,7,105,13.0,6.0,7.0,27.0,10.0,3.0,3.0,19,14,5,10.0,10.0,0.0
9707241,0,0,0,0,0,0,0,980,,,,,,,,1,0,1,,,
9706443,1,1,0,0,0,1,5,17,1.0,1.0,0.0,0.0,0.0,1.0,1.0,13,1,12,4.0,1.0,3.0
204227,2,1,1,1,0,2,4,88,2.0,1.0,1.0,1.0,0.0,2.0,2.0,9,2,7,4.0,2.0,2.0
9607334,2,2,0,0,0,2,6,27,0.0,0.0,0.0,0.0,0.0,0.0,0.0,10,2,8,3.0,0.0,3.0
9807474,2,2,0,0,0,2,11,13,2.0,2.0,0.0,0.0,0.0,2.0,8.0,12,2,10,7.0,2.0,5.0
203061,4,2,2,2,0,4,23,32,0.0,0.0,0.0,0.0,0.0,0.0,0.0,57,4,53,11.0,0.0,11.0
202138,3,1,2,2,0,3,19,20,3.0,1.0,2.0,2.0,0.0,3.0,19.0,18,3,15,5.0,2.0,3.0
9510381,5,4,1,1,1,4,6,117,2.0,2.0,0.0,0.0,1.0,1.0,1.0,8,5,3,2.0,1.0,1.0
9601245,1,1,0,0,0,1,2,237,1.0,1.0,0.0,0.0,0.0,1.0,1.0,4,1,3,2.0,1.0,1.0
11289,7,4,3,5,0,7,53,43,4.0,1.0,3.0,5.0,0.0,4.0,43.0,27,7,20,14.0,2.0,12.0
9702285,6,5,1,1,3,3,3,148,4.0,4.0,0.0,0.0,3.0,1.0,1.0,7,6,1,2.0,2.0,0.0
212397,3,3,0,0,0,3,20,1,1.0,1.0,0.0,0.0,0.0,1.0,6.0,47,3,44,10.0,1.0,9.0
9605358,2,2,0,0,0,2,7,39,2.0,2.0,0.0,0.0,0.0,2.0,5.0,11,2,9,1.0,1.0,0.0
9712327,3,3,0,0,0,3,6,11,0.0,0.0,0.0,0.0,0.0,0.0,0.0,18,3,15,4.0,1.0,3.0
9910355,6,3,3,4,0,6,18,76,6.0,3.0,3.0,4.0,0.0,6.0,12.0,12,6,6,9.0,6.0,3.0
9607242,19,4,15,65,2,17,53,137,18.0,3.0,15.0,65.0,1.0,17.0,53.0,23,19,4,22.0,18.0,4.0
9809356,3,3,0,0,0,3,10,41,2.0,2.0,0.0,0.0,0.0,2.0,4.0,18,3,15,3.0,1.0,2.0
9907550,14,7,7,15,2,12,26,87,3.0,1.0,2.0,3.0,0.0,3.0,3.0,36,14,22,5.0,4.0,1.0
111334,0,0,0,0,0,0,0,2,0.0,0.0,0.0,0.0,0.0,0.0,0.0,84,0,84,4.0,0.0,4.0
202042,1,1,0,0,0,1,5,21,1.0,1.0,0.0,0.0,0.0,1.0,4.0,10,1,9,5.0,1.0,4.0
9905516,0,0,0,0,0,0,0,101,0.0,0.0,0.0,0.0,0.0,0.0,0.0,8,0,8,1.0,0.0,1.0
112003,11,5,6,17,0,11,52,165,11.0,5.0,6.0,17.0,0.0,11.0,52.0,21,11,10,19.0,9.0,10.0
207130,0,0,0,0,0,0,0,460,0.0,0.0,0.0,0.0,0.0,0.0,0.0,1,0,1,1.0,0.0,1.0
9705439,7,3,4,8,2,5,5,106,7.0,3.0,4.0,8.0,2.0,5.0,5.0,12,7,5,6.0,5.0,1.0
9601225,1,1,0,0,0,1,4,60,1.0,1.0,0.0,0.0,0.0,1.0,1.0,15,1,14,2.0,0.0,2.0
9608369,3,1,2,3,0,3,10,14,3.0,1.0,2.0,3.0,0.0,3.0,10.0,7,3,4,6.0,3.0,3.0
109281,2,1,1,1,1,1,1,139,2.0,1.0,1.0,1.0,1.0,1.0,1.0,9,2,7,5.0,0.0,5.0
9610497,1,1,0,0,0,1,2,140,1.0,1.0,0.0,0.0,0.0,1.0,2.0,4,1,3,4.0,1.0,3.0
106226,5,2,3,4,0,5,16,3,0.0,0.0,0.0,0.0,0.0,0.0,0.0,36,5,31,6.0,0.0,6.0
204224,8,3,5,11,0,8,48,108,8.0,3.0,5.0,11.0,0.0,8.0,41.0,28,8,20,8.0,2.0,6.0
9812335,6,2,4,6,0,6,16,8,2.0,1.0,1.0,1.0,0.0,2.0,4.0,17,6,11,5.0,2.0,3.0
9021,6,6,0,0,1,5,37,6,4.0,4.0,0.0,0.0,1.0,3.0,3.0,41,6,35,7.0,3.0,4.0
9902468,2,2,0,0,1,1,2,41,0.0,0.0,0.0,0.0,0.0,0.0,0.0,26,2,24,6.0,0.0,6.0
9602300,5,4,1,3,0,5,7,102,2.0,2.0,0.0,0.0,0.0,2.0,2.0,9,5,4,3.0,2.0,1.0
9412274,7,2,5,8,6,1,1,157,2.0,1.0,1.0,1.0,2.0,0.0,0.0,8,7,1,4.0,4.0,0.0
9312293,0,0,0,0,0,0,0,15,0.0,0.0,0.0,0.0,0.0,0.0,0.0,9,0,9,2.0,0.0,2.0
9403369,3,3,0,0,3,0,0,232,1.0,1.0,0.0,0.0,1.0,0.0,0.0,3,3,0,1.0,1.0,0.0
9313,3,1,2,2,0,3,13,106,3.0,1.0,2.0,2.0,0.0,3.0,8.0,14,3,11,3.0,1.0,2.0
9910352,8,3,5,14,0,8,31,103,8.0,3.0,5.0,14.0,0.0,8.0,31.0,16,8,8,15.0,7.0,8.0
9806349,1,1,0,0,1,0,0,31,0.0,0.0,0.0,0.0,0.0,0.0,0.0,16,1,15,1.0,1.0,0.0
9705321,1,1,0,0,1,0,0,188,1.0,1.0,0.0,0.0,1.0,0.0,0.0,1,1,0,1.0,1.0,0.0
9512308,4,3,1,1,1,3,3,233,0.0,0.0,0.0,0.0,0.0,0.0,0.0,15,4,11,1.0,1.0,0.0
4023,3,3,0,0,0,3,12,3,1.0,1.0,0.0,0.0,0.0,1.0,3.0,35,3,32,4.0,0.0,4.0
209043,4,2,2,4,0,4,54,1,4.0,2.0,2.0,4.0,0.0,4.0,48.0,26,4,22,20.0,4.0,16.0
9911513,3,3,0,0,3,0,0,420,3.0,3.0,0.0,0.0,3.0,0.0,0.0,3,3,0,3.0,3.0,0.0
9709478,2,2,0,0,0,2,10,33,1.0,1.0,0.0,0.0,0.0,1.0,4.0,22,2,20,8.0,1.0,7.0
9912335,1,1,0,0,0,1,4,13,1.0,1.0,0.0,0.0,0.0,1.0,4.0,12,1,11,2.0,0.0,2.0
5214,6,4,2,2,1,5,13,12,0.0,0.0,0.0,0.0,0.0,0.0,0.0,32,6,26,10.0,0.0,10.0
9806460,2,2,0,0,0,2,7,89,0.0,0.0,0.0,0.0,0.0,0.0,0.0,16,2,14,9.0,0.0,9.0
9709332,3,3,0,0,3,0,0,508,2.0,2.0,0.0,0.0,2.0,0.0,0.0,3,3,0,2.0,2.0,0.0
101272,5,1,4,5,0,5,34,12,0.0,0.0,0.0,0.0,0.0,0.0,0.0,39,5,34,13.0,1.0,12.0
9404206,4,3,1,1,4,0,0,72,2.0,1.0,1.0,1.0,2.0,0.0,0.0,4,4,0,2.0,2.0,0.0
12066,8,3,5,7,4,4,5,29,4.0,2.0,2.0,2.0,0.0,4.0,5.0,14,8,6,2.0,2.0,0.0
9706266,7,2,5,8,7,0,0,347,7.0,2.0,5.0,8.0,7.0,0.0,0.0,9,7,2,4.0,4.0,0.0
9807317,1,1,0,0,1,0,0,58,0.0,0.0,0.0,0.0,0.0,0.0,0.0,14,1,13,1.0,0.0,1.0
7232,9,6,3,5,0,9,59,9,3.0,2.0,1.0,1.0,0.0,3.0,31.0,51,9,42,23.0,2.0,21.0
9812395,3,2,1,1,0,3,5,84,1.0,1.0,0.0,0.0,0.0,1.0,1.0,9,3,6,3.0,2.0,1.0
9611300,5,4,1,2,1,4,11,161,3.0,2.0,1.0,2.0,0.0,3.0,5.0,13,5,8,2.0,0.0,2.0
9904394,3,1,2,3,0,3,23,142,3.0,1.0,2.0,3.0,0.0,3.0,23.0,13,3,10,8.0,3.0,5.0
9507305,7,2,5,8,4,3,5,162,3.0,1.0,2.0,3.0,0.0,3.0,4.0,10,7,3,4.0,3.0,1.0
9910245,3,1,2,3,0,3,4,798,0.0,0.0,0.0,0.0,0.0,0.0,0.0,11,3,8,3.0,1.0,2.0
9607221,1,1,0,0,0,1,7,16,1.0,1.0,0.0,0.0,0.0,1.0,4.0,25,1,24,3.0,0.0,3.0
203225,2,1,1,1,2,0,0,59,2.0,1.0,1.0,1.0,2.0,0.0,0.0,8,2,6,,,
6336,4,4,0,0,1,3,4,58,2.0,2.0,0.0,0.0,0.0,2.0,3.0,7,4,3,4.0,2.0,2.0
9910280,1,1,0,0,0,1,4,160,0.0,0.0,0.0,0.0,0.0,0.0,0.0,5,1,4,3.0,0.0,3.0
9410278,1,1,0,0,1,0,0,561,1.0,1.0,0.0,0.0,1.0,0.0,0.0,1,1,0,1.0,1.0,0.0
203094,1,1,0,0,0,1,3,4,1.0,1.0,0.0,0.0,1.0,0.0,0.0,15,1,14,1.0,0.0,1.0
9506418,1,1,0,0,0,1,2,15,1.0,1.0,0.0,0.0,0.0,1.0,1.0,25,1,24,6.0,0.0,6.0
9711364,0,0,0,0,0,0,0,93,0.0,0.0,0.0,0.0,0.0,0.0,0.0,6,0,6,4.0,0.0,4.0
211036,1,1,0,0,0,1,5,22,1.0,1.0,0.0,0.0,0.0,1.0,5.0,23,1,22,8.0,0.0,8.0
9710264,3,3,0,0,0,3,7,13,1.0,1.0,0.0,0.0,0.0,1.0,2.0,11,3,8,3.0,1.0,2.0
103172,5,3,2,2,1,4,14,13,3.0,2.0,1.0,1.0,1.0,2.0,4.0,22,5,17,4.0,2.0,2.0
105156,4,4,0,0,2,2,5,65,3.0,3.0,0.0,0.0,1.0,2.0,5.0,10,4,6,4.0,1.0,3.0
9711297,9,6,3,4,4,5,6,184,5.0,3.0,2.0,3.0,2.0,3.0,3.0,11,9,2,6.0,5.0,1.0
9811421,1,1,0,0,0,1,2,215,1.0,1.0,0.0,0.0,0.0,1.0,1.0,3,1,2,1.0,1.0,0.0
210150,3,1,2,2,0,3,61,9,3.0,1.0,2.0,2.0,0.0,3.0,61.0,27,3,24,9.0,3.0,6.0
4259,6,3,3,4,1,5,5,416,5.0,3.0,2.0,3.0,1.0,4.0,4.0,7,6,1,5.0,4.0,1.0
9906544,1,1,0,0,1,0,0,144,1.0,1.0,0.0,0.0,1.0,0.0,0.0,3,1,2,3.0,1.0,2.0
9407354,4,3,1,1,3,1,1,203,2.0,2.0,0.0,0.0,1.0,1.0,1.0,5,4,1,2.0,2.0,0.0
9504206,4,3,1,1,2,2,3,470,1.0,1.0,0.0,0.0,0.0,1.0,2.0,10,4,6,4.0,2.0,2.0
9812319,3,1,2,3,0,3,7,20,3.0,1.0,2.0,3.0,1.0,2.0,2.0,13,3,10,4.0,3.0,1.0
9807545,12,8,4,6,2,10,22,71,7.0,5.0,2.0,3.0,0.0,7.0,7.0,16,12,4,8.0,7.0,1.0
9811281,4,4,0,0,2,2,6,33,1.0,1.0,0.0,0.0,0.0,1.0,3.0,11,4,7,1.0,1.0,0.0
9910436,3,1,2,3,0,3,12,76,3.0,1.0,2.0,3.0,0.0,3.0,9.0,12,3,9,6.0,3.0,3.0
9912385,7,2,5,14,1,6,64,124,6.0,1.0,5.0,13.0,1.0,5.0,34.0,22,7,15,12.0,5.0,7.0
4102,1,1,0,0,1,0,0,1676,,,,,,,,4,1,3,,,
302274,0,0,0,0,0,0,0,0,0.0,0.0,0.0,0.0,0.0,0.0,0.0,15,0,15,7.0,0.0,7.0
9704315,1,1,0,0,1,0,0,50,0.0,0.0,0.0,0.0,0.0,0.0,0.0,11,1,10,4.0,0.0,4.0
9708425,9,3,6,11,1,8,18,90,8.0,2.0,6.0,11.0,0.0,8.0,16.0,15,9,6,7.0,4.0,3.0
204361,3,3,0,0,0,3,45,11,2.0,2.0,0.0,0.0,0.0,2.0,40.0,31,3,28,10.0,1.0,9.0
9611414,1,1,0,0,1,0,0,71,0.0,0.0,0.0,0.0,0.0,0.0,0.0,22,1,21,3.0,0.0,3.0
9910515,3,2,1,1,0,3,10,117,3.0,2.0,1.0,1.0,0.0,3.0,8.0,16,3,13,5.0,1.0,4.0
207303,1,1,0,0,0,1,2,45,1.0,1.0,0.0,0.0,0.0,1.0,2.0,10,1,9,3.0,1.0,2.0
9608349,2,1,1,1,0,2,16,26,1.0,1.0,0.0,0.0,0.0,1.0,3.0,14,2,12,5.0,1.0,4.0
9809436,1,1,0,0,0,1,4,38,1.0,1.0,0.0,0.0,0.0,1.0,4.0,13,1,12,3.0,1.0,2.0
101302,10,1,9,19,0,10,57,201,10.0,1.0,9.0,19.0,0.0,10.0,50.0,23,10,13,18.0,10.0,8.0
9705289,0,0,0,0,0,0,0,291,0.0,0.0,0.0,0.0,0.0,0.0,0.0,4,0,4,2.0,0.0,2.0
202094,0,0,0,0,0,0,0,70,0.0,0.0,0.0,0.0,0.0,0.0,0.0,28,0,28,24.0,0.0,24.0
107078,6,6,0,0,2,4,13,197,2.0,2.0,0.0,0.0,0.0,2.0,7.0,17,6,11,7.0,1.0,6.0
103200,0,0,0,0,0,0,0,28,0.0,0.0,0.0,0.0,0.0,0.0,0.0,13,0,13,7.0,0.0,7.0
112203,5,4,1,1,1,4,25,3,0.0,0.0,0.0,0.0,0.0,0.0,0.0,54,5,49,7.0,2.0,5.0
11347,1,1,0,0,1,0,0,542,0.0,0.0,0.0,0.0,0.0,0.0,0.0,4,1,3,1.0,0.0,1.0
9309334,1,1,0,0,0,1,1,170,0.0,0.0,0.0,0.0,0.0,0.0,0.0,2,1,1,1.0,0.0,1.0
301219,1,1,0,0,0,1,20,53,1.0,1.0,0.0,0.0,0.0,1.0,20.0,27,1,26,25.0,1.0,24.0
106047,3,3,0,0,2,1,2,522,1.0,1.0,0.0,0.0,1.0,0.0,0.0,6,3,3,2.0,2.0,0.0
7293,5,1,4,4,0,5,30,83,5.0,1.0,4.0,4.0,0.0,5.0,22.0,21,5,16,8.0,3.0,5.0
9507331,1,1,0,0,0,1,2,517,1.0,1.0,0.0,0.0,0.0,1.0,2.0,4,1,3,3.0,1.0,2.0
106024,6,2,4,8,0,6,60,8,4.0,2.0,2.0,3.0,0.0,4.0,22.0,67,6,61,14.0,0.0,14.0
10032,4,4,0,0,4,0,0,24,2.0,2.0,0.0,0.0,2.0,0.0,0.0,14,4,10,2.0,2.0,0.0
208185,3,2,1,1,0,3,20,78,3.0,2.0,1.0,1.0,0.0,3.0,15.0,20,3,17,9.0,3.0,6.0
109155,1,1,0,0,0,1,1,50,0.0,0.0,0.0,0.0,0.0,0.0,0.0,25,1,24,19.0,0.0,19.0
8126,2,2,0,0,0,2,5,165,,,,,,,,6,2,4,2.0,1.0,1.0
9910533,1,1,0,0,1,0,0,40,0.0,0.0,0.0,0.0,0.0,0.0,0.0,16,1,15,3.0,0.0,3.0
9412279,2,2,0,0,1,1,2,208,2.0,2.0,0.0,0.0,1.0,1.0,1.0,6,2,4,2.0,2.0,0.0
212288,0,0,0,0,0,0,0,184,0.0,0.0,0.0,0.0,0.0,0.0,0.0,2,0,2,,,
6313,1,1,0,0,0,1,1,376,1.0,1.0,0.0,0.0,1.0,0.0,0.0,7,1,6,1.0,1.0,0.0
9311231,2,1,1,1,0,2,2,62,,,,,,,,4,2,2,,,
110111,0,0,0,0,0,0,0,52,0.0,0.0,0.0,0.0,0.0,0.0,0.0,4,0,4,1.0,0.0,1.0
209151,0,0,0,0,0,0,0,59,,,,,,,,7,0,7,,,
9901437,4,2,2,2,1,3,3,138,1.0,1.0,0.0,0.0,1.0,0.0,0.0,6,4,2,2.0,1.0,1.0
110165,1,1,0,0,0,1,5,123,1.0,1.0,0.0,0.0,0.0,1.0,4.0,16,1,15,5.0,1.0,4.0
6161,8,3,5,8,6,2,2,166,4.0,2.0,2.0,2.0,4.0,0.0,0.0,10,8,2,3.0,3.0,0.0
9906326,1,1,0,0,0,1,1,133,,,,,,,,2,1,1,,,
9210259,1,1,0,0,1,0,0,2014,,,,,,,,1,1,0,,,
208058,5,2,3,5,0,5,19,37,3.0,1.0,2.0,3.0,0.0,3.0,12.0,15,5,10,3.0,0.0,3.0
302049,1,1,0,0,0,1,10,37,1.0,1.0,0.0,0.0,0.0,1.0,10.0,15,1,14,13.0,1.0,12.0
9910323,2,2,0,0,0,2,17,12,1.0,1.0,0.0,0.0,0.0,1.0,10.0,24,2,22,13.0,1.0,12.0
9712470,1,1,0,0,0,1,9,36,1.0,1.0,0.0,0.0,0.0,1.0,9.0,14,1,13,14.0,1.0,13.0
208259,1,1,0,0,0,1,2,146,1.0,1.0,0.0,0.0,0.0,1.0,2.0,10,1,9,6.0,1.0,5.0
9905435,3,1,2,3,0,3,8,8,3.0,1.0,2.0,3.0,0.0,3.0,8.0,13,3,10,6.0,3.0,3.0
9506376,1,1,0,0,0,1,2,372,1.0,1.0,0.0,0.0,0.0,1.0,2.0,3,1,2,2.0,1.0,1.0
9402246,1,1,0,0,1,0,0,62,,,,,,,,3,1,2,,,
9510264,2,2,0,0,0,2,4,72,2.0,2.0,0.0,0.0,0.0,2.0,4.0,5,2,3,3.0,2.0,1.0
210109,2,2,0,0,0,2,17,19,1.0,1.0,0.0,0.0,0.0,1.0,5.0,18,2,16,6.0,1.0,5.0
209186,0,0,0,0,0,0,0,16,0.0,0.0,0.0,0.0,0.0,0.0,0.0,15,0,15,4.0,0.0,4.0
207360,0,0,0,0,0,0,0,128,0.0,0.0,0.0,0.0,0.0,0.0,0.0,9,0,9,6.0,0.0,6.0
9805450,0,0,0,0,0,0,0,230,0.0,0.0,0.0,0.0,0.0,0.0,0.0,4,0,4,1.0,0.0,1.0
107076,1,1,0,0,0,1,3,166,1.0,1.0,0.0,0.0,0.0,1.0,2.0,11,1,10,6.0,1.0,5.0
110179,0,0,0,0,0,0,0,40,0.0,0.0,0.0,0.0,0.0,0.0,0.0,33,0,33,7.0,0.0,7.0
9712380,2,2,0,0,0,2,8,33,0.0,0.0,0.0,0.0,0.0,0.0,0.0,7,2,5,5.0,2.0,3.0
211054,4,4,0,0,3,1,2,0,0.0,0.0,0.0,0.0,0.0,0.0,0.0,35,4,31,13.0,0.0,13.0
9805460,5,2,3,3,0,5,18,130,4.0,1.0,3.0,3.0,0.0,4.0,15.0,12,5,7,10.0,4.0,6.0
211215,0,0,0,0,0,0,0,670,0.0,0.0,0.0,0.0,0.0,0.0,0.0,2,0,2,1.0,0.0,1.0
201189,4,1,3,3,0,4,46,20,4.0,1.0,3.0,3.0,0.0,4.0,46.0,36,4,32,31.0,2.0,29.0
112184,9,2,7,12,1,8,66,23,7.0,1.0,6.0,11.0,0.0,7.0,51.0,29,9,20,11.0,6.0,5.0
9092,1,1,0,0,0,1,8,0,1.0,1.0,0.0,0.0,0.0,1.0,5.0,17,1,16,9.0,1.0,8.0
9903445,5,3,2,3,0,5,11,104,5.0,3.0,2.0,3.0,5.0,0.0,0.0,15,5,10,5.0,4.0,1.0
9808369,1,1,0,0,0,1,8,29,1.0,1.0,0.0,0.0,0.0,1.0,6.0,11,1,10,2.0,0.0,2.0
211199,1,1,0,0,0,1,2,82,0.0,0.0,0.0,0.0,0.0,0.0,0.0,21,1,20,15.0,0.0,15.0
112197,3,3,0,0,0,3,16,51,2.0,2.0,0.0,0.0,0.0,2.0,6.0,13,3,10,3.0,1.0,2.0
3049,2,2,0,0,0,2,3,308,1.0,1.0,0.0,0.0,0.0,1.0,2.0,9,2,7,5.0,0.0,5.0
9412350,2,2,0,0,0,2,4,19,2.0,2.0,0.0,0.0,0.0,2.0,3.0,6,2,4,1.0,1.0,0.0
105190,4,2,2,2,0,4,21,24,0.0,0.0,0.0,0.0,0.0,0.0,0.0,32,4,28,1.0,1.0,0.0
9181,3,2,1,1,0,3,14,3,2.0,2.0,0.0,0.0,0.0,2.0,2.0,12,3,9,3.0,2.0,1.0
202208,2,2,0,0,0,2,21,20,2.0,2.0,0.0,0.0,0.0,2.0,21.0,20,2,18,5.0,1.0,4.0
9901379,0,0,0,0,0,0,0,1593,,,,,,,,4,0,4,,,
9912508,2,2,0,0,0,2,3,400,2.0,2.0,0.0,0.0,0.0,2.0,2.0,4,2,2,3.0,1.0,2.0
111383,2,2,0,0,1,1,9,64,0.0,0.0,0.0,0.0,0.0,0.0,0.0,23,2,21,5.0,0.0,5.0
9901300,1,1,0,0,0,1,1,283,,,,,,,,3,1,2,,,
9603433,2,1,1,1,0,2,12,4,2.0,1.0,1.0,1.0,0.0,2.0,10.0,12,2,10,7.0,2.0,5.0
112198,0,0,0,0,0,0,0,198,0.0,0.0,0.0,0.0,0.0,0.0,0.0,3,0,3,1.0,0.0,1.0
9909528,1,1,0,0,1,0,0,565,0.0,0.0,0.0,0.0,0.0,0.0,0.0,3,1,2,2.0,0.0,2.0
9905383,2,1,1,1,2,0,0,277,2.0,1.0,1.0,1.0,2.0,0.0,0.0,3,2,1,2.0,2.0,0.0
9605391,1,1,0,0,1,0,0,186,1.0,1.0,0.0,0.0,1.0,0.0,0.0,1,1,0,1.0,1.0,0.0
209313,0,0,0,0,0,0,0,25,0.0,0.0,0.0,0.0,0.0,0.0,0.0,14,0,14,1.0,0.0,1.0
9512332,5,3,2,2,2,3,6,231,1.0,1.0,0.0,0.0,1.0,0.0,0.0,14,5,9,4.0,4.0,0.0
11119,1,1,0,0,1,0,0,30,0.0,0.0,0.0,0.0,0.0,0.0,0.0,14,1,13,2.0,1.0,1.0
9305256,1,1,0,0,1,0,0,1617,1.0,1.0,0.0,0.0,1.0,0.0,0.0,1,1,0,1.0,1.0,0.0
9605366,0,0,0,0,0,0,0,317,0.0,0.0,0.0,0.0,0.0,0.0,0.0,3,0,3,1.0,0.0,1.0
6189,2,2,0,0,2,0,0,52,,,,,,,,6,2,4,1.0,0.0,1.0
205069,2,2,0,0,0,2,7,44,0.0,0.0,0.0,0.0,0.0,0.0,0.0,8,2,6,1.0,1.0,0.0
9511269,0,0,0,0,0,0,0,235,0.0,0.0,0.0,0.0,0.0,0.0,0.0,13,0,13,3.0,0.0,3.0
9504419,3,3,0,0,0,3,3,386,3.0,3.0,0.0,0.0,0.0,3.0,3.0,4,3,1,4.0,3.0,1.0
9806524,2,2,0,0,1,1,8,25,1.0,1.0,0.0,0.0,0.0,1.0,4.0,17,2,15,10.0,1.0,9.0
9709296,1,1,0,0,1,0,0,2102,,,,,,,,1,1,0,,,
208141,5,3,2,3,0,5,90,11,4.0,2.0,2.0,3.0,0.0,4.0,87.0,43,5,38,30.0,4.0,26.0
3039,3,2,1,1,3,0,0,361,3.0,2.0,1.0,1.0,3.0,0.0,0.0,3,3,0,2.0,2.0,0.0
9911484,0,0,0,0,0,0,0,254,0.0,0.0,0.0,0.0,0.0,0.0,0.0,2,0,2,,,
212121,1,1,0,0,0,1,5,89,1.0,1.0,0.0,0.0,0.0,1.0,4.0,33,1,32,13.0,0.0,13.0
111225,1,1,0,0,0,1,7,65,1.0,1.0,0.0,0.0,0.0,1.0,1.0,19,1,18,4.0,0.0,4.0
9307354,0,0,0,0,0,0,0,69,0.0,0.0,0.0,0.0,0.0,0.0,0.0,4,0,4,,,
9303232,1,1,0,0,0,1,1,341,1.0,1.0,0.0,0.0,0.0,1.0,1.0,2,1,1,2.0,1.0,1.0
209184,0,0,0,0,0,0,0,153,0.0,0.0,0.0,0.0,0.0,0.0,0.0,3,0,3,1.0,0.0,1.0
202238,1,1,0,0,1,0,0,11,0.0,0.0,0.0,0.0,0.0,0.0,0.0,48,1,47,29.0,0.0,29.0
201093,4,3,1,1,2,2,3,41,0.0,0.0,0.0,0.0,0.0,0.0,0.0,10,4,6,1.0,1.0,0.0
110378,3,1,2,2,0,3,6,66,0.0,0.0,0.0,0.0,0.0,0.0,0.0,12,3,9,2.0,2.0,0.0
103158,1,1,0,0,0,1,1,177,0.0,0.0,0.0,0.0,0.0,0.0,0.0,13,1,12,5.0,0.0,5.0
101065,2,1,1,1,2,0,0,72,2.0,1.0,1.0,1.0,2.0,0.0,0.0,4,2,2,2.0,2.0,0.0
3240,2,1,1,1,0,2,11,5,2.0,1.0,1.0,1.0,0.0,2.0,9.0,11,2,9,4.0,2.0,2.0
205072,4,3,1,1,0,4,14,282,3.0,2.0,1.0,1.0,0.0,3.0,12.0,10,4,6,7.0,3.0,4.0
9812299,1,1,0,0,1,0,0,58,0.0,0.0,0.0,0.0,0.0,0.0,0.0,12,1,11,3.0,0.0,3.0
9610444,1,1,0,0,0,1,3,100,0.0,0.0,0.0,0.0,0.0,0.0,0.0,7,1,6,3.0,1.0,2.0
302148,0,0,0,0,0,0,0,106,0.0,0.0,0.0,0.0,0.0,0.0,0.0,4,0,4,4.0,0.0,4.0
206197,2,2,0,0,0,2,9,2,0.0,0.0,0.0,0.0,0.0,0.0,0.0,13,2,11,9.0,0.0,9.0
211393,3,3,0,0,0,3,6,107,1.0,1.0,0.0,0.0,0.0,1.0,2.0,19,3,16,5.0,1.0,4.0
112157,5,2,3,3,0,5,23,18,3.0,1.0,2.0,2.0,0.0,3.0,20.0,33,5,28,3.0,0.0,3.0
9908303,0,0,0,0,0,0,0,39,0.0,0.0,0.0,0.0,0.0,0.0,0.0,23,0,23,10.0,0.0,10.0
111308,3,2,1,1,0,3,13,89,0.0,0.0,0.0,0.0,0.0,0.0,0.0,25,3,22,6.0,2.0,4.0
9510322,4,4,0,0,4,0,0,459,1.0,1.0,0.0,0.0,1.0,0.0,0.0,4,4,0,1.0,1.0,0.0
302248,2,2,0,0,1,1,51,107,1.0,1.0,0.0,0.0,0.0,1.0,25.0,54,2,52,19.0,1.0,18.0
9711374,1,1,0,0,1,0,0,12,0.0,0.0,0.0,0.0,0.0,0.0,0.0,35,1,34,7.0,0.0,7.0
111260,3,3,0,0,2,1,1,72,1.0,1.0,0.0,0.0,1.0,0.0,0.0,5,3,2,2.0,1.0,1.0
102283,6,2,4,5,2,4,9,71,2.0,1.0,1.0,1.0,0.0,2.0,6.0,11,6,5,5.0,2.0,3.0
9807301,0,0,0,0,0,0,0,271,0.0,0.0,0.0,0.0,0.0,0.0,0.0,3,0,3,2.0,0.0,2.0
1079,2,2,0,0,0,2,13,21,1.0,1.0,0.0,0.0,0.0,1.0,8.0,14,2,12,1.0,0.0,1.0
112214,2,1,1,1,0,2,10,283,2.0,1.0,1.0,1.0,0.0,2.0,9.0,18,2,16,4.0,2.0,2.0
104069,0,0,0,0,0,0,0,43,0.0,0.0,0.0,0.0,0.0,0.0,0.0,11,0,11,7.0,0.0,7.0
108140,0,0,0,0,0,0,0,359,0.0,0.0,0.0,0.0,0.0,0.0,0.0,4,0,4,2.0,0.0,2.0
103297,2,1,1,1,0,2,5,608,1.0,1.0,0.0,0.0,1.0,0.0,0.0,5,2,3,1.0,1.0,0.0
1262,1,1,0,0,0,1,1,132,0.0,0.0,0.0,0.0,0.0,0.0,0.0,18,1,17,5.0,0.0,5.0
9912247,2,1,1,1,0,2,2,103,0.0,0.0,0.0,0.0,0.0,0.0,0.0,4,2,2,3.0,2.0,1.0
9609455,1,1,0,0,1,0,0,365,0.0,0.0,0.0,0.0,0.0,0.0,0.0,5,1,4,1.0,0.0,1.0
4195,2,2,0,0,0,2,2,246,2.0,2.0,0.0,0.0,0.0,2.0,2.0,3,2,1,1.0,1.0,0.0
9706485,2,2,0,0,0,2,6,97,2.0,2.0,0.0,0.0,0.0,2.0,6.0,8,2,6,2.0,1.0,1.0
7040,0,0,0,0,0,0,0,772,,,,,,,,6,0,6,1.0,0.0,1.0
206261,1,1,0,0,0,1,1,74,0.0,0.0,0.0,0.0,0.0,0.0,0.0,9,1,8,2.0,0.0,2.0
9802348,2,2,0,0,1,1,1,414,1.0,1.0,0.0,0.0,1.0,0.0,0.0,4,2,2,1.0,1.0,0.0
9912202,2,1,1,1,0,2,4,216,2.0,1.0,1.0,1.0,0.0,2.0,4.0,4,2,2,4.0,2.0,2.0
9905360,1,1,0,0,0,1,3,79,1.0,1.0,0.0,0.0,0.0,1.0,2.0,7,1,6,1.0,0.0,1.0
103253,2,2,0,0,0,2,2,72,2.0,2.0,0.0,0.0,2.0,0.0,0.0,3,2,1,1.0,1.0,0.0
9802225,2,2,0,0,0,2,2,85,1.0,1.0,0.0,0.0,1.0,0.0,0.0,10,2,8,5.0,1.0,4.0
9506293,2,1,1,1,2,0,0,52,1.0,1.0,0.0,0.0,1.0,0.0,0.0,4,2,2,2.0,2.0,0.0
9910264,0,0,0,0,0,0,0,595,0.0,0.0,0.0,0.0,0.0,0.0,0.0,5,0,5,1.0,0.0,1.0
9307335,3,3,0,0,2,1,1,246,2.0,2.0,0.0,0.0,2.0,0.0,0.0,7,3,4,2.0,1.0,1.0
9502402,0,0,0,0,0,0,0,26,0.0,0.0,0.0,0.0,0.0,0.0,0.0,5,0,5,4.0,0.0,4.0
106288,0,0,0,0,0,0,0,7,0.0,0.0,0.0,0.0,0.0,0.0,0.0,13,0,13,4.0,0.0,4.0
103246,4,3,1,1,0,4,8,40,2.0,1.0,1.0,1.0,1.0,1.0,2.0,14,4,10,3.0,1.0,2.0
9503391,1,1,0,0,1,0,0,360,0.0,0.0,0.0,0.0,0.0,0.0,0.0,8,1,7,2.0,0.0,2.0
111339,1,1,0,0,0,1,1,684,1.0,1.0,0.0,0.0,1.0,0.0,0.0,2,1,1,1.0,1.0,0.0
2137,5,3,2,2,0,5,20,118,5.0,3.0,2.0,2.0,0.0,5.0,19.0,18,5,13,11.0,4.0,7.0
211459,0,0,0,0,0,0,0,686,0.0,0.0,0.0,0.0,0.0,0.0,0.0,1,0,1,1.0,0.0,1.0
204283,5,3,2,4,0,5,38,23,4.0,2.0,2.0,4.0,0.0,4.0,28.0,18,5,13,12.0,4.0,8.0
105115,2,1,1,1,0,2,9,18,0.0,0.0,0.0,0.0,0.0,0.0,0.0,16,2,14,1.0,0.0,1.0
9703237,6,2,4,5,4,2,2,125,4.0,1.0,3.0,4.0,4.0,0.0,0.0,8,6,2,4.0,4.0,0.0
9510250,1,1,0,0,0,1,2,153,1.0,1.0,0.0,0.0,0.0,1.0,2.0,3,1,2,3.0,1.0,2.0
208146,1,1,0,0,0,1,1,91,1.0,1.0,0.0,0.0,0.0,1.0,1.0,3,1,2,,,
201223,0,0,0,0,0,0,0,20,0.0,0.0,0.0,0.0,0.0,0.0,0.0,9,0,9,1.0,0.0,1.0
201003,0,0,0,0,0,0,0,83,0.0,0.0,0.0,0.0,0.0,0.0,0.0,13,0,13,7.0,0.0,7.0
9611385,0,0,0,0,0,0,0,1023,,,,,,,,1,0,1,,,
9901310,1,1,0,0,0,1,2,15,1.0,1.0,0.0,0.0,1.0,0.0,0.0,10,1,9,2.0,1.0,1.0
9311342,2,1,1,1,2,0,0,2040,,,,,,,,2,2,0,,,
9112,1,1,0,0,0,1,12,12,1.0,1.0,0.0,0.0,0.0,1.0,5.0,44,1,43,9.0,1.0,8.0
211048,0,0,0,0,0,0,0,1329,,,,,,,,1,0,1,,,
202219,2,2,0,0,0,2,19,5,1.0,1.0,0.0,0.0,0.0,1.0,9.0,22,2,20,13.0,1.0,12.0
210224,2,1,1,1,0,2,8,33,2.0,1.0,1.0,1.0,0.0,2.0,8.0,9,2,7,4.0,2.0,2.0
212072,1,1,0,0,1,0,0,239,0.0,0.0,0.0,0.0,0.0,0.0,0.0,7,1,6,4.0,0.0,4.0
210222,0,0,0,0,0,0,0,172,0.0,0.0,0.0,0.0,0.0,0.0,0.0,14,0,14,7.0,0.0,7.0
9807518,3,1,2,3,1,2,2,297,3.0,1.0,2.0,3.0,1.0,2.0,2.0,4,3,1,4.0,3.0,1.0
9704449,0,0,0,0,0,0,0,88,0.0,0.0,0.0,0.0,0.0,0.0,0.0,6,0,6,1.0,0.0,1.0
9905285,3,3,0,0,1,2,4,289,0.0,0.0,0.0,0.0,0.0,0.0,0.0,7,3,4,3.0,1.0,2.0
208042,0,0,0,0,0,0,0,16,0.0,0.0,0.0,0.0,0.0,0.0,0.0,34,0,34,3.0,0.0,3.0
201109,0,0,0,0,0,0,0,271,0.0,0.0,0.0,0.0,0.0,0.0,0.0,4,0,4,3.0,0.0,3.0
201078,1,1,0,0,0,1,3,13,0.0,0.0,0.0,0.0,0.0,0.0,0.0,44,1,43,12.0,0.0,12.0
209374,1,1,0,0,0,1,2,62,0.0,0.0,0.0,0.0,0.0,0.0,0.0,13,1,12,10.0,0.0,10.0
108086,3,2,1,1,0,3,8,123,1.0,1.0,0.0,0.0,0.0,1.0,2.0,11,3,8,4.0,0.0,4.0
110400,6,3,3,3,0,6,19,13,2.0,1.0,1.0,1.0,1.0,1.0,1.0,14,6,8,6.0,3.0,3.0
9704240,1,1,0,0,0,1,3,53,1.0,1.0,0.0,0.0,0.0,1.0,3.0,9,1,8,5.0,1.0,4.0
9912243,1,1,0,0,1,0,0,389,1.0,1.0,0.0,0.0,1.0,0.0,0.0,1,1,0,1.0,1.0,0.0
10263,1,1,0,0,0,1,1,144,0.0,0.0,0.0,0.0,0.0,0.0,0.0,3,1,2,3.0,1.0,2.0
9505424,6,3,3,5,0,6,14,96,4.0,2.0,2.0,2.0,0.0,4.0,10.0,11,6,5,8.0,5.0,3.0
209280,1,1,0,0,0,1,4,3,0.0,0.0,0.0,0.0,0.0,0.0,0.0,54,1,53,28.0,0.0,28.0
208175,1,1,0,0,0,1,4,127,1.0,1.0,0.0,0.0,0.0,1.0,4.0,5,1,4,5.0,1.0,4.0
105098,0,0,0,0,0,0,0,80,0.0,0.0,0.0,0.0,0.0,0.0,0.0,7,0,7,4.0,0.0,4.0
207215,1,1,0,0,0,1,1,30,0.0,0.0,0.0,0.0,0.0,0.0,0.0,13,1,12,3.0,0.0,3.0
9308239,0,0,0,0,0,0,0,363,0.0,0.0,0.0,0.0,0.0,0.0,0.0,2,0,2,,,
9908359,0,0,0,0,0,0,0,172,0.0,0.0,0.0,0.0,0.0,0.0,0.0,5,0,5,1.0,0.0,1.0
110170,1,1,0,0,1,0,0,106,0.0,0.0,0.0,0.0,0.0,0.0,0.0,10,1,9,5.0,0.0,5.0
201304,3,3,0,0,0,3,39,30,3.0,3.0,0.0,0.0,0.0,3.0,37.0,26,3,23,11.0,2.0,9.0
9412320,0,0,0,0,0,0,0,494,0.0,0.0,0.0,0.0,0.0,0.0,0.0,1,0,1,1.0,0.0,1.0
9907367,0,0,0,0,0,0,0,1698,,,,,,,,2,0,2,,,
3232,1,1,0,0,0,1,13,32,1.0,1.0,0.0,0.0,0.0,1.0,13.0,48,1,47,25.0,1.0,24.0
9511254,1,1,0,0,0,1,5,22,0.0,0.0,0.0,0.0,0.0,0.0,0.0,9,1,8,1.0,0.0,1.0
9901250,3,2,1,1,1,2,2,103,1.0,1.0,0.0,0.0,0.0,1.0,1.0,11,3,8,4.0,2.0,2.0
1060,1,1,0,0,1,0,0,10,0.0,0.0,0.0,0.0,0.0,0.0,0.0,11,1,10,1.0,0.0,1.0
9609275,0,0,0,0,0,0,0,8,0.0,0.0,0.0,0.0,0.0,0.0,0.0,4,0,4,1.0,0.0,1.0
212371,0,0,0,0,0,0,0,65,0.0,0.0,0.0,0.0,0.0,0.0,0.0,12,0,12,2.0,0.0,2.0
212004,3,1,2,3,0,3,4,19,0.0,0.0,0.0,0.0,0.0,0.0,0.0,12,3,9,4.0,3.0,1.0
211015,2,2,0,0,1,1,2,89,1.0,1.0,0.0,0.0,0.0,1.0,1.0,4,2,2,2.0,1.0,1.0
12006,0,0,0,0,0,0,0,45,0.0,0.0,0.0,0.0,0.0,0.0,0.0,15,0,15,11.0,0.0,11.0
9811310,0,0,0,0,0,0,0,116,0.0,0.0,0.0,0.0,0.0,0.0,0.0,4,0,4,1.0,0.0,1.0
301094,1,1,0,0,0,1,10,52,1.0,1.0,0.0,0.0,0.0,1.0,9.0,22,1,21,14.0,1.0,13.0
202070,0,0,0,0,0,0,0,301,0.0,0.0,0.0,0.0,0.0,0.0,0.0,10,0,10,7.0,0.0,7.0
207207,1,1,0,0,0,1,4,79,0.0,0.0,0.0,0.0,0.0,0.0,0.0,9,1,8,2.0,1.0,1.0
9907535,1,1,0,0,0,1,1,184,1.0,1.0,0.0,0.0,0.0,1.0,1.0,4,1,3,2.0,1.0,1.0
9802389,0,0,0,0,0,0,0,34,0.0,0.0,0.0,0.0,0.0,0.0,0.0,10,0,10,1.0,0.0,1.0
9910294,0,0,0,0,0,0,0,9,0.0,0.0,0.0,0.0,0.0,0.0,0.0,17,0,17,6.0,0.0,6.0
9709269,0,0,0,0,0,0,0,1349,,,,,,,,1,0,1,,,
9711331,0,0,0,0,0,0,0,96,0.0,0.0,0.0,0.0,0.0,0.0,0.0,11,0,11,8.0,0.0,8.0
9301266,1,1,0,0,1,0,0,1652,1.0,1.0,0.0,0.0,1.0,0.0,0.0,1,1,0,1.0,1.0,0.0
207273,3,3,0,0,0,3,85,109,3.0,3.0,0.0,0.0,0.0,3.0,73.0,44,3,41,26.0,3.0,23.0
9407278,1,1,0,0,1,0,0,124,,,,,,,,1,1,0,,,
105035,0,0,0,0,0,0,0,1716,0.0,0.0,0.0,0.0,0.0,0.0,0.0,6,0,6,1.0,0.0,1.0
210282,0,0,0,0,0,0,0,89,0.0,0.0,0.0,0.0,0.0,0.0,0.0,19,0,19,7.0,0.0,7.0
9902461,1,1,0,0,0,1,7,13,1.0,1.0,0.0,0.0,0.0,1.0,6.0,33,1,32,15.0,1.0,14.0
9412202,1,1,0,0,1,0,0,127,,,,,,,,1,1,0,1.0,1.0,0.0
9408205,0,0,0,0,0,0,0,135,,,,,,,,1,0,1,1.0,0.0,1.0
205159,1,1,0,0,0,1,5,14,1.0,1.0,0.0,0.0,0.0,1.0,2.0,14,1,13,9.0,0.0,9.0
9808476,0,0,0,0,0,0,0,667,0.0,0.0,0.0,0.0,0.0,0.0,0.0,1,0,1,1.0,0.0,1.0
209257,0,0,0,0,0,0,0,179,0.0,0.0,0.0,0.0,0.0,0.0,0.0,10,0,10,1.0,0.0,1.0
209367,0,0,0,0,0,0,0,19,0.0,0.0,0.0,0.0,0.0,0.0,0.0,18,0,18,10.0,0.0,10.0
104233,0,0,0,0,0,0,0,836,0.0,0.0,0.0,0.0,0.0,0.0,0.0,6,0,6,2.0,0.0,2.0
101140,1,1,0,0,0,1,3,247,1.0,1.0,0.0,0.0,0.0,1.0,2.0,4,1,3,3.0,1.0,2.0
108048,1,1,0,0,1,0,0,0,0.0,0.0,0.0,0.0,0.0,0.0,0.0,11,1,10,1.0,0.0,1.0
210354,0,0,0,0,0,0,0,92,0.0,0.0,0.0,0.0,0.0,0.0,0.0,7,0,7,,,
9908457,0,0,0,0,0,0,0,838,,,,,,,,1,0,1,,,
9612273,1,1,0,0,0,1,1,474,1.0,1.0,0.0,0.0,0.0,1.0,1.0,3,1,2,2.0,1.0,1.0
207050,0,0,0,0,0,0,0,32,0.0,0.0,0.0,0.0,0.0,0.0,0.0,26,0,26,3.0,0.0,3.0
9512293,0,0,0,0,0,0,0,1430,0.0,0.0,0.0,0.0,0.0,0.0,0.0,1,0,1,1.0,0.0,1.0
211120,0,0,0,0,0,0,0,789,0.0,0.0,0.0,0.0,0.0,0.0,0.0,2,0,2,2.0,0.0,2.0
9810487,0,0,0,0,0,0,0,17,0.0,0.0,0.0,0.0,0.0,0.0,0.0,30,0,30,18.0,0.0,18.0
9909553,0,0,0,0,0,0,0,113,0.0,0.0,0.0,0.0,0.0,0.0,0.0,2,0,2,1.0,0.0,1.0
9812293,0,0,0,0,0,0,0,705,0.0,0.0,0.0,0.0,0.0,0.0,0.0,1,0,1,1.0,0.0,1.0
9407387,0,0,0,0,0,0,0,98,0.0,0.0,0.0,0.0,0.0,0.0,0.0,3,0,3,,,
105255,2,2,0,0,0,2,13,20,0.0,0.0,0.0,0.0,0.0,0.0,0.0,62,2,60,28.0,0.0,28.0
8330,0,0,0,0,0,0,0,103,0.0,0.0,0.0,0.0,0.0,0.0,0.0,3,0,3,1.0,0.0,1.0
108208,0,0,0,0,0,0,0,262,0.0,0.0,0.0,0.0,0.0,0.0,0.0,3,0,3,3.0,0.0,3.0
9305339,0,0,0,0,0,0,0,75,0.0,0.0,0.0,0.0,0.0,0.0,0.0,11,0,11,1.0,0.0,1.0
9702204,0,0,0,0,0,0,0,449,0.0,0.0,0.0,0.0,0.0,0.0,0.0,7,0,7,2.0,0.0,2.0
5195,0,0,0,0,0,0,0,11,,,,,,,,9,0,9,,,
201041,0,0,0,0,0,0,0,14,0.0,0.0,0.0,0.0,0.0,0.0,0.0,12,0,12,1.0,0.0,1.0
9908206,1,1,0,0,1,0,0,91,0.0,0.0,0.0,0.0,0.0,0.0,0.0,4,1,3,2.0,0.0,2.0
210047,0,0,0,0,0,0,0,405,0.0,0.0,0.0,0.0,0.0,0.0,0.0,11,0,11,1.0,0.0,1.0
12173,1,1,0,0,1,0,0,133,1.0,1.0,0.0,0.0,1.0,0.0,0.0,3,1,2,1.0,1.0,0.0
101355,2,2,0,0,2,0,0,261,1.0,1.0,0.0,0.0,1.0,0.0,0.0,3,2,1,1.0,1.0,0.0
301106,0,0,0,0,0,0,0,18,0.0,0.0,0.0,0.0,0.0,0.0,0.0,29,0,29,21.0,0.0,21.0
9511452,1,1,0,0,0,1,3,155,1.0,1.0,0.0,0.0,0.0,1.0,3.0,13,1,12,3.0,0.0,3.0
9808222,1,1,0,0,0,1,6,103,1.0,1.0,0.0,0.0,0.0,1.0,5.0,11,1,10,5.0,1.0,4.0
203024,1,1,0,0,0,1,1,97,0.0,0.0,0.0,0.0,0.0,0.0,0.0,43,1,42,10.0,0.0,10.0
201260,0,0,0,0,0,0,0,2,,,,,,,,8,0,8,1.0,0.0,1.0
204262,1,1,0,0,0,1,4,123,0.0,0.0,0.0,0.0,0.0,0.0,0.0,8,1,7,2.0,0.0,2.0
9511249,1,1,0,0,1,0,0,175,1.0,1.0,0.0,0.0,1.0,0.0,0.0,1,1,0,1.0,1.0,0.0
103255,1,1,0,0,0,1,6,10,0.0,0.0,0.0,0.0,0.0,0.0,0.0,19,1,18,9.0,0.0,9.0
207272,1,1,0,0,0,1,7,202,1.0,1.0,0.0,0.0,0.0,1.0,5.0,14,1,13,7.0,1.0,6.0
9910418,0,0,0,0,0,0,0,657,0.0,0.0,0.0,0.0,0.0,0.0,0.0,1,0,1,1.0,0.0,1.0
105310,0,0,0,0,0,0,0,83,,,,,,,,2,0,2,,,
206236,1,1,0,0,0,1,2,125,1.0,1.0,0.0,0.0,0.0,1.0,1.0,4,1,3,2.0,1.0,1.0
9504289,0,0,0,0,0,0,0,116,0.0,0.0,0.0,0.0,0.0,0.0,0.0,3,0,3,,,
208172,0,0,0,0,0,0,0,18,0.0,0.0,0.0,0.0,0.0,0.0,0.0,42,0,42,21.0,0.0,21.0
9804442,0,0,0,0,0,0,0,202,,,,,,,,1,0,1,1.0,0.0,1.0
9504344,0,0,0,0,0,0,0,1517,,,,,,,,1,0,1,,,
106187,0,0,0,0,0,0,0,350,0.0,0.0,0.0,0.0,0.0,0.0,0.0,1,0,1,1.0,0.0,1.0
9912239,1,1,0,0,1,0,0,214,0.0,0.0,0.0,0.0,0.0,0.0,0.0,5,1,4,2.0,0.0,2.0
9510299,0,0,0,0,0,0,0,190,0.0,0.0,0.0,0.0,0.0,0.0,0.0,7,0,7,5.0,0.0,5.0
9810422,0,0,0,0,0,0,0,100,0.0,0.0,0.0,0.0,0.0,0.0,0.0,17,0,17,2.0,0.0,2.0
9603399,0,0,0,0,0,0,0,330,0.0,0.0,0.0,0.0,0.0,0.0,0.0,8,0,8,2.0,0.0,2.0
9912342,0,0,0,0,0,0,0,104,,,,,,,,1,0,1,,,
9809348,0,0,0,0,0,0,0,1519,,,,,,,,1,0,1,,,
9512362,0,0,0,0,0,0,0,164,0.0,0.0,0.0,0.0,0.0,0.0,0.0,4,0,4,,,
9018,3,2,1,1,0,3,3,230,3.0,2.0,1.0,1.0,2.0,1.0,1.0,7,3,4,3.0,3.0,0.0
107013,0,0,0,0,0,0,0,189,0.0,0.0,0.0,0.0,0.0,0.0,0.0,6,0,6,5.0,0.0,5.0
11378,0,0,0,0,0,0,0,12,0.0,0.0,0.0,0.0,0.0,0.0,0.0,21,0,21,19.0,0.0,19.0
211132,0,0,0,0,0,0,0,102,0.0,0.0,0.0,0.0,0.0,0.0,0.0,18,0,18,8.0,0.0,8.0
102115,0,0,0,0,0,0,0,6,0.0,0.0,0.0,0.0,0.0,0.0,0.0,10,0,10,1.0,0.0,1.0
12319,1,1,0,0,0,1,2,80,1.0,1.0,0.0,0.0,0.0,1.0,2.0,5,1,4,1.0,0.0,1.0
112311,0,0,0,0,0,0,0,64,0.0,0.0,0.0,0.0,0.0,0.0,0.0,10,0,10,5.0,0.0,5.0
5271,1,1,0,0,0,1,1,350,1.0,1.0,0.0,0.0,0.0,1.0,1.0,6,1,5,2.0,1.0,1.0
206012,0,0,0,0,0,0,0,309,0.0,0.0,0.0,0.0,0.0,0.0,0.0,4,0,4,2.0,0.0,2.0
9309250,0,0,0,0,0,0,0,75,0.0,0.0,0.0,0.0,0.0,0.0,0.0,16,0,16,1.0,0.0,1.0
9709489,0,0,0,0,0,0,0,145,0.0,0.0,0.0,0.0,0.0,0.0,0.0,9,0,9,,,
6144,0,0,0,0,0,0,0,12,0.0,0.0,0.0,0.0,0.0,0.0,0.0,25,0,25,2.0,0.0,2.0
6323,0,0,0,0,0,0,0,541,0.0,0.0,0.0,0.0,0.0,0.0,0.0,2,0,2,1.0,0.0,1.0
106065,0,0,0,0,0,0,0,119,,,,,,,,9,0,9,1.0,0.0,1.0
2015,0,0,0,0,0,0,0,44,0.0,0.0,0.0,0.0,0.0,0.0,0.0,10,0,10,4.0,0.0,4.0
9506300,0,0,0,0,0,0,0,15,0.0,0.0,0.0,0.0,0.0,0.0,0.0,8,0,8,6.0,0.0,6.0
9307332,0,0,0,0,0,0,0,124,,,,,,,,2,0,2,,,
9607260,0,0,0,0,0,0,0,1017,,,,,,,,2,0,2,,,
212342,1,1,0,0,0,1,11,28,1.0,1.0,0.0,0.0,0.0,1.0,9.0,40,1,39,30.0,1.0,29.0
9806399,0,0,0,0,0,0,0,101,0.0,0.0,0.0,0.0,0.0,0.0,0.0,7,0,7,1.0,0.0,1.0
9611205,1,1,0,0,0,1,1,279,1.0,1.0,0.0,0.0,0.0,1.0,1.0,3,1,2,1.0,1.0,0.0
7044,0,0,0,0,0,0,0,272,0.0,0.0,0.0,0.0,0.0,0.0,0.0,6,0,6,1.0,0.0,1.0
9910547,1,1,0,0,0,1,1,110,0.0,0.0,0.0,0.0,0.0,0.0,0.0,23,1,22,8.0,0.0,8.0
9901441,0,0,0,0,0,0,0,41,,,,,,,,2,0,2,,,
211107,1,1,0,0,0,1,2,56,0.0,0.0,0.0,0.0,0.0,0.0,0.0,26,1,25,3.0,0.0,3.0
9411385,0,0,0,0,0,0,0,208,0.0,0.0,0.0,0.0,0.0,0.0,0.0,14,0,14,4.0,0.0,4.0
9096,0,0,0,0,0,0,0,1761,,,,,,,,1,0,1,,,
9908367,0,0,0,0,0,0,0,2138,0.0,0.0,0.0,0.0,0.0,0.0,0.0,5,0,5,,,
107207,0,0,0,0,0,0,0,115,0.0,0.0,0.0,0.0,0.0,0.0,0.0,9,0,9,1.0,0.0,1.0
9401334,0,0,0,0,0,0,0,234,0.0,0.0,0.0,0.0,0.0,0.0,0.0,4,0,4,4.0,0.0,4.0
301133,0,0,0,0,0,0,0,22,0.0,0.0,0.0,0.0,0.0,0.0,0.0,11,0,11,8.0,0.0,8.0
11386,0,0,0,0,0,0,0,501,0.0,0.0,0.0,0.0,0.0,0.0,0.0,2,0,2,2.0,0.0,2.0
9909569,0,0,0,0,0,0,0,168,0.0,0.0,0.0,0.0,0.0,0.0,0.0,2,0,2,1.0,0.0,1.0
9509290,0,0,0,0,0,0,0,60,0.0,0.0,0.0,0.0,0.0,0.0,0.0,5,0,5,,,
9708465,0,0,0,0,0,0,0,434,0.0,0.0,0.0,0.0,0.0,0.0,0.0,4,0,4,3.0,0.0,3.0
9305312,0,0,0,0,0,0,0,1776,,,,,,,,2,0,2,,,
209352,0,0,0,0,0,0,0,7,0.0,0.0,0.0,0.0,0.0,0.0,0.0,36,0,36,5.0,0.0,5.0
9808252,0,0,0,0,0,0,0,190,0.0,0.0,0.0,0.0,0.0,0.0,0.0,6,0,6,2.0,0.0,2.0
111266,0,0,0,0,0,0,0,1,0.0,0.0,0.0,0.0,0.0,0.0,0.0,8,0,8,1.0,0.0,1.0
11171,0,0,0,0,0,0,0,70,0.0,0.0,0.0,0.0,0.0,0.0,0.0,10,0,10,3.0,0.0,3.0
9610462,0,0,0,0,0,0,0,43,0.0,0.0,0.0,0.0,0.0,0.0,0.0,48,0,48,3.0,0.0,3.0
4224,0,0,0,0,0,0,0,267,0.0,0.0,0.0,0.0,0.0,0.0,0.0,5,0,5,2.0,0.0,2.0
9604318,0,0,0,0,0,0,0,72,0.0,0.0,0.0,0.0,0.0,0.0,0.0,1,0,1,,,
101050,0,0,0,0,0,0,0,171,0.0,0.0,0.0,0.0,0.0,0.0,0.0,3,0,3,1.0,0.0,1.0
212330,0,0,0,0,0,0,0,6,0.0,0.0,0.0,0.0,0.0,0.0,0.0,8,0,8,3.0,0.0,3.0
9809389,0,0,0,0,0,0,0,110,0.0,0.0,0.0,0.0,0.0,0.0,0.0,3,0,3,,,
9808267,0,0,0,0,0,0,0,650,0.0,0.0,0.0,0.0,0.0,0.0,0.0,3,0,3,1.0,0.0,1.0
9907239,0,0,0,0,0,0,0,79,,,,,,,,1,0,1,,,
103186,0,0,0,0,0,0,0,24,,,,,,,,10,0,10,2.0,0.0,2.0
212333,0,0,0,0,0,0,0,1,0.0,0.0,0.0,0.0,0.0,0.0,0.0,11,0,11,1.0,0.0,1.0
208025,0,0,0,0,0,0,0,8,0.0,0.0,0.0,0.0,0.0,0.0,0.0,9,0,9,,,
212359,0,0,0,0,0,0,0,103,0.0,0.0,0.0,0.0,0.0,0.0,0.0,12,0,12,6.0,0.0,6.0
9607444,0,0,0,0,0,0,0,1,0.0,0.0,0.0,0.0,0.0,0.0,0.0,17,0,17,1.0,0.0,1.0
9705431,0,0,0,0,0,0,0,241,0.0,0.0,0.0,0.0,0.0,0.0,0.0,6,0,6,2.0,0.0,2.0
9611252,0,0,0,0,0,0,0,189,0.0,0.0,0.0,0.0,0.0,0.0,0.0,1,0,1,1.0,0.0,1.0
9901325,0,0,0,0,0,0,0,169,0.0,0.0,0.0,0.0,0.0,0.0,0.0,3,0,3,1.0,0.0,1.0
106009,0,0,0,0,0,0,0,122,0.0,0.0,0.0,0.0,0.0,0.0,0.0,3,0,3,2.0,0.0,2.0
9810519,0,0,0,0,0,0,0,205,0.0,0.0,0.0,0.0,0.0,0.0,0.0,1,0,1,1.0,0.0,1.0
207190,0,0,0,0,0,0,0,187,,,,,,,,1,0,1,1.0,0.0,1.0
212372,0,0,0,0,0,0,0,9,0.0,0.0,0.0,0.0,0.0,0.0,0.0,27,0,27,6.0,0.0,6.0
9702440,2,2,0,0,0,2,4,186,1.0,1.0,0.0,0.0,0.0,1.0,1.0,4,2,2,1.0,1.0,0.0
9909289,0,0,0,0,0,0,0,354,0.0,0.0,0.0,0.0,0.0,0.0,0.0,9,0,9,4.0,0.0,4.0
9805267,0,0,0,0,0,0,0,298,0.0,0.0,0.0,0.0,0.0,0.0,0.0,2,0,2,2.0,0.0,2.0
110392,1,1,0,0,0,1,1,89,0.0,0.0,0.0,0.0,0.0,0.0,0.0,8,1,7,4.0,0.0,4.0
302204,0,0,0,0,0,0,0,99,0.0,0.0,0.0,0.0,0.0,0.0,0.0,8,0,8,1.0,0.0,1.0
9605402,0,0,0,0,0,0,0,214,0.0,0.0,0.0,0.0,0.0,0.0,0.0,1,0,1,1.0,0.0,1.0
206114,0,0,0,0,0,0,0,66,0.0,0.0,0.0,0.0,0.0,0.0,0.0,16,0,16,11.0,0.0,11.0
211309,0,0,0,0,0,0,0,50,0.0,0.0,0.0,0.0,0.0,0.0,0.0,28,0,28,5.0,0.0,5.0
9901417,0,0,0,0,0,0,0,103,0.0,0.0,0.0,0.0,0.0,0.0,0.0,9,0,9,4.0,0.0,4.0
5294,0,0,0,0,0,0,0,296,0.0,0.0,0.0,0.0,0.0,0.0,0.0,7,0,7,2.0,0.0,2.0
203259,0,0,0,0,0,0,0,30,0.0,0.0,0.0,0.0,0.0,0.0,0.0,6,0,6,,,
9809201,0,0,0,0,0,0,0,113,0.0,0.0,0.0,0.0,0.0,0.0,0.0,7,0,7,1.0,0.0,1.0
9607338,0,0,0,0,0,0,0,14,0.0,0.0,0.0,0.0,0.0,0.0,0.0,4,0,4,2.0,0.0,2.0
212128,0,0,0,0,0,0,0,346,0.0,0.0,0.0,0.0,0.0,0.0,0.0,14,0,14,1.0,0.0,1.0
102244,0,0,0,0,0,0,0,506,0.0,0.0,0.0,0.0,0.0,0.0,0.0,1,0,1,1.0,0.0,1.0
210370,0,0,0,0,0,0,0,18,0.0,0.0,0.0,0.0,0.0,0.0,0.0,17,0,17,5.0,0.0,5.0
9505436,0,0,0,0,0,0,0,386,0.0,0.0,0.0,0.0,0.0,0.0,0.0,1,0,1,,,
103268,0,0,0,0,0,0,0,139,0.0,0.0,0.0,0.0,0.0,0.0,0.0,6,0,6,1.0,0.0,1.0
12251,0,0,0,0,0,0,0,6,0.0,0.0,0.0,0.0,0.0,0.0,0.0,10,0,10,1.0,0.0,1.0
4017,0,0,0,0,0,0,0,377,0.0,0.0,0.0,0.0,0.0,0.0,0.0,3,0,3,2.0,0.0,2.0
109087,0,0,0,0,0,0,0,9,0.0,0.0,0.0,0.0,0.0,0.0,0.0,11,0,11,6.0,0.0,6.0
202197,0,0,0,0,0,0,0,32,0.0,0.0,0.0,0.0,0.0,0.0,0.0,6,0,6,,,
9410246,0,0,0,0,0,0,0,26,0.0,0.0,0.0,0.0,0.0,0.0,0.0,4,0,4,1.0,0.0,1.0
9907566,0,0,0,0,0,0,0,40,0.0,0.0,0.0,0.0,0.0,0.0,0.0,22,0,22,6.0,0.0,6.0
9512289,0,0,0,0,0,0,0,308,0.0,0.0,0.0,0.0,0.0,0.0,0.0,6,0,6,1.0,0.0,1.0
9711388,0,0,0,0,0,0,0,181,,,,,,,,2,0,2,,,
112041,0,0,0,0,0,0,0,1650,,,,,,,,3,0,3,,,
9502335,106,27,79,333,28,78,178,34,30.0,4.0,26.0,167.0,8.0,22.0,31.0,121,106,15,9.0,5.0,4.0
12308,125,16,109,484,49,76,236,1,21.0,6.0,15.0,40.0,3.0,18.0,42.0,166,125,41,21.0,16.0,5.0
6124,216,23,193,1238,19,197,908,1,74.0,3.0,71.0,451.0,1.0,73.0,157.0,287,216,71,31.0,27.0,4.0
9404282,149,18,131,1189,98,51,78,1,89.0,1.0,88.0,897.0,54.0,35.0,56.0,151,149,2,46.0,46.0,0.0
9512388,101,12,89,332,31,70,230,3,36.0,3.0,33.0,133.0,8.0,28.0,101.0,112,101,11,26.0,21.0,5.0
9311357,89,20,69,297,14,75,75,7,30.0,3.0,27.0,119.0,5.0,25.0,25.0,90,89,1,4.0,4.0,0.0
9501281,190,11,179,1476,60,130,391,7,60.0,5.0,55.0,340.0,40.0,20.0,20.0,202,190,12,30.0,28.0,2.0
9408332,48,19,29,103,26,22,50,1,7.0,5.0,2.0,2.0,7.0,0.0,0.0,55,48,7,3.0,3.0,0.0
9711426,26,9,17,38,19,7,9,296,13.0,3.0,10.0,20.0,12.0,1.0,1.0,29,26,3,6.0,6.0,0.0
2041,21,8,13,41,1,20,90,2,11.0,2.0,9.0,36.0,11.0,0.0,0.0,89,21,68,3.0,0.0,3.0
9604412,88,28,60,117,19,69,733,6,25.0,11.0,14.0,28.0,0.0,25.0,407.0,172,88,84,44.0,11.0,33.0
9401354,8,5,3,3,2,6,6,78,3.0,3.0,0.0,0.0,3.0,0.0,0.0,12,8,4,2.0,2.0,0.0
9908236,9,4,5,8,0,9,33,32,0.0,0.0,0.0,0.0,0.0,0.0,0.0,30,9,21,5.0,0.0,5.0
9905281,37,6,31,108,10,27,31,2,7.0,2.0,5.0,12.0,4.0,3.0,3.0,40,37,3,13.0,12.0,1.0
9406416,19,7,12,17,2,17,25,35,4.0,1.0,3.0,4.0,1.0,3.0,3.0,27,19,8,8.0,7.0,1.0
9401258,201,68,133,432,201,0,0,4,16.0,2.0,14.0,57.0,16.0,0.0,0.0,201,201,0,10.0,10.0,0.0
9610272,57,21,36,76,22,35,72,4,5.0,4.0,1.0,1.0,1.0,4.0,10.0,66,57,9,6.0,6.0,0.0
9303241,141,30,111,442,75,66,66,48,33.0,2.0,31.0,142.0,20.0,13.0,13.0,142,141,1,20.0,20.0,0.0
9603435,6,4,2,8,2,4,5,33,3.0,2.0,1.0,2.0,2.0,1.0,1.0,8,6,2,4.0,3.0,1.0
9703463,30,11,19,39,1,29,140,33,9.0,4.0,5.0,8.0,0.0,9.0,28.0,67,30,37,9.0,4.0,5.0
9803262,3,1,2,2,0,3,11,48,0.0,0.0,0.0,0.0,0.0,0.0,0.0,8,3,5,4.0,2.0,2.0
9812298,13,10,3,3,0,13,52,23,2.0,1.0,1.0,1.0,0.0,2.0,9.0,82,13,69,8.0,0.0,8.0
9912396,46,22,24,68,46,0,0,80,7.0,2.0,5.0,15.0,7.0,0.0,0.0,46,46,0,5.0,5.0,0.0
1056,7,2,5,11,0,7,47,26,7.0,2.0,5.0,11.0,0.0,7.0,37.0,17,7,10,6.0,1.0,5.0
9206222,21,9,12,17,18,3,3,13,3.0,1.0,2.0,2.0,2.0,1.0,1.0,22,21,1,5.0,5.0,0.0
9510376,87,13,74,368,4,83,264,26,53.0,4.0,49.0,280.0,0.0,53.0,174.0,112,87,25,34.0,31.0,3.0
9806472,23,9,14,27,0,23,54,116,6.0,3.0,3.0,3.0,0.0,6.0,21.0,32,23,9,12.0,7.0,5.0
1169,11,3,8,21,0,11,75,4,6.0,3.0,3.0,5.0,0.0,6.0,27.0,31,11,20,16.0,6.0,10.0
106351,2,2,0,0,1,1,26,69,0.0,0.0,0.0,0.0,0.0,0.0,0.0,81,2,79,20.0,0.0,20.0
9506409,14,2,12,29,2,12,12,60,9.0,2.0,7.0,18.0,9.0,0.0,0.0,17,14,3,9.0,8.0,1.0
9607388,18,5,13,25,3,15,47,4,8.0,2.0,6.0,11.0,7.0,1.0,1.0,25,18,7,6.0,4.0,2.0
9909392,7,4,3,7,0,7,101,2,6.0,3.0,3.0,6.0,0.0,6.0,95.0,29,7,22,25.0,6.0,19.0
8125,9,3,6,9,1,8,41,86,4.0,2.0,2.0,2.0,0.0,4.0,27.0,28,9,19,15.0,3.0,12.0
111245,23,7,16,39,0,23,306,32,10.0,1.0,9.0,22.0,0.0,10.0,138.0,83,23,60,30.0,7.0,23.0
9903365,22,11,11,20,9,13,29,10,5.0,2.0,3.0,7.0,5.0,0.0,0.0,33,22,11,6.0,6.0,0.0
9803386,10,4,6,9,3,7,13,20,0.0,0.0,0.0,0.0,0.0,0.0,0.0,14,10,4,1.0,1.0,0.0
9310302,16,9,7,9,16,0,0,157,4.0,2.0,2.0,3.0,4.0,0.0,0.0,17,16,1,3.0,3.0,0.0
9206230,36,14,22,76,36,0,0,29,25.0,7.0,18.0,57.0,25.0,0.0,0.0,36,36,0,10.0,10.0,0.0
9406431,46,10,36,164,35,11,11,4,15.0,7.0,8.0,45.0,15.0,0.0,0.0,47,46,1,12.0,11.0,1.0
9310242,75,27,48,194,61,14,14,98,27.0,10.0,17.0,91.0,20.0,7.0,7.0,76,75,1,16.0,15.0,1.0
9506465,19,6,13,43,2,17,37,94,12.0,4.0,8.0,24.0,2.0,10.0,25.0,23,19,4,8.0,5.0,3.0
9310233,136,27,109,634,126,10,10,43,40.0,2.0,38.0,306.0,40.0,0.0,0.0,137,136,1,27.0,27.0,0.0
9503375,26,6,20,44,1,25,53,42,15.0,3.0,12.0,32.0,2.0,13.0,18.0,31,26,5,6.0,5.0,1.0
9504312,71,7,64,228,15,56,193,3,33.0,5.0,28.0,99.0,1.0,32.0,122.0,77,71,6,25.0,20.0,5.0
9506328,69,8,61,217,13,56,137,12,34.0,3.0,31.0,92.0,1.0,33.0,99.0,75,69,6,20.0,15.0,5.0
9607372,147,15,132,880,23,124,718,0,75.0,6.0,69.0,545.0,4.0,71.0,541.0,177,147,30,60.0,49.0,11.0
9807319,59,9,50,272,4,55,225,3,29.0,2.0,27.0,164.0,0.0,29.0,111.0,82,59,23,33.0,26.0,7.0
9906525,41,3,38,182,7,34,176,0,21.0,1.0,20.0,121.0,0.0,21.0,110.0,59,41,18,25.0,20.0,5.0
9909301,22,4,18,44,0,22,234,0,7.0,2.0,5.0,9.0,0.0,7.0,101.0,77,22,55,29.0,6.0,23.0
1124,17,6,11,26,2,15,89,0,3.0,3.0,0.0,0.0,1.0,2.0,6.0,51,17,34,5.0,0.0,5.0
9802314,109,7,102,599,18,91,251,3,55.0,3.0,52.0,350.0,12.0,43.0,67.0,136,109,27,36.0,35.0,1.0
9902293,24,9,15,34,0,24,251,3,14.0,7.0,7.0,17.0,0.0,14.0,116.0,72,24,48,19.0,4.0,15.0
9911275,20,10,10,15,1,19,99,3,5.0,4.0,1.0,1.0,0.0,5.0,37.0,59,20,39,18.0,3.0,15.0
9612247,2,2,0,0,2,0,0,1971,1.0,1.0,0.0,0.0,1.0,0.0,0.0,2,2,0,,,
9505395,23,2,21,58,16,7,10,0,11.0,2.0,9.0,19.0,8.0,3.0,5.0,26,23,3,3.0,3.0,0.0
9811201,37,5,32,140,1,36,205,12,26.0,2.0,24.0,118.0,1.0,25.0,140.0,55,37,18,18.0,15.0,3.0
9808207,13,3,10,16,7,6,14,215,5.0,3.0,2.0,4.0,4.0,1.0,2.0,17,13,4,4.0,1.0,3.0
9310307,10,3,7,12,9,1,1,358,7.0,1.0,6.0,11.0,7.0,0.0,0.0,13,10,3,4.0,4.0,0.0
9812381,21,7,14,57,0,21,175,0,15.0,2.0,13.0,53.0,0.0,15.0,126.0,57,21,36,22.0,13.0,9.0
9205214,28,2,26,114,28,0,0,50,20.0,2.0,18.0,85.0,20.0,0.0,0.0,28,28,0,11.0,11.0,0.0
9805368,10,4,6,9,0,10,76,0,6.0,2.0,4.0,7.0,0.0,6.0,54.0,37,10,27,23.0,5.0,18.0
9405399,43,4,39,134,18,25,62,10,8.0,1.0,7.0,13.0,0.0,8.0,26.0,51,43,8,8.0,8.0,0.0
9303202,212,45,167,876,202,10,11,10,56.0,12.0,44.0,202.0,56.0,0.0,0.0,214,212,2,25.0,25.0,0.0
9807321,6,2,4,6,6,0,0,81,5.0,1.0,4.0,6.0,5.0,0.0,0.0,7,6,1,1.0,1.0,0.0
9609260,5,4,1,1,2,3,7,51,3.0,3.0,0.0,0.0,1.0,2.0,4.0,13,5,8,1.0,1.0,0.0
9605246,23,3,20,79,2,21,68,21,17.0,2.0,15.0,68.0,0.0,17.0,54.0,34,23,11,7.0,4.0,3.0
9406319,108,6,102,584,107,1,1,42,45.0,4.0,41.0,247.0,45.0,0.0,0.0,110,108,2,27.0,27.0,0.0
9304205,69,16,53,147,68,1,1,3,16.0,3.0,13.0,37.0,16.0,0.0,0.0,70,69,1,13.0,13.0,0.0
9503344,73,8,65,252,54,19,22,30,18.0,1.0,17.0,34.0,18.0,0.0,0.0,75,73,2,8.0,8.0,0.0
9204234,38,19,19,35,38,0,0,243,14.0,5.0,9.0,17.0,14.0,0.0,0.0,38,38,0,7.0,7.0,0.0
9305268,1,1,0,0,1,0,0,81,,,,,,,,1,1,0,1.0,1.0,0.0
9902312,22,9,13,31,1,21,108,0,4.0,2.0,2.0,2.0,0.0,4.0,13.0,60,22,38,5.0,0.0,5.0
9604242,19,7,12,16,4,15,22,0,2.0,1.0,1.0,1.0,2.0,0.0,0.0,26,19,7,3.0,3.0,0.0
9411357,13,6,7,8,8,5,5,87,5.0,2.0,3.0,4.0,3.0,2.0,2.0,17,13,4,3.0,3.0,0.0
9903465,37,2,35,166,0,37,399,12,31.0,1.0,30.0,143.0,0.0,31.0,348.0,67,37,30,25.0,18.0,7.0
9608352,29,3,26,75,8,21,58,12,17.0,4.0,13.0,26.0,2.0,15.0,38.0,40,29,11,17.0,11.0,6.0
9806288,6,2,4,7,0,6,29,12,4.0,1.0,3.0,5.0,0.0,4.0,4.0,32,6,26,5.0,4.0,1.0
107121,7,3,4,7,2,5,20,87,4.0,1.0,3.0,5.0,1.0,3.0,13.0,15,7,8,10.0,4.0,6.0
9504326,84,3,81,535,8,76,264,1,58.0,2.0,56.0,426.0,4.0,54.0,216.0,94,84,10,31.0,25.0,6.0
9701231,103,19,84,394,6,97,706,1,25.0,3.0,22.0,104.0,3.0,22.0,56.0,179,103,76,16.0,13.0,3.0
9802361,42,6,36,120,1,41,150,1,25.0,3.0,22.0,72.0,0.0,25.0,95.0,51,42,9,24.0,19.0,5.0
3238,53,16,37,156,1,52,808,1,20.0,3.0,17.0,83.0,0.0,20.0,456.0,200,53,147,48.0,12.0,36.0
9908443,45,4,41,248,0,45,512,32,16.0,2.0,14.0,51.0,0.0,16.0,275.0,88,45,43,37.0,14.0,23.0
9904370,24,3,21,63,0,24,178,67,14.0,2.0,12.0,30.0,0.0,14.0,133.0,48,24,24,29.0,12.0,17.0
101098,14,5,9,17,2,12,55,34,6.0,3.0,3.0,5.0,1.0,5.0,10.0,31,14,17,17.0,5.0,12.0
9607225,85,9,76,483,8,77,360,5,50.0,2.0,48.0,369.0,0.0,50.0,274.0,96,85,11,38.0,29.0,9.0
9703246,36,2,34,88,1,35,271,5,21.0,2.0,19.0,52.0,0.0,21.0,190.0,60,36,24,21.0,7.0,14.0
9711220,11,3,8,18,0,11,115,5,6.0,1.0,5.0,8.0,0.0,6.0,81.0,34,11,23,15.0,4.0,11.0
9707259,62,7,55,186,3,59,252,1,33.0,3.0,30.0,100.0,1.0,32.0,114.0,78,62,16,27.0,23.0,4.0
9505285,51,14,37,142,30,21,21,74,20.0,6.0,14.0,40.0,9.0,11.0,11.0,53,51,2,14.0,13.0,1.0
9406262,55,9,46,172,36,19,24,1,11.0,7.0,4.0,10.0,5.0,6.0,7.0,60,55,5,13.0,13.0,0.0
9607214,58,6,52,316,16,42,94,1,38.0,2.0,36.0,241.0,19.0,19.0,26.0,69,58,11,24.0,22.0,2.0
111169,1,1,0,0,0,1,6,1850,,,,,,,,9,1,8,,,
1170,6,4,2,2,1,5,11,1,0.0,0.0,0.0,0.0,0.0,0.0,0.0,20,6,14,3.0,2.0,1.0
9705440,7,4,3,6,0,7,50,1,7.0,4.0,3.0,6.0,0.0,7.0,46.0,58,7,51,24.0,0.0,24.0
110093,2,1,1,1,0,2,14,1,2.0,1.0,1.0,1.0,0.0,2.0,12.0,35,2,33,3.0,0.0,3.0
9901378,11,5,6,8,2,9,20,7,0.0,0.0,0.0,0.0,0.0,0.0,0.0,23,11,12,4.0,0.0,4.0
9712368,60,35,25,41,45,15,58,92,0.0,0.0,0.0,0.0,0.0,0.0,0.0,88,60,28,4.0,4.0,0.0
9704300,19,6,13,20,10,9,16,1,2.0,2.0,0.0,0.0,2.0,0.0,0.0,31,19,12,3.0,1.0,2.0
9702414,16,3,13,31,1,15,50,141,15.0,3.0,12.0,30.0,1.0,14.0,33.0,32,16,16,14.0,10.0,4.0
9703391,14,11,3,4,5,9,38,4,0.0,0.0,0.0,0.0,0.0,0.0,0.0,48,14,34,2.0,2.0,0.0
9802277,20,13,7,14,5,15,103,21,9.0,6.0,3.0,6.0,0.0,9.0,38.0,56,20,36,13.0,5.0,8.0
9807254,26,3,23,67,3,23,125,7,16.0,1.0,15.0,36.0,0.0,16.0,54.0,43,26,17,8.0,6.0,2.0
9510404,8,7,1,1,1,7,23,7,1.0,1.0,0.0,0.0,0.0,1.0,3.0,18,8,10,1.0,1.0,0.0
9803454,61,5,56,301,7,54,388,24,38.0,2.0,36.0,213.0,0.0,38.0,250.0,89,61,28,28.0,17.0,11.0
7179,9,6,3,3,2,7,14,250,4.0,4.0,0.0,0.0,4.0,0.0,0.0,14,9,5,3.0,3.0,0.0
9512277,5,3,2,2,0,5,12,12,2.0,2.0,0.0,0.0,0.0,2.0,5.0,13,5,8,,,
9408253,81,16,65,199,16,65,223,10,27.0,6.0,21.0,79.0,0.0,27.0,121.0,95,81,14,12.0,12.0,0.0
9406419,4,2,2,2,4,0,0,69,2.0,1.0,1.0,1.0,2.0,0.0,0.0,8,4,4,1.0,1.0,0.0
9705432,26,7,19,51,5,21,25,76,17.0,7.0,10.0,30.0,3.0,14.0,16.0,32,26,6,12.0,10.0,2.0
9701379,10,1,9,16,0,10,10,98,7.0,1.0,6.0,12.0,0.0,7.0,7.0,11,10,1,9.0,8.0,1.0
9707323,35,11,24,57,25,10,41,19,11.0,3.0,8.0,19.0,4.0,7.0,27.0,46,35,11,12.0,5.0,7.0
9607317,31,12,19,55,4,27,112,30,18.0,5.0,13.0,33.0,0.0,18.0,90.0,49,31,18,16.0,4.0,12.0
9606449,16,5,11,22,3,13,38,62,6.0,2.0,4.0,7.0,0.0,6.0,15.0,26,16,10,5.0,4.0,1.0
9509212,29,7,22,67,2,27,63,5,13.0,2.0,11.0,40.0,0.0,13.0,24.0,40,29,11,14.0,12.0,2.0
9707313,35,3,32,200,1,34,164,24,25.0,1.0,24.0,169.0,1.0,24.0,101.0,48,35,13,28.0,23.0,5.0
9804332,66,7,59,316,5,61,78,16,45.0,3.0,42.0,236.0,1.0,44.0,44.0,69,66,3,27.0,26.0,1.0
9603218,12,6,6,12,6,6,6,127,9.0,4.0,5.0,10.0,3.0,6.0,6.0,14,12,2,4.0,3.0,1.0
9304296,22,14,8,11,22,0,0,47,6.0,6.0,0.0,0.0,6.0,0.0,0.0,22,22,0,5.0,5.0,0.0
107071,26,9,17,49,1,25,60,4,10.0,2.0,8.0,18.0,0.0,10.0,12.0,47,26,21,8.0,7.0,1.0
9707436,42,9,33,122,5,37,110,10,15.0,2.0,13.0,44.0,1.0,14.0,40.0,59,42,17,14.0,8.0,6.0
9207226,20,5,15,28,20,0,0,26,9.0,1.0,8.0,13.0,9.0,0.0,0.0,20,20,0,7.0,7.0,0.0
9811492,27,6,21,63,5,22,110,4,6.0,3.0,3.0,5.0,0.0,6.0,41.0,45,27,18,16.0,7.0,9.0
9410361,32,8,24,68,8,24,48,30,23.0,4.0,19.0,54.0,2.0,21.0,40.0,38,32,6,9.0,9.0,0.0
9211262,26,11,15,22,26,0,0,26,4.0,4.0,0.0,0.0,4.0,0.0,0.0,26,26,0,4.0,4.0,0.0
9312277,7,5,2,3,3,4,4,25,3.0,2.0,1.0,1.0,3.0,0.0,0.0,8,7,1,2.0,2.0,0.0
9409418,16,6,10,19,1,15,72,6,5.0,1.0,4.0,8.0,0.0,5.0,11.0,30,16,14,11.0,7.0,4.0
9605206,11,4,7,14,2,9,11,85,9.0,4.0,5.0,11.0,2.0,7.0,9.0,14,11,3,6.0,5.0,1.0
9907363,8,4,4,5,2,6,31,6,4.0,3.0,1.0,1.0,0.0,4.0,28.0,26,8,18,2.0,1.0,1.0
9403359,17,9,8,9,17,0,0,183,6.0,3.0,3.0,4.0,6.0,0.0,0.0,17,17,0,5.0,5.0,0.0
9505288,15,4,11,28,3,12,63,6,11.0,3.0,8.0,21.0,0.0,11.0,51.0,25,15,10,2.0,2.0,0.0
9412247,3,1,2,3,0,3,11,69,3.0,1.0,2.0,3.0,0.0,3.0,9.0,10,3,7,2.0,1.0,1.0
9403231,14,6,8,17,14,0,0,287,4.0,2.0,2.0,3.0,4.0,0.0,0.0,14,14,0,4.0,4.0,0.0
9308274,61,14,47,182,40,21,24,8,19.0,3.0,16.0,60.0,14.0,5.0,5.0,64,61,3,8.0,8.0,0.0
102020,6,1,5,9,1,5,14,38,6.0,1.0,5.0,9.0,2.0,4.0,4.0,14,6,8,7.0,5.0,2.0
9403320,29,7,22,81,29,0,0,22,19.0,2.0,17.0,65.0,19.0,0.0,0.0,29,29,0,13.0,13.0,0.0
9702273,18,13,5,5,8,10,31,51,6.0,6.0,0.0,0.0,0.0,6.0,19.0,26,18,8,7.0,3.0,4.0
9708207,37,15,22,75,4,33,96,38,9.0,7.0,2.0,2.0,0.0,9.0,20.0,48,37,11,11.0,7.0,4.0
9712210,6,2,4,7,2,4,9,22,5.0,1.0,4.0,7.0,1.0,4.0,9.0,11,6,5,5.0,4.0,1.0
9509409,18,4,14,28,0,18,78,38,15.0,3.0,12.0,25.0,0.0,15.0,46.0,30,18,12,8.0,5.0,3.0
9910299,6,3,3,6,0,6,87,22,5.0,2.0,3.0,5.0,0.0,5.0,66.0,52,6,46,24.0,3.0,21.0
9507395,16,5,11,18,0,16,24,104,6.0,2.0,4.0,6.0,0.0,6.0,10.0,19,16,3,7.0,5.0,2.0
9908204,5,5,0,0,0,5,7,15,0.0,0.0,0.0,0.0,0.0,0.0,0.0,31,5,26,3.0,1.0,2.0
9408233,32,15,17,35,15,17,18,52,15.0,7.0,8.0,18.0,4.0,11.0,12.0,34,32,2,8.0,7.0,1.0
9811520,8,1,7,12,1,7,40,21,6.0,1.0,5.0,10.0,1.0,5.0,38.0,22,8,14,19.0,6.0,13.0
9812476,15,8,7,15,4,11,18,21,5.0,4.0,1.0,1.0,3.0,2.0,2.0,19,15,4,12.0,8.0,4.0
9506357,28,4,24,99,1,27,92,16,17.0,4.0,13.0,42.0,1.0,16.0,63.0,36,28,8,18.0,14.0,4.0
9805315,26,5,21,71,1,25,131,16,18.0,2.0,16.0,56.0,0.0,18.0,43.0,41,26,15,20.0,17.0,3.0
9904507,10,1,9,26,0,10,78,43,9.0,1.0,8.0,22.0,0.0,9.0,73.0,25,10,15,22.0,8.0,14.0
9912388,33,8,25,83,0,33,249,43,25.0,5.0,20.0,67.0,0.0,25.0,196.0,57,33,24,26.0,11.0,15.0
9807297,108,25,83,232,36,72,121,77,16.0,5.0,11.0,24.0,0.0,16.0,36.0,124,108,16,13.0,8.0,5.0
9508403,75,16,59,154,45,30,50,39,19.0,2.0,17.0,30.0,19.0,0.0,0.0,80,75,5,13.0,13.0,0.0
102047,74,17,57,165,4,70,564,20,45.0,6.0,39.0,117.0,0.0,45.0,479.0,121,74,47,50.0,15.0,35.0
9912531,40,2,38,236,0,40,243,20,39.0,2.0,37.0,231.0,0.0,39.0,239.0,50,40,10,44.0,34.0,10.0
9204238,23,8,15,44,23,0,0,49,13.0,3.0,10.0,32.0,13.0,0.0,0.0,23,23,0,10.0,10.0,0.0
9405241,91,2,89,721,32,59,135,17,69.0,1.0,68.0,614.0,22.0,47.0,93.0,99,91,8,45.0,44.0,1.0
9803281,1,1,0,0,0,1,1,136,0.0,0.0,0.0,0.0,0.0,0.0,0.0,6,1,5,,,
9803341,10,1,9,35,0,10,29,20,2.0,1.0,1.0,1.0,0.0,2.0,2.0,15,10,5,1.0,0.0,1.0
11027,5,1,4,5,1,4,81,20,3.0,1.0,2.0,2.0,0.0,3.0,71.0,34,5,29,28.0,3.0,25.0
9302270,23,5,18,29,23,0,0,153,10.0,1.0,9.0,12.0,10.0,0.0,0.0,23,23,0,8.0,8.0,0.0
206023,8,2,6,15,0,8,47,37,7.0,2.0,5.0,12.0,0.0,7.0,39.0,17,8,9,14.0,8.0,6.0
9905244,13,2,11,27,0,13,121,2,5.0,3.0,2.0,2.0,0.0,5.0,61.0,32,13,19,11.0,4.0,7.0
9311232,39,6,33,127,7,32,71,6,25.0,4.0,21.0,89.0,0.0,25.0,60.0,44,39,5,22.0,19.0,3.0
9411233,81,16,65,179,14,67,160,10,21.0,5.0,16.0,40.0,2.0,19.0,67.0,90,81,9,11.0,10.0,1.0
9906270,19,6,13,25,1,18,68,5,9.0,2.0,7.0,18.0,0.0,9.0,27.0,35,19,16,6.0,1.0,5.0
9311352,11,9,2,2,9,2,2,60,2.0,2.0,0.0,0.0,2.0,0.0,0.0,12,11,1,3.0,3.0,0.0
9205227,20,4,16,34,20,0,0,5,5.0,5.0,0.0,0.0,5.0,0.0,0.0,20,20,0,2.0,2.0,0.0
9804359,7,2,5,9,0,7,14,5,0.0,0.0,0.0,0.0,0.0,0.0,0.0,16,7,9,3.0,1.0,2.0
9812345,8,4,4,6,0,8,52,99,3.0,1.0,2.0,3.0,0.0,3.0,25.0,42,8,34,15.0,3.0,12.0
9705386,17,5,12,24,9,8,25,42,8.0,3.0,5.0,12.0,5.0,3.0,3.0,27,17,10,4.0,3.0,1.0
9512340,12,5,7,15,0,12,62,15,2.0,1.0,1.0,1.0,0.0,2.0,3.0,30,12,18,9.0,0.0,9.0
9406257,11,5,6,6,11,0,0,35,2.0,2.0,0.0,0.0,2.0,0.0,0.0,11,11,0,4.0,4.0,0.0
9610458,17,1,16,72,0,17,49,158,15.0,3.0,12.0,61.0,2.0,13.0,21.0,26,17,9,17.0,15.0,2.0
9601233,44,21,23,40,20,24,59,30,7.0,3.0,4.0,6.0,1.0,6.0,16.0,80,44,36,10.0,7.0,3.0
9806301,20,4,16,31,5,15,58,4,5.0,2.0,3.0,5.0,1.0,4.0,22.0,41,20,21,5.0,0.0,5.0
9305277,19,4,15,51,19,0,0,4,11.0,1.0,10.0,37.0,11.0,0.0,0.0,19,19,0,11.0,11.0,0.0
9810504,12,4,8,20,1,11,11,95,8.0,2.0,6.0,18.0,0.0,8.0,8.0,13,12,1,6.0,5.0,1.0
9711506,8,6,2,2,8,0,0,310,1.0,1.0,0.0,0.0,1.0,0.0,0.0,17,8,9,6.0,0.0,6.0
9708445,2,2,0,0,0,2,9,310,2.0,2.0,0.0,0.0,0.0,2.0,9.0,7,2,5,7.0,2.0,5.0
9504228,12,5,7,11,11,1,1,348,4.0,2.0,2.0,3.0,4.0,0.0,0.0,13,12,1,3.0,3.0,0.0
9603272,15,2,13,35,5,10,25,81,12.0,2.0,10.0,24.0,2.0,10.0,24.0,20,15,5,9.0,9.0,0.0
9301274,5,2,3,5,5,0,0,293,4.0,2.0,2.0,3.0,4.0,0.0,0.0,5,5,0,3.0,3.0,0.0
9907524,26,3,23,48,1,25,37,41,7.0,1.0,6.0,12.0,1.0,6.0,6.0,34,26,8,2.0,2.0,0.0
9803453,46,10,36,68,8,38,157,23,13.0,4.0,9.0,14.0,0.0,13.0,35.0,60,46,14,18.0,14.0,4.0
9610325,111,31,80,302,57,54,72,31,60.0,8.0,52.0,213.0,28.0,32.0,32.0,114,111,3,22.0,21.0,1.0
9903279,6,2,4,4,0,6,14,227,5.0,1.0,4.0,4.0,1.0,4.0,12.0,13,6,7,8.0,5.0,3.0
9209289,71,17,54,192,71,0,0,6,30.0,4.0,26.0,103.0,30.0,0.0,0.0,71,71,0,5.0,5.0,0.0
9512334,17,5,12,21,1,16,42,6,4.0,4.0,0.0,0.0,4.0,0.0,0.0,25,17,8,7.0,6.0,1.0
9707217,14,5,9,13,0,14,108,6,9.0,2.0,7.0,11.0,0.0,9.0,95.0,44,14,30,9.0,3.0,6.0
9708255,58,16,42,111,7,51,225,8,7.0,3.0,4.0,7.0,0.0,7.0,47.0,91,58,33,16.0,12.0,4.0
9603228,6,4,2,3,6,0,0,153,4.0,2.0,2.0,3.0,4.0,0.0,0.0,6,6,0,3.0,3.0,0.0
9605386,8,6,2,2,0,8,39,10,4.0,4.0,0.0,0.0,0.0,4.0,13.0,21,8,13,7.0,4.0,3.0
9350,173,45,128,554,93,80,329,0,30.0,6.0,24.0,114.0,4.0,26.0,90.0,204,173,31,18.0,7.0,11.0
9707256,33,3,30,74,3,30,124,87,23.0,1.0,22.0,57.0,1.0,22.0,100.0,42,33,9,26.0,17.0,9.0
3163,21,5,16,54,4,17,53,0,11.0,2.0,9.0,34.0,4.0,7.0,20.0,35,21,14,9.0,4.0,5.0
9505327,18,12,6,7,13,5,5,26,4.0,4.0,0.0,0.0,4.0,0.0,0.0,20,18,2,3.0,2.0,1.0
9904310,44,13,31,99,9,35,139,46,20.0,4.0,16.0,62.0,1.0,19.0,91.0,64,44,20,19.0,12.0,7.0
9712479,18,6,12,25,1,17,69,31,15.0,4.0,11.0,24.0,0.0,15.0,59.0,34,18,16,13.0,6.0,7.0
9407214,14,5,9,49,0,14,82,124,12.0,3.0,9.0,49.0,0.0,12.0,74.0,25,14,11,20.0,12.0,8.0
9905481,113,12,101,793,12,101,393,18,72.0,8.0,64.0,535.0,4.0,68.0,257.0,142,113,29,47.0,42.0,5.0
11370,7,2,5,10,0,7,26,4,1.0,1.0,0.0,0.0,0.0,1.0,2.0,29,7,22,4.0,4.0,0.0
7120,11,9,2,5,0,11,54,27,9.0,7.0,2.0,4.0,0.0,9.0,48.0,23,11,12,9.0,6.0,3.0
302264,1,1,0,0,1,0,0,3,0.0,0.0,0.0,0.0,0.0,0.0,0.0,16,1,15,2.0,0.0,2.0
9508249,67,5,62,321,10,57,226,18,44.0,2.0,42.0,247.0,12.0,32.0,74.0,97,67,30,13.0,12.0,1.0
9903501,34,5,29,132,4,30,136,18,22.0,3.0,19.0,106.0,0.0,22.0,110.0,50,34,16,24.0,17.0,7.0
9903298,74,8,66,377,4,70,336,2,41.0,5.0,36.0,194.0,0.0,41.0,225.0,90,74,16,28.0,23.0,5.0
9907294,7,4,3,4,1,6,29,35,4.0,2.0,2.0,3.0,0.0,4.0,18.0,32,7,25,13.0,2.0,11.0
9504364,56,21,35,110,11,45,115,10,13.0,7.0,6.0,12.0,0.0,13.0,29.0,67,56,11,12.0,12.0,0.0
102105,2,2,0,0,1,1,2,86,1.0,1.0,0.0,0.0,0.0,1.0,1.0,10,2,8,3.0,1.0,2.0
11306,21,4,17,39,3,18,64,0,16.0,2.0,14.0,32.0,3.0,13.0,40.0,36,21,15,11.0,4.0,7.0
106201,3,3,0,0,0,3,7,0,0.0,0.0,0.0,0.0,0.0,0.0,0.0,12,3,9,4.0,1.0,3.0
206184,0,0,0,0,0,0,0,111,0.0,0.0,0.0,0.0,0.0,0.0,0.0,3,0,3,3.0,0.0,3.0
9503455,8,5,3,3,1,7,17,10,1.0,1.0,0.0,0.0,0.0,1.0,1.0,18,8,10,4.0,1.0,3.0
9504379,24,7,17,43,23,1,1,51,13.0,4.0,9.0,20.0,13.0,0.0,0.0,25,24,1,9.0,9.0,0.0
1299,35,8,27,101,5,30,64,65,23.0,4.0,19.0,75.0,0.0,23.0,41.0,44,35,9,20.0,17.0,3.0
3195,2,2,0,0,0,2,14,16,0.0,0.0,0.0,0.0,0.0,0.0,0.0,21,2,19,2.0,0.0,2.0
9707262,10,4,6,9,2,8,23,16,0.0,0.0,0.0,0.0,0.0,0.0,0.0,17,10,7,1.0,0.0,1.0
9904244,7,3,4,5,1,6,23,16,5.0,2.0,3.0,3.0,2.0,3.0,5.0,15,7,8,5.0,3.0,2.0
9810241,29,8,21,67,1,28,78,19,15.0,3.0,12.0,41.0,0.0,15.0,23.0,51,29,22,15.0,13.0,2.0
9505358,27,4,23,81,3,24,55,94,12.0,2.0,10.0,34.0,1.0,11.0,24.0,38,27,11,9.0,6.0,3.0
9711456,10,6,4,8,1,9,28,94,0.0,0.0,0.0,0.0,0.0,0.0,0.0,28,10,18,10.0,0.0,10.0
9402285,37,16,21,50,37,0,0,68,9.0,1.0,8.0,16.0,9.0,0.0,0.0,37,37,0,11.0,11.0,0.0
9602315,12,3,9,12,8,4,7,290,5.0,1.0,4.0,4.0,4.0,1.0,1.0,14,12,2,6.0,4.0,2.0
9301254,24,6,18,68,24,0,0,135,12.0,3.0,9.0,35.0,12.0,0.0,0.0,24,24,0,12.0,12.0,0.0
4129,5,3,2,2,1,4,47,2,1.0,1.0,0.0,0.0,0.0,1.0,12.0,54,5,49,22.0,0.0,22.0
9806223,16,4,12,22,1,15,93,0,7.0,2.0,5.0,8.0,0.0,7.0,49.0,36,16,20,5.0,4.0,1.0
9904446,1,1,0,0,0,1,6,2,0.0,0.0,0.0,0.0,0.0,0.0,0.0,14,1,13,1.0,0.0,1.0
101085,13,6,7,10,2,11,32,11,0.0,0.0,0.0,0.0,0.0,0.0,0.0,22,13,9,3.0,2.0,1.0
9408318,15,11,4,6,7,8,11,101,2.0,2.0,0.0,0.0,2.0,0.0,0.0,20,15,5,2.0,0.0,2.0
1161,10,5,5,8,0,10,34,44,6.0,2.0,4.0,7.0,0.0,6.0,11.0,25,10,15,9.0,6.0,3.0
211169,1,1,0,0,0,1,18,19,1.0,1.0,0.0,0.0,0.0,1.0,17.0,89,1,88,38.0,1.0,37.0
104261,14,2,12,34,1,13,55,80,9.0,2.0,7.0,19.0,1.0,8.0,32.0,27,14,13,15.0,10.0,5.0
9804333,1,1,0,0,0,1,1,25,0.0,0.0,0.0,0.0,0.0,0.0,0.0,6,1,5,2.0,0.0,2.0
111160,8,2,6,11,0,8,143,19,7.0,1.0,6.0,11.0,0.0,7.0,125.0,32,8,24,27.0,7.0,20.0
210023,4,4,0,0,1,3,17,19,1.0,1.0,0.0,0.0,0.0,1.0,6.0,21,4,17,9.0,1.0,8.0
111099,40,3,37,293,0,40,315,28,37.0,3.0,34.0,279.0,0.0,37.0,260.0,50,40,10,42.0,33.0,9.0
9906549,54,13,41,122,1,53,435,2,24.0,5.0,19.0,44.0,0.0,24.0,271.0,83,54,29,11.0,11.0,0.0
2224,30,6,24,127,0,30,164,2,20.0,3.0,17.0,88.0,0.0,20.0,119.0,39,30,9,25.0,19.0,6.0
9703449,79,2,77,517,5,74,218,9,58.0,1.0,57.0,448.0,5.0,53.0,122.0,85,79,6,47.0,43.0,4.0
9403318,30,5,25,79,2,28,49,26,23.0,4.0,19.0,59.0,1.0,22.0,43.0,32,30,2,18.0,16.0,2.0
9308270,29,12,17,63,29,0,0,131,14.0,3.0,11.0,53.0,14.0,0.0,0.0,30,29,1,12.0,12.0,0.0
104113,2,2,0,0,0,2,18,2,1.0,1.0,0.0,0.0,0.0,1.0,9.0,21,2,19,17.0,1.0,16.0
9908358,16,4,12,30,0,16,284,2,12.0,3.0,9.0,25.0,0.0,12.0,257.0,50,16,34,40.0,10.0,30.0
9812401,3,1,2,2,0,3,8,276,0.0,0.0,0.0,0.0,0.0,0.0,0.0,15,3,12,5.0,0.0,5.0
11200,9,4,5,10,0,9,84,32,5.0,3.0,2.0,3.0,0.0,5.0,43.0,41,9,32,13.0,3.0,10.0
202185,5,4,1,1,3,2,2,32,0.0,0.0,0.0,0.0,0.0,0.0,0.0,42,5,37,5.0,0.0,5.0
9910202,5,3,2,2,5,0,0,277,0.0,0.0,0.0,0.0,0.0,0.0,0.0,12,5,7,6.0,0.0,6.0
9809301,15,5,10,22,2,13,38,37,2.0,1.0,1.0,1.0,2.0,0.0,0.0,25,15,10,6.0,4.0,2.0
2109,9,4,5,6,0,9,26,107,1.0,1.0,0.0,0.0,0.0,1.0,2.0,23,9,14,7.0,1.0,6.0
9610507,25,8,17,41,9,16,82,12,4.0,3.0,1.0,1.0,0.0,4.0,21.0,40,25,15,6.0,1.0,5.0
9301231,18,9,9,19,6,12,14,164,10.0,6.0,4.0,6.0,2.0,8.0,8.0,21,18,3,3.0,3.0,0.0
9407265,3,2,1,1,1,2,6,234,0.0,0.0,0.0,0.0,0.0,0.0,0.0,13,3,10,2.0,0.0,2.0
9904450,10,3,7,13,0,10,48,86,6.0,1.0,5.0,9.0,0.0,6.0,20.0,20,10,10,11.0,7.0,4.0
9411362,0,0,0,0,0,0,0,194,0.0,0.0,0.0,0.0,0.0,0.0,0.0,1,0,1,,,
9803404,2,2,0,0,1,1,1,300,0.0,0.0,0.0,0.0,0.0,0.0,0.0,9,2,7,3.0,0.0,3.0
110278,8,6,2,3,0,8,73,1,2.0,2.0,0.0,0.0,0.0,2.0,23.0,64,8,56,31.0,0.0,31.0
11064,4,3,1,1,0,4,24,1,2.0,2.0,0.0,0.0,0.0,2.0,11.0,16,4,12,,,
9707523,32,8,24,92,6,26,67,67,14.0,3.0,11.0,36.0,1.0,13.0,41.0,39,32,7,7.0,5.0,2.0
108024,11,2,9,14,3,8,45,1,5.0,1.0,4.0,7.0,0.0,5.0,28.0,42,11,31,3.0,2.0,1.0
9411435,14,5,9,26,9,5,5,5,9.0,3.0,6.0,20.0,9.0,0.0,0.0,15,14,1,8.0,8.0,0.0
9506456,23,4,19,42,17,6,6,9,17.0,2.0,15.0,37.0,17.0,0.0,0.0,24,23,1,13.0,13.0,0.0
5209,11,3,8,20,3,8,35,9,2.0,1.0,1.0,1.0,2.0,0.0,0.0,18,11,7,2.0,2.0,0.0
9310261,70,21,49,197,70,0,0,16,30.0,7.0,23.0,103.0,30.0,0.0,0.0,70,70,0,17.0,17.0,0.0
9603400,90,7,83,372,0,90,712,17,71.0,7.0,64.0,328.0,0.0,71.0,635.0,110,90,20,57.0,40.0,17.0
9608413,29,9,20,49,0,29,222,17,24.0,6.0,18.0,45.0,0.0,24.0,198.0,44,29,15,29.0,17.0,12.0
9210277,22,8,14,21,22,0,0,26,3.0,2.0,1.0,1.0,3.0,0.0,0.0,22,22,0,3.0,3.0,0.0
9501268,4,3,1,2,2,2,3,211,2.0,2.0,0.0,0.0,1.0,1.0,1.0,6,4,2,2.0,2.0,0.0
9909537,7,5,2,2,1,6,11,168,0.0,0.0,0.0,0.0,0.0,0.0,0.0,13,7,6,6.0,3.0,3.0
9701375,20,4,16,28,3,17,41,6,3.0,2.0,1.0,1.0,0.0,3.0,3.0,31,20,11,6.0,3.0,3.0
9401281,8,4,4,7,8,0,0,154,4.0,1.0,3.0,6.0,4.0,0.0,0.0,9,8,1,4.0,4.0,0.0
9610212,9,5,4,4,3,6,49,8,5.0,2.0,3.0,3.0,0.0,5.0,48.0,27,9,18,3.0,1.0,2.0
9705239,0,0,0,0,0,0,0,182,0.0,0.0,0.0,0.0,0.0,0.0,0.0,10,0,10,7.0,0.0,7.0
204292,7,7,0,0,1,6,26,93,4.0,4.0,0.0,0.0,0.0,4.0,12.0,19,7,12,6.0,2.0,4.0
104015,1,1,0,0,0,1,2,44,0.0,0.0,0.0,0.0,0.0,0.0,0.0,13,1,12,7.0,0.0,7.0
9708220,21,5,16,33,6,15,34,1,3.0,2.0,1.0,1.0,0.0,3.0,3.0,29,21,8,8.0,6.0,2.0
9911317,15,3,12,34,0,15,118,12,13.0,2.0,11.0,31.0,0.0,13.0,95.0,67,15,52,6.0,2.0,4.0
9506387,11,4,7,8,7,4,4,88,7.0,1.0,6.0,7.0,4.0,3.0,3.0,13,11,2,4.0,4.0,0.0
9707328,10,5,5,9,0,10,22,36,3.0,3.0,0.0,0.0,1.0,2.0,6.0,22,10,12,3.0,3.0,0.0
9702367,92,22,70,232,31,61,155,54,22.0,7.0,15.0,32.0,0.0,22.0,55.0,133,92,41,15.0,11.0,4.0
9312279,44,10,34,134,44,0,0,54,20.0,2.0,18.0,71.0,20.0,0.0,0.0,44,44,0,12.0,12.0,0.0
9606389,7,4,3,4,1,6,28,68,4.0,2.0,2.0,2.0,0.0,4.0,17.0,21,7,14,10.0,4.0,6.0
102257,19,9,10,33,0,19,224,24,16.0,7.0,9.0,32.0,0.0,16.0,203.0,48,19,29,28.0,9.0,19.0
9708223,22,8,14,51,2,20,90,24,3.0,3.0,0.0,0.0,0.0,3.0,11.0,38,22,16,8.0,4.0,4.0
9505412,3,3,0,0,3,0,0,640,1.0,1.0,0.0,0.0,1.0,0.0,0.0,3,3,0,1.0,1.0,0.0
9808394,2,2,0,0,1,1,1,224,2.0,2.0,0.0,0.0,1.0,1.0,1.0,3,2,1,3.0,2.0,1.0
9407206,13,3,10,33,9,4,5,47,12.0,3.0,9.0,30.0,12.0,0.0,0.0,17,13,4,9.0,9.0,0.0
9705413,26,11,15,27,13,13,18,9,14.0,6.0,8.0,9.0,14.0,0.0,0.0,29,26,3,10.0,10.0,0.0
9701289,129,35,94,446,22,107,467,14,53.0,9.0,44.0,275.0,1.0,52.0,254.0,159,129,30,35.0,28.0,7.0
9308263,45,9,36,100,8,37,37,14,19.0,3.0,16.0,35.0,0.0,19.0,19.0,46,45,1,13.0,12.0,1.0
9311285,30,2,28,83,2,28,28,14,15.0,1.0,14.0,34.0,0.0,15.0,15.0,31,30,1,14.0,13.0,1.0
9207265,38,12,26,60,38,0,0,27,12.0,4.0,8.0,19.0,12.0,0.0,0.0,38,38,0,4.0,4.0,0.0
9804353,19,3,16,35,2,17,82,14,13.0,1.0,12.0,27.0,3.0,10.0,26.0,34,19,15,9.0,8.0,1.0
9306334,3,3,0,0,3,0,0,1283,1.0,1.0,0.0,0.0,1.0,0.0,0.0,4,3,1,1.0,1.0,0.0
9512404,82,4,78,393,1,81,252,13,48.0,2.0,46.0,225.0,0.0,48.0,172.0,97,82,15,20.0,16.0,4.0
9407202,7,5,2,3,6,1,1,1675,1.0,1.0,0.0,0.0,1.0,0.0,0.0,8,7,1,1.0,1.0,0.0
9707424,6,3,3,5,3,3,6,51,1.0,1.0,0.0,0.0,0.0,1.0,2.0,11,6,5,4.0,1.0,3.0
7268,15,3,12,36,0,15,85,43,12.0,2.0,10.0,32.0,0.0,12.0,82.0,28,15,13,20.0,10.0,10.0
9906540,1,1,0,0,0,1,1,8,0.0,0.0,0.0,0.0,0.0,0.0,0.0,25,1,24,2.0,0.0,2.0
9612372,4,1,3,3,4,0,0,25,0.0,0.0,0.0,0.0,0.0,0.0,0.0,31,4,27,2.0,0.0,2.0
9412345,25,7,18,44,13,12,21,57,6.0,2.0,4.0,5.0,6.0,0.0,0.0,30,25,5,4.0,4.0,0.0
9403292,22,14,8,29,21,1,1,16,6.0,3.0,3.0,9.0,6.0,0.0,0.0,23,22,1,8.0,8.0,0.0
9611421,4,3,1,1,2,2,2,186,0.0,0.0,0.0,0.0,0.0,0.0,0.0,8,4,4,1.0,0.0,1.0
9707438,9,4,5,9,2,7,42,66,5.0,1.0,4.0,6.0,0.0,5.0,23.0,18,9,9,11.0,4.0,7.0
9707305,9,3,6,12,0,9,44,13,8.0,3.0,5.0,11.0,0.0,8.0,41.0,18,9,9,15.0,8.0,7.0
9609394,2,2,0,0,2,0,0,1056,,,,,,,,2,2,0,1.0,1.0,0.0
9806493,13,4,9,15,2,11,27,97,9.0,1.0,8.0,14.0,2.0,7.0,7.0,18,13,5,5.0,5.0,0.0
9708480,27,9,18,58,0,27,55,8,14.0,3.0,11.0,28.0,0.0,14.0,29.0,33,27,6,12.0,9.0,3.0
9304229,9,5,4,6,2,7,10,223,1.0,1.0,0.0,0.0,0.0,1.0,1.0,13,9,4,1.0,1.0,0.0
9411252,10,3,7,15,0,10,59,15,5.0,3.0,2.0,2.0,1.0,4.0,8.0,20,10,10,9.0,5.0,4.0
9702378,16,3,13,48,16,0,0,36,14.0,1.0,13.0,48.0,14.0,0.0,0.0,16,16,0,1.0,1.0,0.0
9503351,45,15,30,84,15,30,53,47,16.0,2.0,14.0,34.0,5.0,11.0,16.0,50,45,5,10.0,9.0,1.0
9706211,5,4,1,2,5,0,0,67,2.0,1.0,1.0,1.0,2.0,0.0,0.0,11,5,6,2.0,2.0,0.0
10335,4,2,2,3,0,4,19,3,1.0,1.0,0.0,0.0,0.0,1.0,3.0,22,4,18,7.0,0.0,7.0
9706368,3,1,2,3,3,0,0,336,3.0,1.0,2.0,3.0,3.0,0.0,0.0,4,3,1,3.0,3.0,0.0
9909461,7,2,5,8,0,7,17,0,6.0,1.0,5.0,8.0,0.0,6.0,14.0,17,7,10,5.0,3.0,2.0
9310273,11,7,4,6,8,3,3,159,4.0,3.0,1.0,2.0,4.0,0.0,0.0,12,11,1,4.0,4.0,0.0
9403252,21,6,15,46,21,0,0,52,14.0,4.0,10.0,34.0,14.0,0.0,0.0,21,21,0,12.0,12.0,0.0
9804385,8,2,6,8,2,6,24,52,5.0,2.0,3.0,4.0,0.0,5.0,19.0,15,8,7,11.0,4.0,7.0
9402314,6,2,4,6,0,6,24,63,5.0,1.0,4.0,6.0,0.0,5.0,23.0,18,6,12,10.0,5.0,5.0
9704247,27,7,20,74,9,18,26,60,15.0,4.0,11.0,46.0,3.0,12.0,12.0,36,27,9,14.0,13.0,1.0
9606207,23,5,18,43,1,22,22,1,22.0,5.0,17.0,41.0,1.0,21.0,21.0,24,23,1,13.0,12.0,1.0
5222,5,3,2,2,1,4,17,128,4.0,3.0,1.0,1.0,0.0,4.0,16.0,14,5,9,10.0,3.0,7.0
9312297,3,3,0,0,2,1,2,120,1.0,1.0,0.0,0.0,1.0,0.0,0.0,5,3,2,,,
9605432,10,4,6,7,4,6,20,5,5.0,1.0,4.0,5.0,0.0,5.0,10.0,17,10,7,7.0,5.0,2.0
9812280,9,6,3,6,0,9,71,9,4.0,3.0,1.0,1.0,0.0,4.0,33.0,43,9,34,14.0,4.0,10.0
9601261,5,4,1,1,0,5,17,75,2.0,2.0,0.0,0.0,0.0,2.0,3.0,15,5,10,7.0,2.0,5.0
9805215,27,7,20,56,7,20,79,24,13.0,1.0,12.0,29.0,1.0,12.0,25.0,34,27,7,1.0,0.0,1.0
205257,4,3,1,1,0,4,26,95,1.0,1.0,0.0,0.0,0.0,1.0,4.0,30,4,26,6.0,1.0,5.0
103311,5,4,1,1,1,4,8,22,2.0,2.0,0.0,0.0,1.0,1.0,1.0,17,5,12,3.0,1.0,2.0
11227,4,1,3,3,0,4,9,21,4.0,1.0,3.0,3.0,0.0,4.0,9.0,11,4,7,4.0,3.0,1.0
9206233,8,4,4,4,8,0,0,369,3.0,3.0,0.0,0.0,3.0,0.0,0.0,8,8,0,5.0,5.0,0.0
1284,2,2,0,0,2,0,0,416,1.0,1.0,0.0,0.0,1.0,0.0,0.0,4,2,2,1.0,1.0,0.0
9507242,15,1,14,62,0,15,50,49,14.0,1.0,13.0,59.0,0.0,14.0,39.0,26,15,11,16.0,13.0,3.0
104176,4,3,1,1,0,4,21,27,3.0,2.0,1.0,1.0,0.0,3.0,17.0,14,4,10,2.0,0.0,2.0
9907470,3,3,0,0,0,3,11,14,1.0,1.0,0.0,0.0,0.0,1.0,2.0,10,3,7,4.0,1.0,3.0
9905552,11,4,7,22,0,11,51,56,7.0,3.0,4.0,7.0,0.0,7.0,38.0,19,11,8,5.0,3.0,2.0
9909472,9,3,6,16,2,7,31,30,4.0,2.0,2.0,4.0,2.0,2.0,4.0,21,9,12,1.0,0.0,1.0
9904318,11,4,7,26,1,10,40,2,1.0,1.0,0.0,0.0,0.0,1.0,1.0,17,11,6,2.0,1.0,1.0
9908415,16,5,11,28,0,16,94,58,9.0,2.0,7.0,16.0,1.0,8.0,15.0,38,16,22,15.0,9.0,6.0
104146,39,11,28,72,0,39,489,55,8.0,4.0,4.0,7.0,0.0,8.0,110.0,102,39,63,34.0,18.0,16.0
9811505,15,4,11,39,0,15,59,93,3.0,3.0,0.0,0.0,0.0,3.0,13.0,41,15,26,10.0,2.0,8.0
102213,6,2,4,5,0,6,35,13,2.0,2.0,0.0,0.0,0.0,2.0,25.0,35,6,29,15.0,2.0,13.0
9804231,10,7,3,3,0,10,28,18,5.0,3.0,2.0,2.0,1.0,4.0,15.0,55,10,45,5.0,1.0,4.0
9904206,43,3,40,161,4,39,135,21,23.0,2.0,21.0,70.0,5.0,18.0,30.0,52,43,9,19.0,16.0,3.0
9704313,2,2,0,0,0,2,3,14,1.0,1.0,0.0,0.0,1.0,0.0,0.0,7,2,5,1.0,1.0,0.0
9504225,1,1,0,0,0,1,2,64,1.0,1.0,0.0,0.0,0.0,1.0,2.0,3,1,2,1.0,0.0,1.0
107048,31,8,23,83,1,30,353,1,7.0,6.0,1.0,1.0,0.0,7.0,36.0,91,31,60,24.0,5.0,19.0
9311288,19,2,17,44,5,14,15,36,10.0,2.0,8.0,17.0,2.0,8.0,8.0,22,19,3,6.0,6.0,0.0
9704336,15,3,12,46,0,15,126,36,15.0,3.0,12.0,46.0,0.0,15.0,126.0,29,15,14,24.0,15.0,9.0
207006,5,3,2,3,0,5,35,3,3.0,2.0,1.0,1.0,0.0,3.0,15.0,51,5,46,13.0,2.0,11.0
9905565,6,3,3,4,1,5,8,36,5.0,2.0,3.0,4.0,1.0,4.0,4.0,8,6,2,3.0,2.0,1.0
9308351,14,7,7,15,14,0,0,13,2.0,2.0,0.0,0.0,2.0,0.0,0.0,17,14,3,2.0,2.0,0.0
108110,12,1,11,17,5,7,33,24,2.0,2.0,0.0,0.0,2.0,0.0,0.0,28,12,16,4.0,4.0,0.0
9410349,5,3,2,2,2,3,4,124,3.0,2.0,1.0,1.0,3.0,0.0,0.0,9,5,4,1.0,1.0,0.0
9906335,7,6,1,2,0,7,38,46,2.0,2.0,0.0,0.0,0.0,2.0,12.0,75,7,68,17.0,0.0,17.0
6359,11,5,6,12,1,10,41,102,4.0,1.0,3.0,4.0,0.0,4.0,15.0,23,11,12,8.0,4.0,4.0
9707317,6,2,4,6,0,6,15,42,4.0,1.0,3.0,4.0,0.0,4.0,11.0,12,6,6,5.0,4.0,1.0
9605353,8,5,3,4,6,2,3,229,0.0,0.0,0.0,0.0,0.0,0.0,0.0,14,8,6,2.0,0.0,2.0
9312339,5,2,3,3,5,0,0,237,4.0,1.0,3.0,3.0,4.0,0.0,0.0,6,5,1,4.0,4.0,0.0
9506258,9,5,4,4,9,0,0,30,4.0,3.0,1.0,1.0,4.0,0.0,0.0,9,9,0,2.0,2.0,0.0
9705251,69,4,65,369,4,65,107,1,43.0,2.0,41.0,239.0,3.0,40.0,60.0,74,69,5,32.0,30.0,2.0
9606469,5,1,4,7,0,5,100,1,3.0,1.0,2.0,3.0,0.0,3.0,77.0,38,5,33,22.0,3.0,19.0
9608344,7,2,5,6,0,7,12,98,5.0,1.0,4.0,5.0,0.0,5.0,9.0,10,7,3,7.0,5.0,2.0
8265,0,0,0,0,0,0,0,154,,,,,,,,1,0,1,,,
9401304,5,4,1,2,5,0,0,241,1.0,1.0,0.0,0.0,1.0,0.0,0.0,5,5,0,1.0,1.0,0.0
9707319,15,6,9,17,3,12,70,44,12.0,3.0,9.0,17.0,0.0,12.0,69.0,29,15,14,10.0,6.0,4.0
9612495,12,3,9,25,1,11,19,29,10.0,2.0,8.0,24.0,1.0,9.0,15.0,16,12,4,11.0,8.0,3.0
9605233,9,6,3,3,0,9,32,6,3.0,1.0,2.0,2.0,0.0,3.0,13.0,22,9,13,9.0,3.0,6.0
9911336,1,1,0,0,0,1,8,6,0.0,0.0,0.0,0.0,0.0,0.0,0.0,24,1,23,8.0,0.0,8.0
9403371,37,9,28,82,32,5,5,27,12.0,3.0,9.0,19.0,12.0,0.0,0.0,38,37,1,5.0,5.0,0.0
9905359,23,4,19,82,0,23,215,49,11.0,1.0,10.0,29.0,0.0,11.0,110.0,55,23,32,27.0,10.0,17.0
9602354,7,6,1,1,1,6,15,61,3.0,3.0,0.0,0.0,0.0,3.0,8.0,15,7,8,2.0,1.0,1.0
9708283,12,6,6,12,3,9,29,17,4.0,2.0,2.0,2.0,0.0,4.0,15.0,23,12,11,9.0,3.0,6.0
9911477,3,1,2,2,0,3,3,80,2.0,1.0,1.0,1.0,2.0,0.0,0.0,4,3,1,3.0,3.0,0.0
111107,19,9,10,25,2,17,93,22,14.0,4.0,10.0,24.0,0.0,14.0,64.0,41,19,22,15.0,10.0,5.0
9411336,12,7,5,7,4,8,10,88,6.0,4.0,2.0,2.0,1.0,5.0,5.0,14,12,2,4.0,3.0,1.0
9505441,21,11,10,14,20,1,1,306,8.0,5.0,3.0,3.0,8.0,0.0,0.0,25,21,4,3.0,3.0,0.0
103024,3,1,2,3,0,3,29,0,3.0,1.0,2.0,3.0,0.0,3.0,29.0,27,3,24,23.0,3.0,20.0
9903405,7,4,3,4,6,1,1,57,3.0,2.0,1.0,2.0,3.0,0.0,0.0,11,7,4,2.0,2.0,0.0
9706316,30,6,24,100,1,29,53,1,22.0,2.0,20.0,85.0,1.0,21.0,32.0,36,30,6,15.0,13.0,2.0
9710328,9,4,5,7,1,8,15,10,2.0,2.0,0.0,0.0,0.0,2.0,5.0,21,9,12,3.0,1.0,2.0
9810537,7,2,5,8,0,7,12,42,4.0,2.0,2.0,2.0,2.0,2.0,2.0,16,7,9,2.0,2.0,0.0
9807299,2,1,1,1,0,2,15,22,2.0,1.0,1.0,1.0,0.0,2.0,5.0,22,2,20,,,
109245,4,1,3,4,0,4,30,63,3.0,1.0,2.0,2.0,0.0,3.0,14.0,29,4,25,5.0,3.0,2.0
102093,29,7,22,69,0,29,334,11,21.0,3.0,18.0,64.0,0.0,21.0,277.0,81,29,52,39.0,18.0,21.0
1204,28,12,16,25,3,25,100,41,5.0,3.0,2.0,3.0,0.0,5.0,33.0,74,28,46,18.0,5.0,13.0
103004,0,0,0,0,0,0,0,226,0.0,0.0,0.0,0.0,0.0,0.0,0.0,6,0,6,1.0,0.0,1.0
203143,0,0,0,0,0,0,0,25,0.0,0.0,0.0,0.0,0.0,0.0,0.0,7,0,7,4.0,0.0,4.0
9906390,2,2,0,0,1,1,1,111,0.0,0.0,0.0,0.0,0.0,0.0,0.0,6,2,4,2.0,0.0,2.0
9611253,41,7,34,128,4,37,88,13,27.0,7.0,20.0,73.0,3.0,24.0,60.0,48,41,7,20.0,15.0,5.0
9608347,20,5,15,42,19,1,1,240,9.0,2.0,7.0,20.0,8.0,1.0,1.0,21,20,1,8.0,8.0,0.0
9508290,17,1,16,58,4,13,35,60,11.0,1.0,10.0,35.0,2.0,9.0,27.0,23,17,6,15.0,11.0,4.0
9604303,12,4,8,19,2,10,19,30,3.0,1.0,2.0,3.0,3.0,0.0,0.0,21,12,9,3.0,2.0,1.0
10161,4,3,1,1,0,4,23,9,3.0,2.0,1.0,1.0,0.0,3.0,16.0,24,4,20,8.0,2.0,6.0
9901329,9,7,2,2,3,6,12,74,2.0,2.0,0.0,0.0,0.0,2.0,4.0,26,9,17,10.0,2.0,8.0
9611244,20,2,18,38,8,12,22,48,10.0,1.0,9.0,17.0,1.0,9.0,16.0,22,20,2,11.0,9.0,2.0
9506428,1,1,0,0,1,0,0,61,0.0,0.0,0.0,0.0,0.0,0.0,0.0,8,1,7,2.0,0.0,2.0
108115,11,8,3,5,1,10,32,2,5.0,2.0,3.0,4.0,5.0,0.0,0.0,26,11,15,3.0,0.0,3.0
9910360,2,2,0,0,0,2,4,150,0.0,0.0,0.0,0.0,0.0,0.0,0.0,11,2,9,2.0,0.0,2.0
9506259,2,1,1,1,2,0,0,302,1.0,1.0,0.0,0.0,1.0,0.0,0.0,2,2,0,2.0,2.0,0.0
211446,1,1,0,0,1,0,0,32,0.0,0.0,0.0,0.0,0.0,0.0,0.0,63,1,62,6.0,0.0,6.0
108076,5,3,2,2,0,5,23,33,2.0,1.0,1.0,1.0,0.0,2.0,8.0,16,5,11,5.0,2.0,3.0
9810267,8,4,4,11,0,8,50,15,6.0,2.0,4.0,11.0,0.0,6.0,40.0,16,8,8,1.0,1.0,0.0
109246,2,2,0,0,0,2,9,19,1.0,1.0,0.0,0.0,0.0,1.0,3.0,10,2,8,2.0,0.0,2.0
112300,31,13,18,30,4,27,169,7,11.0,6.0,5.0,8.0,0.0,11.0,87.0,55,31,24,10.0,6.0,4.0
9809237,8,4,4,5,2,6,39,35,2.0,1.0,1.0,1.0,0.0,2.0,6.0,35,8,27,7.0,2.0,5.0
9501202,27,5,22,63,0,27,76,27,22.0,2.0,20.0,59.0,0.0,22.0,64.0,33,27,6,4.0,3.0,1.0
2091,13,3,10,24,0,13,113,27,12.0,2.0,10.0,24.0,0.0,12.0,92.0,33,13,20,16.0,8.0,8.0
9806365,6,5,1,1,0,6,8,79,3.0,2.0,1.0,1.0,0.0,3.0,3.0,8,6,2,4.0,3.0,1.0
109264,4,4,0,0,1,3,8,3,2.0,2.0,0.0,0.0,0.0,2.0,5.0,25,4,21,2.0,0.0,2.0
9901377,10,3,7,15,1,9,10,129,6.0,2.0,4.0,7.0,1.0,5.0,5.0,19,10,9,5.0,5.0,0.0
203209,7,4,3,8,0,7,23,3,3.0,2.0,1.0,2.0,0.0,3.0,5.0,16,7,9,5.0,3.0,2.0
109156,9,8,1,1,1,8,20,3,0.0,0.0,0.0,0.0,0.0,0.0,0.0,42,9,33,9.0,0.0,9.0
9903407,14,4,10,20,1,13,111,2,5.0,2.0,3.0,3.0,0.0,5.0,57.0,48,14,34,7.0,6.0,1.0
108120,24,1,23,94,0,24,269,37,24.0,1.0,23.0,94.0,0.0,24.0,264.0,46,24,22,39.0,21.0,18.0
9805248,3,2,1,1,1,2,6,92,1.0,1.0,0.0,0.0,0.0,1.0,5.0,13,3,10,1.0,0.0,1.0
207042,11,6,5,7,1,10,82,47,7.0,4.0,3.0,5.0,0.0,7.0,52.0,46,11,35,18.0,6.0,12.0
9605383,4,4,0,0,1,3,5,309,0.0,0.0,0.0,0.0,0.0,0.0,0.0,13,4,9,1.0,1.0,0.0
108005,39,8,31,102,5,34,142,3,17.0,3.0,14.0,40.0,0.0,17.0,69.0,51,39,12,18.0,12.0,6.0
202247,28,7,21,40,2,26,178,3,5.0,3.0,2.0,3.0,0.0,5.0,28.0,87,28,59,11.0,7.0,4.0
9909281,2,1,1,1,0,2,32,5,2.0,1.0,1.0,1.0,0.0,2.0,21.0,30,2,28,25.0,2.0,23.0
9603371,8,5,3,3,3,5,26,3,1.0,1.0,0.0,0.0,0.0,1.0,9.0,32,8,24,3.0,1.0,2.0
9807494,20,5,15,31,0,20,142,8,5.0,1.0,4.0,5.0,0.0,5.0,37.0,52,20,32,12.0,4.0,8.0
102149,1,1,0,0,1,0,0,71,0.0,0.0,0.0,0.0,0.0,0.0,0.0,13,1,12,10.0,0.0,10.0
9703248,18,3,15,40,2,16,50,100,13.0,1.0,12.0,30.0,2.0,11.0,39.0,27,18,9,15.0,7.0,8.0
206116,0,0,0,0,0,0,0,624,0.0,0.0,0.0,0.0,0.0,0.0,0.0,7,0,7,1.0,0.0,1.0
9610443,2,1,1,1,0,2,5,126,1.0,1.0,0.0,0.0,0.0,1.0,2.0,5,2,3,4.0,2.0,2.0
9904420,21,3,18,70,0,21,162,11,21.0,3.0,18.0,70.0,0.0,21.0,159.0,39,21,18,4.0,2.0,2.0
9806298,24,4,20,61,7,17,58,47,12.0,3.0,9.0,25.0,2.0,10.0,30.0,32,24,8,17.0,11.0,6.0
9610217,26,5,21,109,16,10,10,13,22.0,3.0,19.0,100.0,14.0,8.0,8.0,27,26,1,18.0,18.0,0.0
101306,3,3,0,0,0,3,22,2,2.0,2.0,0.0,0.0,0.0,2.0,8.0,16,3,13,10.0,3.0,7.0
9507334,1,1,0,0,1,0,0,1962,1.0,1.0,0.0,0.0,1.0,0.0,0.0,1,1,0,1.0,1.0,0.0
9412314,2,2,0,0,2,0,0,72,,,,,,,,2,2,0,1.0,1.0,0.0
9809435,6,3,3,6,6,0,0,15,0.0,0.0,0.0,0.0,0.0,0.0,0.0,10,6,4,2.0,0.0,2.0
9805396,13,8,5,9,0,13,41,44,8.0,4.0,4.0,8.0,0.0,8.0,25.0,22,13,9,4.0,3.0,1.0
9901430,19,5,14,41,3,16,34,65,12.0,3.0,9.0,24.0,3.0,9.0,9.0,28,19,9,6.0,5.0,1.0
9809292,11,3,8,13,3,8,17,168,3.0,1.0,2.0,3.0,0.0,3.0,8.0,19,11,8,6.0,3.0,3.0
9902408,10,1,9,35,1,9,37,102,9.0,1.0,8.0,32.0,0.0,9.0,37.0,15,10,5,14.0,9.0,5.0
9504433,6,5,1,1,3,3,6,231,4.0,3.0,1.0,1.0,3.0,1.0,1.0,11,6,5,3.0,2.0,1.0
207341,0,0,0,0,0,0,0,257,0.0,0.0,0.0,0.0,0.0,0.0,0.0,11,0,11,3.0,0.0,3.0
10116,11,6,5,7,1,10,16,104,3.0,1.0,2.0,2.0,1.0,2.0,2.0,19,11,8,3.0,3.0,0.0
9502217,7,2,5,7,3,4,4,214,7.0,2.0,5.0,7.0,3.0,4.0,4.0,10,7,3,6.0,5.0,1.0
9307327,4,1,3,4,4,0,0,304,1.0,1.0,0.0,0.0,1.0,0.0,0.0,4,4,0,2.0,2.0,0.0
9807322,2,1,1,1,0,2,2,128,0.0,0.0,0.0,0.0,0.0,0.0,0.0,4,2,2,1.0,0.0,1.0
104205,13,3,10,34,1,12,181,109,11.0,1.0,10.0,34.0,0.0,11.0,177.0,42,13,29,34.0,11.0,23.0
103316,8,3,5,15,0,8,53,109,7.0,2.0,5.0,15.0,0.0,7.0,52.0,20,8,12,15.0,7.0,8.0
9601368,4,3,1,1,0,4,44,75,1.0,1.0,0.0,0.0,0.0,1.0,15.0,26,4,22,19.0,2.0,17.0
9907466,7,2,5,12,0,7,39,12,7.0,2.0,5.0,12.0,0.0,7.0,39.0,27,7,20,20.0,3.0,17.0
201287,24,4,20,40,5,19,43,50,5.0,1.0,4.0,5.0,0.0,5.0,7.0,40,24,16,7.0,5.0,2.0
9121,1,1,0,0,0,1,2,135,,,,,,,,3,1,2,2.0,1.0,1.0
9705450,10,6,4,5,2,8,14,170,3.0,3.0,0.0,0.0,0.0,3.0,5.0,29,10,19,2.0,1.0,1.0
12209,6,2,4,10,0,6,12,102,3.0,2.0,1.0,2.0,1.0,2.0,2.0,12,6,6,3.0,2.0,1.0
9711352,3,3,0,0,0,3,25,36,2.0,2.0,0.0,0.0,0.0,2.0,22.0,36,3,33,25.0,1.0,24.0
9909551,3,3,0,0,2,1,4,22,2.0,2.0,0.0,0.0,2.0,0.0,0.0,14,3,11,4.0,1.0,3.0
9608389,12,6,6,8,0,12,31,6,5.0,2.0,3.0,4.0,0.0,5.0,11.0,23,12,11,5.0,4.0,1.0
9807390,17,5,12,26,1,16,159,5,7.0,1.0,6.0,11.0,0.0,7.0,115.0,48,17,31,35.0,6.0,29.0
9610454,1,1,0,0,0,1,1,127,,,,,,,,2,1,1,,,
9409417,1,1,0,0,0,1,2,372,1.0,1.0,0.0,0.0,0.0,1.0,1.0,7,1,6,1.0,1.0,0.0
9905219,7,4,3,6,2,5,61,2,5.0,2.0,3.0,6.0,0.0,5.0,61.0,40,7,33,19.0,4.0,15.0
9806444,10,6,4,7,2,8,17,49,2.0,1.0,1.0,1.0,0.0,2.0,4.0,16,10,6,2.0,2.0,0.0
9706365,10,3,7,15,4,6,24,8,7.0,3.0,4.0,7.0,2.0,5.0,20.0,15,10,5,10.0,5.0,5.0
9909410,1,1,0,0,0,1,1,23,,,,,,,,4,1,3,,,
2261,9,5,4,9,0,9,29,6,0.0,0.0,0.0,0.0,0.0,0.0,0.0,33,9,24,7.0,5.0,2.0
205255,5,4,1,1,1,4,13,24,3.0,3.0,0.0,0.0,1.0,2.0,5.0,14,5,9,5.0,3.0,2.0
9911408,16,15,1,1,11,5,8,64,5.0,5.0,0.0,0.0,3.0,2.0,2.0,23,16,7,3.0,2.0,1.0
9301256,2,2,0,0,2,0,0,154,1.0,1.0,0.0,0.0,1.0,0.0,0.0,2,2,0,1.0,1.0,0.0
6141,4,3,1,2,0,4,9,106,4.0,3.0,1.0,2.0,0.0,4.0,8.0,8,4,4,4.0,2.0,2.0
9408360,6,5,1,1,5,1,1,124,1.0,1.0,0.0,0.0,1.0,0.0,0.0,7,6,1,1.0,1.0,0.0
9910375,3,2,1,1,0,3,12,222,2.0,1.0,1.0,1.0,0.0,2.0,10.0,11,3,8,7.0,2.0,5.0
9901266,9,3,6,13,0,9,39,29,5.0,1.0,4.0,7.0,0.0,5.0,28.0,27,9,18,14.0,6.0,8.0
103047,7,1,6,6,2,5,31,24,3.0,1.0,2.0,2.0,2.0,1.0,3.0,23,7,16,4.0,1.0,3.0
9710367,9,4,5,7,2,7,20,14,1.0,1.0,0.0,0.0,1.0,0.0,0.0,21,9,12,3.0,1.0,2.0
102224,11,1,10,17,0,11,65,9,8.0,1.0,7.0,14.0,0.0,8.0,51.0,22,11,11,7.0,2.0,5.0
9712205,8,4,4,5,1,7,14,6,0.0,0.0,0.0,0.0,0.0,0.0,0.0,16,8,8,2.0,1.0,1.0
9602327,8,4,4,10,8,0,0,41,8.0,4.0,4.0,10.0,8.0,0.0,0.0,10,8,2,8.0,8.0,0.0
9901237,1,1,0,0,0,1,3,4,0.0,0.0,0.0,0.0,0.0,0.0,0.0,19,1,18,1.0,0.0,1.0
9609370,9,5,4,4,0,9,28,18,4.0,3.0,1.0,1.0,1.0,3.0,3.0,15,9,6,7.0,5.0,2.0
9806420,1,1,0,0,0,1,5,27,0.0,0.0,0.0,0.0,0.0,0.0,0.0,8,1,7,1.0,0.0,1.0
9712496,25,7,18,34,6,19,67,13,10.0,1.0,9.0,16.0,2.0,8.0,30.0,53,25,28,5.0,3.0,2.0
9905476,1,1,0,0,0,1,2,128,0.0,0.0,0.0,0.0,0.0,0.0,0.0,10,1,9,3.0,1.0,2.0
9911315,29,11,18,60,3,26,106,46,19.0,3.0,16.0,54.0,0.0,19.0,74.0,53,29,24,22.0,14.0,8.0
2302,1,1,0,0,1,0,0,151,0.0,0.0,0.0,0.0,0.0,0.0,0.0,3,1,2,1.0,0.0,1.0
109189,1,1,0,0,0,1,1,43,0.0,0.0,0.0,0.0,0.0,0.0,0.0,20,1,19,3.0,0.0,3.0
9710518,3,2,1,1,1,2,8,14,2.0,1.0,1.0,1.0,0.0,2.0,8.0,7,3,4,6.0,2.0,4.0
9802317,2,1,1,1,2,0,0,516,0.0,0.0,0.0,0.0,0.0,0.0,0.0,4,2,2,2.0,1.0,1.0
1288,4,1,3,3,1,3,11,143,2.0,2.0,0.0,0.0,0.0,2.0,5.0,14,4,10,7.0,3.0,4.0
9906336,4,4,0,0,0,4,18,32,1.0,1.0,0.0,0.0,0.0,1.0,2.0,13,4,9,2.0,1.0,1.0
9912210,15,3,12,29,4,11,93,3,11.0,3.0,8.0,21.0,2.0,9.0,87.0,32,15,17,11.0,6.0,5.0
10204,4,3,1,2,0,4,19,56,3.0,3.0,0.0,0.0,0.0,3.0,14.0,13,4,9,1.0,1.0,0.0
9804422,2,2,0,0,0,2,10,56,2.0,2.0,0.0,0.0,0.0,2.0,10.0,8,2,6,,,
9711503,7,5,2,2,0,7,14,13,2.0,1.0,1.0,1.0,0.0,2.0,4.0,18,7,11,1.0,0.0,1.0
207253,2,2,0,0,0,2,15,193,1.0,1.0,0.0,0.0,0.0,1.0,9.0,19,2,17,11.0,1.0,10.0
9810214,2,2,0,0,0,2,3,95,2.0,2.0,0.0,0.0,0.0,2.0,2.0,13,2,11,2.0,0.0,2.0
9801333,4,4,0,0,0,4,15,38,2.0,2.0,0.0,0.0,0.0,2.0,6.0,15,4,11,7.0,1.0,6.0
208139,1,1,0,0,0,1,3,21,1.0,1.0,0.0,0.0,0.0,1.0,3.0,10,1,9,1.0,0.0,1.0
302192,0,0,0,0,0,0,0,15,0.0,0.0,0.0,0.0,0.0,0.0,0.0,17,0,17,2.0,0.0,2.0
9210257,3,1,2,2,3,0,0,955,,,,,,,,4,3,1,,,
9406349,5,1,4,5,0,5,7,284,5.0,1.0,4.0,5.0,0.0,5.0,7.0,7,5,2,7.0,5.0,2.0
201296,40,5,35,121,6,34,57,27,30.0,1.0,29.0,99.0,4.0,26.0,38.0,44,40,4,22.0,20.0,2.0
112156,3,2,1,1,0,3,26,8,2.0,1.0,1.0,1.0,0.0,2.0,18.0,29,3,26,3.0,1.0,2.0
9708210,5,4,1,1,5,0,0,395,3.0,2.0,1.0,1.0,3.0,0.0,0.0,5,5,0,2.0,2.0,0.0
9903368,2,1,1,1,1,1,1,74,1.0,1.0,0.0,0.0,1.0,0.0,0.0,3,2,1,1.0,1.0,0.0
9908445,2,2,0,0,2,0,0,221,1.0,1.0,0.0,0.0,1.0,0.0,0.0,2,2,0,1.0,1.0,0.0
9912361,4,3,1,1,0,4,15,45,2.0,1.0,1.0,1.0,0.0,2.0,9.0,19,4,15,7.0,2.0,5.0
301003,0,0,0,0,0,0,0,39,0.0,0.0,0.0,0.0,0.0,0.0,0.0,18,0,18,6.0,0.0,6.0
9608385,5,5,0,0,1,4,4,380,5.0,5.0,0.0,0.0,2.0,3.0,3.0,10,5,5,4.0,3.0,1.0
9901333,6,4,2,2,0,6,21,39,1.0,1.0,0.0,0.0,0.0,1.0,8.0,20,6,14,9.0,1.0,8.0
7105,3,3,0,0,2,1,1,1,2.0,2.0,0.0,0.0,1.0,1.0,1.0,14,3,11,2.0,0.0,2.0
9910342,7,4,3,7,0,7,29,78,6.0,3.0,3.0,4.0,0.0,6.0,24.0,20,7,13,13.0,6.0,7.0
109030,24,4,20,50,3,21,120,46,11.0,1.0,10.0,20.0,0.0,11.0,40.0,51,24,27,11.0,3.0,8.0
109154,8,2,6,13,0,8,94,73,7.0,2.0,5.0,9.0,0.0,7.0,60.0,31,8,23,14.0,7.0,7.0
9912478,7,4,3,7,0,7,48,73,3.0,1.0,2.0,3.0,0.0,3.0,19.0,29,7,22,4.0,1.0,3.0
9508360,7,7,0,0,7,0,0,104,0.0,0.0,0.0,0.0,0.0,0.0,0.0,9,7,2,2.0,2.0,0.0
9901289,6,2,4,8,3,3,4,159,5.0,2.0,3.0,7.0,2.0,3.0,4.0,13,6,7,6.0,4.0,2.0
9703225,10,5,5,8,6,4,4,258,5.0,1.0,4.0,6.0,2.0,3.0,3.0,12,10,2,2.0,2.0,0.0
9204203,3,3,0,0,3,0,0,426,1.0,1.0,0.0,0.0,1.0,0.0,0.0,3,3,0,1.0,1.0,0.0
12291,4,2,2,3,0,4,42,50,4.0,2.0,2.0,3.0,0.0,4.0,41.0,21,4,17,18.0,4.0,14.0
9805398,5,1,4,4,5,0,0,50,3.0,1.0,2.0,2.0,3.0,0.0,0.0,5,5,0,3.0,3.0,0.0
9602410,4,2,2,3,1,3,11,304,3.0,1.0,2.0,3.0,1.0,2.0,2.0,13,4,9,4.0,3.0,1.0
2133,10,8,2,4,2,8,15,147,2.0,2.0,0.0,0.0,0.0,2.0,3.0,14,10,4,3.0,1.0,2.0
9806378,1,1,0,0,0,1,1,1641,0.0,0.0,0.0,0.0,0.0,0.0,0.0,10,1,9,1.0,0.0,1.0
9908470,1,1,0,0,0,1,4,13,0.0,0.0,0.0,0.0,0.0,0.0,0.0,10,1,9,7.0,0.0,7.0
9509233,4,2,2,2,0,4,24,48,3.0,2.0,1.0,1.0,0.0,3.0,12.0,20,4,16,5.0,0.0,5.0
9810532,5,5,0,0,5,0,0,67,,,,,,,,5,5,0,2.0,2.0,0.0
9807268,7,5,2,2,4,3,5,11,2.0,1.0,1.0,1.0,1.0,1.0,1.0,14,7,7,1.0,0.0,1.0
9300,2,2,0,0,0,2,9,183,1.0,1.0,0.0,0.0,0.0,1.0,6.0,17,2,15,8.0,1.0,7.0
9904475,5,4,1,1,0,5,31,6,0.0,0.0,0.0,0.0,0.0,0.0,0.0,28,5,23,8.0,3.0,5.0
9609240,4,3,1,1,0,4,33,15,4.0,3.0,1.0,1.0,0.0,4.0,32.0,26,4,22,17.0,1.0,16.0
9411438,26,6,20,56,21,5,5,51,17.0,3.0,14.0,46.0,17.0,0.0,0.0,27,26,1,12.0,12.0,0.0
9404215,4,3,1,1,4,0,0,398,2.0,2.0,0.0,0.0,2.0,0.0,0.0,5,4,1,1.0,1.0,0.0
9406429,1,1,0,0,1,0,0,121,,,,,,,,3,1,2,,,
11244,6,4,2,2,0,6,48,26,3.0,3.0,0.0,0.0,0.0,3.0,27.0,75,6,69,22.0,4.0,18.0
9806541,12,1,11,18,2,10,31,72,8.0,1.0,7.0,9.0,2.0,6.0,17.0,32,12,20,7.0,6.0,1.0
9801228,4,2,2,3,1,3,8,9,0.0,0.0,0.0,0.0,0.0,0.0,0.0,35,4,31,7.0,0.0,7.0
9712487,2,1,1,1,0,2,2,164,1.0,1.0,0.0,0.0,0.0,1.0,1.0,5,2,3,,,
9709501,2,1,1,1,0,2,8,141,2.0,1.0,1.0,1.0,0.0,2.0,3.0,8,2,6,2.0,1.0,1.0
108085,31,5,26,111,2,29,232,0,25.0,3.0,22.0,102.0,0.0,25.0,217.0,67,31,36,37.0,11.0,26.0
203052,2,1,1,1,0,2,7,0,0.0,0.0,0.0,0.0,0.0,0.0,0.0,12,2,10,1.0,0.0,1.0
9804204,3,3,0,0,3,0,0,251,2.0,2.0,0.0,0.0,2.0,0.0,0.0,3,3,0,1.0,1.0,0.0
103274,16,8,8,14,2,14,51,65,11.0,4.0,7.0,13.0,0.0,11.0,41.0,40,16,24,13.0,5.0,8.0
109046,1,1,0,0,0,1,2,77,1.0,1.0,0.0,0.0,1.0,0.0,0.0,6,1,5,1.0,1.0,0.0
9910248,2,2,0,0,0,2,4,31,1.0,1.0,0.0,0.0,1.0,0.0,0.0,5,2,3,1.0,1.0,0.0
7011,14,3,11,16,4,10,60,3,9.0,2.0,7.0,12.0,1.0,8.0,42.0,43,14,29,4.0,2.0,2.0
205066,5,4,1,1,0,5,19,381,3.0,3.0,0.0,0.0,0.0,3.0,7.0,23,5,18,7.0,1.0,6.0
208097,2,2,0,0,0,2,3,107,0.0,0.0,0.0,0.0,0.0,0.0,0.0,18,2,16,4.0,0.0,4.0
201129,2,2,0,0,0,2,11,81,1.0,1.0,0.0,0.0,0.0,1.0,6.0,24,2,22,8.0,1.0,7.0
7182,36,9,27,87,0,36,96,108,22.0,2.0,20.0,70.0,0.0,22.0,48.0,55,36,19,15.0,12.0,3.0
9711477,6,2,4,4,0,6,18,22,6.0,2.0,4.0,4.0,0.0,6.0,18.0,10,6,4,9.0,6.0,3.0
9611264,6,2,4,7,0,6,30,17,6.0,2.0,4.0,7.0,0.0,6.0,28.0,13,6,7,4.0,4.0,0.0
9402309,8,6,2,2,8,0,0,452,1.0,1.0,0.0,0.0,1.0,0.0,0.0,8,8,0,2.0,2.0,0.0
207002,5,4,1,1,0,5,23,6,1.0,1.0,0.0,0.0,0.0,1.0,2.0,20,5,15,3.0,1.0,2.0
207193,1,1,0,0,1,0,0,233,0.0,0.0,0.0,0.0,0.0,0.0,0.0,4,1,3,1.0,1.0,0.0
209225,2,1,1,1,1,1,3,59,0.0,0.0,0.0,0.0,0.0,0.0,0.0,15,2,13,4.0,2.0,2.0
9810321,4,4,0,0,2,2,5,33,1.0,1.0,0.0,0.0,0.0,1.0,4.0,17,4,13,2.0,1.0,1.0
112226,9,5,4,9,1,8,36,0,5.0,1.0,4.0,9.0,0.0,5.0,13.0,29,9,20,8.0,5.0,3.0
9905341,5,3,2,2,0,5,7,163,3.0,2.0,1.0,1.0,0.0,3.0,3.0,10,5,5,5.0,3.0,2.0
6239,5,3,2,3,5,0,0,259,5.0,3.0,2.0,3.0,5.0,0.0,0.0,6,5,1,3.0,3.0,0.0
9504432,2,1,1,1,0,2,12,25,2.0,1.0,1.0,1.0,0.0,2.0,10.0,12,2,10,2.0,0.0,2.0
204191,9,7,2,2,0,9,63,9,7.0,5.0,2.0,2.0,0.0,7.0,32.0,31,9,22,13.0,6.0,7.0
9606305,8,2,6,12,3,5,16,172,6.0,1.0,5.0,9.0,2.0,4.0,10.0,17,8,9,9.0,6.0,3.0
302222,0,0,0,0,0,0,0,42,0.0,0.0,0.0,0.0,0.0,0.0,0.0,17,0,17,1.0,0.0,1.0
210173,4,1,3,3,0,4,65,1,4.0,1.0,3.0,3.0,0.0,4.0,59.0,35,4,31,21.0,4.0,17.0
9705370,2,2,0,0,0,2,10,36,2.0,2.0,0.0,0.0,0.0,2.0,10.0,7,2,5,,,
9406294,6,3,3,4,0,6,6,94,1.0,1.0,0.0,0.0,1.0,0.0,0.0,8,6,2,2.0,1.0,1.0
9908507,2,2,0,0,0,2,6,101,1.0,1.0,0.0,0.0,0.0,1.0,2.0,13,2,11,7.0,0.0,7.0
9409357,8,4,4,5,8,0,0,204,2.0,2.0,0.0,0.0,2.0,0.0,0.0,8,8,0,2.0,2.0,0.0
7023,3,1,2,2,0,3,8,174,3.0,1.0,2.0,2.0,0.0,3.0,8.0,7,3,4,6.0,3.0,3.0
10342,3,3,0,0,1,2,4,59,1.0,1.0,0.0,0.0,0.0,1.0,1.0,10,3,7,1.0,1.0,0.0
9601364,1,1,0,0,0,1,1,254,1.0,1.0,0.0,0.0,0.0,1.0,1.0,2,1,1,2.0,1.0,1.0
6197,12,1,11,52,0,12,27,66,12.0,1.0,11.0,52.0,0.0,12.0,12.0,16,12,4,13.0,12.0,1.0
108040,9,3,6,14,0,9,49,20,9.0,3.0,6.0,14.0,0.0,9.0,47.0,19,9,10,13.0,6.0,7.0
110275,7,2,5,9,0,7,138,2,7.0,2.0,5.0,9.0,0.0,7.0,127.0,68,7,61,29.0,5.0,24.0
12300,3,2,1,1,0,3,28,12,3.0,2.0,1.0,1.0,0.0,3.0,28.0,40,3,37,17.0,2.0,15.0
211293,0,0,0,0,0,0,0,268,0.0,0.0,0.0,0.0,0.0,0.0,0.0,5,0,5,5.0,0.0,5.0
7333,6,4,2,2,0,6,30,24,5.0,3.0,2.0,2.0,0.0,5.0,26.0,19,6,13,3.0,1.0,2.0
9710211,1,1,0,0,0,1,3,47,1.0,1.0,0.0,0.0,0.0,1.0,2.0,11,1,10,3.0,0.0,3.0
202056,7,5,2,2,5,2,7,1,1.0,1.0,0.0,0.0,0.0,1.0,5.0,40,7,33,15.0,1.0,14.0
3210,3,3,0,0,0,3,10,0,1.0,1.0,0.0,0.0,0.0,1.0,1.0,14,3,11,3.0,1.0,2.0
9204227,1,1,0,0,1,0,0,892,,,,,,,,1,1,0,,,
12030,18,3,15,45,1,17,119,4,11.0,3.0,8.0,28.0,0.0,11.0,83.0,50,18,32,26.0,3.0,23.0
9604326,5,3,2,2,0,5,31,30,3.0,1.0,2.0,2.0,0.0,3.0,26.0,22,5,17,14.0,2.0,12.0
9711484,3,2,1,1,0,3,14,13,3.0,2.0,1.0,1.0,0.0,3.0,13.0,16,3,13,5.0,2.0,3.0
9707449,5,3,2,2,1,4,36,17,4.0,2.0,2.0,2.0,0.0,4.0,36.0,31,5,26,21.0,3.0,18.0
9710239,3,2,1,1,0,3,6,82,3.0,2.0,1.0,1.0,0.0,3.0,6.0,5,3,2,2.0,1.0,1.0
209084,9,6,3,3,0,9,60,25,4.0,3.0,1.0,1.0,0.0,4.0,26.0,24,9,15,11.0,3.0,8.0
9812347,3,3,0,0,1,2,3,29,0.0,0.0,0.0,0.0,0.0,0.0,0.0,11,3,8,2.0,1.0,1.0
3200,2,2,0,0,0,2,2,240,0.0,0.0,0.0,0.0,0.0,0.0,0.0,16,2,14,6.0,0.0,6.0
9906424,21,3,18,85,0,21,130,68,18.0,1.0,17.0,78.0,1.0,17.0,81.0,37,21,16,23.0,16.0,7.0
103267,7,3,4,6,3,4,21,68,5.0,2.0,3.0,4.0,1.0,4.0,21.0,16,7,9,11.0,3.0,8.0
108253,2,2,0,0,0,2,14,118,2.0,2.0,0.0,0.0,0.0,2.0,13.0,16,2,14,8.0,1.0,7.0
107254,8,3,5,10,3,5,42,7,5.0,1.0,4.0,7.0,1.0,4.0,21.0,21,8,13,10.0,4.0,6.0
9305235,1,1,0,0,1,0,0,29,0.0,0.0,0.0,0.0,0.0,0.0,0.0,8,1,7,3.0,0.0,3.0
9507415,6,4,2,2,2,4,22,33,5.0,3.0,2.0,2.0,2.0,3.0,15.0,16,6,10,10.0,4.0,6.0
12171,2,2,0,0,0,2,2,118,0.0,0.0,0.0,0.0,0.0,0.0,0.0,9,2,7,1.0,0.0,1.0
107063,2,2,0,0,2,0,0,39,1.0,1.0,0.0,0.0,1.0,0.0,0.0,4,2,2,,,
9608440,1,1,0,0,0,1,2,167,0.0,0.0,0.0,0.0,0.0,0.0,0.0,3,1,2,,,
9611260,4,3,1,1,0,4,7,233,2.0,1.0,1.0,1.0,0.0,2.0,2.0,13,4,9,3.0,0.0,3.0
111149,2,2,0,0,0,2,10,2,,,,,,,,10,2,8,,,
9406341,2,2,0,0,1,1,1,179,0.0,0.0,0.0,0.0,0.0,0.0,0.0,4,2,2,1.0,0.0,1.0
9506302,2,2,0,0,0,2,4,241,1.0,1.0,0.0,0.0,0.0,1.0,1.0,4,2,2,2.0,1.0,1.0
9504229,17,7,10,18,12,5,7,307,14.0,5.0,9.0,17.0,10.0,4.0,4.0,19,17,2,8.0,8.0,0.0
9502411,7,6,1,1,5,2,2,85,2.0,1.0,1.0,1.0,0.0,2.0,2.0,10,7,3,3.0,2.0,1.0
7211,1,1,0,0,0,1,2,1943,,,,,,,,3,1,2,,,
9703238,14,4,10,19,2,12,48,115,12.0,3.0,9.0,15.0,2.0,10.0,41.0,22,14,8,7.0,4.0,3.0
9801332,3,3,0,0,0,3,18,117,2.0,2.0,0.0,0.0,0.0,2.0,10.0,17,3,14,8.0,1.0,7.0
111387,0,0,0,0,0,0,0,6,0.0,0.0,0.0,0.0,0.0,0.0,0.0,22,0,22,11.0,0.0,11.0
9701369,3,3,0,0,3,0,0,327,2.0,2.0,0.0,0.0,2.0,0.0,0.0,3,3,0,1.0,1.0,0.0
2236,2,1,1,1,0,2,12,42,2.0,1.0,1.0,1.0,0.0,2.0,6.0,13,2,11,9.0,2.0,7.0
9312207,4,2,2,2,1,3,3,35,3.0,3.0,0.0,0.0,1.0,2.0,2.0,5,4,1,4.0,3.0,1.0
9905457,0,0,0,0,0,0,0,367,0.0,0.0,0.0,0.0,0.0,0.0,0.0,1,0,1,1.0,0.0,1.0
9612429,2,2,0,0,0,2,14,58,1.0,1.0,0.0,0.0,0.0,1.0,9.0,24,2,22,8.0,1.0,7.0
9509234,2,2,0,0,0,2,2,343,2.0,2.0,0.0,0.0,0.0,2.0,2.0,3,2,1,3.0,2.0,1.0
106087,0,0,0,0,0,0,0,615,,,,,,,,3,0,3,1.0,0.0,1.0
107298,3,1,2,3,0,3,9,0,1.0,1.0,0.0,0.0,0.0,1.0,5.0,25,3,22,2.0,1.0,1.0
9611430,4,2,2,3,0,4,6,411,3.0,1.0,2.0,3.0,0.0,3.0,5.0,7,4,3,5.0,3.0,2.0
9910448,4,3,1,1,0,4,18,150,0.0,0.0,0.0,0.0,0.0,0.0,0.0,13,4,9,1.0,0.0,1.0
204344,0,0,0,0,0,0,0,286,0.0,0.0,0.0,0.0,0.0,0.0,0.0,8,0,8,3.0,0.0,3.0
9704242,2,1,1,1,0,2,2,149,2.0,1.0,1.0,1.0,0.0,2.0,2.0,5,2,3,3.0,2.0,1.0
9905368,3,2,1,1,0,3,14,240,3.0,2.0,1.0,1.0,0.0,3.0,11.0,12,3,9,7.0,3.0,4.0
9606404,4,2,2,2,1,3,8,79,3.0,1.0,2.0,2.0,0.0,3.0,8.0,11,4,7,1.0,0.0,1.0
107017,13,9,4,11,0,13,89,20,10.0,6.0,4.0,11.0,0.0,10.0,84.0,35,13,22,24.0,2.0,22.0
204173,8,5,3,5,1,7,25,0,4.0,1.0,3.0,3.0,1.0,3.0,8.0,29,8,21,9.0,3.0,6.0
9706421,12,5,7,10,0,12,57,29,5.0,1.0,4.0,6.0,0.0,5.0,13.0,32,12,20,9.0,1.0,8.0
211206,2,2,0,0,0,2,35,4,1.0,1.0,0.0,0.0,0.0,1.0,20.0,45,2,43,18.0,1.0,17.0
9610417,5,4,1,1,2,3,3,597,1.0,1.0,0.0,0.0,1.0,0.0,0.0,7,5,2,1.0,1.0,0.0
9805426,2,2,0,0,0,2,4,61,0.0,0.0,0.0,0.0,0.0,0.0,0.0,31,2,29,10.0,0.0,10.0
103039,10,7,3,4,0,10,78,7,8.0,7.0,1.0,1.0,0.0,8.0,49.0,33,10,23,15.0,5.0,10.0
4256,9,3,6,11,0,9,85,55,7.0,3.0,4.0,7.0,0.0,7.0,74.0,29,9,20,9.0,4.0,5.0
9810347,4,3,1,1,3,1,1,82,,,,,,,,5,4,1,1.0,1.0,0.0
12310,1,1,0,0,0,1,2,47,0.0,0.0,0.0,0.0,0.0,0.0,0.0,10,1,9,1.0,0.0,1.0
5085,14,7,7,11,2,12,41,9,4.0,2.0,2.0,2.0,0.0,4.0,11.0,34,14,20,8.0,1.0,7.0
9285,2,1,1,1,0,2,13,20,2.0,1.0,1.0,1.0,0.0,2.0,8.0,28,2,26,6.0,2.0,4.0
101182,0,0,0,0,0,0,0,111,0.0,0.0,0.0,0.0,0.0,0.0,0.0,5,0,5,2.0,0.0,2.0
2074,13,8,5,9,0,13,55,45,5.0,4.0,1.0,1.0,0.0,5.0,15.0,29,13,16,11.0,6.0,5.0
9811455,7,2,5,8,2,5,9,44,4.0,1.0,3.0,5.0,0.0,4.0,7.0,12,7,5,6.0,4.0,2.0
201043,4,3,1,1,1,3,10,84,1.0,1.0,0.0,0.0,0.0,1.0,4.0,25,4,21,8.0,0.0,8.0
12076,8,3,5,7,0,8,26,5,2.0,1.0,1.0,1.0,0.0,2.0,2.0,24,8,16,5.0,3.0,2.0
12107,2,1,1,1,1,1,4,350,2.0,1.0,1.0,1.0,1.0,1.0,3.0,7,2,5,4.0,2.0,2.0
9511435,2,2,0,0,2,0,0,2067,1.0,1.0,0.0,0.0,1.0,0.0,0.0,2,2,0,1.0,1.0,0.0
111278,4,2,2,2,0,4,17,83,1.0,1.0,0.0,0.0,0.0,1.0,6.0,27,4,23,5.0,1.0,4.0
9212297,5,5,0,0,5,0,0,302,5.0,5.0,0.0,0.0,5.0,0.0,0.0,5,5,0,4.0,4.0,0.0
9808286,6,4,2,2,0,6,12,19,1.0,1.0,0.0,0.0,0.0,1.0,1.0,9,6,3,2.0,1.0,1.0
9909444,5,2,3,3,0,5,33,78,3.0,2.0,1.0,1.0,0.0,3.0,19.0,32,5,27,11.0,3.0,8.0
2207,4,4,0,0,2,2,17,58,0.0,0.0,0.0,0.0,0.0,0.0,0.0,36,4,32,15.0,0.0,15.0
9712382,7,2,5,7,4,3,4,105,5.0,2.0,3.0,4.0,5.0,0.0,0.0,9,7,2,4.0,3.0,1.0
9704430,1,1,0,0,0,1,2,188,1.0,1.0,0.0,0.0,0.0,1.0,1.0,6,1,5,1.0,0.0,1.0
8236,5,2,3,3,0,5,33,17,3.0,3.0,0.0,0.0,0.0,3.0,30.0,30,5,25,5.0,1.0,4.0
102192,2,1,1,1,0,2,5,88,2.0,1.0,1.0,1.0,2.0,0.0,0.0,11,2,9,2.0,2.0,0.0
9902314,2,1,1,1,0,2,4,54,0.0,0.0,0.0,0.0,0.0,0.0,0.0,5,2,3,2.0,0.0,2.0
105043,7,4,3,7,2,5,5,392,5.0,3.0,2.0,4.0,1.0,4.0,4.0,9,7,2,6.0,5.0,1.0
204200,5,4,1,2,0,5,65,32,5.0,4.0,1.0,2.0,0.0,5.0,59.0,48,5,43,29.0,4.0,25.0
9907443,1,1,0,0,0,1,1,53,1.0,1.0,0.0,0.0,0.0,1.0,1.0,19,1,18,5.0,0.0,5.0
9709293,6,1,5,7,1,5,20,117,6.0,1.0,5.0,7.0,1.0,5.0,15.0,22,6,16,9.0,5.0,4.0
9609270,2,1,1,1,1,1,1,26,0.0,0.0,0.0,0.0,0.0,0.0,0.0,16,2,14,5.0,0.0,5.0
9503457,2,1,1,1,1,1,1,96,0.0,0.0,0.0,0.0,0.0,0.0,0.0,4,2,2,1.0,0.0,1.0
9407356,4,4,0,0,4,0,0,198,1.0,1.0,0.0,0.0,1.0,0.0,0.0,4,4,0,1.0,1.0,0.0
302123,0,0,0,0,0,0,0,1,0.0,0.0,0.0,0.0,0.0,0.0,0.0,37,0,37,9.0,0.0,9.0
102121,1,1,0,0,0,1,11,9,1.0,1.0,0.0,0.0,0.0,1.0,11.0,18,1,17,9.0,1.0,8.0
5012,3,3,0,0,3,0,0,431,2.0,2.0,0.0,0.0,2.0,0.0,0.0,3,3,0,2.0,2.0,0.0
9805421,11,2,9,20,11,0,0,76,10.0,1.0,9.0,20.0,10.0,0.0,0.0,11,11,0,9.0,9.0,0.0
9610352,4,2,2,3,0,4,17,137,4.0,2.0,2.0,3.0,0.0,4.0,17.0,11,4,7,9.0,4.0,5.0
9708407,1,1,0,0,0,1,2,41,0.0,0.0,0.0,0.0,0.0,0.0,0.0,13,1,12,8.0,0.0,8.0
9909570,4,3,1,1,0,4,24,10,1.0,1.0,0.0,0.0,0.0,1.0,6.0,28,4,24,3.0,1.0,2.0
1017,1,1,0,0,0,1,7,2,0.0,0.0,0.0,0.0,0.0,0.0,0.0,14,1,13,1.0,0.0,1.0
204190,1,1,0,0,0,1,5,21,1.0,1.0,0.0,0.0,0.0,1.0,4.0,12,1,11,5.0,1.0,4.0
9904288,8,3,5,6,6,2,3,334,6.0,1.0,5.0,6.0,6.0,0.0,0.0,19,8,11,5.0,5.0,0.0
112143,9,4,5,8,0,9,58,165,7.0,2.0,5.0,8.0,0.0,7.0,48.0,39,9,30,20.0,7.0,13.0
204326,2,2,0,0,2,0,0,460,2.0,2.0,0.0,0.0,2.0,0.0,0.0,2,2,0,1.0,1.0,0.0
11111,2,1,1,1,0,2,21,192,2.0,1.0,1.0,1.0,0.0,2.0,10.0,24,2,22,10.0,2.0,8.0
9706362,5,5,0,0,0,5,50,36,4.0,4.0,0.0,0.0,0.0,4.0,44.0,67,5,62,38.0,2.0,36.0
9604269,2,1,1,1,0,2,10,14,2.0,1.0,1.0,1.0,0.0,2.0,9.0,22,2,20,5.0,2.0,3.0
204327,2,2,0,0,1,1,1,139,2.0,2.0,0.0,0.0,1.0,1.0,1.0,3,2,1,2.0,2.0,0.0
9712309,9,4,5,11,3,6,21,140,5.0,1.0,4.0,10.0,0.0,5.0,12.0,23,9,14,7.0,3.0,4.0
206137,9,5,4,4,0,9,138,0,3.0,1.0,2.0,2.0,0.0,3.0,49.0,67,9,58,24.0,3.0,21.0
207052,4,2,2,3,0,4,32,108,4.0,2.0,2.0,3.0,0.0,4.0,30.0,15,4,11,10.0,3.0,7.0
109051,3,3,0,0,0,3,6,65,1.0,1.0,0.0,0.0,0.0,1.0,2.0,21,3,18,2.0,1.0,1.0
9703355,0,0,0,0,0,0,0,94,0.0,0.0,0.0,0.0,0.0,0.0,0.0,16,0,16,1.0,0.0,1.0
5288,6,3,3,4,1,5,11,142,3.0,1.0,2.0,3.0,1.0,2.0,2.0,12,6,6,6.0,4.0,2.0
9505261,2,1,1,1,2,0,0,102,1.0,1.0,0.0,0.0,1.0,0.0,0.0,2,2,0,1.0,1.0,0.0
9601202,5,3,2,2,0,5,10,6,0.0,0.0,0.0,0.0,0.0,0.0,0.0,41,5,36,5.0,3.0,2.0
9206243,1,1,0,0,1,0,0,1413,1.0,1.0,0.0,0.0,1.0,0.0,0.0,1,1,0,1.0,1.0,0.0
9501348,4,3,1,1,3,1,1,232,3.0,2.0,1.0,1.0,3.0,0.0,0.0,8,4,4,2.0,2.0,0.0
102322,2,1,1,1,1,1,1,138,0.0,0.0,0.0,0.0,0.0,0.0,0.0,17,2,15,2.0,0.0,2.0
9804378,5,3,2,2,2,3,9,103,3.0,2.0,1.0,1.0,1.0,2.0,5.0,12,5,7,4.0,2.0,2.0
9712282,1,1,0,0,0,1,8,31,1.0,1.0,0.0,0.0,0.0,1.0,6.0,15,1,14,8.0,0.0,8.0
9801423,1,1,0,0,1,0,0,310,1.0,1.0,0.0,0.0,1.0,0.0,0.0,2,1,1,1.0,0.0,1.0
9506410,0,0,0,0,0,0,0,433,0.0,0.0,0.0,0.0,0.0,0.0,0.0,1,0,1,,,
1006,2,1,1,1,1,1,1,1288,2.0,1.0,1.0,1.0,2.0,0.0,0.0,5,2,3,1.0,1.0,0.0
210198,4,2,2,2,0,4,48,1,3.0,1.0,2.0,2.0,0.0,3.0,41.0,72,4,68,33.0,2.0,31.0
9912532,4,3,1,1,4,0,0,420,4.0,3.0,1.0,1.0,4.0,0.0,0.0,4,4,0,3.0,3.0,0.0
109253,1,1,0,0,0,1,15,11,1.0,1.0,0.0,0.0,0.0,1.0,15.0,54,1,53,9.0,1.0,8.0
9912472,3,3,0,0,1,2,6,35,2.0,2.0,0.0,0.0,0.0,2.0,4.0,19,3,16,8.0,1.0,7.0
11274,4,1,3,4,0,4,21,10,3.0,1.0,2.0,2.0,1.0,2.0,3.0,17,4,13,9.0,2.0,7.0
1308,8,3,5,6,1,7,29,13,5.0,2.0,3.0,4.0,0.0,5.0,18.0,21,8,13,12.0,3.0,9.0
209314,0,0,0,0,0,0,0,70,0.0,0.0,0.0,0.0,0.0,0.0,0.0,6,0,6,1.0,0.0,1.0
105157,5,2,3,5,0,5,33,12,4.0,2.0,2.0,3.0,0.0,4.0,27.0,21,5,16,3.0,1.0,2.0
9905286,2,1,1,1,2,0,0,853,2.0,1.0,1.0,1.0,2.0,0.0,0.0,2,2,0,,,
212340,1,1,0,0,1,0,0,122,0.0,0.0,0.0,0.0,0.0,0.0,0.0,4,1,3,1.0,0.0,1.0
9312298,2,1,1,1,2,0,0,180,1.0,1.0,0.0,0.0,1.0,0.0,0.0,2,2,0,1.0,1.0,0.0
9710218,5,4,1,1,1,4,10,37,1.0,1.0,0.0,0.0,0.0,1.0,6.0,16,5,11,9.0,1.0,8.0
7144,7,2,5,10,0,7,10,147,6.0,3.0,3.0,6.0,2.0,4.0,4.0,9,7,2,6.0,5.0,1.0
9509340,1,1,0,0,0,1,1,84,1.0,1.0,0.0,0.0,0.0,1.0,1.0,4,1,3,2.0,0.0,2.0
9602303,1,1,0,0,0,1,3,182,1.0,1.0,0.0,0.0,0.0,1.0,3.0,6,1,5,5.0,1.0,4.0
9906463,2,1,1,1,0,2,19,142,2.0,1.0,1.0,1.0,0.0,2.0,18.0,16,2,14,8.0,2.0,6.0
209082,0,0,0,0,0,0,0,168,0.0,0.0,0.0,0.0,0.0,0.0,0.0,13,0,13,6.0,0.0,6.0
9409319,2,1,1,1,0,2,3,96,2.0,1.0,1.0,1.0,0.0,2.0,3.0,8,2,6,3.0,1.0,2.0
9607441,4,4,0,0,0,4,19,8,1.0,1.0,0.0,0.0,0.0,1.0,7.0,41,4,37,6.0,1.0,5.0
107137,5,4,1,1,2,3,6,83,0.0,0.0,0.0,0.0,0.0,0.0,0.0,22,5,17,8.0,0.0,8.0
9908324,3,3,0,0,1,2,6,58,2.0,2.0,0.0,0.0,0.0,2.0,6.0,9,3,6,4.0,2.0,2.0
9911296,4,1,3,3,0,4,52,102,4.0,1.0,3.0,3.0,0.0,4.0,50.0,19,4,15,16.0,4.0,12.0
9811477,3,2,1,1,2,1,1,63,1.0,1.0,0.0,0.0,1.0,0.0,0.0,5,3,2,2.0,1.0,1.0
209210,3,2,1,1,0,3,28,4,2.0,1.0,1.0,1.0,0.0,2.0,19.0,37,3,34,9.0,0.0,9.0
9809293,2,2,0,0,0,2,5,15,2.0,2.0,0.0,0.0,2.0,0.0,0.0,7,2,5,1.0,1.0,0.0
9508312,3,1,2,2,1,2,4,93,3.0,1.0,2.0,2.0,3.0,0.0,0.0,7,3,4,4.0,3.0,1.0
211321,9,6,3,5,3,6,29,38,4.0,1.0,3.0,4.0,0.0,4.0,20.0,25,9,16,4.0,2.0,2.0
9705367,5,4,1,1,5,0,0,198,4.0,3.0,1.0,1.0,4.0,0.0,0.0,5,5,0,3.0,3.0,0.0
107036,5,5,0,0,0,5,20,14,1.0,1.0,0.0,0.0,0.0,1.0,4.0,38,5,33,6.0,1.0,5.0
202246,7,4,3,5,0,7,39,65,7.0,4.0,3.0,5.0,0.0,7.0,38.0,20,7,13,14.0,6.0,8.0
9802413,0,0,0,0,0,0,0,40,,,,,,,,5,0,5,1.0,0.0,1.0
9606420,0,0,0,0,0,0,0,33,0.0,0.0,0.0,0.0,0.0,0.0,0.0,4,0,4,1.0,0.0,1.0
7014,3,2,1,1,0,3,16,9,0.0,0.0,0.0,0.0,0.0,0.0,0.0,19,3,16,5.0,1.0,4.0
9605242,0,0,0,0,0,0,0,253,0.0,0.0,0.0,0.0,0.0,0.0,0.0,1,0,1,,,
9712285,2,1,1,1,0,2,11,141,2.0,1.0,1.0,1.0,0.0,2.0,7.0,8,2,6,7.0,2.0,5.0
9809592,1,1,0,0,1,0,0,52,1.0,1.0,0.0,0.0,1.0,0.0,0.0,5,1,4,1.0,0.0,1.0
9504409,2,1,1,1,1,1,3,470,1.0,1.0,0.0,0.0,1.0,0.0,0.0,9,2,7,1.0,1.0,0.0
204091,8,6,2,2,2,6,45,0,4.0,3.0,1.0,1.0,0.0,4.0,34.0,29,8,21,17.0,4.0,13.0
9909522,1,1,0,0,0,1,6,163,1.0,1.0,0.0,0.0,0.0,1.0,4.0,10,1,9,7.0,1.0,6.0
9810353,3,3,0,0,0,3,3,2087,1.0,1.0,0.0,0.0,0.0,1.0,1.0,9,3,6,,,
9912220,3,1,2,3,0,3,17,76,3.0,1.0,2.0,3.0,0.0,3.0,13.0,12,3,9,9.0,3.0,6.0
101329,1,1,0,0,1,0,0,124,,,,,,,,1,1,0,,,
9903323,2,2,0,0,1,1,1,1,1.0,1.0,0.0,0.0,1.0,0.0,0.0,19,2,17,4.0,0.0,4.0
210043,2,2,0,0,2,0,0,562,0.0,0.0,0.0,0.0,0.0,0.0,0.0,4,2,2,1.0,0.0,1.0
9610321,2,2,0,0,2,0,0,366,1.0,1.0,0.0,0.0,1.0,0.0,0.0,2,2,0,,,
9710397,5,4,1,1,0,5,25,90,2.0,2.0,0.0,0.0,0.0,2.0,16.0,31,5,26,14.0,1.0,13.0
206216,2,1,1,1,0,2,26,11,2.0,1.0,1.0,1.0,0.0,2.0,26.0,20,2,18,,,
202029,2,2,0,0,0,2,3,43,1.0,1.0,0.0,0.0,0.0,1.0,2.0,13,2,11,3.0,1.0,2.0
9910539,4,2,2,2,0,4,28,117,4.0,2.0,2.0,2.0,0.0,4.0,24.0,24,4,20,14.0,2.0,12.0
5071,4,3,1,1,1,3,26,11,1.0,1.0,0.0,0.0,0.0,1.0,14.0,27,4,23,1.0,1.0,0.0
9701282,1,1,0,0,0,1,5,26,0.0,0.0,0.0,0.0,0.0,0.0,0.0,14,1,13,5.0,0.0,5.0
9501272,2,2,0,0,0,2,2,462,2.0,2.0,0.0,0.0,0.0,2.0,2.0,4,2,2,4.0,2.0,2.0
9901330,2,2,0,0,0,2,16,25,1.0,1.0,0.0,0.0,0.0,1.0,8.0,31,2,29,13.0,1.0,12.0
9507328,3,1,2,2,2,1,1,291,1.0,1.0,0.0,0.0,0.0,1.0,1.0,8,3,5,3.0,1.0,2.0
104300,15,2,13,27,0,15,245,70,15.0,2.0,13.0,27.0,0.0,15.0,245.0,34,15,19,32.0,13.0,19.0
9207275,1,1,0,0,1,0,0,872,,,,,,,,1,1,0,1.0,1.0,0.0
9609355,3,1,2,2,0,3,7,119,2.0,1.0,1.0,1.0,0.0,2.0,4.0,9,3,6,2.0,2.0,0.0
108158,6,3,3,3,0,6,45,3,2.0,2.0,0.0,0.0,0.0,2.0,23.0,51,6,45,13.0,0.0,13.0
104310,0,0,0,0,0,0,0,109,0.0,0.0,0.0,0.0,0.0,0.0,0.0,10,0,10,10.0,0.0,10.0
9310353,2,2,0,0,1,1,1,35,1.0,1.0,0.0,0.0,1.0,0.0,0.0,4,2,2,,,
9910272,8,5,3,4,8,0,0,266,2.0,2.0,0.0,0.0,2.0,0.0,0.0,9,8,1,2.0,1.0,1.0
7250,4,1,3,4,0,4,12,161,4.0,1.0,3.0,4.0,0.0,4.0,11.0,13,4,9,6.0,1.0,5.0
9801316,5,5,0,0,3,2,2,84,3.0,3.0,0.0,0.0,1.0,2.0,2.0,13,5,8,2.0,1.0,1.0
9703310,1,1,0,0,1,0,0,1588,,,,,,,,4,1,3,1.0,1.0,0.0
106145,1,1,0,0,0,1,2,23,0.0,0.0,0.0,0.0,0.0,0.0,0.0,5,1,4,1.0,0.0,1.0
209277,2,1,1,1,0,2,2,18,2.0,1.0,1.0,1.0,0.0,2.0,2.0,17,2,15,2.0,0.0,2.0
106321,4,2,2,2,1,3,17,31,3.0,1.0,2.0,2.0,0.0,3.0,15.0,13,4,9,9.0,2.0,7.0
9410229,2,2,0,0,2,0,0,667,1.0,1.0,0.0,0.0,1.0,0.0,0.0,3,2,1,1.0,1.0,0.0
202213,1,1,0,0,0,1,2,76,1.0,1.0,0.0,0.0,0.0,1.0,1.0,4,1,3,2.0,1.0,1.0
107225,6,4,2,2,2,4,11,127,3.0,2.0,1.0,1.0,0.0,3.0,9.0,13,6,7,5.0,1.0,4.0
9901451,2,2,0,0,0,2,8,71,2.0,2.0,0.0,0.0,0.0,2.0,8.0,9,2,7,2.0,0.0,2.0
203022,2,2,0,0,0,2,4,184,2.0,2.0,0.0,0.0,1.0,1.0,3.0,9,2,7,3.0,1.0,2.0
105052,4,2,2,2,0,4,14,18,1.0,1.0,0.0,0.0,0.0,1.0,2.0,14,4,10,4.0,1.0,3.0
11187,1,1,0,0,1,0,0,294,0.0,0.0,0.0,0.0,0.0,0.0,0.0,11,1,10,4.0,1.0,3.0
202159,3,2,1,1,0,3,13,123,2.0,1.0,1.0,1.0,0.0,2.0,4.0,12,3,9,4.0,2.0,2.0
203226,0,0,0,0,0,0,0,34,0.0,0.0,0.0,0.0,0.0,0.0,0.0,32,0,32,7.0,0.0,7.0
9905537,4,3,1,1,1,3,4,138,2.0,1.0,1.0,1.0,2.0,0.0,0.0,14,4,10,1.0,1.0,0.0
9810209,2,2,0,0,1,1,1,22,1.0,1.0,0.0,0.0,0.0,1.0,1.0,28,2,26,6.0,0.0,6.0
9910328,1,1,0,0,1,0,0,166,1.0,1.0,0.0,0.0,1.0,0.0,0.0,1,1,0,,,
9406298,2,2,0,0,2,0,0,1870,,,,,,,,2,2,0,1.0,1.0,0.0
101204,1,1,0,0,1,0,0,13,0.0,0.0,0.0,0.0,0.0,0.0,0.0,6,1,5,2.0,0.0,2.0
208153,7,5,2,3,4,3,11,37,5.0,3.0,2.0,3.0,4.0,1.0,1.0,20,7,13,4.0,1.0,3.0
9608259,2,2,0,0,0,2,13,11,2.0,2.0,0.0,0.0,0.0,2.0,4.0,10,2,8,4.0,2.0,2.0
106183,1,1,0,0,0,1,5,12,0.0,0.0,0.0,0.0,0.0,0.0,0.0,8,1,7,1.0,0.0,1.0
9902296,4,3,1,1,3,1,1,446,4.0,3.0,1.0,1.0,4.0,0.0,0.0,5,4,1,3.0,3.0,0.0
2153,1,1,0,0,0,1,5,90,1.0,1.0,0.0,0.0,0.0,1.0,5.0,13,1,12,3.0,0.0,3.0
9903223,1,1,0,0,1,0,0,100,0.0,0.0,0.0,0.0,0.0,0.0,0.0,4,1,3,,,
9812461,4,2,2,2,1,3,9,57,3.0,1.0,2.0,2.0,0.0,3.0,9.0,7,4,3,6.0,3.0,3.0
9501346,3,1,2,2,3,0,0,2027,3.0,1.0,2.0,2.0,3.0,0.0,0.0,3,3,0,,,
9903391,0,0,0,0,0,0,0,141,0.0,0.0,0.0,0.0,0.0,0.0,0.0,7,0,7,3.0,0.0,3.0
211038,3,3,0,0,1,2,8,23,1.0,1.0,0.0,0.0,0.0,1.0,4.0,21,3,18,3.0,0.0,3.0
206195,6,5,1,1,0,6,31,16,2.0,2.0,0.0,0.0,0.0,2.0,7.0,19,6,13,4.0,1.0,3.0
107229,1,1,0,0,1,0,0,198,0.0,0.0,0.0,0.0,0.0,0.0,0.0,3,1,2,1.0,1.0,0.0
202014,0,0,0,0,0,0,0,73,0.0,0.0,0.0,0.0,0.0,0.0,0.0,14,0,14,6.0,0.0,6.0
5281,2,1,1,1,0,2,2,166,0.0,0.0,0.0,0.0,0.0,0.0,0.0,11,2,9,3.0,2.0,1.0
3266,6,4,2,2,0,6,14,167,4.0,2.0,2.0,2.0,0.0,4.0,4.0,13,6,7,6.0,4.0,2.0
9209286,2,1,1,1,2,0,0,241,2.0,1.0,1.0,1.0,2.0,0.0,0.0,2,2,0,,,
201038,2,2,0,0,1,1,5,338,1.0,1.0,0.0,0.0,0.0,1.0,2.0,8,2,6,4.0,1.0,3.0
9506383,1,1,0,0,0,1,3,14,1.0,1.0,0.0,0.0,0.0,1.0,2.0,6,1,5,,,
9409415,1,1,0,0,1,0,0,489,1.0,1.0,0.0,0.0,1.0,0.0,0.0,2,1,1,1.0,0.0,1.0
9601231,1,1,0,0,1,0,0,229,1.0,1.0,0.0,0.0,1.0,0.0,0.0,2,1,1,2.0,1.0,1.0
111151,7,2,5,15,0,7,60,23,7.0,2.0,5.0,15.0,0.0,7.0,50.0,39,7,32,24.0,1.0,23.0
9804463,1,1,0,0,0,1,4,11,1.0,1.0,0.0,0.0,0.0,1.0,3.0,27,1,26,4.0,1.0,3.0
9701297,1,1,0,0,1,0,0,104,1.0,1.0,0.0,0.0,1.0,0.0,0.0,4,1,3,1.0,0.0,1.0
9904265,3,3,0,0,1,2,3,267,1.0,1.0,0.0,0.0,0.0,1.0,2.0,5,3,2,2.0,1.0,1.0
202063,6,3,3,5,0,6,27,82,6.0,3.0,3.0,5.0,0.0,6.0,25.0,20,6,14,17.0,5.0,12.0
202059,1,1,0,0,0,1,2,172,0.0,0.0,0.0,0.0,0.0,0.0,0.0,6,1,5,2.0,0.0,2.0
9809327,1,1,0,0,1,0,0,241,0.0,0.0,0.0,0.0,0.0,0.0,0.0,9,1,8,1.0,0.0,1.0
207102,0,0,0,0,0,0,0,1242,,,,,,,,1,0,1,,,
206140,4,3,1,1,0,4,74,49,2.0,1.0,1.0,1.0,0.0,2.0,34.0,77,4,73,26.0,2.0,24.0
9811480,4,4,0,0,2,2,2,98,4.0,4.0,0.0,0.0,2.0,2.0,2.0,5,4,1,3.0,2.0,1.0
109173,9,2,7,16,0,9,80,20,7.0,1.0,6.0,12.0,0.0,7.0,71.0,37,9,28,9.0,6.0,3.0
9808497,3,2,1,1,1,2,38,94,2.0,1.0,1.0,1.0,0.0,2.0,34.0,29,3,26,21.0,2.0,19.0
208194,1,1,0,0,1,0,0,29,0.0,0.0,0.0,0.0,0.0,0.0,0.0,11,1,10,1.0,1.0,0.0
109006,3,2,1,1,2,1,4,64,1.0,1.0,0.0,0.0,0.0,1.0,3.0,14,3,11,4.0,0.0,4.0
9809392,0,0,0,0,0,0,0,193,0.0,0.0,0.0,0.0,0.0,0.0,0.0,3,0,3,2.0,0.0,2.0
3202,3,3,0,0,0,3,5,84,1.0,1.0,0.0,0.0,0.0,1.0,1.0,7,3,4,2.0,1.0,1.0
102185,1,1,0,0,0,1,1,198,1.0,1.0,0.0,0.0,0.0,1.0,1.0,2,1,1,1.0,1.0,0.0
9806495,2,1,1,1,2,0,0,565,2.0,1.0,1.0,1.0,2.0,0.0,0.0,2,2,0,2.0,2.0,0.0
9803249,0,0,0,0,0,0,0,26,0.0,0.0,0.0,0.0,0.0,0.0,0.0,5,0,5,3.0,0.0,3.0
10292,4,4,0,0,0,4,16,106,3.0,3.0,0.0,0.0,0.0,3.0,10.0,11,4,7,7.0,3.0,4.0
201286,1,1,0,0,0,1,10,15,1.0,1.0,0.0,0.0,0.0,1.0,9.0,42,1,41,10.0,0.0,10.0
110174,1,1,0,0,0,1,3,290,1.0,1.0,0.0,0.0,0.0,1.0,2.0,5,1,4,3.0,1.0,2.0
210394,0,0,0,0,0,0,0,186,0.0,0.0,0.0,0.0,0.0,0.0,0.0,4,0,4,3.0,0.0,3.0
9506447,1,1,0,0,1,0,0,609,1.0,1.0,0.0,0.0,1.0,0.0,0.0,3,1,2,2.0,1.0,1.0
9207262,1,1,0,0,1,0,0,317,1.0,1.0,0.0,0.0,1.0,0.0,0.0,1,1,0,,,
9709336,4,4,0,0,0,4,7,9,1.0,1.0,0.0,0.0,0.0,1.0,2.0,9,4,5,,,
9605275,2,1,1,1,1,1,1,44,,,,,,,,3,2,1,,,
9411205,3,1,2,2,0,3,6,235,3.0,1.0,2.0,2.0,0.0,3.0,5.0,6,3,3,3.0,2.0,1.0
9405305,0,0,0,0,0,0,0,223,0.0,0.0,0.0,0.0,0.0,0.0,0.0,2,0,2,2.0,0.0,2.0
107128,2,1,1,1,0,2,9,136,2.0,1.0,1.0,1.0,0.0,2.0,8.0,7,2,5,6.0,2.0,4.0
202073,2,2,0,0,0,2,7,52,2.0,2.0,0.0,0.0,0.0,2.0,6.0,14,2,12,8.0,2.0,6.0
5157,2,1,1,1,1,1,7,77,1.0,1.0,0.0,0.0,0.0,1.0,3.0,9,2,7,3.0,1.0,2.0
211159,0,0,0,0,0,0,0,28,0.0,0.0,0.0,0.0,0.0,0.0,0.0,21,0,21,17.0,0.0,17.0
101321,2,2,0,0,0,2,13,44,2.0,2.0,0.0,0.0,0.0,2.0,10.0,13,2,11,6.0,2.0,4.0
204163,4,2,2,2,0,4,7,89,1.0,1.0,0.0,0.0,0.0,1.0,2.0,19,4,15,2.0,1.0,1.0
112031,1,1,0,0,1,0,0,153,0.0,0.0,0.0,0.0,0.0,0.0,0.0,5,1,4,2.0,0.0,2.0
301177,1,1,0,0,0,1,10,108,1.0,1.0,0.0,0.0,0.0,1.0,10.0,17,1,16,9.0,1.0,8.0
210223,0,0,0,0,0,0,0,73,0.0,0.0,0.0,0.0,0.0,0.0,0.0,5,0,5,1.0,0.0,1.0
9702391,0,0,0,0,0,0,0,10,0.0,0.0,0.0,0.0,0.0,0.0,0.0,6,0,6,4.0,0.0,4.0
201285,1,1,0,0,0,1,19,11,1.0,1.0,0.0,0.0,0.0,1.0,17.0,57,1,56,27.0,1.0,26.0
9404295,3,3,0,0,3,0,0,2106,1.0,1.0,0.0,0.0,1.0,0.0,0.0,4,3,1,1.0,1.0,0.0
111358,5,4,1,1,0,5,13,33,1.0,1.0,0.0,0.0,1.0,0.0,0.0,12,5,7,2.0,1.0,1.0
103273,2,1,1,1,0,2,7,185,2.0,1.0,1.0,1.0,0.0,2.0,6.0,9,2,7,5.0,2.0,3.0
301263,0,0,0,0,0,0,0,16,0.0,0.0,0.0,0.0,0.0,0.0,0.0,29,0,29,9.0,0.0,9.0
9911251,1,1,0,0,0,1,4,5,1.0,1.0,0.0,0.0,0.0,1.0,4.0,8,1,7,4.0,1.0,3.0
210216,1,1,0,0,0,1,5,282,1.0,1.0,0.0,0.0,0.0,1.0,5.0,6,1,5,6.0,1.0,5.0
9904456,5,3,2,2,4,1,4,6,2.0,2.0,0.0,0.0,2.0,0.0,0.0,30,5,25,2.0,2.0,0.0
9707232,0,0,0,0,0,0,0,100,0.0,0.0,0.0,0.0,0.0,0.0,0.0,12,0,12,6.0,0.0,6.0
204042,2,1,1,1,0,2,44,11,2.0,1.0,1.0,1.0,0.0,2.0,19.0,50,2,48,11.0,2.0,9.0
208219,3,3,0,0,0,3,14,4,0.0,0.0,0.0,0.0,0.0,0.0,0.0,32,3,29,2.0,0.0,2.0
211404,2,1,1,1,0,2,69,3,2.0,1.0,1.0,1.0,0.0,2.0,55.0,94,2,92,23.0,1.0,22.0
201194,1,1,0,0,0,1,5,18,0.0,0.0,0.0,0.0,0.0,0.0,0.0,18,1,17,1.0,0.0,1.0
9604424,4,3,1,1,3,1,1,39,2.0,1.0,1.0,1.0,2.0,0.0,0.0,5,4,1,2.0,2.0,0.0
302129,1,1,0,0,0,1,3,89,1.0,1.0,0.0,0.0,0.0,1.0,1.0,8,1,7,4.0,1.0,3.0
101071,1,1,0,0,1,0,0,189,1.0,1.0,0.0,0.0,1.0,0.0,0.0,2,1,1,1.0,1.0,0.0
111095,0,0,0,0,0,0,0,260,0.0,0.0,0.0,0.0,0.0,0.0,0.0,12,0,12,7.0,0.0,7.0
105033,0,0,0,0,0,0,0,83,0.0,0.0,0.0,0.0,0.0,0.0,0.0,9,0,9,5.0,0.0,5.0
9902229,1,1,0,0,0,1,3,217,1.0,1.0,0.0,0.0,0.0,1.0,3.0,7,1,6,6.0,1.0,5.0
9712511,0,0,0,0,0,0,0,352,0.0,0.0,0.0,0.0,0.0,0.0,0.0,2,0,2,1.0,0.0,1.0
9808314,2,1,1,1,2,0,0,242,2.0,1.0,1.0,1.0,2.0,0.0,0.0,5,2,3,3.0,0.0,3.0
1141,1,1,0,0,0,1,2,138,1.0,1.0,0.0,0.0,0.0,1.0,2.0,3,1,2,2.0,1.0,1.0
205029,3,2,1,1,0,3,6,283,2.0,1.0,1.0,1.0,0.0,2.0,4.0,11,3,8,1.0,0.0,1.0
11011,1,1,0,0,0,1,4,43,1.0,1.0,0.0,0.0,0.0,1.0,4.0,16,1,15,12.0,1.0,11.0
9905314,1,1,0,0,0,1,2,359,1.0,1.0,0.0,0.0,0.0,1.0,1.0,4,1,3,2.0,1.0,1.0
9709416,0,0,0,0,0,0,0,243,0.0,0.0,0.0,0.0,0.0,0.0,0.0,6,0,6,1.0,0.0,1.0
3040,2,2,0,0,1,1,1,361,1.0,1.0,0.0,0.0,0.0,1.0,1.0,3,2,1,2.0,1.0,1.0
9410287,0,0,0,0,0,0,0,1346,,,,,,,,3,0,3,1.0,0.0,1.0
9612257,3,2,1,1,3,0,0,41,1.0,1.0,0.0,0.0,1.0,0.0,0.0,3,3,0,1.0,1.0,0.0
9409280,4,3,1,1,3,1,1,270,3.0,2.0,1.0,1.0,3.0,0.0,0.0,6,4,2,3.0,3.0,0.0
9505360,2,2,0,0,1,1,1,132,1.0,1.0,0.0,0.0,0.0,1.0,1.0,4,2,2,1.0,0.0,1.0
4103,1,1,0,0,1,0,0,772,0.0,0.0,0.0,0.0,0.0,0.0,0.0,19,1,18,1.0,1.0,0.0
211267,4,3,1,1,2,2,10,7,3.0,2.0,1.0,1.0,1.0,2.0,6.0,28,4,24,4.0,1.0,3.0
9601258,1,1,0,0,1,0,0,414,1.0,1.0,0.0,0.0,1.0,0.0,0.0,4,1,3,2.0,0.0,2.0
301264,0,0,0,0,0,0,0,219,0.0,0.0,0.0,0.0,0.0,0.0,0.0,7,0,7,6.0,0.0,6.0
9911525,0,0,0,0,0,0,0,1727,,,,,,,,3,0,3,,,
9911416,2,2,0,0,2,0,0,814,1.0,1.0,0.0,0.0,1.0,0.0,0.0,2,2,0,1.0,1.0,0.0
9811449,1,1,0,0,0,1,3,85,0.0,0.0,0.0,0.0,0.0,0.0,0.0,11,1,10,6.0,0.0,6.0
8250,1,1,0,0,1,0,0,167,0.0,0.0,0.0,0.0,0.0,0.0,0.0,10,1,9,5.0,0.0,5.0
7348,1,1,0,0,0,1,14,13,1.0,1.0,0.0,0.0,0.0,1.0,14.0,15,1,14,5.0,1.0,4.0
9404262,1,1,0,0,0,1,1,418,0.0,0.0,0.0,0.0,0.0,0.0,0.0,5,1,4,3.0,0.0,3.0
301156,0,0,0,0,0,0,0,209,0.0,0.0,0.0,0.0,0.0,0.0,0.0,23,0,23,12.0,0.0,12.0
10220,0,0,0,0,0,0,0,292,0.0,0.0,0.0,0.0,0.0,0.0,0.0,1,0,1,,,
104255,5,4,1,1,0,5,16,40,3.0,3.0,0.0,0.0,0.0,3.0,14.0,12,5,7,6.0,3.0,3.0
101153,0,0,0,0,0,0,0,97,0.0,0.0,0.0,0.0,0.0,0.0,0.0,2,0,2,2.0,0.0,2.0
9608414,0,0,0,0,0,0,0,39,0.0,0.0,0.0,0.0,0.0,0.0,0.0,6,0,6,1.0,0.0,1.0
9910243,1,1,0,0,0,1,1,31,1.0,1.0,0.0,0.0,0.0,1.0,1.0,10,1,9,5.0,0.0,5.0
9801382,1,1,0,0,1,0,0,686,1.0,1.0,0.0,0.0,1.0,0.0,0.0,1,1,0,1.0,1.0,0.0
202021,4,2,2,2,0,4,29,23,4.0,2.0,2.0,2.0,0.0,4.0,22.0,32,4,28,14.0,1.0,13.0
102049,1,1,0,0,0,1,6,18,,,,,,,,12,1,11,1.0,1.0,0.0
9510251,2,1,1,1,0,2,2,451,2.0,1.0,1.0,1.0,0.0,2.0,2.0,3,2,1,3.0,2.0,1.0
212391,0,0,0,0,0,0,0,2,0.0,0.0,0.0,0.0,0.0,0.0,0.0,22,0,22,,,
111097,0,0,0,0,0,0,0,51,0.0,0.0,0.0,0.0,0.0,0.0,0.0,10,0,10,9.0,0.0,9.0
201212,1,1,0,0,0,1,2,20,1.0,1.0,0.0,0.0,1.0,0.0,0.0,4,1,3,1.0,1.0,0.0
106301,3,2,1,1,0,3,18,83,3.0,2.0,1.0,1.0,0.0,3.0,13.0,24,3,21,18.0,3.0,15.0
202181,4,4,0,0,0,4,15,9,3.0,3.0,0.0,0.0,0.0,3.0,9.0,25,4,21,7.0,3.0,4.0
9807435,1,1,0,0,0,1,1,123,0.0,0.0,0.0,0.0,0.0,0.0,0.0,6,1,5,1.0,1.0,0.0
9901205,1,1,0,0,0,1,5,33,0.0,0.0,0.0,0.0,0.0,0.0,0.0,12,1,11,3.0,0.0,3.0
10272,0,0,0,0,0,0,0,11,0.0,0.0,0.0,0.0,0.0,0.0,0.0,34,0,34,23.0,0.0,23.0
9307333,1,1,0,0,1,0,0,1758,0.0,0.0,0.0,0.0,0.0,0.0,0.0,2,1,1,,,
9611428,0,0,0,0,0,0,0,110,0.0,0.0,0.0,0.0,0.0,0.0,0.0,4,0,4,1.0,0.0,1.0
211136,2,2,0,0,0,2,10,33,1.0,1.0,0.0,0.0,0.0,1.0,6.0,26,2,24,8.0,1.0,7.0
9505284,3,2,1,1,3,0,0,229,2.0,1.0,1.0,1.0,2.0,0.0,0.0,3,3,0,2.0,2.0,0.0
208029,2,2,0,0,0,2,4,45,0.0,0.0,0.0,0.0,0.0,0.0,0.0,33,2,31,17.0,0.0,17.0
9908201,3,1,2,3,1,2,2,297,3.0,1.0,2.0,3.0,1.0,2.0,2.0,5,3,2,4.0,3.0,1.0
9503297,0,0,0,0,0,0,0,833,,,,,,,,1,0,1,,,
207001,0,0,0,0,0,0,0,608,0.0,0.0,0.0,0.0,0.0,0.0,0.0,8,0,8,1.0,0.0,1.0
206050,1,1,0,0,0,1,1,351,0.0,0.0,0.0,0.0,0.0,0.0,0.0,9,1,8,3.0,0.0,3.0
9508223,1,1,0,0,1,0,0,93,0.0,0.0,0.0,0.0,0.0,0.0,0.0,13,1,12,10.0,0.0,10.0
11277,2,2,0,0,1,1,5,13,0.0,0.0,0.0,0.0,0.0,0.0,0.0,18,2,16,4.0,0.0,4.0
212223,1,1,0,0,1,0,0,969,,,,,,,,1,1,0,,,
9904229,6,5,1,1,3,3,13,96,1.0,1.0,0.0,0.0,0.0,1.0,5.0,50,6,44,19.0,1.0,18.0
110413,1,1,0,0,0,1,2,13,1.0,1.0,0.0,0.0,0.0,1.0,2.0,12,1,11,2.0,1.0,1.0
9604377,1,1,0,0,1,0,0,232,0.0,0.0,0.0,0.0,0.0,0.0,0.0,5,1,4,2.0,0.0,2.0
207256,0,0,0,0,0,0,0,146,0.0,0.0,0.0,0.0,0.0,0.0,0.0,1,0,1,1.0,0.0,1.0
9904293,2,1,1,1,2,0,0,81,0.0,0.0,0.0,0.0,0.0,0.0,0.0,8,2,6,4.0,0.0,4.0
9707236,1,1,0,0,1,0,0,96,0.0,0.0,0.0,0.0,0.0,0.0,0.0,5,1,4,4.0,0.0,4.0
9902450,0,0,0,0,0,0,0,46,0.0,0.0,0.0,0.0,0.0,0.0,0.0,8,0,8,3.0,0.0,3.0
9703382,1,1,0,0,0,1,3,91,1.0,1.0,0.0,0.0,0.0,1.0,2.0,5,1,4,2.0,1.0,1.0
9408221,1,1,0,0,0,1,1,133,1.0,1.0,0.0,0.0,0.0,1.0,1.0,2,1,1,2.0,1.0,1.0
9508207,0,0,0,0,0,0,0,984,,,,,,,,1,0,1,,,
9604361,0,0,0,0,0,0,0,55,0.0,0.0,0.0,0.0,0.0,0.0,0.0,6,0,6,3.0,0.0,3.0
301118,0,0,0,0,0,0,0,29,0.0,0.0,0.0,0.0,0.0,0.0,0.0,33,0,33,4.0,0.0,4.0
102084,0,0,0,0,0,0,0,191,0.0,0.0,0.0,0.0,0.0,0.0,0.0,6,0,6,3.0,0.0,3.0
205252,1,1,0,0,0,1,6,41,0.0,0.0,0.0,0.0,0.0,0.0,0.0,15,1,14,9.0,1.0,8.0
9401205,2,2,0,0,2,0,0,494,2.0,2.0,0.0,0.0,2.0,0.0,0.0,2,2,0,2.0,2.0,0.0
212259,2,1,1,1,1,1,1,19,0.0,0.0,0.0,0.0,0.0,0.0,0.0,15,2,13,9.0,0.0,9.0
9803207,0,0,0,0,0,0,0,0,0.0,0.0,0.0,0.0,0.0,0.0,0.0,17,0,17,1.0,0.0,1.0
204309,0,0,0,0,0,0,0,398,0.0,0.0,0.0,0.0,0.0,0.0,0.0,9,0,9,2.0,0.0,2.0
9705317,0,0,0,0,0,0,0,54,0.0,0.0,0.0,0.0,0.0,0.0,0.0,8,0,8,1.0,0.0,1.0
9912462,0,0,0,0,0,0,0,13,0.0,0.0,0.0,0.0,0.0,0.0,0.0,9,0,9,6.0,0.0,6.0
8028,0,0,0,0,0,0,0,329,0.0,0.0,0.0,0.0,0.0,0.0,0.0,5,0,5,2.0,0.0,2.0
204182,2,2,0,0,1,1,3,220,1.0,1.0,0.0,0.0,0.0,1.0,2.0,6,2,4,3.0,1.0,2.0
212261,2,1,1,1,0,2,11,160,2.0,1.0,1.0,1.0,0.0,2.0,4.0,15,2,13,7.0,2.0,5.0
110012,3,3,0,0,0,3,5,40,0.0,0.0,0.0,0.0,0.0,0.0,0.0,27,3,24,5.0,1.0,4.0
9803264,0,0,0,0,0,0,0,232,0.0,0.0,0.0,0.0,0.0,0.0,0.0,5,0,5,2.0,0.0,2.0
210302,0,0,0,0,0,0,0,23,0.0,0.0,0.0,0.0,0.0,0.0,0.0,8,0,8,,,
9908266,1,1,0,0,0,1,4,42,0.0,0.0,0.0,0.0,0.0,0.0,0.0,18,1,17,4.0,1.0,3.0
112318,0,0,0,0,0,0,0,70,0.0,0.0,0.0,0.0,0.0,0.0,0.0,20,0,20,20.0,0.0,20.0
105259,2,2,0,0,1,1,1,740,1.0,1.0,0.0,0.0,1.0,0.0,0.0,3,2,1,1.0,1.0,0.0
9804346,0,0,0,0,0,0,0,12,,,,,,,,8,0,8,,,
109290,2,2,0,0,0,2,17,30,0.0,0.0,0.0,0.0,0.0,0.0,0.0,32,2,30,6.0,0.0,6.0
9909239,1,1,0,0,0,1,1,217,0.0,0.0,0.0,0.0,0.0,0.0,0.0,10,1,9,6.0,0.0,6.0
6149,1,1,0,0,0,1,4,87,1.0,1.0,0.0,0.0,0.0,1.0,3.0,7,1,6,4.0,1.0,3.0
301227,0,0,0,0,0,0,0,439,0.0,0.0,0.0,0.0,0.0,0.0,0.0,5,0,5,3.0,0.0,3.0
9612214,3,2,1,1,3,0,0,132,3.0,2.0,1.0,1.0,3.0,0.0,0.0,5,3,2,1.0,1.0,0.0
9216,1,1,0,0,0,1,1,2070,1.0,1.0,0.0,0.0,1.0,0.0,0.0,3,1,2,1.0,1.0,0.0
9903485,0,0,0,0,0,0,0,13,0.0,0.0,0.0,0.0,0.0,0.0,0.0,10,0,10,1.0,0.0,1.0
206134,0,0,0,0,0,0,0,1340,,,,,,,,1,0,1,,,
9806447,1,1,0,0,0,1,3,88,1.0,1.0,0.0,0.0,0.0,1.0,1.0,7,1,6,1.0,0.0,1.0
9809280,1,1,0,0,0,1,11,13,1.0,1.0,0.0,0.0,0.0,1.0,11.0,18,1,17,12.0,1.0,11.0
9119,0,0,0,0,0,0,0,259,0.0,0.0,0.0,0.0,0.0,0.0,0.0,2,0,2,1.0,0.0,1.0
208246,0,0,0,0,0,0,0,64,,,,,,,,2,0,2,,,
2299,1,1,0,0,0,1,3,173,1.0,1.0,0.0,0.0,0.0,1.0,2.0,5,1,4,3.0,1.0,2.0
207304,0,0,0,0,0,0,0,166,0.0,0.0,0.0,0.0,0.0,0.0,0.0,9,0,9,3.0,0.0,3.0
206253,2,2,0,0,0,2,10,1,2.0,2.0,0.0,0.0,0.0,2.0,9.0,20,2,18,12.0,0.0,12.0
9712208,0,0,0,0,0,0,0,27,0.0,0.0,0.0,0.0,0.0,0.0,0.0,16,0,16,4.0,0.0,4.0
8148,0,0,0,0,0,0,0,296,0.0,0.0,0.0,0.0,0.0,0.0,0.0,3,0,3,2.0,0.0,2.0
212102,1,1,0,0,0,1,3,340,1.0,1.0,0.0,0.0,0.0,1.0,3.0,5,1,4,4.0,1.0,3.0
4144,0,0,0,0,0,0,0,199,0.0,0.0,0.0,0.0,0.0,0.0,0.0,3,0,3,1.0,0.0,1.0
204035,0,0,0,0,0,0,0,195,0.0,0.0,0.0,0.0,0.0,0.0,0.0,12,0,12,5.0,0.0,5.0
211279,2,2,0,0,0,2,26,32,1.0,1.0,0.0,0.0,0.0,1.0,1.0,24,2,22,3.0,1.0,2.0
9601315,3,2,1,1,3,0,0,474,3.0,2.0,1.0,1.0,3.0,0.0,0.0,3,3,0,3.0,3.0,0.0
9701349,0,0,0,0,0,0,0,1164,,,,,,,,6,0,6,,,
11001,0,0,0,0,0,0,0,11,0.0,0.0,0.0,0.0,0.0,0.0,0.0,12,0,12,2.0,0.0,2.0
101129,2,2,0,0,0,2,4,213,1.0,1.0,0.0,0.0,0.0,1.0,1.0,4,2,2,3.0,2.0,1.0
203146,0,0,0,0,0,0,0,121,0.0,0.0,0.0,0.0,0.0,0.0,0.0,13,0,13,3.0,0.0,3.0
102232,0,0,0,0,0,0,0,97,0.0,0.0,0.0,0.0,0.0,0.0,0.0,6,0,6,2.0,0.0,2.0
9810248,1,1,0,0,1,0,0,705,1.0,1.0,0.0,0.0,1.0,0.0,0.0,1,1,0,1.0,1.0,0.0
9503493,0,0,0,0,0,0,0,35,0.0,0.0,0.0,0.0,0.0,0.0,0.0,4,0,4,3.0,0.0,3.0
11046,2,1,1,1,1,1,3,175,0.0,0.0,0.0,0.0,0.0,0.0,0.0,5,2,3,1.0,0.0,1.0
9508256,0,0,0,0,0,0,0,62,0.0,0.0,0.0,0.0,0.0,0.0,0.0,7,0,7,3.0,0.0,3.0
202079,0,0,0,0,0,0,0,38,0.0,0.0,0.0,0.0,0.0,0.0,0.0,3,0,3,2.0,0.0,2.0
209215,0,0,0,0,0,0,0,289,0.0,0.0,0.0,0.0,0.0,0.0,0.0,5,0,5,1.0,0.0,1.0
9311322,0,0,0,0,0,0,0,1325,,,,,,,,1,0,1,,,
12298,0,0,0,0,0,0,0,1268,,,,,,,,2,0,2,,,
101044,1,1,0,0,0,1,4,14,1.0,1.0,0.0,0.0,1.0,0.0,0.0,6,1,5,1.0,1.0,0.0
9912533,2,2,0,0,2,0,0,586,1.0,1.0,0.0,0.0,1.0,0.0,0.0,2,2,0,1.0,1.0,0.0
209075,0,0,0,0,0,0,0,24,0.0,0.0,0.0,0.0,0.0,0.0,0.0,7,0,7,,,
9805350,0,0,0,0,0,0,0,47,0.0,0.0,0.0,0.0,0.0,0.0,0.0,6,0,6,4.0,0.0,4.0
206091,1,1,0,0,0,1,3,261,0.0,0.0,0.0,0.0,0.0,0.0,0.0,15,1,14,2.0,0.0,2.0
208178,2,2,0,0,0,2,23,18,2.0,2.0,0.0,0.0,0.0,2.0,23.0,51,2,49,25.0,1.0,24.0
302110,0,0,0,0,0,0,0,956,0.0,0.0,0.0,0.0,0.0,0.0,0.0,4,0,4,2.0,0.0,2.0
301170,0,0,0,0,0,0,0,19,0.0,0.0,0.0,0.0,0.0,0.0,0.0,9,0,9,1.0,0.0,1.0
7060,2,2,0,0,0,2,2,111,1.0,1.0,0.0,0.0,1.0,0.0,0.0,7,2,5,3.0,0.0,3.0
9506223,0,0,0,0,0,0,0,232,0.0,0.0,0.0,0.0,0.0,0.0,0.0,1,0,1,1.0,0.0,1.0
204306,3,3,0,0,0,3,40,29,3.0,3.0,0.0,0.0,0.0,3.0,31.0,36,3,33,16.0,3.0,13.0
9904466,0,0,0,0,0,0,0,474,0.0,0.0,0.0,0.0,0.0,0.0,0.0,1,0,1,1.0,0.0,1.0
212002,1,1,0,0,0,1,10,23,0.0,0.0,0.0,0.0,0.0,0.0,0.0,60,1,59,28.0,0.0,28.0
9403260,0,0,0,0,0,0,0,147,,,,,,,,2,0,2,1.0,0.0,1.0
9608467,0,0,0,0,0,0,0,237,0.0,0.0,0.0,0.0,0.0,0.0,0.0,4,0,4,2.0,0.0,2.0
9801360,0,0,0,0,0,0,0,91,0.0,0.0,0.0,0.0,0.0,0.0,0.0,5,0,5,2.0,0.0,2.0
9503490,0,0,0,0,0,0,0,297,0.0,0.0,0.0,0.0,0.0,0.0,0.0,3,0,3,,,
302139,0,0,0,0,0,0,0,111,,,,,,,,2,0,2,,,
205096,0,0,0,0,0,0,0,80,0.0,0.0,0.0,0.0,0.0,0.0,0.0,21,0,21,17.0,0.0,17.0
10279,0,0,0,0,0,0,0,26,0.0,0.0,0.0,0.0,0.0,0.0,0.0,9,0,9,4.0,0.0,4.0
112033,0,0,0,0,0,0,0,18,0.0,0.0,0.0,0.0,0.0,0.0,0.0,22,0,22,8.0,0.0,8.0
301169,0,0,0,0,0,0,0,22,0.0,0.0,0.0,0.0,0.0,0.0,0.0,15,0,15,3.0,0.0,3.0
112323,0,0,0,0,0,0,0,6,0.0,0.0,0.0,0.0,0.0,0.0,0.0,7,0,7,1.0,0.0,1.0
9502310,0,0,0,0,0,0,0,719,0.0,0.0,0.0,0.0,0.0,0.0,0.0,1,0,1,1.0,0.0,1.0
9607344,2,2,0,0,2,0,0,394,1.0,1.0,0.0,0.0,1.0,0.0,0.0,5,2,3,2.0,2.0,0.0
9405395,1,1,0,0,1,0,0,330,1.0,1.0,0.0,0.0,1.0,0.0,0.0,2,1,1,1.0,0.0,1.0
3308,0,0,0,0,0,0,0,40,0.0,0.0,0.0,0.0,0.0,0.0,0.0,3,0,3,1.0,0.0,1.0
207188,0,0,0,0,0,0,0,11,0.0,0.0,0.0,0.0,0.0,0.0,0.0,42,0,42,28.0,0.0,28.0
9902329,1,1,0,0,0,1,7,54,1.0,1.0,0.0,0.0,0.0,1.0,7.0,9,1,8,9.0,1.0,8.0
111424,1,1,0,0,1,0,0,230,1.0,1.0,0.0,0.0,1.0,0.0,0.0,1,1,0,1.0,1.0,0.0
9909533,0,0,0,0,0,0,0,72,0.0,0.0,0.0,0.0,0.0,0.0,0.0,7,0,7,2.0,0.0,2.0
211357,0,0,0,0,0,0,0,4,0.0,0.0,0.0,0.0,0.0,0.0,0.0,38,0,38,4.0,0.0,4.0
209226,2,2,0,0,0,2,9,13,2.0,2.0,0.0,0.0,0.0,2.0,8.0,10,2,8,7.0,2.0,5.0
10169,1,1,0,0,0,1,2,6,0.0,0.0,0.0,0.0,0.0,0.0,0.0,7,1,6,3.0,0.0,3.0
210040,0,0,0,0,0,0,0,193,0.0,0.0,0.0,0.0,0.0,0.0,0.0,10,0,10,6.0,0.0,6.0
5130,0,0,0,0,0,0,0,115,0.0,0.0,0.0,0.0,0.0,0.0,0.0,11,0,11,2.0,0.0,2.0
12245,0,0,0,0,0,0,0,42,0.0,0.0,0.0,0.0,0.0,0.0,0.0,8,0,8,7.0,0.0,7.0
3245,1,1,0,0,0,1,13,57,1.0,1.0,0.0,0.0,0.0,1.0,11.0,14,1,13,10.0,1.0,9.0
103283,0,0,0,0,0,0,0,1426,,,,,,,,1,0,1,,,
104295,0,0,0,0,0,0,0,189,0.0,0.0,0.0,0.0,0.0,0.0,0.0,3,0,3,1.0,0.0,1.0
1275,1,1,0,0,0,1,1,885,,,,,,,,5,1,4,1.0,1.0,0.0
9907492,0,0,0,0,0,0,0,199,0.0,0.0,0.0,0.0,0.0,0.0,0.0,2,0,2,,,
9706475,0,0,0,0,0,0,0,5,0.0,0.0,0.0,0.0,0.0,0.0,0.0,10,0,10,1.0,0.0,1.0
9811462,1,1,0,0,0,1,7,44,1.0,1.0,0.0,0.0,0.0,1.0,3.0,19,1,18,5.0,1.0,4.0
108229,0,0,0,0,0,0,0,111,0.0,0.0,0.0,0.0,0.0,0.0,0.0,4,0,4,,,
8045,0,0,0,0,0,0,0,53,0.0,0.0,0.0,0.0,0.0,0.0,0.0,14,0,14,1.0,0.0,1.0
9511328,0,0,0,0,0,0,0,132,0.0,0.0,0.0,0.0,0.0,0.0,0.0,1,0,1,1.0,0.0,1.0
208250,0,0,0,0,0,0,0,161,0.0,0.0,0.0,0.0,0.0,0.0,0.0,10,0,10,1.0,0.0,1.0
9609435,0,0,0,0,0,0,0,343,0.0,0.0,0.0,0.0,0.0,0.0,0.0,3,0,3,3.0,0.0,3.0
3290,0,0,0,0,0,0,0,154,,,,,,,,2,0,2,,,
112221,0,0,0,0,0,0,0,54,,,,,,,,4,0,4,,,
106276,0,0,0,0,0,0,0,285,0.0,0.0,0.0,0.0,0.0,0.0,0.0,3,0,3,1.0,0.0,1.0
8137,0,0,0,0,0,0,0,126,0.0,0.0,0.0,0.0,0.0,0.0,0.0,2,0,2,1.0,0.0,1.0
211167,0,0,0,0,0,0,0,19,0.0,0.0,0.0,0.0,0.0,0.0,0.0,6,0,6,2.0,0.0,2.0
210274,0,0,0,0,0,0,0,46,0.0,0.0,0.0,0.0,0.0,0.0,0.0,8,0,8,4.0,0.0,4.0
111293,0,0,0,0,0,0,0,1886,,,,,,,,2,0,2,,,
9807471,0,0,0,0,0,0,0,155,0.0,0.0,0.0,0.0,0.0,0.0,0.0,6,0,6,2.0,0.0,2.0
9812524,0,0,0,0,0,0,0,2072,,,,,,,,4,0,4,,,
9701339,0,0,0,0,0,0,0,28,0.0,0.0,0.0,0.0,0.0,0.0,0.0,4,0,4,1.0,0.0,1.0
210307,1,1,0,0,0,1,1,64,0.0,0.0,0.0,0.0,0.0,0.0,0.0,7,1,6,1.0,0.0,1.0
212301,0,0,0,0,0,0,0,340,0.0,0.0,0.0,0.0,0.0,0.0,0.0,4,0,4,3.0,0.0,3.0
105176,0,0,0,0,0,0,0,187,0.0,0.0,0.0,0.0,0.0,0.0,0.0,2,0,2,2.0,0.0,2.0
208273,0,0,0,0,0,0,0,18,0.0,0.0,0.0,0.0,0.0,0.0,0.0,59,0,59,22.0,0.0,22.0
9707501,1,1,0,0,1,0,0,434,1.0,1.0,0.0,0.0,1.0,0.0,0.0,1,1,0,,,
302213,0,0,0,0,0,0,0,216,0.0,0.0,0.0,0.0,0.0,0.0,0.0,5,0,5,4.0,0.0,4.0
9709393,0,0,0,0,0,0,0,145,0.0,0.0,0.0,0.0,0.0,0.0,0.0,9,0,9,1.0,0.0,1.0
9412303,1,1,0,0,1,0,0,375,1.0,1.0,0.0,0.0,1.0,0.0,0.0,1,1,0,1.0,1.0,0.0
9311362,0,0,0,0,0,0,0,1990,0.0,0.0,0.0,0.0,0.0,0.0,0.0,4,0,4,1.0,0.0,1.0
302233,0,0,0,0,0,0,0,19,0.0,0.0,0.0,0.0,0.0,0.0,0.0,21,0,21,2.0,0.0,2.0
9505401,0,0,0,0,0,0,0,734,0.0,0.0,0.0,0.0,0.0,0.0,0.0,1,0,1,1.0,0.0,1.0
206097,1,1,0,0,0,1,1,521,1.0,1.0,0.0,0.0,0.0,1.0,1.0,2,1,1,2.0,1.0,1.0
9309312,0,0,0,0,0,0,0,87,,,,,,,,1,0,1,,,
111356,0,0,0,0,0,0,0,112,0.0,0.0,0.0,0.0,0.0,0.0,0.0,13,0,13,9.0,0.0,9.0
11050,0,0,0,0,0,0,0,63,0.0,0.0,0.0,0.0,0.0,0.0,0.0,29,0,29,9.0,0.0,9.0
9901259,0,0,0,0,0,0,0,1300,0.0,0.0,0.0,0.0,0.0,0.0,0.0,3,0,3,,,
9612218,0,0,0,0,0,0,0,17,0.0,0.0,0.0,0.0,0.0,0.0,0.0,33,0,33,26.0,0.0,26.0
9509397,0,0,0,0,0,0,0,342,0.0,0.0,0.0,0.0,0.0,0.0,0.0,5,0,5,4.0,0.0,4.0
9502269,0,0,0,0,0,0,0,1246,,,,,,,,1,0,1,,,
301244,0,0,0,0,0,0,0,47,0.0,0.0,0.0,0.0,0.0,0.0,0.0,22,0,22,17.0,0.0,17.0
208170,0,0,0,0,0,0,0,48,0.0,0.0,0.0,0.0,0.0,0.0,0.0,13,0,13,1.0,0.0,1.0
110410,0,0,0,0,0,0,0,89,0.0,0.0,0.0,0.0,0.0,0.0,0.0,5,0,5,3.0,0.0,3.0
9408268,0,0,0,0,0,0,0,1752,0.0,0.0,0.0,0.0,0.0,0.0,0.0,4,0,4,3.0,0.0,3.0
9704356,0,0,0,0,0,0,0,326,0.0,0.0,0.0,0.0,0.0,0.0,0.0,2,0,2,1.0,0.0,1.0
9511418,0,0,0,0,0,0,0,110,0.0,0.0,0.0,0.0,0.0,0.0,0.0,7,0,7,3.0,0.0,3.0
9703329,0,0,0,0,0,0,0,1424,,,,,,,,2,0,2,,,
9508350,0,0,0,0,0,0,0,137,0.0,0.0,0.0,0.0,0.0,0.0,0.0,2,0,2,2.0,0.0,2.0
9807410,0,0,0,0,0,0,0,1066,0.0,0.0,0.0,0.0,0.0,0.0,0.0,3,0,3,,,
9310220,0,0,0,0,0,0,0,208,0.0,0.0,0.0,0.0,0.0,0.0,0.0,1,0,1,1.0,0.0,1.0
7322,0,0,0,0,0,0,0,1,0.0,0.0,0.0,0.0,0.0,0.0,0.0,13,0,13,,,
9611335,0,0,0,0,0,0,0,61,0.0,0.0,0.0,0.0,0.0,0.0,0.0,8,0,8,3.0,0.0,3.0
9710557,0,0,0,0,0,0,0,89,0.0,0.0,0.0,0.0,0.0,0.0,0.0,3,0,3,,,
208059,0,0,0,0,0,0,0,101,0.0,0.0,0.0,0.0,0.0,0.0,0.0,5,0,5,3.0,0.0,3.0
9807290,0,0,0,0,0,0,0,36,0.0,0.0,0.0,0.0,0.0,0.0,0.0,12,0,12,5.0,0.0,5.0
209273,0,0,0,0,0,0,0,46,,,,,,,,5,0,5,2.0,0.0,2.0
201124,0,0,0,0,0,0,0,249,0.0,0.0,0.0,0.0,0.0,0.0,0.0,4,0,4,2.0,0.0,2.0
202230,0,0,0,0,0,0,0,2,0.0,0.0,0.0,0.0,0.0,0.0,0.0,16,0,16,1.0,0.0,1.0
101021,0,0,0,0,0,0,0,1305,,,,,,,,3,0,3,,,
211407,0,0,0,0,0,0,0,190,0.0,0.0,0.0,0.0,0.0,0.0,0.0,7,0,7,2.0,0.0,2.0
9906534,0,0,0,0,0,0,0,8,0.0,0.0,0.0,0.0,0.0,0.0,0.0,30,0,30,5.0,0.0,5.0
9905389,0,0,0,0,0,0,0,122,0.0,0.0,0.0,0.0,0.0,0.0,0.0,6,0,6,4.0,0.0,4.0
9502362,0,0,0,0,0,0,0,326,0.0,0.0,0.0,0.0,0.0,0.0,0.0,2,0,2,1.0,0.0,1.0
9602290,0,0,0,0,0,0,0,27,,,,,,,,4,0,4,,,
110294,0,0,0,0,0,0,0,48,0.0,0.0,0.0,0.0,0.0,0.0,0.0,6,0,6,,,
9607416,0,0,0,0,0,0,0,1075,,,,,,,,1,0,1,,,
205197,0,0,0,0,0,0,0,44,0.0,0.0,0.0,0.0,0.0,0.0,0.0,6,0,6,5.0,0.0,5.0
209348,0,0,0,0,0,0,0,27,,,,,,,,6,0,6,6.0,0.0,6.0
1289,0,0,0,0,0,0,0,1371,,,,,,,,3,0,3,,,
212285,0,0,0,0,0,0,0,340,0.0,0.0,0.0,0.0,0.0,0.0,0.0,4,0,4,4.0,0.0,4.0
301044,0,0,0,0,0,0,0,3,0.0,0.0,0.0,0.0,0.0,0.0,0.0,55,0,55,7.0,0.0,7.0
207111,0,0,0,0,0,0,0,108,,,,,,,,3,0,3,,,
207088,0,0,0,0,0,0,0,579,0.0,0.0,0.0,0.0,0.0,0.0,0.0,1,0,1,1.0,0.0,1.0
9609514,0,0,0,0,0,0,0,183,0.0,0.0,0.0,0.0,0.0,0.0,0.0,5,0,5,3.0,0.0,3.0
301139,0,0,0,0,0,0,0,964,,,,,,,,1,0,1,,,
9611408,0,0,0,0,0,0,0,132,0.0,0.0,0.0,0.0,0.0,0.0,0.0,5,0,5,2.0,0.0,2.0
9408236,0,0,0,0,0,0,0,274,0.0,0.0,0.0,0.0,0.0,0.0,0.0,2,0,2,1.0,0.0,1.0
9809241,0,0,0,0,0,0,0,111,0.0,0.0,0.0,0.0,0.0,0.0,0.0,2,0,2,1.0,0.0,1.0
9611296,6,2,4,6,2,4,5,100,4.0,2.0,2.0,2.0,1.0,3.0,3.0,9,6,3,2.0,1.0,1.0
104062,91,22,69,302,8,83,487,1,11.0,4.0,7.0,15.0,0.0,11.0,48.0,152,91,61,23.0,10.0,13.0
6225,13,6,7,13,0,13,79,1,5.0,3.0,2.0,3.0,0.0,5.0,38.0,37,13,24,11.0,6.0,5.0
9408404,133,15,118,1170,35,98,174,1,87.0,4.0,83.0,927.0,25.0,62.0,62.0,139,133,6,35.0,35.0,0.0
9702315,65,17,48,131,9,56,254,3,20.0,3.0,17.0,50.0,0.0,20.0,102.0,88,65,23,21.0,13.0,8.0
9312311,157,16,141,777,47,110,230,6,65.0,10.0,55.0,278.0,3.0,62.0,147.0,164,157,7,22.0,22.0,0.0
9501389,9,5,4,11,4,5,5,192,0.0,0.0,0.0,0.0,0.0,0.0,0.0,11,9,2,1.0,1.0,0.0
9409399,2,1,1,1,1,1,1,192,0.0,0.0,0.0,0.0,0.0,0.0,0.0,6,2,4,,,
9801412,27,7,20,77,9,18,91,67,2.0,2.0,0.0,0.0,0.0,2.0,11.0,45,27,18,11.0,1.0,10.0
3090,5,4,1,1,4,1,1,32,1.0,1.0,0.0,0.0,1.0,0.0,0.0,19,5,14,2.0,2.0,0.0
9606354,59,22,37,81,35,24,46,1,8.0,5.0,3.0,4.0,3.0,5.0,10.0,90,59,31,5.0,2.0,3.0
9402360,225,29,196,1572,129,96,262,6,72.0,11.0,61.0,480.0,9.0,63.0,194.0,233,225,8,39.0,35.0,4.0
9304240,110,23,87,312,110,0,0,35,27.0,6.0,21.0,83.0,27.0,0.0,0.0,110,110,0,15.0,15.0,0.0
9908327,40,15,25,68,11,29,75,35,4.0,1.0,3.0,5.0,1.0,3.0,11.0,50,40,10,15.0,12.0,3.0
9410400,35,9,26,92,10,25,42,35,21.0,4.0,17.0,69.0,2.0,19.0,27.0,43,35,8,17.0,16.0,1.0
9504378,201,21,180,1046,80,121,305,4,37.0,1.0,36.0,218.0,37.0,0.0,0.0,225,201,24,22.0,21.0,1.0
9703203,4,3,1,1,4,0,0,87,2.0,1.0,1.0,1.0,2.0,0.0,0.0,8,4,4,1.0,0.0,1.0
9303249,61,6,55,262,40,21,21,48,41.0,2.0,39.0,197.0,28.0,13.0,13.0,62,61,1,20.0,20.0,0.0
9603441,18,2,16,31,8,10,75,61,1.0,1.0,0.0,0.0,0.0,1.0,8.0,52,18,34,16.0,7.0,9.0
9704244,34,3,31,108,10,24,49,48,23.0,2.0,21.0,66.0,7.0,16.0,30.0,39,34,5,17.0,16.0,1.0
9803445,343,56,287,1087,187,156,445,43,25.0,1.0,24.0,115.0,0.0,25.0,95.0,374,343,31,25.0,16.0,9.0
9812387,18,6,12,21,2,16,66,33,5.0,2.0,3.0,4.0,1.0,4.0,8.0,49,18,31,2.0,0.0,2.0
9912458,15,3,12,25,1,14,47,33,13.0,2.0,11.0,24.0,1.0,12.0,28.0,23,15,8,4.0,4.0,0.0
1133,16,8,8,15,0,16,81,26,9.0,5.0,4.0,9.0,0.0,9.0,53.0,36,16,20,15.0,8.0,7.0
9206225,38,11,27,43,38,0,0,26,17.0,3.0,14.0,22.0,17.0,0.0,0.0,38,38,0,5.0,5.0,0.0
9601217,3,2,1,1,0,3,6,26,1.0,1.0,0.0,0.0,0.0,1.0,1.0,9,3,6,3.0,1.0,2.0
9807349,46,7,39,124,1,45,284,4,12.0,2.0,10.0,17.0,1.0,11.0,45.0,102,46,56,14.0,8.0,6.0
2238,13,4,9,33,0,13,117,4,4.0,3.0,1.0,1.0,0.0,4.0,22.0,39,13,26,18.0,6.0,12.0
108069,14,5,9,22,1,13,88,80,6.0,1.0,5.0,8.0,0.0,6.0,38.0,38,14,24,13.0,6.0,7.0
9507294,105,18,87,380,58,47,76,60,26.0,1.0,25.0,156.0,21.0,5.0,5.0,112,105,7,23.0,21.0,2.0
9610408,30,3,27,118,2,28,148,36,10.0,2.0,8.0,26.0,0.0,10.0,65.0,55,30,25,21.0,8.0,13.0
9910366,21,5,16,30,2,19,51,86,10.0,4.0,6.0,9.0,1.0,9.0,22.0,34,21,13,8.0,2.0,6.0
9212,46,9,37,97,1,45,372,32,16.0,4.0,12.0,42.0,0.0,16.0,166.0,86,46,40,30.0,10.0,20.0
111312,19,4,15,50,4,15,26,4,8.0,2.0,6.0,18.0,8.0,0.0,0.0,23,19,4,8.0,8.0,0.0
9903404,84,21,63,262,7,77,653,4,45.0,7.0,38.0,196.0,0.0,45.0,450.0,108,84,24,44.0,28.0,16.0
9804233,151,8,143,1296,22,129,285,20,79.0,2.0,77.0,922.0,2.0,77.0,151.0,159,151,8,48.0,46.0,2.0
9402224,34,6,28,73,31,3,3,63,12.0,1.0,11.0,24.0,11.0,1.0,1.0,36,34,2,8.0,8.0,0.0
9206241,72,19,53,193,72,0,0,29,28.0,6.0,22.0,80.0,28.0,0.0,0.0,72,72,0,7.0,7.0,0.0
9410330,26,13,13,18,5,21,74,25,4.0,3.0,1.0,1.0,1.0,3.0,11.0,66,26,40,10.0,2.0,8.0
9310276,60,19,41,150,45,15,15,98,24.0,8.0,16.0,76.0,17.0,7.0,7.0,61,60,1,16.0,15.0,1.0
9511261,11,4,7,11,2,9,28,25,9.0,2.0,7.0,11.0,0.0,9.0,25.0,26,11,15,13.0,7.0,6.0
9501222,74,14,60,185,23,51,106,10,11.0,1.0,10.0,27.0,0.0,11.0,18.0,89,74,15,5.0,5.0,0.0
9303230,347,16,331,2511,339,8,8,5,106.0,1.0,105.0,1122.0,106.0,0.0,0.0,348,347,1,43.0,43.0,0.0
9506261,25,9,16,46,3,22,40,10,3.0,2.0,1.0,2.0,3.0,0.0,0.0,28,25,3,7.0,6.0,1.0
9510439,116,10,106,667,43,73,132,12,41.0,5.0,36.0,175.0,8.0,33.0,66.0,120,116,4,31.0,28.0,3.0
9607437,77,7,70,612,32,45,58,0,52.0,2.0,50.0,456.0,27.0,25.0,31.0,81,77,4,44.0,43.0,1.0
9807325,140,6,134,1267,11,129,363,3,95.0,3.0,92.0,957.0,2.0,93.0,292.0,150,140,10,55.0,50.0,5.0
9907234,70,13,57,311,6,64,631,0,38.0,5.0,33.0,179.0,0.0,38.0,479.0,117,70,47,44.0,13.0,31.0
9910516,17,4,13,39,0,17,100,0,4.0,1.0,3.0,3.0,0.0,4.0,41.0,42,17,25,6.0,6.0,0.0
1129,5,2,3,3,3,2,4,0,0.0,0.0,0.0,0.0,0.0,0.0,0.0,13,5,8,1.0,1.0,0.0
9802334,132,15,117,622,57,75,285,3,46.0,4.0,42.0,245.0,35.0,11.0,11.0,156,132,24,25.0,11.0,14.0
9902385,21,4,17,39,5,16,26,3,11.0,4.0,7.0,15.0,2.0,9.0,9.0,26,21,5,10.0,8.0,2.0
9911364,23,6,17,36,2,21,146,3,12.0,2.0,10.0,16.0,1.0,11.0,85.0,52,23,29,12.0,7.0,5.0
9612391,6,3,3,4,0,6,23,119,2.0,2.0,0.0,0.0,0.0,2.0,9.0,15,6,9,9.0,2.0,7.0
9605273,103,11,92,465,47,56,163,0,33.0,2.0,31.0,152.0,28.0,5.0,5.0,126,103,23,16.0,16.0,0.0
9811326,8,3,5,8,0,8,34,12,6.0,1.0,5.0,8.0,0.0,6.0,21.0,32,8,24,1.0,0.0,1.0
9810448,3,2,1,1,2,1,1,1089,1.0,1.0,0.0,0.0,1.0,0.0,0.0,4,3,1,,,
9801276,27,8,19,54,9,18,35,0,12.0,5.0,7.0,13.0,10.0,2.0,2.0,34,27,7,5.0,4.0,1.0
9901215,28,8,20,53,16,12,25,107,9.0,3.0,6.0,14.0,2.0,7.0,7.0,51,28,23,8.0,0.0,8.0
9208230,37,12,25,46,25,12,12,164,8.0,5.0,3.0,3.0,8.0,0.0,0.0,39,37,2,7.0,7.0,0.0
9806256,7,5,2,2,1,6,19,0,0.0,0.0,0.0,0.0,0.0,0.0,0.0,19,7,12,3.0,0.0,3.0
9406397,42,13,29,77,3,39,104,10,7.0,2.0,5.0,6.0,0.0,7.0,24.0,56,42,14,8.0,7.0,1.0
9601241,2,1,1,1,0,2,2,81,0.0,0.0,0.0,0.0,0.0,0.0,0.0,9,2,7,2.0,2.0,0.0
9311312,30,6,24,92,11,19,41,81,27.0,6.0,21.0,86.0,8.0,19.0,40.0,34,30,4,16.0,13.0,3.0
9301218,40,19,21,44,35,5,5,22,5.0,2.0,3.0,7.0,5.0,0.0,0.0,41,40,1,3.0,3.0,0.0
9610517,20,5,15,40,0,20,91,3,4.0,2.0,2.0,2.0,0.0,4.0,8.0,57,20,37,9.0,6.0,3.0
9608256,41,7,34,136,4,37,80,42,21.0,4.0,17.0,91.0,5.0,16.0,27.0,46,41,5,21.0,19.0,2.0
9503318,21,5,16,49,1,20,20,3,10.0,2.0,8.0,19.0,0.0,10.0,10.0,22,21,1,10.0,9.0,1.0
9504351,13,6,7,17,6,7,7,71,5.0,2.0,3.0,5.0,5.0,0.0,0.0,16,13,3,4.0,4.0,0.0
9209232,340,67,273,1498,296,44,45,10,64.0,6.0,58.0,294.0,64.0,0.0,0.0,342,340,2,23.0,23.0,0.0
9511456,9,5,4,4,3,6,8,81,2.0,1.0,1.0,1.0,0.0,2.0,2.0,14,9,5,3.0,2.0,1.0
9811296,7,5,2,2,0,7,32,0,0.0,0.0,0.0,0.0,0.0,0.0,0.0,42,7,35,7.0,4.0,3.0
9810398,3,2,1,1,0,3,9,3,2.0,1.0,1.0,1.0,0.0,2.0,6.0,11,3,8,2.0,2.0,0.0
9501244,30,10,20,33,19,11,11,81,9.0,3.0,6.0,12.0,9.0,0.0,0.0,32,30,2,8.0,7.0,1.0
9905549,34,7,27,119,0,34,532,12,28.0,6.0,22.0,97.0,0.0,28.0,468.0,78,34,44,37.0,12.0,25.0
9609360,58,15,43,96,35,23,43,5,9.0,4.0,5.0,8.0,8.0,1.0,1.0,65,58,7,5.0,4.0,1.0
9806494,20,4,16,24,4,16,64,12,5.0,1.0,4.0,5.0,0.0,5.0,25.0,42,20,22,17.0,5.0,12.0
108103,22,9,13,22,2,20,78,1,7.0,6.0,1.0,1.0,0.0,7.0,20.0,39,22,17,4.0,2.0,2.0
9504327,131,9,122,1135,10,121,441,1,98.0,1.0,97.0,982.0,5.0,93.0,365.0,141,131,10,42.0,41.0,1.0
9703410,19,5,14,41,10,9,17,48,9.0,2.0,7.0,13.0,9.0,0.0,0.0,34,19,15,4.0,2.0,2.0
9804319,58,5,53,356,0,58,484,1,50.0,3.0,47.0,308.0,0.0,50.0,402.0,75,58,17,51.0,39.0,12.0
6175,17,5,12,27,0,17,109,7,9.0,3.0,6.0,13.0,0.0,9.0,26.0,39,17,22,10.0,8.0,2.0
9908499,20,7,13,28,0,20,115,23,0.0,0.0,0.0,0.0,0.0,0.0,0.0,78,20,58,24.0,0.0,24.0
9905264,23,7,16,41,1,22,110,67,13.0,4.0,9.0,18.0,0.0,13.0,63.0,42,23,19,20.0,11.0,9.0
9404331,10,5,5,8,8,2,2,257,3.0,1.0,2.0,2.0,3.0,0.0,0.0,11,10,1,2.0,2.0,0.0
9607397,100,15,85,511,2,98,490,5,54.0,6.0,48.0,366.0,0.0,54.0,326.0,119,100,19,40.0,31.0,9.0
9703250,28,5,23,64,1,27,250,5,22.0,3.0,19.0,54.0,0.0,22.0,219.0,49,28,21,18.0,12.0,6.0
9711264,25,6,19,45,2,23,226,5,11.0,4.0,7.0,18.0,0.0,11.0,155.0,74,25,49,19.0,3.0,16.0
9903453,75,15,60,191,1,74,494,1,15.0,7.0,8.0,19.0,0.0,15.0,115.0,123,75,48,13.0,12.0,1.0
9507445,35,7,28,103,12,23,77,33,19.0,2.0,17.0,56.0,0.0,19.0,62.0,42,35,7,14.0,11.0,3.0
9610283,40,4,36,139,1,39,80,1,17.0,1.0,16.0,51.0,17.0,0.0,0.0,55,40,15,13.0,10.0,3.0
9701233,71,6,65,454,5,66,194,1,50.0,2.0,48.0,363.0,6.0,44.0,117.0,86,71,15,33.0,28.0,5.0
111392,5,3,2,2,0,5,37,6,4.0,2.0,2.0,2.0,0.0,4.0,17.0,23,5,18,1.0,1.0,0.0
2216,33,8,25,74,0,33,208,7,14.0,1.0,13.0,31.0,0.0,14.0,47.0,63,33,30,12.0,9.0,3.0
9710331,30,6,24,124,0,30,274,1,27.0,4.0,23.0,111.0,0.0,27.0,225.0,56,30,26,20.0,16.0,4.0
110301,7,5,2,2,2,5,31,1,2.0,1.0,1.0,1.0,0.0,2.0,14.0,72,7,65,11.0,0.0,11.0
9903477,19,6,13,20,4,15,40,1,3.0,1.0,2.0,3.0,3.0,0.0,0.0,24,19,5,5.0,5.0,0.0
9801238,54,22,32,59,11,43,233,61,5.0,2.0,3.0,4.0,0.0,5.0,37.0,106,54,52,18.0,6.0,12.0
9708305,28,8,20,57,1,27,94,1,10.0,3.0,7.0,32.0,10.0,0.0,0.0,40,28,12,10.0,10.0,0.0
9703330,35,16,19,38,17,18,60,4,3.0,2.0,1.0,1.0,0.0,3.0,10.0,59,35,24,8.0,3.0,5.0
7353,3,2,1,1,3,0,0,349,1.0,1.0,0.0,0.0,1.0,0.0,0.0,6,3,3,3.0,0.0,3.0
9807454,37,13,24,42,7,30,216,15,8.0,5.0,3.0,4.0,0.0,8.0,89.0,85,37,48,30.0,4.0,26.0
9902208,16,6,10,14,3,13,34,7,9.0,3.0,6.0,10.0,1.0,8.0,11.0,30,16,14,4.0,2.0,2.0
9606444,19,4,15,51,5,14,26,7,15.0,2.0,13.0,45.0,7.0,8.0,12.0,25,19,6,10.0,9.0,1.0
9305289,24,17,7,10,15,9,10,26,4.0,4.0,0.0,0.0,1.0,3.0,3.0,27,24,3,2.0,2.0,0.0
9604238,1,1,0,0,1,0,0,250,0.0,0.0,0.0,0.0,0.0,0.0,0.0,3,1,2,2.0,0.0,2.0
9601382,5,4,1,3,1,4,9,12,,,,,,,,10,5,5,2.0,1.0,1.0
9409295,24,2,22,62,10,14,31,15,8.0,1.0,7.0,16.0,5.0,3.0,3.0,29,24,5,4.0,3.0,1.0
9408217,26,1,25,70,6,20,55,69,17.0,1.0,16.0,50.0,1.0,16.0,46.0,31,26,5,7.0,7.0,0.0
9705433,35,10,25,73,18,17,20,76,17.0,8.0,9.0,28.0,4.0,13.0,15.0,38,35,3,11.0,9.0,2.0
9702235,12,4,8,15,10,2,2,76,7.0,1.0,6.0,8.0,7.0,0.0,0.0,13,12,1,2.0,2.0,0.0
9708239,55,7,48,184,4,51,370,19,22.0,2.0,20.0,79.0,1.0,21.0,140.0,99,55,44,21.0,12.0,9.0
9703227,5,3,2,4,1,4,7,98,5.0,3.0,2.0,4.0,1.0,4.0,7.0,8,5,3,4.0,2.0,2.0
9606466,11,4,7,15,0,11,59,62,6.0,2.0,4.0,9.0,0.0,6.0,30.0,32,11,21,8.0,3.0,5.0
8099,12,5,7,17,0,12,38,24,4.0,2.0,2.0,3.0,0.0,4.0,13.0,18,12,6,8.0,4.0,4.0
9801436,6,5,1,2,2,4,20,245,2.0,2.0,0.0,0.0,0.0,2.0,8.0,13,6,7,9.0,3.0,6.0
9806260,12,6,6,8,1,11,64,16,4.0,2.0,2.0,2.0,0.0,4.0,24.0,35,12,23,3.0,2.0,1.0
9711486,18,6,12,23,2,16,34,115,8.0,3.0,5.0,12.0,1.0,7.0,16.0,24,18,6,10.0,7.0,3.0
9311237,62,17,45,121,30,32,32,57,24.0,3.0,21.0,63.0,5.0,19.0,19.0,63,62,1,16.0,15.0,1.0
9501214,36,11,25,118,23,13,22,30,22.0,3.0,19.0,90.0,16.0,6.0,6.0,40,36,4,17.0,17.0,0.0
9711417,19,11,8,21,3,16,46,5,0.0,0.0,0.0,0.0,0.0,0.0,0.0,68,19,49,2.0,1.0,1.0
9303255,154,68,86,221,154,0,0,39,18.0,15.0,3.0,4.0,18.0,0.0,0.0,154,154,0,5.0,5.0,0.0
9812328,16,3,13,45,2,14,34,4,3.0,2.0,1.0,1.0,3.0,0.0,0.0,25,16,9,8.0,7.0,1.0
9411321,4,1,3,3,0,4,9,30,3.0,1.0,2.0,2.0,0.0,3.0,7.0,11,4,7,3.0,1.0,2.0
9212312,7,5,2,2,7,0,0,86,5.0,4.0,1.0,1.0,5.0,0.0,0.0,7,7,0,2.0,2.0,0.0
9312284,22,6,16,49,22,0,0,134,13.0,1.0,12.0,42.0,13.0,0.0,0.0,22,22,0,12.0,12.0,0.0
9412299,3,3,0,0,0,3,13,6,0.0,0.0,0.0,0.0,0.0,0.0,0.0,12,3,9,3.0,1.0,2.0
9610425,23,4,19,68,0,23,163,6,19.0,3.0,16.0,61.0,0.0,19.0,130.0,44,23,21,21.0,6.0,15.0
9907517,11,2,9,21,0,11,83,6,7.0,1.0,6.0,14.0,0.0,7.0,59.0,31,11,20,11.0,8.0,3.0
9405314,11,5,6,8,1,10,10,6,0.0,0.0,0.0,0.0,0.0,0.0,0.0,15,11,4,2.0,0.0,2.0
9507437,32,6,26,95,5,27,134,6,13.0,3.0,10.0,27.0,0.0,13.0,63.0,41,32,9,8.0,7.0,1.0
9501320,19,10,9,13,14,5,9,4,2.0,1.0,1.0,1.0,2.0,0.0,0.0,28,19,9,2.0,2.0,0.0
9405290,36,3,33,203,28,8,8,66,25.0,2.0,23.0,130.0,25.0,0.0,0.0,37,36,1,22.0,21.0,1.0
9510410,66,13,53,202,29,37,60,14,16.0,3.0,13.0,41.0,1.0,15.0,29.0,70,66,4,13.0,13.0,0.0
103219,12,4,8,27,1,11,27,38,9.0,3.0,6.0,17.0,0.0,9.0,12.0,27,12,15,11.0,8.0,3.0
9505372,8,4,4,5,5,3,5,270,4.0,2.0,2.0,2.0,4.0,0.0,0.0,11,8,3,2.0,2.0,0.0
9704255,52,7,45,250,3,49,187,45,39.0,6.0,33.0,202.0,2.0,37.0,149.0,61,52,9,34.0,29.0,5.0
9710538,13,3,10,18,0,13,60,15,6.0,1.0,5.0,10.0,0.0,6.0,36.0,33,13,20,2.0,1.0,1.0
9807439,4,1,3,3,0,4,21,22,4.0,1.0,3.0,3.0,0.0,4.0,17.0,18,4,14,5.0,3.0,2.0
9512263,47,9,38,149,44,3,3,22,24.0,4.0,20.0,89.0,24.0,0.0,0.0,48,47,1,12.0,12.0,0.0
9910334,18,7,11,30,3,15,53,22,6.0,3.0,3.0,5.0,0.0,6.0,23.0,36,18,18,8.0,6.0,2.0
9508233,23,11,12,38,22,1,1,88,10.0,3.0,7.0,20.0,10.0,0.0,0.0,24,23,1,8.0,8.0,0.0
9908269,22,1,21,49,12,10,23,88,9.0,1.0,8.0,16.0,2.0,7.0,15.0,29,22,7,9.0,6.0,3.0
9411238,1,1,0,0,1,0,0,1745,1.0,1.0,0.0,0.0,1.0,0.0,0.0,1,1,0,1.0,1.0,0.0
9902274,4,2,2,2,0,4,25,21,4.0,2.0,2.0,2.0,0.0,4.0,25.0,16,4,12,1.0,1.0,0.0
9812483,73,8,65,365,15,58,509,2,36.0,4.0,32.0,193.0,0.0,36.0,421.0,93,73,20,34.0,20.0,14.0
9511386,62,9,53,153,37,25,39,43,14.0,2.0,12.0,28.0,8.0,6.0,6.0,66,62,4,5.0,5.0,0.0
9805341,18,4,14,44,2,16,38,19,12.0,2.0,10.0,34.0,1.0,11.0,15.0,28,18,10,9.0,8.0,1.0
9905283,15,3,12,32,2,13,42,19,11.0,2.0,9.0,26.0,1.0,10.0,35.0,23,15,8,3.0,2.0,1.0
9709442,64,4,60,262,3,61,288,39,38.0,2.0,36.0,131.0,0.0,38.0,161.0,82,64,18,39.0,31.0,8.0
9308370,8,4,4,5,3,5,5,39,3.0,2.0,1.0,1.0,0.0,3.0,3.0,9,8,1,3.0,3.0,0.0
9706480,5,3,2,2,0,5,17,39,3.0,1.0,2.0,2.0,0.0,3.0,7.0,13,5,8,2.0,2.0,0.0
103092,6,3,3,5,0,6,41,20,4.0,2.0,2.0,3.0,0.0,4.0,21.0,23,6,17,2.0,1.0,1.0
1043,6,1,5,9,5,1,2,20,0.0,0.0,0.0,0.0,0.0,0.0,0.0,10,6,4,1.0,0.0,1.0
9209239,74,21,53,204,57,17,17,29,33.0,12.0,21.0,82.0,33.0,0.0,0.0,75,74,1,15.0,15.0,0.0
9405407,111,10,101,788,10,101,218,17,78.0,4.0,74.0,671.0,4.0,74.0,154.0,118,111,7,50.0,48.0,2.0
9811227,30,3,27,153,0,30,135,20,26.0,2.0,24.0,137.0,0.0,26.0,123.0,42,30,12,25.0,19.0,6.0
9807318,12,5,7,13,3,9,46,20,2.0,2.0,0.0,0.0,1.0,1.0,3.0,21,12,9,3.0,2.0,1.0
11034,1,1,0,0,0,1,4,20,0.0,0.0,0.0,0.0,0.0,0.0,0.0,6,1,5,2.0,0.0,2.0
9407314,20,10,10,17,7,13,13,153,13.0,7.0,6.0,8.0,5.0,8.0,8.0,21,20,1,9.0,8.0,1.0
206029,5,1,4,8,0,5,28,37,3.0,1.0,2.0,3.0,0.0,3.0,8.0,16,5,11,4.0,1.0,3.0
9905487,43,1,42,238,0,43,165,2,23.0,1.0,22.0,99.0,23.0,0.0,0.0,55,43,12,19.0,19.0,0.0
9504231,19,5,14,32,4,15,39,6,5.0,2.0,3.0,3.0,4.0,1.0,1.0,31,19,12,5.0,3.0,2.0
9412332,23,10,13,36,15,8,20,75,6.0,2.0,4.0,9.0,5.0,1.0,1.0,34,23,11,9.0,7.0,2.0
9907319,77,9,68,398,6,71,474,5,26.0,4.0,22.0,140.0,0.0,26.0,150.0,134,77,57,29.0,23.0,6.0
9504415,73,17,56,137,42,31,43,32,12.0,1.0,11.0,26.0,12.0,0.0,0.0,79,73,6,3.0,3.0,0.0
9210241,29,4,25,69,29,0,0,18,18.0,5.0,13.0,42.0,18.0,0.0,0.0,29,29,0,9.0,9.0,0.0
9903448,86,2,84,530,1,85,245,5,43.0,1.0,42.0,314.0,2.0,41.0,50.0,102,86,16,35.0,34.0,1.0
9903286,2,2,0,0,2,0,0,99,0.0,0.0,0.0,0.0,0.0,0.0,0.0,3,2,1,1.0,0.0,1.0
9706391,17,3,14,25,1,16,69,42,10.0,1.0,9.0,17.0,0.0,10.0,43.0,36,17,19,11.0,6.0,5.0
9609364,20,11,9,22,3,17,63,15,10.0,3.0,7.0,18.0,0.0,10.0,39.0,30,20,10,4.0,4.0,0.0
9411277,12,8,4,6,7,5,10,35,3.0,3.0,0.0,0.0,1.0,2.0,5.0,17,12,5,7.0,3.0,4.0
9611312,18,1,17,92,11,7,21,158,16.0,2.0,14.0,79.0,16.0,0.0,0.0,25,18,7,17.0,17.0,0.0
9707511,9,5,4,5,0,9,33,114,8.0,4.0,4.0,5.0,2.0,6.0,16.0,19,9,10,11.0,7.0,4.0
9808274,2,2,0,0,2,0,0,242,0.0,0.0,0.0,0.0,0.0,0.0,0.0,4,2,2,1.0,0.0,1.0
9311372,58,13,45,270,43,15,21,4,35.0,3.0,32.0,208.0,35.0,0.0,0.0,65,58,7,29.0,29.0,0.0
9812236,54,9,45,175,2,52,176,95,25.0,5.0,20.0,79.0,1.0,24.0,68.0,65,54,11,23.0,18.0,5.0
9809543,57,6,51,295,3,54,365,70,54.0,4.0,50.0,293.0,0.0,54.0,365.0,65,57,8,45.0,37.0,8.0
9805259,35,4,31,130,1,34,151,50,26.0,1.0,25.0,111.0,0.0,26.0,117.0,46,35,11,27.0,20.0,7.0
9603223,5,3,2,2,0,5,5,348,1.0,1.0,0.0,0.0,0.0,1.0,1.0,8,5,3,1.0,1.0,0.0
9802351,7,4,3,3,5,2,6,62,1.0,1.0,0.0,0.0,0.0,1.0,2.0,14,7,7,2.0,0.0,2.0
9305208,17,5,12,16,12,5,5,99,4.0,3.0,1.0,1.0,2.0,2.0,2.0,19,17,2,5.0,4.0,1.0
9910315,57,23,34,65,21,36,94,41,9.0,3.0,6.0,9.0,0.0,9.0,35.0,69,57,12,11.0,6.0,5.0
9507375,11,6,5,9,9,2,4,239,2.0,2.0,0.0,0.0,2.0,0.0,0.0,13,11,2,2.0,2.0,0.0
9711379,3,3,0,0,3,0,0,343,1.0,1.0,0.0,0.0,1.0,0.0,0.0,3,3,0,1.0,1.0,0.0
9905305,11,6,5,9,2,9,32,227,8.0,4.0,4.0,7.0,0.0,8.0,30.0,20,11,9,13.0,5.0,8.0
9501406,7,5,2,3,7,0,0,24,1.0,1.0,0.0,0.0,1.0,0.0,0.0,7,7,0,2.0,2.0,0.0
9602324,22,6,16,44,1,21,127,6,15.0,3.0,12.0,33.0,0.0,15.0,106.0,35,22,13,13.0,8.0,5.0
209056,1,1,0,0,0,1,1,23,1.0,1.0,0.0,0.0,1.0,0.0,0.0,7,1,6,1.0,0.0,1.0
9708473,1,1,0,0,1,0,0,1298,,,,,,,,1,1,0,,,
9607296,15,4,11,28,0,15,97,81,4.0,3.0,1.0,1.0,0.0,4.0,29.0,35,15,20,6.0,1.0,5.0
9606235,2,2,0,0,1,1,10,1,1.0,1.0,0.0,0.0,0.0,1.0,9.0,22,2,20,15.0,0.0,15.0
10348,30,4,26,83,0,30,170,55,19.0,4.0,15.0,47.0,0.0,19.0,102.0,56,30,26,24.0,16.0,8.0
9708304,9,5,4,4,3,6,18,5,2.0,1.0,1.0,1.0,0.0,2.0,2.0,27,9,18,2.0,2.0,0.0
5261,46,5,41,139,0,46,191,0,27.0,2.0,25.0,95.0,2.0,25.0,96.0,66,46,20,19.0,15.0,4.0
9511464,22,3,19,49,12,10,11,55,10.0,1.0,9.0,30.0,3.0,7.0,7.0,24,22,2,9.0,9.0,0.0
3231,9,4,5,6,0,9,52,3,3.0,2.0,1.0,1.0,0.0,3.0,6.0,26,9,17,4.0,3.0,1.0
9910242,53,9,44,123,53,0,0,31,34.0,8.0,26.0,77.0,34.0,0.0,0.0,53,53,0,11.0,11.0,0.0
9412302,16,1,15,49,0,16,113,124,16.0,1.0,15.0,49.0,0.0,16.0,105.0,38,16,22,28.0,16.0,12.0
9907261,66,3,63,403,0,66,335,18,45.0,2.0,43.0,273.0,0.0,45.0,219.0,91,66,25,40.0,33.0,7.0
12254,4,2,2,2,2,2,12,8,2.0,1.0,1.0,1.0,0.0,2.0,7.0,16,4,12,9.0,2.0,7.0
9343,5,5,0,0,1,4,25,27,4.0,4.0,0.0,0.0,0.0,4.0,25.0,17,5,12,8.0,3.0,5.0
9802441,51,8,43,193,2,49,197,5,31.0,5.0,26.0,100.0,1.0,30.0,129.0,70,51,19,27.0,14.0,13.0
9701301,68,15,53,214,5,63,416,18,33.0,4.0,29.0,132.0,2.0,31.0,176.0,107,68,39,11.0,7.0,4.0
9910497,5,2,3,5,0,5,23,5,1.0,1.0,0.0,0.0,0.0,1.0,8.0,28,5,23,13.0,1.0,12.0
9809504,14,8,6,7,1,13,28,18,4.0,3.0,1.0,1.0,0.0,4.0,14.0,25,14,11,2.0,2.0,0.0
9909284,24,13,11,17,0,24,102,13,8.0,5.0,3.0,5.0,0.0,8.0,37.0,43,24,19,12.0,6.0,6.0
9511352,17,3,14,28,12,5,7,7,11.0,2.0,9.0,20.0,11.0,0.0,0.0,21,17,4,3.0,3.0,0.0
9710313,35,6,29,109,15,20,72,4,18.0,1.0,17.0,73.0,10.0,8.0,11.0,50,35,15,12.0,10.0,2.0
102234,71,2,69,383,36,35,49,0,43.0,1.0,42.0,235.0,20.0,23.0,34.0,77,71,6,29.0,29.0,0.0
9909453,19,7,12,31,5,14,22,0,9.0,3.0,6.0,18.0,9.0,0.0,0.0,23,19,4,2.0,2.0,0.0
9508325,113,39,74,143,83,30,42,111,18.0,7.0,11.0,16.0,18.0,0.0,0.0,122,113,9,11.0,11.0,0.0
9504279,22,2,20,58,0,22,71,69,18.0,2.0,16.0,48.0,0.0,18.0,64.0,28,22,6,17.0,13.0,4.0
9506270,14,5,9,26,10,4,5,51,9.0,2.0,7.0,20.0,6.0,3.0,3.0,17,14,3,8.0,8.0,0.0
2190,5,4,1,1,0,5,27,118,4.0,3.0,1.0,1.0,0.0,4.0,20.0,15,5,10,12.0,4.0,8.0
9305314,36,9,27,94,36,0,0,163,18.0,4.0,14.0,51.0,18.0,0.0,0.0,37,36,1,10.0,10.0,0.0
9708233,3,2,1,1,2,1,1,252,1.0,1.0,0.0,0.0,1.0,0.0,0.0,4,3,1,1.0,1.0,0.0
9904317,6,4,2,2,3,3,7,66,3.0,2.0,1.0,1.0,3.0,0.0,0.0,12,6,6,2.0,1.0,1.0
9710413,17,8,9,21,6,11,44,25,9.0,5.0,4.0,14.0,0.0,9.0,37.0,30,17,13,16.0,9.0,7.0
9507240,46,8,38,173,10,36,119,94,29.0,5.0,24.0,135.0,0.0,29.0,93.0,57,46,11,28.0,24.0,4.0
9711472,18,3,15,37,1,17,121,4,7.0,2.0,5.0,12.0,0.0,7.0,37.0,42,18,24,3.0,2.0,1.0
9504394,1,1,0,0,1,0,0,293,1.0,1.0,0.0,0.0,1.0,0.0,0.0,3,1,2,1.0,1.0,0.0
9602316,8,4,4,8,4,4,4,290,3.0,2.0,1.0,2.0,2.0,1.0,1.0,9,8,1,5.0,4.0,1.0
9304311,16,3,13,52,16,0,0,135,11.0,3.0,8.0,32.0,11.0,0.0,0.0,16,16,0,11.0,11.0,0.0
4130,13,3,10,30,0,13,82,2,9.0,1.0,8.0,24.0,0.0,9.0,18.0,27,13,14,6.0,0.0,6.0
9812402,3,3,0,0,1,2,4,276,1.0,1.0,0.0,0.0,0.0,1.0,1.0,7,3,4,2.0,1.0,1.0
9905415,50,2,48,241,0,50,453,2,34.0,2.0,32.0,161.0,0.0,34.0,341.0,74,50,24,37.0,25.0,12.0
101221,5,5,0,0,3,2,14,202,1.0,1.0,0.0,0.0,0.0,1.0,3.0,40,5,35,3.0,0.0,3.0
9504284,13,2,11,23,0,13,29,11,7.0,1.0,6.0,10.0,0.0,7.0,14.0,17,13,4,7.0,6.0,1.0
10104,7,3,4,5,1,6,45,44,6.0,2.0,4.0,5.0,0.0,6.0,28.0,26,7,19,13.0,6.0,7.0
211296,4,3,1,1,2,2,3,19,0.0,0.0,0.0,0.0,0.0,0.0,0.0,14,4,10,9.0,0.0,9.0
107086,9,6,3,3,0,9,50,33,4.0,2.0,2.0,2.0,0.0,4.0,22.0,29,9,20,11.0,2.0,9.0
9910292,9,5,4,8,3,6,6,442,3.0,2.0,1.0,1.0,0.0,3.0,3.0,10,9,1,5.0,4.0,1.0
111164,18,1,17,34,0,18,151,19,11.0,1.0,10.0,22.0,0.0,11.0,70.0,53,18,35,16.0,7.0,9.0
3268,5,4,1,1,2,3,10,160,1.0,1.0,0.0,0.0,0.0,1.0,1.0,25,5,20,3.0,1.0,2.0
112161,28,3,25,120,0,28,310,28,23.0,1.0,22.0,117.0,0.0,23.0,181.0,58,28,30,33.0,23.0,10.0
103043,9,1,8,18,0,9,43,2,9.0,1.0,8.0,18.0,9.0,0.0,0.0,30,9,21,1.0,1.0,0.0
3129,66,7,59,229,2,64,365,2,37.0,3.0,34.0,149.0,0.0,37.0,155.0,96,66,30,30.0,25.0,5.0
9705279,19,2,17,61,0,19,119,9,16.0,2.0,14.0,53.0,0.0,16.0,96.0,27,19,8,23.0,15.0,8.0
9501253,0,0,0,0,0,0,0,108,,,,,,,,2,0,2,,,
9411383,13,5,8,9,1,12,45,10,5.0,2.0,3.0,4.0,1.0,4.0,11.0,34,13,21,7.0,4.0,3.0
106033,3,1,2,3,0,3,17,168,2.0,1.0,1.0,1.0,0.0,2.0,6.0,12,3,9,4.0,2.0,2.0
5030,6,3,3,4,0,6,40,28,4.0,2.0,2.0,2.0,1.0,3.0,3.0,23,6,17,3.0,3.0,0.0
9909481,32,3,29,112,0,32,211,2,23.0,1.0,22.0,68.0,4.0,19.0,54.0,48,32,16,19.0,15.0,4.0
12031,4,3,1,1,1,3,14,32,2.0,2.0,0.0,0.0,0.0,2.0,10.0,23,4,19,3.0,1.0,2.0
2102,12,5,7,11,0,12,67,2,3.0,2.0,1.0,1.0,0.0,3.0,24.0,39,12,27,4.0,3.0,1.0
9306226,30,12,18,47,12,18,32,75,9.0,4.0,5.0,14.0,5.0,4.0,11.0,36,30,6,7.0,3.0,4.0
4135,0,0,0,0,0,0,0,774,0.0,0.0,0.0,0.0,0.0,0.0,0.0,2,0,2,1.0,0.0,1.0
9403257,35,10,25,62,21,14,14,120,22.0,4.0,18.0,52.0,12.0,10.0,10.0,36,35,1,13.0,13.0,0.0
9309208,3,3,0,0,3,0,0,12,,,,,,,,4,3,1,1.0,1.0,0.0
9307252,14,6,8,21,14,0,0,164,7.0,4.0,3.0,3.0,7.0,0.0,0.0,14,14,0,3.0,3.0,0.0
9909231,5,4,1,1,0,5,14,0,3.0,2.0,1.0,1.0,0.0,3.0,12.0,24,5,19,8.0,3.0,5.0
9906467,5,2,3,4,0,5,28,86,5.0,2.0,3.0,4.0,0.0,5.0,25.0,12,5,7,10.0,4.0,6.0
9404284,18,4,14,31,18,0,0,194,8.0,3.0,5.0,12.0,8.0,0.0,0.0,18,18,0,7.0,7.0,0.0
9906232,10,1,9,12,0,10,73,3,8.0,2.0,6.0,8.0,0.0,8.0,60.0,45,10,35,2.0,0.0,2.0
1298,2,2,0,0,1,1,9,32,0.0,0.0,0.0,0.0,0.0,0.0,0.0,35,2,33,10.0,0.0,10.0
11391,1,1,0,0,0,1,2,450,0.0,0.0,0.0,0.0,0.0,0.0,0.0,6,1,5,1.0,0.0,1.0
9708300,26,6,20,62,3,23,67,67,12.0,1.0,11.0,25.0,0.0,12.0,42.0,32,26,6,5.0,3.0,2.0
109088,7,5,2,2,0,7,25,1,2.0,1.0,1.0,1.0,0.0,2.0,9.0,34,7,27,10.0,3.0,7.0
9303302,3,1,2,3,3,0,0,61,1.0,1.0,0.0,0.0,1.0,0.0,0.0,4,3,1,3.0,3.0,0.0
9803501,10,4,6,7,2,8,28,29,0.0,0.0,0.0,0.0,0.0,0.0,0.0,28,10,18,8.0,0.0,8.0
6321,29,2,27,142,0,29,202,9,25.0,2.0,23.0,134.0,0.0,25.0,178.0,42,29,13,16.0,15.0,1.0
9603384,27,2,25,94,1,26,74,15,14.0,1.0,13.0,47.0,0.0,14.0,14.0,37,27,10,4.0,4.0,0.0
9604237,55,10,45,149,1,54,167,17,39.0,5.0,34.0,122.0,0.0,39.0,140.0,63,55,8,27.0,20.0,7.0
9609281,6,3,3,3,0,6,29,17,6.0,3.0,3.0,3.0,0.0,6.0,29.0,19,6,13,1.0,1.0,0.0
9608294,12,2,10,19,0,12,45,26,9.0,1.0,8.0,17.0,0.0,9.0,20.0,26,12,14,6.0,5.0,1.0
9503274,1,1,0,0,1,0,0,850,,,,,,,,1,1,0,,,
2135,10,5,5,7,0,10,29,56,3.0,1.0,2.0,3.0,0.0,3.0,4.0,25,10,15,4.0,1.0,3.0
9809229,7,1,6,15,0,7,37,24,5.0,1.0,4.0,9.0,0.0,5.0,7.0,15,7,8,9.0,6.0,3.0
9402287,2,2,0,0,1,1,1,104,1.0,1.0,0.0,0.0,1.0,0.0,0.0,3,2,1,1.0,1.0,0.0
9205213,41,14,27,85,41,0,0,8,7.0,4.0,3.0,4.0,7.0,0.0,0.0,41,41,0,4.0,4.0,0.0
9208236,27,5,22,82,27,0,0,182,21.0,1.0,20.0,78.0,21.0,0.0,0.0,27,27,0,20.0,20.0,0.0
9302,10,2,8,15,7,3,3,93,6.0,2.0,4.0,7.0,6.0,0.0,0.0,11,10,1,7.0,7.0,0.0
104184,3,3,0,0,0,3,13,12,0.0,0.0,0.0,0.0,0.0,0.0,0.0,27,3,24,10.0,0.0,10.0
9803401,21,10,11,14,4,17,60,1,0.0,0.0,0.0,0.0,0.0,0.0,0.0,52,21,31,6.0,0.0,6.0
9603318,20,4,16,28,2,18,29,7,4.0,2.0,2.0,2.0,0.0,4.0,7.0,25,20,5,6.0,4.0,2.0
9412312,5,4,1,1,2,3,5,88,1.0,1.0,0.0,0.0,0.0,1.0,1.0,11,5,6,2.0,2.0,0.0
9701264,2,1,1,1,0,2,9,5,2.0,1.0,1.0,1.0,0.0,2.0,9.0,40,2,38,6.0,0.0,6.0
9707500,28,4,24,78,0,28,133,54,25.0,3.0,22.0,75.0,0.0,25.0,115.0,37,28,9,27.0,20.0,7.0
9609226,26,7,19,57,1,25,93,54,18.0,5.0,13.0,48.0,0.0,18.0,52.0,42,26,16,20.0,16.0,4.0
9607252,6,3,3,6,0,6,33,14,5.0,2.0,3.0,6.0,0.0,5.0,28.0,18,6,12,3.0,1.0,2.0
104259,10,1,9,25,0,10,118,24,10.0,1.0,9.0,25.0,0.0,10.0,106.0,36,10,26,21.0,9.0,12.0
9808463,41,4,37,202,0,41,209,24,32.0,3.0,29.0,161.0,0.0,32.0,153.0,52,41,11,25.0,19.0,6.0
9606385,10,4,6,12,3,7,15,92,3.0,1.0,2.0,2.0,0.0,3.0,7.0,16,10,6,1.0,0.0,1.0
9207204,28,9,19,37,28,0,0,64,6.0,1.0,5.0,7.0,6.0,0.0,0.0,28,28,0,4.0,4.0,0.0
9407332,6,5,1,1,3,3,6,47,0.0,0.0,0.0,0.0,0.0,0.0,0.0,13,6,7,4.0,2.0,2.0
9708237,20,8,12,24,18,2,3,9,7.0,1.0,6.0,6.0,7.0,0.0,0.0,23,20,3,1.0,1.0,0.0
9705344,70,19,51,200,11,59,254,14,37.0,8.0,29.0,139.0,0.0,37.0,182.0,86,70,16,29.0,21.0,8.0
9310316,106,13,93,466,106,0,0,14,39.0,6.0,33.0,129.0,39.0,0.0,0.0,106,106,0,21.0,21.0,0.0
9312237,37,7,30,74,2,35,62,14,14.0,4.0,10.0,16.0,0.0,14.0,14.0,41,37,4,10.0,9.0,1.0
9208208,7,3,4,5,7,0,0,440,2.0,2.0,0.0,0.0,2.0,0.0,0.0,7,7,0,2.0,2.0,0.0
9804397,24,6,18,33,2,22,92,9,11.0,5.0,6.0,10.0,0.0,11.0,36.0,32,24,8,14.0,10.0,4.0
9708484,3,3,0,0,0,3,18,101,1.0,1.0,0.0,0.0,0.0,1.0,6.0,22,3,19,1.0,0.0,1.0
9601285,17,3,14,48,1,16,75,13,16.0,2.0,14.0,48.0,0.0,16.0,75.0,26,17,9,18.0,11.0,7.0
9601374,6,2,4,9,0,6,59,10,5.0,1.0,4.0,9.0,0.0,5.0,48.0,30,6,24,15.0,5.0,10.0
5044,20,5,15,24,3,17,63,45,11.0,1.0,10.0,14.0,0.0,11.0,43.0,32,20,12,16.0,8.0,8.0
6326,5,2,3,3,0,5,34,45,3.0,1.0,2.0,2.0,0.0,3.0,8.0,27,5,22,5.0,3.0,2.0
9911384,5,5,0,0,1,4,27,17,3.0,3.0,0.0,0.0,0.0,3.0,24.0,18,5,13,2.0,1.0,1.0
9802307,8,5,3,4,3,5,7,244,4.0,3.0,1.0,1.0,1.0,3.0,3.0,14,8,6,5.0,4.0,1.0
9701241,15,7,8,26,2,13,92,16,10.0,6.0,4.0,15.0,2.0,8.0,62.0,37,15,22,19.0,6.0,13.0
9405400,23,8,15,36,13,10,13,16,6.0,4.0,2.0,2.0,1.0,5.0,6.0,25,23,2,8.0,8.0,0.0
9612469,2,2,0,0,1,1,2,101,0.0,0.0,0.0,0.0,0.0,0.0,0.0,5,2,3,1.0,0.0,1.0
9707459,8,6,2,2,0,8,21,39,5.0,3.0,2.0,2.0,0.0,5.0,8.0,13,8,5,3.0,3.0,0.0
9709406,4,2,2,2,0,4,17,13,4.0,2.0,2.0,2.0,0.0,4.0,17.0,18,4,14,11.0,3.0,8.0
9609405,3,3,0,0,1,2,4,194,1.0,1.0,0.0,0.0,0.0,1.0,2.0,10,3,7,6.0,1.0,5.0
9808481,6,3,3,5,2,4,7,97,4.0,1.0,3.0,5.0,0.0,4.0,7.0,8,6,2,1.0,1.0,0.0
9710487,43,7,36,142,7,36,134,8,19.0,4.0,15.0,62.0,3.0,16.0,32.0,59,43,16,22.0,17.0,5.0
9305219,19,5,14,43,7,12,20,176,11.0,3.0,8.0,27.0,0.0,11.0,19.0,21,19,2,13.0,11.0,2.0
9411427,1,1,0,0,0,1,1,1233,0.0,0.0,0.0,0.0,0.0,0.0,0.0,2,1,1,1.0,0.0,1.0
9703311,64,6,58,517,1,63,273,36,57.0,6.0,51.0,499.0,3.0,54.0,222.0,78,64,14,48.0,43.0,5.0
9502356,5,4,1,2,5,0,0,401,3.0,2.0,1.0,1.0,3.0,0.0,0.0,5,5,0,3.0,3.0,0.0
9809498,26,5,21,70,2,24,136,60,10.0,1.0,9.0,28.0,0.0,10.0,76.0,42,26,16,20.0,8.0,12.0
12354,12,1,11,29,0,12,32,0,10.0,1.0,9.0,26.0,0.0,10.0,22.0,19,12,7,11.0,9.0,2.0
9806318,2,2,0,0,2,0,0,336,1.0,1.0,0.0,0.0,1.0,0.0,0.0,3,2,1,,,
9302237,1,1,0,0,1,0,0,912,,,,,,,,1,1,0,,,
9310349,8,4,4,5,6,2,3,159,4.0,1.0,3.0,4.0,3.0,1.0,1.0,11,8,3,2.0,1.0,1.0
9407350,25,5,20,58,25,0,0,52,17.0,1.0,16.0,45.0,17.0,0.0,0.0,25,25,0,13.0,13.0,0.0
9810322,23,2,21,102,17,6,6,201,17.0,1.0,16.0,84.0,12.0,5.0,5.0,25,23,2,16.0,16.0,0.0
9704389,21,11,10,18,4,17,102,15,10.0,4.0,6.0,14.0,0.0,10.0,62.0,41,21,20,2.0,2.0,0.0
9510311,12,2,10,25,0,12,113,71,10.0,1.0,9.0,24.0,0.0,10.0,102.0,28,12,16,23.0,10.0,13.0
9810351,5,1,4,5,2,3,3,1809,,,,,,,,6,5,1,,,
104240,2,2,0,0,0,2,3,128,0.0,0.0,0.0,0.0,0.0,0.0,0.0,9,2,7,1.0,0.0,1.0
9906272,4,3,1,1,3,1,3,120,2.0,2.0,0.0,0.0,1.0,1.0,3.0,8,4,4,1.0,1.0,0.0
9803481,10,6,4,6,5,5,9,5,4.0,1.0,3.0,5.0,4.0,0.0,0.0,19,10,9,2.0,1.0,1.0
9903221,5,2,3,5,1,4,17,145,3.0,1.0,2.0,3.0,0.0,3.0,7.0,12,5,7,5.0,3.0,2.0
9603347,5,4,1,2,0,5,15,41,0.0,0.0,0.0,0.0,0.0,0.0,0.0,22,5,17,9.0,1.0,8.0
9812357,34,16,18,39,5,29,206,25,6.0,3.0,3.0,7.0,0.0,6.0,38.0,125,34,91,18.0,5.0,13.0
9807244,1,1,0,0,0,1,2,61,0.0,0.0,0.0,0.0,0.0,0.0,0.0,25,1,24,8.0,0.0,8.0
107129,16,6,10,26,0,16,105,21,13.0,3.0,10.0,26.0,0.0,13.0,83.0,34,16,18,24.0,13.0,11.0
9912448,9,3,6,12,1,8,23,21,7.0,1.0,6.0,12.0,0.0,7.0,13.0,19,9,10,6.0,6.0,0.0
9208247,11,3,8,9,11,0,0,369,3.0,3.0,0.0,0.0,3.0,0.0,0.0,11,11,0,6.0,6.0,0.0
4039,2,1,1,1,0,2,3,90,2.0,1.0,1.0,1.0,0.0,2.0,3.0,10,2,8,5.0,0.0,5.0
9704330,0,0,0,0,0,0,0,171,0.0,0.0,0.0,0.0,0.0,0.0,0.0,2,0,2,2.0,0.0,2.0
9606346,33,7,26,97,10,23,43,14,22.0,5.0,17.0,65.0,22.0,0.0,0.0,37,33,4,14.0,14.0,0.0
209229,1,1,0,0,0,1,1,225,0.0,0.0,0.0,0.0,0.0,0.0,0.0,17,1,16,3.0,0.0,3.0
9911226,2,2,0,0,0,2,10,56,2.0,2.0,0.0,0.0,0.0,2.0,10.0,13,2,11,5.0,1.0,4.0
9911482,15,5,10,27,1,14,78,30,8.0,2.0,6.0,14.0,0.0,8.0,39.0,33,15,18,15.0,5.0,10.0
9904355,30,3,27,192,0,30,272,2,27.0,3.0,24.0,182.0,0.0,27.0,257.0,43,30,13,35.0,23.0,12.0
9909399,4,1,3,4,0,4,17,32,2.0,1.0,1.0,1.0,0.0,2.0,2.0,13,4,9,7.0,3.0,4.0
106245,47,10,37,143,0,47,358,55,22.0,6.0,16.0,53.0,0.0,22.0,137.0,79,47,32,27.0,18.0,9.0
9812535,6,3,3,6,1,5,5,15,0.0,0.0,0.0,0.0,0.0,0.0,0.0,20,6,14,2.0,1.0,1.0
103063,19,5,14,19,3,16,82,13,9.0,1.0,8.0,9.0,0.0,9.0,59.0,29,19,10,8.0,5.0,3.0
9812332,12,5,7,11,2,10,64,25,4.0,3.0,1.0,1.0,0.0,4.0,29.0,42,12,30,12.0,3.0,9.0
9907510,72,16,56,224,5,67,272,21,22.0,3.0,19.0,56.0,6.0,16.0,22.0,100,72,28,18.0,15.0,3.0
9602282,3,2,1,1,0,3,8,112,2.0,2.0,0.0,0.0,0.0,2.0,5.0,9,3,6,5.0,2.0,3.0
9906520,3,3,0,0,3,0,0,475,2.0,2.0,0.0,0.0,2.0,0.0,0.0,4,3,1,1.0,1.0,0.0
204225,16,6,10,26,0,16,149,7,9.0,3.0,6.0,14.0,0.0,9.0,73.0,49,16,33,19.0,10.0,9.0
9508397,10,1,9,20,2,8,26,36,7.0,2.0,5.0,8.0,1.0,6.0,13.0,14,10,4,10.0,6.0,4.0
9704428,23,4,19,116,0,23,285,36,23.0,4.0,19.0,116.0,0.0,23.0,273.0,46,23,23,37.0,22.0,15.0
207051,4,3,1,1,1,3,16,55,2.0,2.0,0.0,0.0,0.0,2.0,10.0,25,4,21,8.0,0.0,8.0
9612485,5,2,3,6,0,5,17,26,3.0,2.0,1.0,2.0,0.0,3.0,10.0,15,5,10,7.0,3.0,4.0
9310324,30,7,23,84,28,2,2,58,16.0,3.0,13.0,42.0,16.0,0.0,0.0,31,30,1,12.0,12.0,0.0
108227,12,3,9,12,0,12,99,67,6.0,2.0,4.0,6.0,0.0,6.0,59.0,50,12,38,28.0,5.0,23.0
9508412,7,1,6,10,0,7,17,6,1.0,1.0,0.0,0.0,0.0,1.0,1.0,12,7,5,1.0,0.0,1.0
9912380,28,9,19,46,3,25,88,3,9.0,3.0,6.0,9.0,0.0,9.0,9.0,39,28,11,9.0,8.0,1.0
9504215,19,5,14,29,15,4,15,30,6.0,3.0,3.0,5.0,2.0,4.0,4.0,26,19,7,8.0,8.0,0.0
4024,5,5,0,0,1,4,12,21,2.0,2.0,0.0,0.0,0.0,2.0,9.0,16,5,11,1.0,0.0,1.0
9612321,16,2,14,25,1,15,113,5,11.0,2.0,9.0,19.0,0.0,11.0,94.0,28,16,12,18.0,8.0,10.0
9308299,4,3,1,1,4,0,0,237,4.0,3.0,1.0,1.0,4.0,0.0,0.0,4,4,0,3.0,3.0,0.0
9607450,5,4,1,2,0,5,19,5,1.0,1.0,0.0,0.0,1.0,0.0,0.0,11,5,6,1.0,1.0,0.0
9706294,45,5,40,196,1,44,130,1,33.0,5.0,28.0,124.0,1.0,32.0,90.0,54,45,9,27.0,24.0,3.0
9607304,4,4,0,0,1,3,10,13,0.0,0.0,0.0,0.0,0.0,0.0,0.0,11,4,7,1.0,0.0,1.0
9610246,3,3,0,0,3,0,0,80,,,,,,,,3,3,0,1.0,1.0,0.0
3017,11,9,2,2,4,7,29,154,1.0,1.0,0.0,0.0,0.0,1.0,3.0,45,11,34,6.0,1.0,5.0
9512299,10,5,5,7,7,3,3,241,4.0,4.0,0.0,0.0,4.0,0.0,0.0,11,10,1,2.0,2.0,0.0
9708478,5,3,2,2,1,4,5,44,0.0,0.0,0.0,0.0,0.0,0.0,0.0,10,5,5,1.0,0.0,1.0
9703335,13,4,9,23,3,10,19,74,10.0,2.0,8.0,21.0,1.0,9.0,17.0,15,13,2,12.0,10.0,2.0
9802369,5,4,1,1,1,4,10,213,2.0,2.0,0.0,0.0,0.0,2.0,7.0,11,5,6,7.0,2.0,5.0
104048,20,8,12,15,1,19,72,8,3.0,2.0,1.0,1.0,0.0,3.0,20.0,42,20,22,11.0,3.0,8.0
9504400,5,4,1,2,2,3,5,85,2.0,1.0,1.0,1.0,0.0,2.0,2.0,10,5,5,2.0,2.0,0.0
9907336,8,4,4,6,8,0,0,257,6.0,2.0,4.0,6.0,6.0,0.0,0.0,9,8,1,5.0,5.0,0.0
9503448,1,1,0,0,1,0,0,898,,,,,,,,1,1,0,,,
9708353,6,2,4,10,1,5,38,43,5.0,1.0,4.0,10.0,0.0,5.0,38.0,14,6,8,13.0,5.0,8.0
9710526,14,2,12,26,0,14,77,42,9.0,2.0,7.0,13.0,0.0,9.0,61.0,27,14,13,19.0,8.0,11.0
111114,8,6,2,5,0,8,47,22,6.0,4.0,2.0,5.0,0.0,6.0,37.0,73,8,65,16.0,6.0,10.0
9507444,16,5,11,28,2,14,29,22,3.0,2.0,1.0,1.0,0.0,3.0,9.0,23,16,7,5.0,3.0,2.0
9509257,5,4,1,1,1,4,4,319,4.0,3.0,1.0,1.0,1.0,3.0,3.0,6,5,1,5.0,4.0,1.0
103300,25,8,17,79,2,23,55,0,21.0,4.0,17.0,77.0,0.0,21.0,52.0,37,25,12,12.0,12.0,0.0
9410392,7,4,3,3,5,2,2,47,3.0,1.0,2.0,2.0,3.0,0.0,0.0,8,7,1,1.0,1.0,0.0
9308259,6,4,2,2,5,1,1,253,2.0,2.0,0.0,0.0,1.0,1.0,1.0,7,6,1,1.0,1.0,0.0
9801340,1,1,0,0,0,1,2,42,0.0,0.0,0.0,0.0,0.0,0.0,0.0,8,1,7,,,
9906365,4,1,3,3,0,4,20,42,2.0,1.0,1.0,1.0,0.0,2.0,4.0,13,4,9,7.0,2.0,5.0
9612450,8,4,4,7,0,8,44,15,3.0,2.0,1.0,1.0,0.0,3.0,4.0,21,8,13,4.0,3.0,1.0
205216,7,6,1,1,2,5,18,0,2.0,2.0,0.0,0.0,1.0,1.0,2.0,67,7,60,11.0,1.0,10.0
108265,5,3,2,3,0,5,27,11,4.0,3.0,1.0,2.0,0.0,4.0,25.0,21,5,16,3.0,1.0,2.0
1273,13,5,8,15,7,6,22,63,5.0,2.0,3.0,4.0,3.0,2.0,9.0,31,13,18,9.0,1.0,8.0
5088,1,1,0,0,1,0,0,227,0.0,0.0,0.0,0.0,0.0,0.0,0.0,7,1,6,2.0,1.0,1.0
9805432,4,2,2,3,1,3,8,25,3.0,1.0,2.0,3.0,1.0,2.0,2.0,8,4,4,5.0,3.0,2.0
9906435,5,4,1,1,0,5,42,3,3.0,2.0,1.0,1.0,0.0,3.0,34.0,21,5,16,3.0,2.0,1.0
9704415,38,5,33,146,8,30,82,13,25.0,5.0,20.0,77.0,4.0,21.0,64.0,44,38,6,23.0,18.0,5.0
112260,13,7,6,8,1,12,35,32,2.0,1.0,1.0,1.0,2.0,0.0,0.0,27,13,14,7.0,4.0,3.0
9610508,3,2,1,1,3,0,0,229,2.0,1.0,1.0,1.0,2.0,0.0,0.0,5,3,2,2.0,2.0,0.0
9605316,10,2,8,20,0,10,23,48,0.0,0.0,0.0,0.0,0.0,0.0,0.0,26,10,16,2.0,0.0,2.0
9810275,34,7,27,95,3,31,167,9,29.0,5.0,24.0,92.0,0.0,29.0,153.0,51,34,17,31.0,21.0,10.0
9511329,16,10,6,13,16,0,0,48,4.0,1.0,3.0,5.0,4.0,0.0,0.0,16,16,0,4.0,4.0,0.0
9709316,9,2,7,13,0,9,26,33,4.0,1.0,3.0,3.0,0.0,4.0,9.0,21,9,12,5.0,4.0,1.0
9509270,4,4,0,0,0,4,16,26,1.0,1.0,0.0,0.0,0.0,1.0,6.0,17,4,13,7.0,2.0,5.0
9707531,4,2,2,2,0,4,17,36,1.0,1.0,0.0,0.0,0.0,1.0,13.0,19,4,15,2.0,1.0,1.0
9911400,5,5,0,0,2,3,3,296,2.0,2.0,0.0,0.0,2.0,0.0,0.0,11,5,6,4.0,3.0,1.0
9403393,2,2,0,0,1,1,2,44,1.0,1.0,0.0,0.0,1.0,0.0,0.0,4,2,2,2.0,1.0,1.0
212142,6,3,3,4,1,5,15,3,0.0,0.0,0.0,0.0,0.0,0.0,0.0,22,6,16,7.0,0.0,7.0
109149,18,5,13,45,2,16,57,1,0.0,0.0,0.0,0.0,0.0,0.0,0.0,50,18,32,11.0,10.0,1.0
9810499,17,3,14,43,0,17,150,15,17.0,3.0,14.0,43.0,0.0,17.0,143.0,43,17,26,11.0,7.0,4.0
9612236,8,7,1,1,1,7,18,19,0.0,0.0,0.0,0.0,0.0,0.0,0.0,34,8,26,9.0,1.0,8.0
204119,9,5,4,6,0,9,81,7,0.0,0.0,0.0,0.0,0.0,0.0,0.0,73,9,64,21.0,0.0,21.0
9812384,16,7,9,14,7,9,20,3,7.0,2.0,5.0,5.0,7.0,0.0,0.0,24,16,8,3.0,3.0,0.0
9505361,12,5,7,11,6,6,9,68,4.0,1.0,3.0,4.0,4.0,0.0,0.0,14,12,2,3.0,3.0,0.0
9906418,8,3,5,6,1,7,43,27,5.0,3.0,2.0,2.0,0.0,5.0,35.0,22,8,14,3.0,2.0,1.0
9601372,3,1,2,2,0,3,16,10,3.0,1.0,2.0,2.0,0.0,3.0,15.0,23,3,20,8.0,3.0,5.0
110041,9,6,3,3,2,7,19,0,1.0,1.0,0.0,0.0,0.0,1.0,7.0,26,9,17,4.0,1.0,3.0
9903288,45,17,28,52,28,17,38,44,10.0,3.0,7.0,17.0,7.0,3.0,3.0,52,45,7,6.0,6.0,0.0
203233,11,4,7,14,1,10,26,3,2.0,1.0,1.0,1.0,0.0,2.0,4.0,18,11,7,10.0,4.0,6.0
112120,3,3,0,0,1,2,8,0,1.0,1.0,0.0,0.0,0.0,1.0,3.0,31,3,28,8.0,1.0,7.0
9605204,3,3,0,0,2,1,2,56,1.0,1.0,0.0,0.0,1.0,0.0,0.0,7,3,4,2.0,1.0,1.0
104112,14,1,13,45,0,14,72,37,11.0,1.0,10.0,35.0,0.0,11.0,27.0,21,14,7,12.0,11.0,1.0
9909563,11,4,7,12,2,9,24,18,0.0,0.0,0.0,0.0,0.0,0.0,0.0,32,11,21,5.0,5.0,0.0
9508401,15,5,10,23,9,6,7,47,7.0,1.0,6.0,16.0,7.0,0.0,0.0,17,15,2,5.0,5.0,0.0
9606448,3,2,1,1,1,2,3,47,2.0,1.0,1.0,1.0,1.0,1.0,1.0,5,3,2,,,
110243,10,2,8,18,0,10,117,0,4.0,1.0,3.0,4.0,0.0,4.0,46.0,41,10,31,7.0,3.0,4.0
202262,8,2,6,9,0,8,81,107,7.0,2.0,5.0,8.0,0.0,7.0,61.0,27,8,19,16.0,7.0,9.0
8177,1,1,0,0,0,1,3,3,0.0,0.0,0.0,0.0,0.0,0.0,0.0,28,1,27,7.0,0.0,7.0
9608402,1,1,0,0,0,1,3,228,1.0,1.0,0.0,0.0,0.0,1.0,3.0,6,1,5,3.0,1.0,2.0
9809263,15,3,12,51,3,12,81,24,6.0,1.0,5.0,7.0,1.0,5.0,28.0,33,15,18,19.0,12.0,7.0
103180,2,2,0,0,0,2,8,2,0.0,0.0,0.0,0.0,0.0,0.0,0.0,14,2,12,1.0,0.0,1.0
9707369,7,5,2,3,4,3,5,82,1.0,1.0,0.0,0.0,0.0,1.0,1.0,11,7,4,1.0,1.0,0.0
205011,4,2,2,2,1,3,11,48,3.0,1.0,2.0,2.0,0.0,3.0,5.0,15,4,11,7.0,3.0,4.0
9707381,5,2,3,6,4,1,3,239,4.0,1.0,3.0,4.0,4.0,0.0,0.0,8,5,3,4.0,1.0,3.0
9907281,15,4,11,24,0,15,130,11,12.0,3.0,9.0,22.0,0.0,12.0,114.0,34,15,19,6.0,3.0,3.0
9808454,44,5,39,134,1,43,221,11,13.0,4.0,9.0,16.0,0.0,13.0,41.0,65,44,21,22.0,14.0,8.0
9801215,16,2,14,48,2,14,16,13,16.0,2.0,14.0,48.0,2.0,14.0,16.0,19,16,3,14.0,13.0,1.0
3011,9,4,5,10,2,7,18,2,5.0,2.0,3.0,5.0,0.0,5.0,11.0,13,9,4,9.0,6.0,3.0
302124,0,0,0,0,0,0,0,59,0.0,0.0,0.0,0.0,0.0,0.0,0.0,9,0,9,4.0,0.0,4.0
9406400,2,1,1,1,1,1,1,71,1.0,1.0,0.0,0.0,1.0,0.0,0.0,3,2,1,,,
3111,5,2,3,4,0,5,88,15,5.0,2.0,3.0,4.0,0.0,5.0,88.0,42,5,37,23.0,5.0,18.0
9223,7,3,4,7,1,6,19,39,0.0,0.0,0.0,0.0,0.0,0.0,0.0,16,7,9,6.0,4.0,2.0
9608444,3,2,1,1,1,2,10,62,2.0,1.0,1.0,1.0,0.0,2.0,9.0,18,3,15,7.0,1.0,6.0
9403241,6,4,2,3,5,1,1,63,3.0,2.0,1.0,2.0,3.0,0.0,0.0,9,6,3,1.0,0.0,1.0
9907500,7,2,5,10,1,6,23,102,6.0,1.0,5.0,9.0,0.0,6.0,23.0,11,7,4,10.0,6.0,4.0
11291,0,0,0,0,0,0,0,111,0.0,0.0,0.0,0.0,0.0,0.0,0.0,1,0,1,,,
106346,20,13,7,11,4,16,101,6,7.0,5.0,2.0,4.0,0.0,7.0,64.0,64,20,44,8.0,5.0,3.0
103279,2,2,0,0,1,1,2,8,0.0,0.0,0.0,0.0,0.0,0.0,0.0,21,2,19,4.0,1.0,3.0
9509284,7,2,5,10,2,5,9,214,6.0,2.0,4.0,5.0,2.0,4.0,8.0,11,7,4,8.0,6.0,2.0
9905573,6,6,0,0,6,0,0,351,3.0,3.0,0.0,0.0,3.0,0.0,0.0,10,6,4,1.0,1.0,0.0
112261,2,2,0,0,0,2,2,21,0.0,0.0,0.0,0.0,0.0,0.0,0.0,11,2,9,6.0,0.0,6.0
104232,21,5,16,59,1,20,226,109,19.0,5.0,14.0,55.0,0.0,19.0,213.0,57,21,36,37.0,18.0,19.0
12175,8,4,4,5,4,4,8,86,1.0,1.0,0.0,0.0,0.0,1.0,3.0,23,8,15,3.0,0.0,3.0
9607342,4,3,1,1,2,2,2,5,,,,,,,,6,4,2,1.0,1.0,0.0
9312232,5,4,1,1,5,0,0,281,1.0,1.0,0.0,0.0,1.0,0.0,0.0,7,5,2,1.0,1.0,0.0
9908276,31,7,24,84,0,31,129,28,19.0,4.0,15.0,51.0,0.0,19.0,62.0,48,31,17,20.0,16.0,4.0
9908483,17,10,7,10,3,14,40,39,7.0,4.0,3.0,3.0,0.0,7.0,14.0,28,17,11,8.0,7.0,1.0
9804389,4,3,1,1,0,4,16,41,0.0,0.0,0.0,0.0,0.0,0.0,0.0,29,4,25,4.0,0.0,4.0
101299,5,1,4,6,1,4,11,102,1.0,1.0,0.0,0.0,0.0,1.0,1.0,16,5,11,2.0,0.0,2.0
9808413,4,4,0,0,1,3,20,36,2.0,2.0,0.0,0.0,0.0,2.0,15.0,15,4,11,5.0,1.0,4.0
9908527,1,1,0,0,1,0,0,1186,1.0,1.0,0.0,0.0,1.0,0.0,0.0,1,1,0,1.0,1.0,0.0
9802380,8,8,0,0,7,1,1,151,0.0,0.0,0.0,0.0,0.0,0.0,0.0,12,8,4,1.0,1.0,0.0
9809319,6,4,2,2,0,6,31,92,2.0,1.0,1.0,1.0,0.0,2.0,5.0,42,6,36,5.0,2.0,3.0
9308294,9,6,3,4,9,0,0,127,2.0,2.0,0.0,0.0,2.0,0.0,0.0,9,9,0,2.0,2.0,0.0
9410312,2,2,0,0,0,2,3,6,0.0,0.0,0.0,0.0,0.0,0.0,0.0,14,2,12,2.0,1.0,1.0
9907401,4,2,2,2,1,3,39,2,3.0,1.0,2.0,2.0,0.0,3.0,37.0,18,4,14,16.0,3.0,13.0
9807464,24,6,18,34,3,21,44,7,9.0,1.0,8.0,15.0,4.0,5.0,6.0,34,24,10,8.0,6.0,2.0
9808247,16,6,10,31,2,14,54,8,11.0,3.0,8.0,22.0,0.0,11.0,44.0,29,16,13,16.0,9.0,7.0
9902309,8,4,4,6,1,7,12,5,5.0,2.0,3.0,5.0,0.0,5.0,9.0,10,8,2,3.0,1.0,2.0
6241,7,2,5,10,1,6,16,296,5.0,1.0,4.0,8.0,0.0,5.0,5.0,12,7,5,10.0,6.0,4.0
9808438,9,4,5,11,3,6,14,186,6.0,1.0,5.0,11.0,3.0,3.0,3.0,16,9,7,8.0,6.0,2.0
101040,2,2,0,0,1,1,1,184,1.0,1.0,0.0,0.0,0.0,1.0,1.0,9,2,7,3.0,1.0,2.0
9510298,4,4,0,0,4,0,0,292,1.0,1.0,0.0,0.0,1.0,0.0,0.0,4,4,0,1.0,1.0,0.0
6244,11,4,7,12,1,10,21,106,11.0,4.0,7.0,12.0,1.0,10.0,20.0,17,11,6,10.0,8.0,2.0
9501291,5,4,1,1,3,2,3,208,0.0,0.0,0.0,0.0,0.0,0.0,0.0,16,5,11,5.0,0.0,5.0
9310376,2,2,0,0,1,1,1,554,0.0,0.0,0.0,0.0,0.0,0.0,0.0,4,2,2,3.0,2.0,1.0
9407388,22,5,17,70,7,15,45,29,17.0,3.0,14.0,61.0,9.0,8.0,8.0,31,22,9,9.0,6.0,3.0
202114,1,1,0,0,0,1,4,24,0.0,0.0,0.0,0.0,0.0,0.0,0.0,10,1,9,3.0,1.0,2.0
9710501,1,1,0,0,0,1,7,14,1.0,1.0,0.0,0.0,0.0,1.0,7.0,13,1,12,3.0,0.0,3.0
102273,3,1,2,3,0,3,15,9,3.0,1.0,2.0,3.0,1.0,2.0,2.0,13,3,10,5.0,1.0,4.0
201147,1,1,0,0,0,1,2,23,0.0,0.0,0.0,0.0,0.0,0.0,0.0,16,1,15,11.0,0.0,11.0
9602426,6,2,4,9,1,5,9,41,5.0,1.0,4.0,9.0,0.0,5.0,7.0,11,6,5,7.0,5.0,2.0
9910269,2,1,1,1,0,2,5,4,1.0,1.0,0.0,0.0,0.0,1.0,1.0,27,2,25,7.0,0.0,7.0
9506304,2,1,1,1,0,2,2,972,,,,,,,,3,2,1,1.0,1.0,0.0
9608469,2,2,0,0,1,1,2,151,1.0,1.0,0.0,0.0,1.0,0.0,0.0,5,2,3,1.0,1.0,0.0
9408299,60,11,49,211,1,59,167,40,52.0,9.0,43.0,198.0,0.0,52.0,159.0,64,60,4,30.0,26.0,4.0
9611280,6,1,5,8,0,6,19,60,2.0,1.0,1.0,1.0,0.0,2.0,4.0,13,6,7,1.0,1.0,0.0
9911422,9,5,4,7,0,9,99,12,2.0,2.0,0.0,0.0,0.0,2.0,43.0,42,9,33,16.0,2.0,14.0
3204,6,2,4,6,0,6,39,14,4.0,1.0,3.0,4.0,0.0,4.0,20.0,17,6,11,7.0,4.0,3.0
109194,1,1,0,0,0,1,2,41,0.0,0.0,0.0,0.0,0.0,0.0,0.0,13,1,12,7.0,0.0,7.0
9711423,7,4,3,5,0,7,39,14,2.0,1.0,1.0,1.0,0.0,2.0,11.0,33,7,26,8.0,2.0,6.0
9805251,11,4,7,13,0,11,97,54,10.0,3.0,7.0,13.0,0.0,10.0,84.0,25,11,14,19.0,10.0,9.0
2276,5,2,3,4,0,5,18,143,2.0,1.0,1.0,1.0,0.0,2.0,7.0,21,5,16,6.0,2.0,4.0
9708490,5,2,3,7,0,5,14,12,4.0,1.0,3.0,5.0,0.0,4.0,4.0,18,5,13,3.0,0.0,3.0
5075,14,8,6,22,2,12,47,3,10.0,5.0,5.0,21.0,0.0,10.0,41.0,26,14,12,9.0,2.0,7.0
9308275,25,5,20,69,4,21,36,56,16.0,1.0,15.0,37.0,0.0,16.0,26.0,29,25,4,13.0,11.0,2.0
9805407,7,5,2,2,0,7,31,56,6.0,4.0,2.0,2.0,0.0,6.0,28.0,17,7,10,3.0,2.0,1.0
9803266,48,7,41,128,5,43,208,13,21.0,4.0,17.0,36.0,0.0,21.0,122.0,69,48,21,28.0,13.0,15.0
208158,4,4,0,0,0,4,9,9,0.0,0.0,0.0,0.0,0.0,0.0,0.0,63,4,59,9.0,0.0,9.0
9306252,6,5,1,1,1,5,10,234,5.0,4.0,1.0,1.0,0.0,5.0,10.0,8,6,2,6.0,4.0,2.0
9405324,5,1,4,5,5,0,0,38,3.0,1.0,2.0,3.0,3.0,0.0,0.0,5,5,0,3.0,3.0,0.0
104210,8,2,6,9,0,8,83,21,8.0,2.0,6.0,9.0,0.0,8.0,68.0,40,8,32,13.0,0.0,13.0
101230,13,7,6,11,0,13,161,15,7.0,3.0,4.0,6.0,0.0,7.0,122.0,82,13,69,57.0,3.0,54.0
9208245,12,8,4,9,12,0,0,96,6.0,2.0,4.0,8.0,6.0,0.0,0.0,12,12,0,2.0,2.0,0.0
9606239,10,2,8,15,6,4,8,284,9.0,2.0,7.0,14.0,5.0,4.0,8.0,14,10,4,11.0,9.0,2.0
204004,35,7,28,80,0,35,155,27,29.0,5.0,24.0,65.0,0.0,29.0,127.0,50,35,15,24.0,18.0,6.0
202207,3,3,0,0,0,3,6,244,1.0,1.0,0.0,0.0,0.0,1.0,3.0,14,3,11,6.0,1.0,5.0
9708369,8,4,4,9,0,8,49,158,6.0,3.0,3.0,8.0,0.0,6.0,37.0,21,8,13,17.0,6.0,11.0
9905223,2,2,0,0,1,1,2,74,0.0,0.0,0.0,0.0,0.0,0.0,0.0,7,2,5,1.0,0.0,1.0
9409450,0,0,0,0,0,0,0,206,0.0,0.0,0.0,0.0,0.0,0.0,0.0,1,0,1,,,
101004,5,2,3,3,0,5,17,43,1.0,1.0,0.0,0.0,0.0,1.0,2.0,19,5,14,3.0,1.0,2.0
109102,16,2,14,31,1,15,44,16,13.0,2.0,11.0,26.0,0.0,13.0,38.0,23,16,7,15.0,11.0,4.0
9908431,1,1,0,0,0,1,1,79,0.0,0.0,0.0,0.0,0.0,0.0,0.0,9,1,8,5.0,0.0,5.0
9904329,2,2,0,0,0,2,18,1,1.0,1.0,0.0,0.0,0.0,1.0,13.0,29,2,27,17.0,0.0,17.0
103319,1,1,0,0,0,1,1,1,0.0,0.0,0.0,0.0,0.0,0.0,0.0,12,1,11,8.0,0.0,8.0
9810222,1,1,0,0,0,1,5,196,1.0,1.0,0.0,0.0,0.0,1.0,1.0,10,1,9,2.0,1.0,1.0
111089,10,2,8,14,0,10,61,46,8.0,1.0,7.0,11.0,0.0,8.0,32.0,53,10,43,4.0,0.0,4.0
109214,19,2,17,64,18,1,1,219,18.0,2.0,16.0,57.0,18.0,0.0,0.0,20,19,1,14.0,14.0,0.0
12279,18,7,11,24,4,14,21,73,2.0,2.0,0.0,0.0,0.0,2.0,3.0,23,18,5,9.0,8.0,1.0
211433,0,0,0,0,0,0,0,995,0.0,0.0,0.0,0.0,0.0,0.0,0.0,5,0,5,1.0,0.0,1.0
9907212,1,1,0,0,1,0,0,159,0.0,0.0,0.0,0.0,0.0,0.0,0.0,8,1,7,2.0,0.0,2.0
9905557,4,3,1,1,1,3,8,258,3.0,2.0,1.0,1.0,0.0,3.0,7.0,14,4,10,9.0,2.0,7.0
9408248,16,12,4,5,0,16,44,14,10.0,7.0,3.0,3.0,6.0,4.0,5.0,24,16,8,2.0,1.0,1.0
12317,9,6,3,3,4,5,8,50,2.0,2.0,0.0,0.0,2.0,0.0,0.0,13,9,4,2.0,2.0,0.0
9805467,10,5,5,14,0,10,13,50,7.0,3.0,4.0,8.0,0.0,7.0,7.0,12,10,2,4.0,3.0,1.0
9606290,1,1,0,0,1,0,0,92,0.0,0.0,0.0,0.0,0.0,0.0,0.0,5,1,4,,,
6121,5,1,4,8,1,4,15,130,3.0,1.0,2.0,3.0,0.0,3.0,7.0,12,5,7,3.0,0.0,3.0
9912538,2,2,0,0,2,0,0,117,0.0,0.0,0.0,0.0,0.0,0.0,0.0,9,2,7,2.0,0.0,2.0
9911339,7,5,2,2,7,0,0,13,1.0,1.0,0.0,0.0,1.0,0.0,0.0,7,7,0,1.0,1.0,0.0
9706392,2,2,0,0,1,1,9,19,0.0,0.0,0.0,0.0,0.0,0.0,0.0,14,2,12,8.0,1.0,7.0
9706479,5,3,2,3,0,5,39,60,2.0,2.0,0.0,0.0,0.0,2.0,17.0,43,5,38,20.0,1.0,19.0
9811349,12,3,9,21,0,12,88,11,8.0,2.0,6.0,14.0,0.0,8.0,59.0,43,12,31,17.0,5.0,12.0
9604259,11,3,8,15,7,4,9,183,7.0,1.0,6.0,13.0,7.0,0.0,0.0,20,11,9,7.0,7.0,0.0
101134,2,1,1,1,0,2,2,261,2.0,1.0,1.0,1.0,0.0,2.0,2.0,5,2,3,3.0,2.0,1.0
9301292,6,5,1,2,6,0,0,378,5.0,4.0,1.0,2.0,5.0,0.0,0.0,6,6,0,4.0,4.0,0.0
9502372,18,12,6,8,18,0,0,45,4.0,2.0,2.0,2.0,4.0,0.0,0.0,19,18,1,3.0,3.0,0.0
9612492,3,3,0,0,2,1,1,270,1.0,1.0,0.0,0.0,1.0,0.0,0.0,9,3,6,1.0,1.0,0.0
6327,5,1,4,5,0,5,30,2,0.0,0.0,0.0,0.0,0.0,0.0,0.0,24,5,19,4.0,3.0,1.0
9612388,4,4,0,0,1,3,7,48,2.0,2.0,0.0,0.0,0.0,2.0,6.0,16,4,12,7.0,0.0,7.0
9811224,13,3,10,21,2,11,15,197,12.0,2.0,10.0,21.0,1.0,11.0,15.0,15,13,2,12.0,10.0,2.0
9510428,9,4,5,10,6,3,6,79,6.0,2.0,4.0,8.0,3.0,3.0,5.0,17,9,8,3.0,1.0,2.0
9909212,15,8,7,14,1,14,168,12,12.0,6.0,6.0,13.0,0.0,12.0,154.0,49,15,34,30.0,10.0,20.0
9712450,1,1,0,0,1,0,0,210,0.0,0.0,0.0,0.0,0.0,0.0,0.0,3,1,2,1.0,1.0,0.0
112345,12,1,11,30,0,12,95,0,11.0,1.0,10.0,28.0,0.0,11.0,92.0,33,12,21,20.0,5.0,15.0
204351,2,1,1,1,1,1,7,0,0.0,0.0,0.0,0.0,0.0,0.0,0.0,12,2,10,3.0,0.0,3.0
9609218,22,9,13,40,5,17,42,10,9.0,6.0,3.0,5.0,2.0,7.0,12.0,33,22,11,9.0,6.0,3.0
107282,9,6,3,3,1,8,30,8,4.0,2.0,2.0,2.0,0.0,4.0,20.0,29,9,20,17.0,1.0,16.0
103238,1,1,0,0,0,1,9,77,1.0,1.0,0.0,0.0,0.0,1.0,6.0,10,1,9,4.0,0.0,4.0
9207251,9,7,2,4,9,0,0,417,5.0,5.0,0.0,0.0,5.0,0.0,0.0,9,9,0,4.0,4.0,0.0
102102,4,3,1,1,2,2,2,1755,,,,,,,,5,4,1,,,
206243,2,2,0,0,0,2,14,278,1.0,1.0,0.0,0.0,0.0,1.0,4.0,18,2,16,7.0,1.0,6.0
5148,1,1,0,0,0,1,6,3,1.0,1.0,0.0,0.0,0.0,1.0,5.0,19,1,18,7.0,1.0,6.0
8223,4,2,2,2,1,3,18,81,2.0,1.0,1.0,1.0,0.0,2.0,17.0,17,4,13,5.0,2.0,3.0
9507296,2,2,0,0,2,0,0,125,,,,,,,,2,2,0,1.0,1.0,0.0
9809332,1,1,0,0,1,0,0,476,0.0,0.0,0.0,0.0,0.0,0.0,0.0,5,1,4,2.0,0.0,2.0
201103,16,4,12,33,2,14,111,1,12.0,2.0,10.0,31.0,0.0,12.0,102.0,38,16,22,24.0,11.0,13.0
9407376,5,5,0,0,3,2,2,452,3.0,3.0,0.0,0.0,3.0,0.0,0.0,7,5,2,4.0,3.0,1.0
207228,11,6,5,8,2,9,29,1,5.0,2.0,3.0,4.0,0.0,5.0,17.0,19,11,8,1.0,1.0,0.0
207235,5,4,1,1,1,4,16,62,2.0,1.0,1.0,1.0,0.0,2.0,12.0,23,5,18,12.0,2.0,10.0
3125,8,5,3,3,1,7,9,59,4.0,2.0,2.0,2.0,2.0,2.0,2.0,17,8,9,4.0,3.0,1.0
203256,3,3,0,0,0,3,16,25,3.0,3.0,0.0,0.0,0.0,3.0,13.0,15,3,12,6.0,3.0,3.0
102063,3,3,0,0,0,3,5,0,1.0,1.0,0.0,0.0,0.0,1.0,2.0,27,3,24,2.0,0.0,2.0
9910395,16,5,11,29,5,11,23,163,9.0,3.0,6.0,15.0,2.0,7.0,10.0,26,16,10,6.0,6.0,0.0
12127,4,1,3,5,4,0,0,76,3.0,1.0,2.0,3.0,3.0,0.0,0.0,4,4,0,4.0,4.0,0.0
9703344,3,3,0,0,2,1,5,6,2.0,2.0,0.0,0.0,1.0,1.0,1.0,17,3,14,1.0,0.0,1.0
9402324,14,9,5,12,12,2,2,57,10.0,5.0,5.0,10.0,9.0,1.0,1.0,16,14,2,3.0,3.0,0.0
9305320,3,1,2,3,3,0,0,54,2.0,1.0,1.0,1.0,2.0,0.0,0.0,3,3,0,2.0,2.0,0.0
211252,2,2,0,0,1,1,14,3,1.0,1.0,0.0,0.0,0.0,1.0,10.0,115,2,113,14.0,0.0,14.0
202127,8,2,6,16,0,8,99,1,8.0,2.0,6.0,16.0,0.0,8.0,96.0,27,8,19,24.0,8.0,16.0
9604214,2,1,1,1,1,1,1,61,0.0,0.0,0.0,0.0,0.0,0.0,0.0,12,2,10,3.0,1.0,2.0
9610305,6,4,2,2,5,1,1,320,2.0,1.0,1.0,1.0,2.0,0.0,0.0,20,6,14,2.0,2.0,0.0
9907417,5,4,1,1,0,5,17,101,5.0,4.0,1.0,1.0,0.0,5.0,17.0,12,5,7,8.0,2.0,6.0
9908295,14,6,8,12,0,14,99,12,7.0,2.0,5.0,8.0,0.0,7.0,42.0,60,14,46,5.0,3.0,2.0
11029,1,1,0,0,0,1,5,174,1.0,1.0,0.0,0.0,0.0,1.0,5.0,6,1,5,6.0,1.0,5.0
9608451,3,2,1,1,2,1,2,59,2.0,1.0,1.0,1.0,2.0,0.0,0.0,7,3,4,3.0,2.0,1.0
212151,2,2,0,0,1,1,19,4,0.0,0.0,0.0,0.0,0.0,0.0,0.0,58,2,56,3.0,0.0,3.0
10288,6,5,1,1,3,3,3,66,1.0,1.0,0.0,0.0,1.0,0.0,0.0,7,6,1,3.0,2.0,1.0
12041,14,6,8,31,1,13,54,20,9.0,3.0,6.0,23.0,0.0,9.0,47.0,28,14,14,8.0,8.0,0.0
9908347,6,5,1,1,0,6,25,2,4.0,3.0,1.0,1.0,0.0,4.0,11.0,11,6,5,7.0,4.0,3.0
12321,8,3,5,10,0,8,84,12,4.0,2.0,2.0,2.0,0.0,4.0,33.0,38,8,30,6.0,5.0,1.0
210014,2,1,1,1,0,2,5,268,2.0,1.0,1.0,1.0,0.0,2.0,5.0,11,2,9,4.0,2.0,2.0
102247,17,4,13,20,3,14,49,66,12.0,2.0,10.0,15.0,0.0,12.0,35.0,27,17,10,8.0,8.0,0.0
9710272,5,2,3,3,0,5,14,47,5.0,2.0,3.0,3.0,0.0,5.0,14.0,9,5,4,6.0,4.0,2.0
106223,4,1,3,3,0,4,45,1,3.0,3.0,0.0,0.0,0.0,3.0,22.0,37,4,33,11.0,4.0,7.0
8032,2,2,0,0,2,0,0,119,1.0,1.0,0.0,0.0,1.0,0.0,0.0,6,2,4,1.0,1.0,0.0
9407306,1,1,0,0,1,0,0,96,,,,,,,,2,1,1,,,
102218,11,3,8,25,0,11,188,32,9.0,1.0,8.0,19.0,0.0,9.0,141.0,50,11,39,27.0,9.0,18.0
9505309,5,1,4,7,0,5,15,94,5.0,1.0,4.0,7.0,0.0,5.0,15.0,8,5,3,8.0,5.0,3.0
9712483,26,7,19,37,5,21,77,113,15.0,3.0,12.0,27.0,0.0,15.0,54.0,35,26,9,17.0,12.0,5.0
9809362,4,1,3,3,0,4,31,17,3.0,1.0,2.0,2.0,0.0,3.0,28.0,22,4,18,7.0,0.0,7.0
9804402,1,1,0,0,0,1,1,212,0.0,0.0,0.0,0.0,0.0,0.0,0.0,9,1,8,3.0,0.0,3.0
210034,8,1,7,9,0,8,30,18,5.0,1.0,4.0,5.0,1.0,4.0,13.0,28,8,20,3.0,2.0,1.0
9312209,9,5,4,7,6,3,4,24,2.0,2.0,0.0,0.0,1.0,1.0,1.0,11,9,2,2.0,2.0,0.0
9909245,12,3,9,18,1,11,62,34,10.0,1.0,9.0,18.0,0.0,10.0,52.0,28,12,16,9.0,2.0,7.0
9909235,9,5,4,6,0,9,21,68,3.0,3.0,0.0,0.0,0.0,3.0,7.0,18,9,9,6.0,3.0,3.0
106055,13,6,7,7,1,12,44,68,7.0,5.0,2.0,2.0,0.0,7.0,29.0,28,13,15,15.0,5.0,10.0
9602348,1,1,0,0,1,0,0,144,0.0,0.0,0.0,0.0,0.0,0.0,0.0,2,1,1,,,
9411306,3,2,1,1,2,1,1,78,0.0,0.0,0.0,0.0,0.0,0.0,0.0,7,3,4,2.0,1.0,1.0
9509292,4,3,1,1,4,0,0,78,2.0,1.0,1.0,1.0,2.0,0.0,0.0,5,4,1,2.0,2.0,0.0
9504325,5,5,0,0,3,2,2,104,1.0,1.0,0.0,0.0,1.0,0.0,0.0,12,5,7,2.0,2.0,0.0
103175,6,2,4,4,0,6,19,28,1.0,1.0,0.0,0.0,0.0,1.0,1.0,19,6,13,2.0,0.0,2.0
9804349,3,3,0,0,0,3,15,17,1.0,1.0,0.0,0.0,0.0,1.0,7.0,40,3,37,22.0,0.0,22.0
9702205,3,1,2,3,3,0,0,207,,,,,,,,5,3,2,1.0,0.0,1.0
9902351,8,3,5,6,2,6,9,152,3.0,3.0,0.0,0.0,1.0,2.0,2.0,11,8,3,2.0,2.0,0.0
9708420,2,1,1,1,0,2,4,28,0.0,0.0,0.0,0.0,0.0,0.0,0.0,7,2,5,1.0,0.0,1.0
9612342,2,2,0,0,2,0,0,364,1.0,1.0,0.0,0.0,1.0,0.0,0.0,3,2,1,1.0,1.0,0.0
9706356,2,2,0,0,0,2,9,43,1.0,1.0,0.0,0.0,0.0,1.0,7.0,9,2,7,1.0,1.0,0.0
9803390,7,4,3,3,1,6,7,307,6.0,3.0,3.0,3.0,0.0,6.0,6.0,9,7,2,6.0,5.0,1.0
9810283,3,1,2,2,0,3,27,49,3.0,1.0,2.0,2.0,0.0,3.0,21.0,21,3,18,10.0,3.0,7.0
9412240,2,2,0,0,2,0,0,263,1.0,1.0,0.0,0.0,1.0,0.0,0.0,3,2,1,1.0,1.0,0.0
9705288,8,2,6,15,0,8,32,16,8.0,2.0,6.0,15.0,0.0,8.0,19.0,53,8,45,9.0,7.0,2.0
9802425,4,2,2,2,0,4,16,117,2.0,1.0,1.0,1.0,0.0,2.0,4.0,22,4,18,2.0,1.0,1.0
9711238,3,1,2,3,0,3,14,6,1.0,1.0,0.0,0.0,0.0,1.0,3.0,11,3,8,6.0,2.0,4.0
9711295,4,4,0,0,4,0,0,327,4.0,4.0,0.0,0.0,4.0,0.0,0.0,6,4,2,3.0,2.0,1.0
9706296,2,2,0,0,0,2,6,137,2.0,2.0,0.0,0.0,0.0,2.0,6.0,8,2,6,7.0,1.0,6.0
9212307,6,2,4,12,6,0,0,35,4.0,2.0,2.0,4.0,4.0,0.0,0.0,6,6,0,4.0,4.0,0.0
206043,1,1,0,0,0,1,3,20,1.0,1.0,0.0,0.0,1.0,0.0,0.0,13,1,12,2.0,1.0,1.0
9705246,8,5,3,5,3,5,9,123,4.0,3.0,1.0,2.0,0.0,4.0,7.0,11,8,3,7.0,4.0,3.0
9812203,1,1,0,0,0,1,19,71,1.0,1.0,0.0,0.0,0.0,1.0,19.0,21,1,20,20.0,1.0,19.0
9810285,0,0,0,0,0,0,0,314,0.0,0.0,0.0,0.0,0.0,0.0,0.0,4,0,4,1.0,0.0,1.0
201087,5,4,1,1,0,5,15,0,2.0,2.0,0.0,0.0,0.0,2.0,3.0,30,5,25,7.0,0.0,7.0
9601239,0,0,0,0,0,0,0,43,,,,,,,,7,0,7,,,
9706319,1,1,0,0,0,1,2,17,1.0,1.0,0.0,0.0,0.0,1.0,2.0,35,1,34,2.0,0.0,2.0
201213,1,1,0,0,1,0,0,286,1.0,1.0,0.0,0.0,1.0,0.0,0.0,1,1,0,,,
9807524,3,2,1,1,1,2,3,149,3.0,2.0,1.0,1.0,1.0,2.0,3.0,5,3,2,4.0,2.0,2.0
9612456,8,3,5,11,1,7,7,240,7.0,2.0,5.0,11.0,0.0,7.0,7.0,9,8,1,8.0,7.0,1.0
9505271,7,5,2,2,1,6,30,71,4.0,3.0,1.0,1.0,0.0,4.0,17.0,21,7,14,4.0,3.0,1.0
112106,1,1,0,0,0,1,8,20,1.0,1.0,0.0,0.0,0.0,1.0,4.0,14,1,13,7.0,1.0,6.0
209222,5,1,4,4,0,5,31,0,3.0,1.0,2.0,2.0,0.0,3.0,23.0,24,5,19,15.0,3.0,12.0
9911530,2,2,0,0,0,2,8,29,1.0,1.0,0.0,0.0,0.0,1.0,6.0,8,2,6,1.0,0.0,1.0
211384,3,2,1,1,0,3,24,4,1.0,1.0,0.0,0.0,0.0,1.0,11.0,25,3,22,5.0,2.0,3.0
102177,6,3,3,4,2,4,18,25,0.0,0.0,0.0,0.0,0.0,0.0,0.0,12,6,6,3.0,2.0,1.0
211076,2,1,1,1,0,2,10,95,1.0,1.0,0.0,0.0,0.0,1.0,2.0,18,2,16,2.0,0.0,2.0
103133,11,3,8,13,1,10,48,7,3.0,1.0,2.0,2.0,0.0,3.0,11.0,28,11,17,5.0,4.0,1.0
202129,4,3,1,1,1,3,34,55,2.0,1.0,1.0,1.0,0.0,2.0,28.0,24,4,20,6.0,0.0,6.0
9907382,12,3,9,27,2,10,45,82,11.0,2.0,9.0,26.0,1.0,10.0,43.0,26,12,14,12.0,7.0,5.0
110273,1,1,0,0,0,1,9,16,1.0,1.0,0.0,0.0,0.0,1.0,4.0,22,1,21,6.0,1.0,5.0
5245,18,5,13,28,0,18,67,13,13.0,4.0,9.0,20.0,0.0,13.0,51.0,39,18,21,14.0,10.0,4.0
9512375,9,3,6,18,7,2,2,20,7.0,3.0,4.0,13.0,7.0,0.0,0.0,11,9,2,7.0,7.0,0.0
9908389,1,1,0,0,1,0,0,397,0.0,0.0,0.0,0.0,0.0,0.0,0.0,6,1,5,2.0,0.0,2.0
3021,9,2,7,13,0,9,87,45,6.0,1.0,5.0,11.0,0.0,6.0,55.0,36,9,27,17.0,6.0,11.0
9906547,2,2,0,0,2,0,0,658,2.0,2.0,0.0,0.0,2.0,0.0,0.0,2,2,0,2.0,2.0,0.0
202157,4,2,2,2,1,3,5,31,0.0,0.0,0.0,0.0,0.0,0.0,0.0,15,4,11,2.0,1.0,1.0
111333,2,2,0,0,0,2,16,60,1.0,1.0,0.0,0.0,0.0,1.0,2.0,15,2,13,4.0,1.0,3.0
3285,7,5,2,4,3,4,6,350,7.0,5.0,2.0,4.0,4.0,3.0,3.0,18,7,11,4.0,4.0,0.0
11342,1,1,0,0,0,1,1,362,1.0,1.0,0.0,0.0,1.0,0.0,0.0,3,1,2,2.0,1.0,1.0
102179,3,2,1,1,1,2,10,300,2.0,1.0,1.0,1.0,0.0,2.0,4.0,13,3,10,6.0,2.0,4.0
9406414,1,1,0,0,1,0,0,302,1.0,1.0,0.0,0.0,1.0,0.0,0.0,2,1,1,,,
9711496,1,1,0,0,0,1,4,315,1.0,1.0,0.0,0.0,0.0,1.0,3.0,6,1,5,5.0,1.0,4.0
9911448,3,2,1,1,1,2,5,133,2.0,1.0,1.0,1.0,1.0,1.0,1.0,9,3,6,1.0,0.0,1.0
10122,3,2,1,1,0,3,10,58,2.0,1.0,1.0,1.0,0.0,2.0,9.0,16,3,13,7.0,1.0,6.0
9906408,4,2,2,3,0,4,4,105,4.0,2.0,2.0,3.0,0.0,4.0,4.0,6,4,2,5.0,4.0,1.0
9510221,3,3,0,0,0,3,3,188,3.0,3.0,0.0,0.0,0.0,3.0,3.0,5,3,2,1.0,1.0,0.0
8327,3,2,1,1,1,2,7,24,0.0,0.0,0.0,0.0,0.0,0.0,0.0,32,3,29,19.0,0.0,19.0
202134,4,1,3,4,1,3,7,88,3.0,1.0,2.0,3.0,2.0,1.0,1.0,10,4,6,5.0,4.0,1.0
7272,9,3,6,8,0,9,29,27,5.0,2.0,3.0,4.0,5.0,0.0,0.0,18,9,9,8.0,7.0,1.0
9902284,1,1,0,0,1,0,0,606,0.0,0.0,0.0,0.0,0.0,0.0,0.0,6,1,5,1.0,0.0,1.0
205250,3,3,0,0,3,0,0,312,0.0,0.0,0.0,0.0,0.0,0.0,0.0,12,3,9,4.0,0.0,4.0
9809478,3,2,1,1,0,3,11,45,1.0,1.0,0.0,0.0,0.0,1.0,6.0,12,3,9,1.0,1.0,0.0
9306291,7,7,0,0,7,0,0,304,5.0,5.0,0.0,0.0,5.0,0.0,0.0,7,7,0,2.0,2.0,0.0
9208259,1,1,0,0,1,0,0,1734,,,,,,,,1,1,0,,,
111336,4,2,2,3,1,3,9,1,4.0,2.0,2.0,3.0,2.0,2.0,4.0,11,4,7,5.0,3.0,2.0
9905501,10,6,4,5,1,9,19,31,4.0,2.0,2.0,3.0,0.0,4.0,4.0,16,10,6,6.0,3.0,3.0
205046,7,4,3,4,0,7,22,12,1.0,1.0,0.0,0.0,0.0,1.0,2.0,34,7,27,4.0,3.0,1.0
9904375,1,1,0,0,0,1,2,9,,,,,,,,8,1,7,,,
102184,9,5,4,4,4,5,18,0,3.0,1.0,2.0,2.0,0.0,3.0,11.0,38,9,29,19.0,0.0,19.0
9904213,3,2,1,1,0,3,6,111,1.0,1.0,0.0,0.0,0.0,1.0,1.0,8,3,5,5.0,0.0,5.0
9411387,8,6,2,3,6,2,2,96,4.0,2.0,2.0,3.0,4.0,0.0,0.0,9,8,1,4.0,4.0,0.0
9507316,2,2,0,0,1,1,1,450,2.0,2.0,0.0,0.0,1.0,1.0,1.0,3,2,1,1.0,1.0,0.0
9401231,0,0,0,0,0,0,0,211,0.0,0.0,0.0,0.0,0.0,0.0,0.0,5,0,5,1.0,0.0,1.0
7177,2,2,0,0,0,2,10,2,1.0,1.0,0.0,0.0,1.0,0.0,0.0,9,2,7,2.0,1.0,1.0
9808234,3,3,0,0,0,3,3,21,3.0,3.0,0.0,0.0,0.0,3.0,3.0,5,3,2,,,
202256,2,2,0,0,0,2,4,343,1.0,1.0,0.0,0.0,0.0,1.0,1.0,8,2,6,2.0,1.0,1.0
202121,8,2,6,14,0,8,42,165,8.0,2.0,6.0,14.0,0.0,8.0,42.0,16,8,8,16.0,8.0,8.0
102240,0,0,0,0,0,0,0,79,,,,,,,,2,0,2,,,
8230,2,1,1,1,0,2,2,144,0.0,0.0,0.0,0.0,0.0,0.0,0.0,15,2,13,5.0,0.0,5.0
108163,1,1,0,0,0,1,10,12,1.0,1.0,0.0,0.0,0.0,1.0,6.0,15,1,14,12.0,1.0,11.0
9302245,4,3,1,1,4,0,0,52,2.0,1.0,1.0,1.0,2.0,0.0,0.0,4,4,0,1.0,1.0,0.0
9709352,10,6,4,7,10,0,0,139,5.0,3.0,2.0,2.0,5.0,0.0,0.0,10,10,0,4.0,4.0,0.0
9903377,4,1,3,6,0,4,18,140,4.0,1.0,3.0,6.0,0.0,4.0,11.0,14,4,10,6.0,2.0,4.0
5136,9,6,3,5,0,9,48,46,4.0,3.0,1.0,3.0,0.0,4.0,17.0,28,9,19,4.0,2.0,2.0
12061,2,2,0,0,2,0,0,108,,,,,,,,2,2,0,,,
111196,5,3,2,2,0,5,33,129,2.0,2.0,0.0,0.0,0.0,2.0,6.0,24,5,19,6.0,3.0,3.0
9504226,3,2,1,1,0,3,5,86,0.0,0.0,0.0,0.0,0.0,0.0,0.0,8,3,5,1.0,0.0,1.0
9904429,4,1,3,4,4,0,0,142,4.0,1.0,3.0,4.0,4.0,0.0,0.0,5,4,1,4.0,4.0,0.0
9904387,0,0,0,0,0,0,0,102,0.0,0.0,0.0,0.0,0.0,0.0,0.0,11,0,11,3.0,0.0,3.0
9910390,2,2,0,0,1,1,8,23,1.0,1.0,0.0,0.0,0.0,1.0,7.0,23,2,21,14.0,1.0,13.0
9904415,2,2,0,0,0,2,3,28,1.0,1.0,0.0,0.0,1.0,0.0,0.0,13,2,11,1.0,1.0,0.0
9803311,2,1,1,1,0,2,7,13,2.0,1.0,1.0,1.0,0.0,2.0,7.0,19,2,17,3.0,0.0,3.0
9811393,7,3,4,5,3,4,5,106,5.0,2.0,3.0,4.0,5.0,0.0,0.0,12,7,5,3.0,3.0,0.0
9712341,1,1,0,0,1,0,0,96,0.0,0.0,0.0,0.0,0.0,0.0,0.0,6,1,5,2.0,0.0,2.0
4125,0,0,0,0,0,0,0,246,0.0,0.0,0.0,0.0,0.0,0.0,0.0,3,0,3,2.0,0.0,2.0
9802288,2,2,0,0,1,1,1,319,1.0,1.0,0.0,0.0,1.0,0.0,0.0,6,2,4,1.0,1.0,0.0
9302293,8,5,3,3,8,0,0,433,4.0,3.0,1.0,1.0,4.0,0.0,0.0,8,8,0,3.0,3.0,0.0
2301,1,1,0,0,0,1,11,3,1.0,1.0,0.0,0.0,0.0,1.0,3.0,30,1,29,2.0,0.0,2.0
9908365,1,1,0,0,1,0,0,1939,,,,,,,,2,1,1,,,
3130,14,10,4,6,9,5,7,186,3.0,2.0,1.0,1.0,3.0,0.0,0.0,18,14,4,4.0,4.0,0.0
5330,2,2,0,0,0,2,2,104,0.0,0.0,0.0,0.0,0.0,0.0,0.0,11,2,9,4.0,0.0,4.0
208235,3,2,1,1,1,2,11,37,2.0,1.0,1.0,1.0,0.0,2.0,11.0,10,3,7,9.0,2.0,7.0
103005,2,1,1,1,0,2,10,10,1.0,1.0,0.0,0.0,0.0,1.0,1.0,18,2,16,11.0,1.0,10.0
9907276,2,2,0,0,0,2,8,13,1.0,1.0,0.0,0.0,0.0,1.0,3.0,14,2,12,8.0,0.0,8.0
9807368,0,0,0,0,0,0,0,136,0.0,0.0,0.0,0.0,0.0,0.0,0.0,5,0,5,2.0,0.0,2.0
107111,4,3,1,1,0,4,30,12,2.0,1.0,1.0,1.0,0.0,2.0,9.0,47,4,43,14.0,0.0,14.0
9906416,2,2,0,0,0,2,5,6,1.0,1.0,0.0,0.0,1.0,0.0,0.0,24,2,22,1.0,0.0,1.0
203272,6,6,0,0,1,5,18,122,3.0,3.0,0.0,0.0,0.0,3.0,14.0,24,6,18,14.0,2.0,12.0
9803223,1,1,0,0,1,0,0,103,0.0,0.0,0.0,0.0,0.0,0.0,0.0,13,1,12,4.0,0.0,4.0
212370,0,0,0,0,0,0,0,66,0.0,0.0,0.0,0.0,0.0,0.0,0.0,6,0,6,1.0,0.0,1.0
9910427,3,2,1,1,0,3,9,147,2.0,2.0,0.0,0.0,0.0,2.0,4.0,10,3,7,2.0,1.0,1.0
9510371,1,1,0,0,0,1,2,84,1.0,1.0,0.0,0.0,0.0,1.0,1.0,6,1,5,2.0,0.0,2.0
9148,3,2,1,2,0,3,8,278,1.0,1.0,0.0,0.0,0.0,1.0,3.0,9,3,6,5.0,1.0,4.0
207025,2,2,0,0,1,1,2,80,1.0,1.0,0.0,0.0,0.0,1.0,2.0,6,2,4,1.0,1.0,0.0
109023,1,1,0,0,0,1,5,168,1.0,1.0,0.0,0.0,0.0,1.0,5.0,6,1,5,6.0,1.0,5.0
9405285,3,3,0,0,3,0,0,96,1.0,1.0,0.0,0.0,1.0,0.0,0.0,3,3,0,1.0,1.0,0.0
9708234,1,1,0,0,0,1,3,67,1.0,1.0,0.0,0.0,0.0,1.0,3.0,6,1,5,1.0,0.0,1.0
208217,5,4,1,1,2,3,4,74,3.0,3.0,0.0,0.0,0.0,3.0,4.0,8,5,3,5.0,3.0,2.0
9908426,7,3,4,4,4,3,4,58,5.0,2.0,3.0,3.0,3.0,2.0,2.0,11,7,4,5.0,4.0,1.0
101047,1,1,0,0,1,0,0,226,0.0,0.0,0.0,0.0,0.0,0.0,0.0,3,1,2,1.0,0.0,1.0
111428,0,0,0,0,0,0,0,98,0.0,0.0,0.0,0.0,0.0,0.0,0.0,6,0,6,4.0,0.0,4.0
9809324,6,3,3,4,3,3,6,4,1.0,1.0,0.0,0.0,1.0,0.0,0.0,10,6,4,2.0,2.0,0.0
9807546,3,2,1,1,1,2,4,77,1.0,1.0,0.0,0.0,0.0,1.0,1.0,8,3,5,3.0,1.0,2.0
1241,0,0,0,0,0,0,0,123,0.0,0.0,0.0,0.0,0.0,0.0,0.0,4,0,4,,,
9908401,1,1,0,0,0,1,3,172,0.0,0.0,0.0,0.0,0.0,0.0,0.0,12,1,11,4.0,0.0,4.0
7063,1,1,0,0,0,1,6,58,1.0,1.0,0.0,0.0,0.0,1.0,5.0,10,1,9,7.0,1.0,6.0
203155,20,15,5,6,1,19,87,14,5.0,4.0,1.0,1.0,0.0,5.0,34.0,82,20,62,18.0,3.0,15.0
9907259,2,1,1,1,0,2,9,84,1.0,1.0,0.0,0.0,0.0,1.0,6.0,10,2,8,6.0,1.0,5.0
9705448,9,4,5,6,1,8,20,42,6.0,2.0,4.0,5.0,0.0,6.0,12.0,16,9,7,2.0,2.0,0.0
9710542,4,3,1,1,3,1,6,30,1.0,1.0,0.0,0.0,1.0,0.0,0.0,26,4,22,10.0,0.0,10.0
203264,1,1,0,0,0,1,10,9,1.0,1.0,0.0,0.0,0.0,1.0,9.0,28,1,27,2.0,0.0,2.0
9810356,2,2,0,0,1,1,4,212,1.0,1.0,0.0,0.0,1.0,0.0,0.0,6,2,4,1.0,1.0,0.0
9811413,3,1,2,2,0,3,10,114,0.0,0.0,0.0,0.0,0.0,0.0,0.0,16,3,13,7.0,0.0,7.0
206074,4,3,1,1,1,3,8,9,2.0,2.0,0.0,0.0,0.0,2.0,3.0,11,4,7,5.0,3.0,2.0
9712331,2,2,0,0,0,2,2,290,2.0,2.0,0.0,0.0,0.0,2.0,2.0,6,2,4,2.0,0.0,2.0
9901387,7,4,3,5,0,7,41,17,3.0,1.0,2.0,3.0,0.0,3.0,13.0,19,7,12,11.0,3.0,8.0
9703371,1,1,0,0,1,0,0,214,0.0,0.0,0.0,0.0,0.0,0.0,0.0,4,1,3,3.0,0.0,3.0
2045,1,1,0,0,1,0,0,828,0.0,0.0,0.0,0.0,0.0,0.0,0.0,5,1,4,1.0,0.0,1.0
9907348,2,1,1,1,2,0,0,98,2.0,1.0,1.0,1.0,2.0,0.0,0.0,3,2,1,2.0,2.0,0.0
9512243,5,2,3,6,5,0,0,53,2.0,1.0,1.0,1.0,2.0,0.0,0.0,5,5,0,3.0,3.0,0.0
9802217,1,1,0,0,0,1,6,6,0.0,0.0,0.0,0.0,0.0,0.0,0.0,21,1,20,4.0,0.0,4.0
207174,3,2,1,1,0,3,20,0,2.0,1.0,1.0,1.0,0.0,2.0,19.0,27,3,24,20.0,1.0,19.0
9512324,1,1,0,0,0,1,2,13,0.0,0.0,0.0,0.0,0.0,0.0,0.0,9,1,8,1.0,0.0,1.0
9710282,0,0,0,0,0,0,0,30,0.0,0.0,0.0,0.0,0.0,0.0,0.0,8,0,8,5.0,0.0,5.0
205198,3,2,1,1,1,2,5,11,,,,,,,,6,3,3,,,
11242,5,4,1,1,0,5,19,77,1.0,1.0,0.0,0.0,0.0,1.0,4.0,20,5,15,4.0,2.0,2.0
209062,1,1,0,0,0,1,2,28,0.0,0.0,0.0,0.0,0.0,0.0,0.0,21,1,20,1.0,1.0,0.0
211110,2,2,0,0,0,2,15,27,2.0,2.0,0.0,0.0,0.0,2.0,15.0,24,2,22,12.0,2.0,10.0
9404297,2,2,0,0,0,2,4,10,0.0,0.0,0.0,0.0,0.0,0.0,0.0,39,2,37,10.0,0.0,10.0
9401212,3,1,2,2,2,1,1,462,3.0,1.0,2.0,2.0,2.0,1.0,1.0,4,3,1,4.0,3.0,1.0
9909336,2,2,0,0,0,2,8,8,0.0,0.0,0.0,0.0,0.0,0.0,0.0,10,2,8,2.0,0.0,2.0
9409463,6,4,2,3,1,5,6,291,5.0,3.0,2.0,3.0,1.0,4.0,5.0,11,6,5,6.0,4.0,2.0
106353,13,1,12,25,0,13,223,70,13.0,1.0,12.0,25.0,0.0,13.0,223.0,34,13,21,31.0,13.0,18.0
104268,2,1,1,1,2,0,0,861,,,,,,,,3,2,1,,,
9611339,1,1,0,0,1,0,0,87,0.0,0.0,0.0,0.0,0.0,0.0,0.0,6,1,5,1.0,0.0,1.0
206085,4,4,0,0,1,3,7,3,2.0,2.0,0.0,0.0,2.0,0.0,0.0,17,4,13,2.0,2.0,0.0
102162,1,1,0,0,0,1,9,109,1.0,1.0,0.0,0.0,0.0,1.0,9.0,20,1,19,17.0,1.0,16.0
105131,2,2,0,0,1,1,2,1844,1.0,1.0,0.0,0.0,1.0,0.0,0.0,4,2,2,3.0,2.0,1.0
4252,4,2,2,2,0,4,4,53,,,,,,,,6,4,2,1.0,1.0,0.0
10034,3,2,1,2,0,3,25,161,3.0,2.0,1.0,2.0,0.0,3.0,17.0,20,3,17,6.0,3.0,3.0
9910268,4,4,0,0,2,2,5,84,2.0,2.0,0.0,0.0,1.0,1.0,3.0,9,4,5,4.0,2.0,2.0
9903374,4,1,3,4,0,4,18,206,4.0,1.0,3.0,4.0,0.0,4.0,17.0,13,4,9,10.0,4.0,6.0
9501248,6,6,0,0,3,3,3,164,1.0,1.0,0.0,0.0,1.0,0.0,0.0,13,6,7,7.0,0.0,7.0
206035,2,2,0,0,1,1,6,2,2.0,2.0,0.0,0.0,1.0,1.0,4.0,18,2,16,11.0,1.0,10.0
109158,10,6,4,5,3,7,24,31,4.0,3.0,1.0,1.0,0.0,4.0,13.0,26,10,16,4.0,0.0,4.0
102175,0,0,0,0,0,0,0,12,0.0,0.0,0.0,0.0,0.0,0.0,0.0,17,0,17,3.0,0.0,3.0
6150,3,2,1,1,0,3,14,76,1.0,1.0,0.0,0.0,0.0,1.0,8.0,21,3,18,10.0,1.0,9.0
9805394,6,3,3,3,2,4,10,127,4.0,3.0,1.0,1.0,0.0,4.0,10.0,13,6,7,1.0,0.0,1.0
203194,3,2,1,1,2,1,1,46,2.0,1.0,1.0,1.0,2.0,0.0,0.0,12,3,9,1.0,1.0,0.0
108132,2,1,1,1,0,2,4,184,2.0,1.0,1.0,1.0,0.0,2.0,4.0,5,2,3,4.0,2.0,2.0
9808302,1,1,0,0,1,0,0,103,1.0,1.0,0.0,0.0,1.0,0.0,0.0,2,1,1,1.0,1.0,0.0
3135,5,2,3,4,0,5,16,294,4.0,1.0,3.0,4.0,0.0,4.0,15.0,14,5,9,9.0,3.0,6.0
8315,10,2,8,13,2,8,13,125,2.0,2.0,0.0,0.0,0.0,2.0,2.0,19,10,9,4.0,2.0,2.0
9606243,2,2,0,0,2,0,0,188,0.0,0.0,0.0,0.0,0.0,0.0,0.0,3,2,1,1.0,0.0,1.0
9810495,3,3,0,0,2,1,2,138,3.0,3.0,0.0,0.0,2.0,1.0,2.0,7,3,4,4.0,2.0,2.0
111284,0,0,0,0,0,0,0,1088,,,,,,,,2,0,2,,,
302009,0,0,0,0,0,0,0,1872,0.0,0.0,0.0,0.0,0.0,0.0,0.0,5,0,5,,,
9404267,0,0,0,0,0,0,0,329,0.0,0.0,0.0,0.0,0.0,0.0,0.0,4,0,4,3.0,0.0,3.0
112088,4,4,0,0,0,4,37,13,3.0,3.0,0.0,0.0,0.0,3.0,32.0,27,4,23,13.0,2.0,11.0
208249,7,7,0,0,0,7,43,37,3.0,3.0,0.0,0.0,0.0,3.0,24.0,33,7,26,2.0,1.0,1.0
9805441,1,1,0,0,0,1,10,182,1.0,1.0,0.0,0.0,0.0,1.0,6.0,12,1,11,8.0,1.0,7.0
9601281,1,1,0,0,0,1,3,210,1.0,1.0,0.0,0.0,0.0,1.0,1.0,5,1,4,3.0,1.0,2.0
9706389,1,1,0,0,0,1,13,15,1.0,1.0,0.0,0.0,0.0,1.0,13.0,19,1,18,19.0,1.0,18.0
9308260,3,1,2,3,3,0,0,90,0.0,0.0,0.0,0.0,0.0,0.0,0.0,4,3,1,,,
9812245,2,2,0,0,2,0,0,8,0.0,0.0,0.0,0.0,0.0,0.0,0.0,20,2,18,2.0,0.0,2.0
205041,2,1,1,1,0,2,22,73,0.0,0.0,0.0,0.0,0.0,0.0,0.0,17,2,15,13.0,2.0,11.0
9608409,7,1,6,17,0,7,14,16,7.0,1.0,6.0,17.0,0.0,7.0,14.0,10,7,3,2.0,0.0,2.0
9804366,4,2,2,3,2,2,2,35,2.0,1.0,1.0,1.0,1.0,1.0,1.0,14,4,10,4.0,3.0,1.0
211434,1,1,0,0,0,1,33,19,1.0,1.0,0.0,0.0,0.0,1.0,25.0,122,1,121,15.0,0.0,15.0
212205,1,1,0,0,0,1,13,2,1.0,1.0,0.0,0.0,0.0,1.0,9.0,23,1,22,9.0,1.0,8.0
2059,2,1,1,1,1,1,1,512,2.0,1.0,1.0,1.0,2.0,0.0,0.0,3,2,1,2.0,2.0,0.0
9704446,0,0,0,0,0,0,0,229,0.0,0.0,0.0,0.0,0.0,0.0,0.0,2,0,2,2.0,0.0,2.0
11230,4,1,3,4,0,4,5,166,4.0,1.0,3.0,4.0,0.0,4.0,4.0,10,4,6,5.0,4.0,1.0
9602243,3,2,1,1,1,2,4,53,0.0,0.0,0.0,0.0,0.0,0.0,0.0,9,3,6,2.0,0.0,2.0
9809411,12,3,9,15,3,9,15,135,3.0,2.0,1.0,1.0,2.0,1.0,1.0,17,12,5,7.0,4.0,3.0
7084,2,1,1,1,2,0,0,338,2.0,1.0,1.0,1.0,2.0,0.0,0.0,2,2,0,2.0,2.0,0.0
9710253,4,2,2,2,0,4,12,27,2.0,1.0,1.0,1.0,0.0,2.0,8.0,10,4,6,2.0,1.0,1.0
7118,2,2,0,0,2,0,0,16,0.0,0.0,0.0,0.0,0.0,0.0,0.0,10,2,8,7.0,0.0,7.0
9512221,3,2,1,1,3,0,0,360,1.0,1.0,0.0,0.0,1.0,0.0,0.0,3,3,0,,,
3061,3,1,2,3,3,0,0,127,1.0,1.0,0.0,0.0,1.0,0.0,0.0,4,3,1,2.0,1.0,1.0
110356,1,1,0,0,0,1,1,31,0.0,0.0,0.0,0.0,0.0,0.0,0.0,7,1,6,,,
208231,2,2,0,0,1,1,2,49,2.0,2.0,0.0,0.0,1.0,1.0,2.0,17,2,15,12.0,0.0,12.0
9905304,3,2,1,1,0,3,12,29,2.0,1.0,1.0,1.0,0.0,2.0,10.0,9,3,6,7.0,2.0,5.0
202068,6,3,3,5,0,6,42,82,6.0,3.0,3.0,5.0,0.0,6.0,41.0,25,6,19,17.0,4.0,13.0
202071,3,3,0,0,0,3,6,64,2.0,2.0,0.0,0.0,0.0,2.0,5.0,11,3,8,4.0,1.0,3.0
9808347,2,2,0,0,0,2,4,84,1.0,1.0,0.0,0.0,1.0,0.0,0.0,7,2,5,3.0,1.0,2.0
9904216,7,5,2,3,5,2,2,63,4.0,3.0,1.0,1.0,4.0,0.0,0.0,11,7,4,4.0,2.0,2.0
9905209,3,3,0,0,2,1,1,296,1.0,1.0,0.0,0.0,1.0,0.0,0.0,7,3,4,1.0,0.0,1.0
9506404,0,0,0,0,0,0,0,1369,,,,,,,,2,0,2,,,
109256,11,5,6,10,0,11,77,20,9.0,3.0,6.0,8.0,0.0,9.0,69.0,25,11,14,9.0,6.0,3.0
9509240,2,2,0,0,0,2,6,35,0.0,0.0,0.0,0.0,0.0,0.0,0.0,11,2,9,3.0,0.0,3.0
9308334,2,1,1,1,2,0,0,148,1.0,1.0,0.0,0.0,1.0,0.0,0.0,2,2,0,1.0,1.0,0.0
9902317,0,0,0,0,0,0,0,1615,0.0,0.0,0.0,0.0,0.0,0.0,0.0,3,0,3,2.0,0.0,2.0
106059,2,2,0,0,0,2,11,9,1.0,1.0,0.0,0.0,0.0,1.0,9.0,13,2,11,8.0,1.0,7.0
9911507,5,4,1,2,0,5,49,24,3.0,2.0,1.0,2.0,0.0,3.0,42.0,23,5,18,18.0,3.0,15.0
206062,1,1,0,0,0,1,2,104,0.0,0.0,0.0,0.0,0.0,0.0,0.0,11,1,10,4.0,0.0,4.0
9809420,1,1,0,0,0,1,1,565,1.0,1.0,0.0,0.0,0.0,1.0,1.0,2,1,1,2.0,1.0,1.0
9309329,0,0,0,0,0,0,0,523,0.0,0.0,0.0,0.0,0.0,0.0,0.0,1,0,1,1.0,0.0,1.0
9508363,0,0,0,0,0,0,0,26,0.0,0.0,0.0,0.0,0.0,0.0,0.0,44,0,44,8.0,0.0,8.0
109044,2,2,0,0,0,2,5,184,2.0,2.0,0.0,0.0,1.0,1.0,2.0,11,2,9,6.0,1.0,5.0
6067,2,1,1,1,2,0,0,290,0.0,0.0,0.0,0.0,0.0,0.0,0.0,8,2,6,2.0,2.0,0.0
112040,1,1,0,0,0,1,2,29,1.0,1.0,0.0,0.0,0.0,1.0,1.0,9,1,8,2.0,1.0,1.0
9507205,1,1,0,0,0,1,1,1815,1.0,1.0,0.0,0.0,1.0,0.0,0.0,4,1,3,1.0,1.0,0.0
9406348,1,1,0,0,1,0,0,1458,1.0,1.0,0.0,0.0,1.0,0.0,0.0,1,1,0,1.0,1.0,0.0
9805501,4,2,2,2,4,0,0,313,1.0,1.0,0.0,0.0,1.0,0.0,0.0,11,4,7,1.0,1.0,0.0
9606453,2,2,0,0,0,2,3,44,1.0,1.0,0.0,0.0,1.0,0.0,0.0,4,2,2,1.0,1.0,0.0
111445,0,0,0,0,0,0,0,1832,,,,,,,,1,0,1,,,
9301235,1,1,0,0,1,0,0,223,1.0,1.0,0.0,0.0,1.0,0.0,0.0,1,1,0,1.0,1.0,0.0
104014,4,1,3,6,0,4,13,136,4.0,1.0,3.0,6.0,0.0,4.0,11.0,8,4,4,7.0,4.0,3.0
203097,2,2,0,0,0,2,13,3,1.0,1.0,0.0,0.0,0.0,1.0,10.0,48,2,46,10.0,1.0,9.0
108025,1,1,0,0,0,1,3,282,1.0,1.0,0.0,0.0,0.0,1.0,3.0,8,1,7,4.0,1.0,3.0
10061,0,0,0,0,0,0,0,72,0.0,0.0,0.0,0.0,0.0,0.0,0.0,5,0,5,4.0,0.0,4.0
3226,2,2,0,0,0,2,2,44,2.0,2.0,0.0,0.0,0.0,2.0,2.0,5,2,3,,,
9910319,0,0,0,0,0,0,0,97,0.0,0.0,0.0,0.0,0.0,0.0,0.0,9,0,9,8.0,0.0,8.0
112032,1,1,0,0,1,0,0,1601,1.0,1.0,0.0,0.0,1.0,0.0,0.0,1,1,0,1.0,1.0,0.0
9607352,2,2,0,0,2,0,0,1314,1.0,1.0,0.0,0.0,1.0,0.0,0.0,3,2,1,1.0,1.0,0.0
110258,1,1,0,0,0,1,18,46,1.0,1.0,0.0,0.0,0.0,1.0,13.0,23,1,22,15.0,1.0,14.0
9509384,1,1,0,0,0,1,6,26,0.0,0.0,0.0,0.0,0.0,0.0,0.0,18,1,17,9.0,0.0,9.0
8098,0,0,0,0,0,0,0,96,0.0,0.0,0.0,0.0,0.0,0.0,0.0,3,0,3,3.0,0.0,3.0
9710254,3,3,0,0,2,1,2,5,0.0,0.0,0.0,0.0,0.0,0.0,0.0,30,3,27,2.0,0.0,2.0
9610284,1,1,0,0,1,0,0,241,0.0,0.0,0.0,0.0,0.0,0.0,0.0,2,1,1,1.0,0.0,1.0
108215,3,1,2,2,1,2,8,185,3.0,1.0,2.0,2.0,1.0,2.0,8.0,14,3,11,7.0,1.0,6.0
110370,4,2,2,3,0,4,13,11,0.0,0.0,0.0,0.0,0.0,0.0,0.0,28,4,24,2.0,0.0,2.0
205127,0,0,0,0,0,0,0,8,0.0,0.0,0.0,0.0,0.0,0.0,0.0,33,0,33,3.0,0.0,3.0
9302277,0,0,0,0,0,0,0,1165,,,,,,,,1,0,1,1.0,0.0,1.0
9912456,2,2,0,0,2,0,0,70,0.0,0.0,0.0,0.0,0.0,0.0,0.0,19,2,17,16.0,0.0,16.0
9505263,1,1,0,0,0,1,2,307,1.0,1.0,0.0,0.0,0.0,1.0,2.0,3,1,2,2.0,1.0,1.0
9178,6,1,5,14,0,6,21,187,6.0,1.0,5.0,14.0,0.0,6.0,17.0,17,6,11,10.0,6.0,4.0
9509227,6,3,3,4,6,0,0,396,6.0,3.0,3.0,4.0,6.0,0.0,0.0,6,6,0,4.0,4.0,0.0
207373,3,2,1,1,0,3,31,3,2.0,1.0,1.0,1.0,0.0,2.0,21.0,40,3,37,11.0,2.0,9.0
204271,1,1,0,0,0,1,17,18,0.0,0.0,0.0,0.0,0.0,0.0,0.0,34,1,33,9.0,0.0,9.0
9805326,1,1,0,0,0,1,1,115,,,,,,,,8,1,7,,,
108248,2,2,0,0,1,1,3,316,1.0,1.0,0.0,0.0,0.0,1.0,3.0,6,2,4,4.0,1.0,3.0
9812400,3,2,1,1,3,0,0,93,0.0,0.0,0.0,0.0,0.0,0.0,0.0,7,3,4,2.0,2.0,0.0
108149,3,1,2,2,0,3,6,20,3.0,1.0,2.0,2.0,0.0,3.0,6.0,11,3,8,3.0,1.0,2.0
102112,1,1,0,0,0,1,5,83,1.0,1.0,0.0,0.0,0.0,1.0,4.0,11,1,10,5.0,1.0,4.0
209350,0,0,0,0,0,0,0,512,0.0,0.0,0.0,0.0,0.0,0.0,0.0,8,0,8,4.0,0.0,4.0
8211,0,0,0,0,0,0,0,1461,0.0,0.0,0.0,0.0,0.0,0.0,0.0,1,0,1,,,
9410381,0,0,0,0,0,0,0,91,0.0,0.0,0.0,0.0,0.0,0.0,0.0,1,0,1,,,
9305236,0,0,0,0,0,0,0,1788,0.0,0.0,0.0,0.0,0.0,0.0,0.0,4,0,4,,,
9809419,0,0,0,0,0,0,0,270,0.0,0.0,0.0,0.0,0.0,0.0,0.0,6,0,6,3.0,0.0,3.0
107167,0,0,0,0,0,0,0,797,0.0,0.0,0.0,0.0,0.0,0.0,0.0,2,0,2,1.0,0.0,1.0
9611416,1,1,0,0,0,1,2,72,1.0,1.0,0.0,0.0,0.0,1.0,2.0,8,1,7,7.0,1.0,6.0
9704370,0,0,0,0,0,0,0,7,,,,,,,,7,0,7,1.0,0.0,1.0
3078,1,1,0,0,1,0,0,361,0.0,0.0,0.0,0.0,0.0,0.0,0.0,2,1,1,1.0,0.0,1.0
9506468,0,0,0,0,0,0,0,64,0.0,0.0,0.0,0.0,0.0,0.0,0.0,8,0,8,5.0,0.0,5.0
9612315,1,1,0,0,1,0,0,63,0.0,0.0,0.0,0.0,0.0,0.0,0.0,5,1,4,,,
9502216,1,1,0,0,1,0,0,270,1.0,1.0,0.0,0.0,1.0,0.0,0.0,2,1,1,1.0,0.0,1.0
204072,0,0,0,0,0,0,0,143,0.0,0.0,0.0,0.0,0.0,0.0,0.0,14,0,14,3.0,0.0,3.0
111416,0,0,0,0,0,0,0,252,0.0,0.0,0.0,0.0,0.0,0.0,0.0,6,0,6,5.0,0.0,5.0
7205,3,3,0,0,1,2,3,145,2.0,2.0,0.0,0.0,1.0,1.0,2.0,7,3,4,3.0,1.0,2.0
301148,0,0,0,0,0,0,0,29,0.0,0.0,0.0,0.0,0.0,0.0,0.0,16,0,16,,,
212112,1,1,0,0,0,1,3,219,1.0,1.0,0.0,0.0,0.0,1.0,3.0,7,1,6,6.0,1.0,5.0
9801248,4,3,1,1,1,3,9,12,3.0,2.0,1.0,1.0,0.0,3.0,6.0,13,4,9,2.0,1.0,1.0
9412288,0,0,0,0,0,0,0,478,0.0,0.0,0.0,0.0,0.0,0.0,0.0,3,0,3,1.0,0.0,1.0
9912502,0,0,0,0,0,0,0,286,0.0,0.0,0.0,0.0,0.0,0.0,0.0,9,0,9,1.0,0.0,1.0
9404242,1,1,0,0,1,0,0,1472,1.0,1.0,0.0,0.0,1.0,0.0,0.0,1,1,0,1.0,1.0,0.0
9910538,1,1,0,0,0,1,8,13,1.0,1.0,0.0,0.0,0.0,1.0,8.0,12,1,11,4.0,0.0,4.0
9411440,3,2,1,1,0,3,3,246,2.0,2.0,0.0,0.0,0.0,2.0,2.0,4,3,1,3.0,2.0,1.0
203028,4,2,2,5,0,4,16,209,4.0,2.0,2.0,5.0,0.0,4.0,15.0,17,4,13,13.0,4.0,9.0
9812294,1,1,0,0,0,1,2,68,1.0,1.0,0.0,0.0,0.0,1.0,2.0,4,1,3,4.0,1.0,3.0
203081,1,1,0,0,0,1,4,40,1.0,1.0,0.0,0.0,0.0,1.0,1.0,5,1,4,3.0,0.0,3.0
1055,0,0,0,0,0,0,0,92,0.0,0.0,0.0,0.0,0.0,0.0,0.0,23,0,23,3.0,0.0,3.0
212193,0,0,0,0,0,0,0,362,0.0,0.0,0.0,0.0,0.0,0.0,0.0,3,0,3,1.0,0.0,1.0
2092,0,0,0,0,0,0,0,1335,,,,,,,,1,0,1,,,
201028,0,0,0,0,0,0,0,879,,,,,,,,1,0,1,,,
9712465,0,0,0,0,0,0,0,141,0.0,0.0,0.0,0.0,0.0,0.0,0.0,8,0,8,3.0,0.0,3.0
105114,1,1,0,0,0,1,5,18,0.0,0.0,0.0,0.0,0.0,0.0,0.0,16,1,15,6.0,0.0,6.0
9506424,4,2,2,3,4,0,0,451,4.0,2.0,2.0,3.0,4.0,0.0,0.0,4,4,0,3.0,3.0,0.0
203032,3,2,1,1,0,3,20,2,0.0,0.0,0.0,0.0,0.0,0.0,0.0,27,3,24,18.0,0.0,18.0
302040,0,0,0,0,0,0,0,124,0.0,0.0,0.0,0.0,0.0,0.0,0.0,13,0,13,6.0,0.0,6.0
101274,0,0,0,0,0,0,0,435,0.0,0.0,0.0,0.0,0.0,0.0,0.0,9,0,9,4.0,0.0,4.0
108124,1,1,0,0,0,1,9,83,1.0,1.0,0.0,0.0,0.0,1.0,5.0,23,1,22,15.0,1.0,14.0
201113,4,1,3,3,0,4,15,178,4.0,1.0,3.0,3.0,0.0,4.0,13.0,16,4,12,8.0,4.0,4.0
9710230,1,1,0,0,0,1,3,42,1.0,1.0,0.0,0.0,1.0,0.0,0.0,7,1,6,1.0,0.0,1.0
212157,0,0,0,0,0,0,0,70,0.0,0.0,0.0,0.0,0.0,0.0,0.0,25,0,25,23.0,0.0,23.0
9309254,0,0,0,0,0,0,0,2083,,,,,,,,1,0,1,,,
9411262,1,1,0,0,0,1,2,35,0.0,0.0,0.0,0.0,0.0,0.0,0.0,5,1,4,1.0,0.0,1.0
6155,0,0,0,0,0,0,0,104,0.0,0.0,0.0,0.0,0.0,0.0,0.0,5,0,5,2.0,0.0,2.0
202126,1,1,0,0,0,1,5,33,1.0,1.0,0.0,0.0,0.0,1.0,3.0,12,1,11,5.0,1.0,4.0
210100,0,0,0,0,0,0,0,20,0.0,0.0,0.0,0.0,0.0,0.0,0.0,11,0,11,3.0,0.0,3.0
111211,4,3,1,1,1,3,5,45,1.0,1.0,0.0,0.0,1.0,0.0,0.0,10,4,6,2.0,0.0,2.0
9909354,2,1,1,1,0,2,7,297,2.0,1.0,1.0,1.0,0.0,2.0,4.0,6,2,4,4.0,2.0,2.0
9508228,0,0,0,0,0,0,0,1261,,,,,,,,1,0,1,,,
9412220,1,1,0,0,0,1,2,214,1.0,1.0,0.0,0.0,0.0,1.0,2.0,5,1,4,3.0,1.0,2.0
206130,2,2,0,0,0,2,6,16,0.0,0.0,0.0,0.0,0.0,0.0,0.0,10,2,8,1.0,0.0,1.0
203230,2,2,0,0,0,2,2,465,2.0,2.0,0.0,0.0,0.0,2.0,2.0,3,2,1,3.0,2.0,1.0
111212,3,1,2,2,0,3,28,13,2.0,1.0,1.0,1.0,0.0,2.0,14.0,40,3,37,12.0,2.0,10.0
9902281,0,0,0,0,0,0,0,524,0.0,0.0,0.0,0.0,0.0,0.0,0.0,3,0,3,1.0,0.0,1.0
9904261,7,5,2,3,1,6,22,96,4.0,2.0,2.0,3.0,0.0,4.0,9.0,23,7,16,8.0,2.0,6.0
201289,3,2,1,1,0,3,21,83,2.0,1.0,1.0,1.0,0.0,2.0,9.0,20,3,17,8.0,2.0,6.0
9606374,1,1,0,0,0,1,4,53,1.0,1.0,0.0,0.0,0.0,1.0,4.0,6,1,5,5.0,1.0,4.0
6117,0,0,0,0,0,0,0,21,0.0,0.0,0.0,0.0,0.0,0.0,0.0,7,0,7,2.0,0.0,2.0
9510456,0,0,0,0,0,0,0,94,0.0,0.0,0.0,0.0,0.0,0.0,0.0,12,0,12,4.0,0.0,4.0
9810459,1,1,0,0,0,1,7,96,0.0,0.0,0.0,0.0,0.0,0.0,0.0,11,1,10,4.0,0.0,4.0
104251,0,0,0,0,0,0,0,15,0.0,0.0,0.0,0.0,0.0,0.0,0.0,56,0,56,24.0,0.0,24.0
8247,1,1,0,0,0,1,14,24,1.0,1.0,0.0,0.0,0.0,1.0,12.0,23,1,22,3.0,1.0,2.0
9507373,1,1,0,0,0,1,1,133,1.0,1.0,0.0,0.0,0.0,1.0,1.0,4,1,3,3.0,1.0,2.0
3137,0,0,0,0,0,0,0,116,0.0,0.0,0.0,0.0,0.0,0.0,0.0,9,0,9,6.0,0.0,6.0
212279,1,1,0,0,0,1,6,2,1.0,1.0,0.0,0.0,0.0,1.0,6.0,37,1,36,20.0,1.0,19.0
109201,4,3,1,1,0,4,55,1,2.0,2.0,0.0,0.0,0.0,2.0,23.0,56,4,52,15.0,1.0,14.0
8322,1,1,0,0,0,1,2,191,1.0,1.0,0.0,0.0,0.0,1.0,2.0,4,1,3,4.0,1.0,3.0
8128,0,0,0,0,0,0,0,1271,,,,,,,,2,0,2,,,
102191,1,1,0,0,0,1,27,5,0.0,0.0,0.0,0.0,0.0,0.0,0.0,65,1,64,11.0,0.0,11.0
302051,0,0,0,0,0,0,0,7,0.0,0.0,0.0,0.0,0.0,0.0,0.0,31,0,31,22.0,0.0,22.0
10048,0,0,0,0,0,0,0,467,0.0,0.0,0.0,0.0,0.0,0.0,0.0,6,0,6,2.0,0.0,2.0
302197,0,0,0,0,0,0,0,1888,0.0,0.0,0.0,0.0,0.0,0.0,0.0,1,0,1,1.0,0.0,1.0
205036,0,0,0,0,0,0,0,194,0.0,0.0,0.0,0.0,0.0,0.0,0.0,4,0,4,3.0,0.0,3.0
2084,0,0,0,0,0,0,0,408,0.0,0.0,0.0,0.0,0.0,0.0,0.0,1,0,1,1.0,0.0,1.0
9408324,0,0,0,0,0,0,0,42,0.0,0.0,0.0,0.0,0.0,0.0,0.0,6,0,6,1.0,0.0,1.0
301131,2,1,1,1,0,2,6,10,0.0,0.0,0.0,0.0,0.0,0.0,0.0,18,2,16,2.0,0.0,2.0
301223,0,0,0,0,0,0,0,70,0.0,0.0,0.0,0.0,0.0,0.0,0.0,24,0,24,21.0,0.0,21.0
204302,1,1,0,0,1,0,0,587,0.0,0.0,0.0,0.0,0.0,0.0,0.0,3,1,2,1.0,0.0,1.0
9705338,1,1,0,0,1,0,0,300,1.0,1.0,0.0,0.0,1.0,0.0,0.0,5,1,4,1.0,1.0,0.0
9805258,1,1,0,0,0,1,3,52,0.0,0.0,0.0,0.0,0.0,0.0,0.0,7,1,6,4.0,0.0,4.0
112175,0,0,0,0,0,0,0,97,0.0,0.0,0.0,0.0,0.0,0.0,0.0,10,0,10,4.0,0.0,4.0
9511365,0,0,0,0,0,0,0,53,0.0,0.0,0.0,0.0,0.0,0.0,0.0,10,0,10,1.0,0.0,1.0
9293,0,0,0,0,0,0,0,6,0.0,0.0,0.0,0.0,0.0,0.0,0.0,64,0,64,26.0,0.0,26.0
210070,0,0,0,0,0,0,0,132,0.0,0.0,0.0,0.0,0.0,0.0,0.0,4,0,4,4.0,0.0,4.0
105120,3,3,0,0,1,2,11,35,1.0,1.0,0.0,0.0,0.0,1.0,4.0,14,3,11,9.0,1.0,8.0
302265,0,0,0,0,0,0,0,107,0.0,0.0,0.0,0.0,0.0,0.0,0.0,14,0,14,2.0,0.0,2.0
206198,2,1,1,1,2,0,0,101,0.0,0.0,0.0,0.0,0.0,0.0,0.0,14,2,12,8.0,0.0,8.0
102123,2,1,1,1,1,1,1,67,0.0,0.0,0.0,0.0,0.0,0.0,0.0,11,2,9,2.0,2.0,0.0
9912237,3,2,1,1,2,1,2,132,1.0,1.0,0.0,0.0,0.0,1.0,2.0,8,3,5,3.0,0.0,3.0
9701202,0,0,0,0,0,0,0,1193,,,,,,,,2,0,2,,,
211139,0,0,0,0,0,0,0,65,0.0,0.0,0.0,0.0,0.0,0.0,0.0,5,0,5,3.0,0.0,3.0
9912535,0,0,0,0,0,0,0,47,0.0,0.0,0.0,0.0,0.0,0.0,0.0,5,0,5,5.0,0.0,5.0
204024,1,1,0,0,0,1,1,59,0.0,0.0,0.0,0.0,0.0,0.0,0.0,8,1,7,4.0,0.0,4.0
110360,2,1,1,1,0,2,9,31,1.0,1.0,0.0,0.0,0.0,1.0,6.0,11,2,9,3.0,2.0,1.0
9711408,2,1,1,1,1,1,1,92,1.0,1.0,0.0,0.0,0.0,1.0,1.0,7,2,5,2.0,2.0,0.0
9809414,0,0,0,0,0,0,0,38,0.0,0.0,0.0,0.0,0.0,0.0,0.0,13,0,13,4.0,0.0,4.0
9912537,0,0,0,0,0,0,0,47,0.0,0.0,0.0,0.0,0.0,0.0,0.0,5,0,5,5.0,0.0,5.0
9709217,0,0,0,0,0,0,0,2003,0.0,0.0,0.0,0.0,0.0,0.0,0.0,2,0,2,2.0,0.0,2.0
5111,0,0,0,0,0,0,0,62,0.0,0.0,0.0,0.0,0.0,0.0,0.0,5,0,5,5.0,0.0,5.0
9611403,1,1,0,0,0,1,1,138,0.0,0.0,0.0,0.0,0.0,0.0,0.0,13,1,12,4.0,0.0,4.0
9602217,0,0,0,0,0,0,0,96,0.0,0.0,0.0,0.0,0.0,0.0,0.0,4,0,4,2.0,0.0,2.0
204267,2,1,1,1,2,0,0,340,2.0,1.0,1.0,1.0,2.0,0.0,0.0,2,2,0,2.0,2.0,0.0
9506339,0,0,0,0,0,0,0,99,0.0,0.0,0.0,0.0,0.0,0.0,0.0,7,0,7,1.0,0.0,1.0
211137,0,0,0,0,0,0,0,23,0.0,0.0,0.0,0.0,0.0,0.0,0.0,7,0,7,1.0,0.0,1.0
209236,1,1,0,0,0,1,5,91,1.0,1.0,0.0,0.0,0.0,1.0,4.0,9,1,8,6.0,1.0,5.0
111300,0,0,0,0,0,0,0,41,0.0,0.0,0.0,0.0,0.0,0.0,0.0,4,0,4,2.0,0.0,2.0
11045,0,0,0,0,0,0,0,364,0.0,0.0,0.0,0.0,0.0,0.0,0.0,4,0,4,4.0,0.0,4.0
111401,0,0,0,0,0,0,0,172,0.0,0.0,0.0,0.0,0.0,0.0,0.0,4,0,4,3.0,0.0,3.0
9607339,0,0,0,0,0,0,0,197,0.0,0.0,0.0,0.0,0.0,0.0,0.0,1,0,1,1.0,0.0,1.0
204057,0,0,0,0,0,0,0,26,0.0,0.0,0.0,0.0,0.0,0.0,0.0,28,0,28,2.0,0.0,2.0
211387,0,0,0,0,0,0,0,118,0.0,0.0,0.0,0.0,0.0,0.0,0.0,9,0,9,4.0,0.0,4.0
201090,0,0,0,0,0,0,0,0,0.0,0.0,0.0,0.0,0.0,0.0,0.0,9,0,9,2.0,0.0,2.0
8014,0,0,0,0,0,0,0,137,0.0,0.0,0.0,0.0,0.0,0.0,0.0,4,0,4,3.0,0.0,3.0
9905325,2,1,1,1,1,1,1,166,1.0,1.0,0.0,0.0,1.0,0.0,0.0,3,2,1,1.0,1.0,0.0
9407358,1,1,0,0,1,0,0,164,,,,,,,,3,1,2,,,
9602219,0,0,0,0,0,0,0,69,0.0,0.0,0.0,0.0,0.0,0.0,0.0,11,0,11,5.0,0.0,5.0
11140,1,1,0,0,1,0,0,13,0.0,0.0,0.0,0.0,0.0,0.0,0.0,44,1,43,12.0,0.0,12.0
302250,0,0,0,0,0,0,0,86,0.0,0.0,0.0,0.0,0.0,0.0,0.0,17,0,17,1.0,0.0,1.0
9808395,0,0,0,0,0,0,0,314,0.0,0.0,0.0,0.0,0.0,0.0,0.0,4,0,4,3.0,0.0,3.0
302103,0,0,0,0,0,0,0,116,0.0,0.0,0.0,0.0,0.0,0.0,0.0,48,0,48,14.0,0.0,14.0
107179,0,0,0,0,0,0,0,33,0.0,0.0,0.0,0.0,0.0,0.0,0.0,28,0,28,12.0,0.0,12.0
9910401,0,0,0,0,0,0,0,77,0.0,0.0,0.0,0.0,0.0,0.0,0.0,3,0,3,1.0,0.0,1.0
9902415,0,0,0,0,0,0,0,130,,,,,,,,6,0,6,1.0,0.0,1.0
208010,1,1,0,0,1,0,0,261,,,,,,,,1,1,0,,,
205026,2,2,0,0,0,2,22,18,2.0,2.0,0.0,0.0,0.0,2.0,22.0,18,2,16,14.0,2.0,12.0
212274,2,1,1,1,0,2,3,1,2.0,1.0,1.0,1.0,2.0,0.0,0.0,18,2,16,3.0,2.0,1.0
9609440,0,0,0,0,0,0,0,154,,,,,,,,3,0,3,1.0,0.0,1.0
9401201,0,0,0,0,0,0,0,35,0.0,0.0,0.0,0.0,0.0,0.0,0.0,8,0,8,6.0,0.0,6.0
9602257,0,0,0,0,0,0,0,643,0.0,0.0,0.0,0.0,0.0,0.0,0.0,1,0,1,1.0,0.0,1.0
9906309,0,0,0,0,0,0,0,11,0.0,0.0,0.0,0.0,0.0,0.0,0.0,8,0,8,5.0,0.0,5.0
207203,0,0,0,0,0,0,0,38,0.0,0.0,0.0,0.0,0.0,0.0,0.0,5,0,5,2.0,0.0,2.0
9609272,0,0,0,0,0,0,0,26,0.0,0.0,0.0,0.0,0.0,0.0,0.0,16,0,16,3.0,0.0,3.0
106061,0,0,0,0,0,0,0,1097,,,,,,,,2,0,2,,,
9310214,0,0,0,0,0,0,0,1048,,,,,,,,1,0,1,1.0,0.0,1.0
9406408,0,0,0,0,0,0,0,1766,,,,,,,,1,0,1,1.0,0.0,1.0
9808237,0,0,0,0,0,0,0,145,0.0,0.0,0.0,0.0,0.0,0.0,0.0,6,0,6,1.0,0.0,1.0
9610343,0,0,0,0,0,0,0,200,0.0,0.0,0.0,0.0,0.0,0.0,0.0,6,0,6,6.0,0.0,6.0
106146,2,2,0,0,0,2,13,80,1.0,1.0,0.0,0.0,0.0,1.0,9.0,17,2,15,10.0,1.0,9.0
9501413,0,0,0,0,0,0,0,15,0.0,0.0,0.0,0.0,0.0,0.0,0.0,9,0,9,2.0,0.0,2.0
207308,0,0,0,0,0,0,0,46,0.0,0.0,0.0,0.0,0.0,0.0,0.0,20,0,20,1.0,0.0,1.0
101167,1,1,0,0,0,1,2,22,0.0,0.0,0.0,0.0,0.0,0.0,0.0,18,1,17,6.0,0.0,6.0
105125,0,0,0,0,0,0,0,2,0.0,0.0,0.0,0.0,0.0,0.0,0.0,20,0,20,3.0,0.0,3.0
9405333,1,1,0,0,1,0,0,719,1.0,1.0,0.0,0.0,1.0,0.0,0.0,1,1,0,1.0,1.0,0.0
211098,0,0,0,0,0,0,0,304,0.0,0.0,0.0,0.0,0.0,0.0,0.0,10,0,10,1.0,0.0,1.0
2028,0,0,0,0,0,0,0,210,0.0,0.0,0.0,0.0,0.0,0.0,0.0,3,0,3,2.0,0.0,2.0
204355,0,0,0,0,0,0,0,720,0.0,0.0,0.0,0.0,0.0,0.0,0.0,2,0,2,2.0,0.0,2.0
206117,1,1,0,0,0,1,2,11,,,,,,,,5,1,4,1.0,0.0,1.0
209250,1,1,0,0,0,1,44,29,1.0,1.0,0.0,0.0,0.0,1.0,15.0,46,1,45,17.0,1.0,16.0
9810544,0,0,0,0,0,0,0,97,0.0,0.0,0.0,0.0,0.0,0.0,0.0,6,0,6,5.0,0.0,5.0
209140,1,1,0,0,0,1,7,328,1.0,1.0,0.0,0.0,0.0,1.0,3.0,8,1,7,4.0,1.0,3.0
211064,1,1,0,0,0,1,2,18,0.0,0.0,0.0,0.0,0.0,0.0,0.0,57,1,56,30.0,0.0,30.0
9901393,0,0,0,0,0,0,0,42,0.0,0.0,0.0,0.0,0.0,0.0,0.0,7,0,7,7.0,0.0,7.0
3325,1,1,0,0,0,1,5,6,1.0,1.0,0.0,0.0,0.0,1.0,1.0,11,1,10,3.0,1.0,2.0
205145,0,0,0,0,0,0,0,11,,,,,,,,8,0,8,,,
210087,0,0,0,0,0,0,0,279,0.0,0.0,0.0,0.0,0.0,0.0,0.0,7,0,7,1.0,0.0,1.0
1198,0,0,0,0,0,0,0,252,0.0,0.0,0.0,0.0,0.0,0.0,0.0,2,0,2,1.0,0.0,1.0
9507408,0,0,0,0,0,0,0,171,0.0,0.0,0.0,0.0,0.0,0.0,0.0,2,0,2,2.0,0.0,2.0
9708470,0,0,0,0,0,0,0,5,0.0,0.0,0.0,0.0,0.0,0.0,0.0,7,0,7,,,
9408327,0,0,0,0,0,0,0,52,0.0,0.0,0.0,0.0,0.0,0.0,0.0,2,0,2,1.0,0.0,1.0
108183,0,0,0,0,0,0,0,23,0.0,0.0,0.0,0.0,0.0,0.0,0.0,10,0,10,1.0,0.0,1.0
212357,1,1,0,0,0,1,7,108,0.0,0.0,0.0,0.0,0.0,0.0,0.0,17,1,16,4.0,1.0,3.0
208008,0,0,0,0,0,0,0,201,0.0,0.0,0.0,0.0,0.0,0.0,0.0,12,0,12,9.0,0.0,9.0
9907236,0,0,0,0,0,0,0,269,0.0,0.0,0.0,0.0,0.0,0.0,0.0,3,0,3,2.0,0.0,2.0
302106,0,0,0,0,0,0,0,169,0.0,0.0,0.0,0.0,0.0,0.0,0.0,2,0,2,,,
9910455,1,1,0,0,0,1,4,113,1.0,1.0,0.0,0.0,0.0,1.0,1.0,7,1,6,4.0,1.0,3.0
9506342,0,0,0,0,0,0,0,53,0.0,0.0,0.0,0.0,0.0,0.0,0.0,8,0,8,,,
8278,0,0,0,0,0,0,0,373,0.0,0.0,0.0,0.0,0.0,0.0,0.0,5,0,5,2.0,0.0,2.0
9507464,0,0,0,0,0,0,0,93,0.0,0.0,0.0,0.0,0.0,0.0,0.0,2,0,2,1.0,0.0,1.0
209308,0,0,0,0,0,0,0,51,0.0,0.0,0.0,0.0,0.0,0.0,0.0,5,0,5,2.0,0.0,2.0
1089,0,0,0,0,0,0,0,38,0.0,0.0,0.0,0.0,0.0,0.0,0.0,7,0,7,,,
9512331,0,0,0,0,0,0,0,24,0.0,0.0,0.0,0.0,0.0,0.0,0.0,5,0,5,1.0,0.0,1.0
6207,0,0,0,0,0,0,0,9,0.0,0.0,0.0,0.0,0.0,0.0,0.0,10,0,10,,,
9310360,0,0,0,0,0,0,0,1258,,,,,,,,5,0,5,,,
9812264,0,0,0,0,0,0,0,101,0.0,0.0,0.0,0.0,0.0,0.0,0.0,6,0,6,1.0,0.0,1.0
9507286,0,0,0,0,0,0,0,25,0.0,0.0,0.0,0.0,0.0,0.0,0.0,9,0,9,1.0,0.0,1.0
111378,0,0,0,0,0,0,0,118,0.0,0.0,0.0,0.0,0.0,0.0,0.0,4,0,4,,,
9410210,0,0,0,0,0,0,0,2006,,,,,,,,4,0,4,,,
9403214,1,1,0,0,0,1,1,108,1.0,1.0,0.0,0.0,0.0,1.0,1.0,7,1,6,4.0,0.0,4.0
209155,0,0,0,0,0,0,0,780,0.0,0.0,0.0,0.0,0.0,0.0,0.0,1,0,1,1.0,0.0,1.0
205311,0,0,0,0,0,0,0,233,0.0,0.0,0.0,0.0,0.0,0.0,0.0,2,0,2,1.0,0.0,1.0
9905273,0,0,0,0,0,0,0,157,0.0,0.0,0.0,0.0,0.0,0.0,0.0,3,0,3,3.0,0.0,3.0
207081,3,1,2,2,0,3,10,167,3.0,1.0,2.0,2.0,1.0,2.0,6.0,9,3,6,7.0,3.0,4.0
5070,0,0,0,0,0,0,0,56,0.0,0.0,0.0,0.0,0.0,0.0,0.0,8,0,8,,,
9707231,0,0,0,0,0,0,0,67,0.0,0.0,0.0,0.0,0.0,0.0,0.0,14,0,14,2.0,0.0,2.0
9803429,0,0,0,0,0,0,0,117,0.0,0.0,0.0,0.0,0.0,0.0,0.0,4,0,4,3.0,0.0,3.0
9705343,0,0,0,0,0,0,0,135,0.0,0.0,0.0,0.0,0.0,0.0,0.0,4,0,4,3.0,0.0,3.0
9804260,1,1,0,0,0,1,1,124,1.0,1.0,0.0,0.0,1.0,0.0,0.0,10,1,9,2.0,0.0,2.0
9304,0,0,0,0,0,0,0,143,0.0,0.0,0.0,0.0,0.0,0.0,0.0,2,0,2,2.0,0.0,2.0
9505374,1,1,0,0,1,0,0,734,1.0,1.0,0.0,0.0,1.0,0.0,0.0,1,1,0,1.0,1.0,0.0
9910218,0,0,0,0,0,0,0,1582,0.0,0.0,0.0,0.0,0.0,0.0,0.0,5,0,5,1.0,0.0,1.0
102272,0,0,0,0,0,0,0,40,0.0,0.0,0.0,0.0,0.0,0.0,0.0,8,0,8,,,
103191,1,1,0,0,0,1,1,112,1.0,1.0,0.0,0.0,0.0,1.0,1.0,8,1,7,1.0,0.0,1.0
9406415,0,0,0,0,0,0,0,158,0.0,0.0,0.0,0.0,0.0,0.0,0.0,1,0,1,1.0,0.0,1.0
302044,0,0,0,0,0,0,0,338,0.0,0.0,0.0,0.0,0.0,0.0,0.0,11,0,11,3.0,0.0,3.0
301162,0,0,0,0,0,0,0,20,0.0,0.0,0.0,0.0,0.0,0.0,0.0,21,0,21,7.0,0.0,7.0
9206265,1,1,0,0,1,0,0,342,1.0,1.0,0.0,0.0,1.0,0.0,0.0,1,1,0,1.0,1.0,0.0
9411393,0,0,0,0,0,0,0,29,0.0,0.0,0.0,0.0,0.0,0.0,0.0,12,0,12,7.0,0.0,7.0
203196,0,0,0,0,0,0,0,1313,,,,,,,,5,0,5,,,
9405219,0,0,0,0,0,0,0,94,,,,,,,,2,0,2,,,
2107,0,0,0,0,0,0,0,294,0.0,0.0,0.0,0.0,0.0,0.0,0.0,4,0,4,3.0,0.0,3.0
204133,0,0,0,0,0,0,0,55,0.0,0.0,0.0,0.0,0.0,0.0,0.0,22,0,22,3.0,0.0,3.0
302196,0,0,0,0,0,0,0,107,0.0,0.0,0.0,0.0,0.0,0.0,0.0,12,0,12,3.0,0.0,3.0
9406371,0,0,0,0,0,0,0,276,0.0,0.0,0.0,0.0,0.0,0.0,0.0,1,0,1,1.0,0.0,1.0
301207,0,0,0,0,0,0,0,412,0.0,0.0,0.0,0.0,0.0,0.0,0.0,6,0,6,2.0,0.0,2.0
9508226,1,1,0,0,0,1,1,137,1.0,1.0,0.0,0.0,0.0,1.0,1.0,2,1,1,2.0,1.0,1.0
104219,0,0,0,0,0,0,0,214,0.0,0.0,0.0,0.0,0.0,0.0,0.0,4,0,4,2.0,0.0,2.0
110024,0,0,0,0,0,0,0,22,0.0,0.0,0.0,0.0,0.0,0.0,0.0,75,0,75,16.0,0.0,16.0
9707252,0,0,0,0,0,0,0,841,0.0,0.0,0.0,0.0,0.0,0.0,0.0,2,0,2,,,
207374,0,0,0,0,0,0,0,11,0.0,0.0,0.0,0.0,0.0,0.0,0.0,41,0,41,34.0,0.0,34.0
9707370,0,0,0,0,0,0,0,141,0.0,0.0,0.0,0.0,0.0,0.0,0.0,11,0,11,6.0,0.0,6.0
9807314,0,0,0,0,0,0,0,185,0.0,0.0,0.0,0.0,0.0,0.0,0.0,1,0,1,,,
206059,0,0,0,0,0,0,0,1585,,,,,,,,1,0,1,,,
2031,0,0,0,0,0,0,0,50,0.0,0.0,0.0,0.0,0.0,0.0,0.0,7,0,7,,,
9409271,0,0,0,0,0,0,0,108,,,,,,,,1,0,1,,,
9807242,0,0,0,0,0,0,0,31,0.0,0.0,0.0,0.0,0.0,0.0,0.0,4,0,4,1.0,0.0,1.0
9809361,0,0,0,0,0,0,0,1630,,,,,,,,1,0,1,,,
103285,0,0,0,0,0,0,0,198,0.0,0.0,0.0,0.0,0.0,0.0,0.0,9,0,9,4.0,0.0,4.0
211377,0,0,0,0,0,0,0,2,0.0,0.0,0.0,0.0,0.0,0.0,0.0,46,0,46,17.0,0.0,17.0
301141,0,0,0,0,0,0,0,72,0.0,0.0,0.0,0.0,0.0,0.0,0.0,10,0,10,3.0,0.0,3.0
9067,0,0,0,0,0,0,0,428,0.0,0.0,0.0,0.0,0.0,0.0,0.0,6,0,6,4.0,0.0,4.0
9502265,0,0,0,0,0,0,0,360,0.0,0.0,0.0,0.0,0.0,0.0,0.0,2,0,2,1.0,0.0,1.0
9812452,0,0,0,0,0,0,0,1,0.0,0.0,0.0,0.0,0.0,0.0,0.0,35,0,35,19.0,0.0,19.0
301157,0,0,0,0,0,0,0,28,0.0,0.0,0.0,0.0,0.0,0.0,0.0,14,0,14,3.0,0.0,3.0
9905345,0,0,0,0,0,0,0,1947,,,,,,,,1,0,1,1.0,0.0,1.0
208133,0,0,0,0,0,0,0,93,,,,,,,,2,0,2,,,
9710535,0,0,0,0,0,0,0,211,0.0,0.0,0.0,0.0,0.0,0.0,0.0,5,0,5,1.0,0.0,1.0
11085,0,0,0,0,0,0,0,106,0.0,0.0,0.0,0.0,0.0,0.0,0.0,6,0,6,4.0,0.0,4.0
301238,0,0,0,0,0,0,0,11,0.0,0.0,0.0,0.0,0.0,0.0,0.0,55,0,55,37.0,0.0,37.0
204320,0,0,0,0,0,0,0,49,0.0,0.0,0.0,0.0,0.0,0.0,0.0,7,0,7,2.0,0.0,2.0
104222,2,2,0,0,2,0,0,579,2.0,2.0,0.0,0.0,2.0,0.0,0.0,2,2,0,2.0,2.0,0.0
111417,0,0,0,0,0,0,0,153,0.0,0.0,0.0,0.0,0.0,0.0,0.0,9,0,9,5.0,0.0,5.0
9307276,0,0,0,0,0,0,0,87,,,,,,,,1,0,1,,,
211212,0,0,0,0,0,0,0,27,0.0,0.0,0.0,0.0,0.0,0.0,0.0,18,0,18,8.0,0.0,8.0
9608249,0,0,0,0,0,0,0,889,,,,,,,,1,0,1,,,
212168,0,0,0,0,0,0,0,1043,0.0,0.0,0.0,0.0,0.0,0.0,0.0,4,0,4,,,
9612258,1,1,0,0,0,1,1,100,1.0,1.0,0.0,0.0,0.0,1.0,1.0,5,1,4,,,
104110,141,27,114,462,4,137,1151,1,37.0,7.0,30.0,97.0,0.0,37.0,285.0,222,141,81,23.0,8.0,15.0
6351,31,3,28,105,0,31,255,1,27.0,2.0,25.0,101.0,0.0,27.0,197.0,68,31,37,26.0,16.0,10.0
9411308,58,6,52,359,53,5,7,1,38.0,2.0,36.0,265.0,38.0,0.0,0.0,61,58,3,23.0,23.0,0.0
9704402,46,13,33,101,1,45,259,1,12.0,3.0,9.0,16.0,0.0,12.0,51.0,76,46,30,14.0,9.0,5.0
9312359,204,22,182,1138,60,144,249,6,96.0,13.0,83.0,522.0,7.0,89.0,169.0,207,204,3,23.0,23.0,0.0
9502300,166,14,152,834,13,153,499,8,45.0,1.0,44.0,336.0,11.0,34.0,34.0,184,166,18,15.0,14.0,1.0
9411367,26,6,20,65,24,2,2,7,15.0,4.0,11.0,35.0,15.0,0.0,0.0,28,26,2,11.0,11.0,0.0
9806412,31,11,20,31,18,13,13,296,11.0,6.0,5.0,5.0,3.0,8.0,8.0,32,31,1,6.0,5.0,1.0
3133,6,6,0,0,3,3,18,32,0.0,0.0,0.0,0.0,0.0,0.0,0.0,66,6,60,13.0,0.0,13.0
9610208,58,13,45,173,17,41,70,1,16.0,4.0,12.0,26.0,1.0,15.0,31.0,64,58,6,7.0,6.0,1.0
9402364,210,27,183,1355,128,82,168,6,59.0,7.0,52.0,352.0,7.0,52.0,120.0,217,210,7,38.0,34.0,4.0
9311370,22,5,17,72,16,6,6,114,15.0,3.0,12.0,51.0,15.0,0.0,0.0,24,22,2,12.0,12.0,0.0
9406228,12,4,8,9,1,11,27,86,4.0,2.0,2.0,2.0,0.0,4.0,11.0,18,12,6,9.0,4.0,5.0
9410404,369,114,255,833,313,56,67,39,17.0,3.0,14.0,63.0,17.0,0.0,0.0,372,369,3,14.0,14.0,0.0
9606399,542,114,428,1863,356,186,307,4,27.0,7.0,20.0,84.0,9.0,18.0,23.0,559,542,17,13.0,12.0,1.0
9811350,255,15,240,2588,3,252,1232,2,134.0,4.0,130.0,1671.0,0.0,134.0,839.0,271,255,16,68.0,61.0,7.0
9312210,44,12,32,164,28,16,21,33,20.0,5.0,15.0,75.0,12.0,8.0,8.0,50,44,6,12.0,11.0,1.0
9603442,15,4,11,34,5,10,11,33,6.0,3.0,3.0,6.0,5.0,1.0,1.0,18,15,3,8.0,7.0,1.0
9704257,47,4,43,216,5,42,283,12,13.0,2.0,11.0,31.0,0.0,13.0,85.0,78,47,31,20.0,11.0,9.0
9804241,97,8,89,658,5,92,558,24,71.0,6.0,65.0,507.0,0.0,71.0,384.0,116,97,19,34.0,31.0,3.0
9812518,14,6,8,13,0,14,84,48,6.0,3.0,3.0,4.0,0.0,6.0,38.0,30,14,16,10.0,4.0,6.0
6035,9,4,5,11,0,9,20,4,3.0,2.0,1.0,1.0,0.0,3.0,7.0,16,9,7,5.0,3.0,2.0
6050,7,4,3,4,1,6,16,26,4.0,3.0,1.0,1.0,0.0,4.0,12.0,15,7,8,1.0,0.0,1.0
9207249,20,7,13,22,20,0,0,26,5.0,2.0,3.0,5.0,5.0,0.0,0.0,20,20,0,8.0,8.0,0.0
9601305,7,5,2,4,4,3,16,26,0.0,0.0,0.0,0.0,0.0,0.0,0.0,25,7,18,13.0,0.0,13.0
9807469,7,5,2,3,1,6,32,26,1.0,1.0,0.0,0.0,0.0,1.0,4.0,26,7,19,5.0,1.0,4.0
108264,47,28,19,33,17,30,75,80,6.0,2.0,4.0,5.0,2.0,4.0,7.0,100,47,53,5.0,2.0,3.0
201141,2,1,1,1,0,2,2,1979,0.0,0.0,0.0,0.0,0.0,0.0,0.0,9,2,7,,,
9509275,4,1,3,3,1,3,6,60,4.0,1.0,3.0,3.0,1.0,3.0,6.0,7,4,3,3.0,1.0,2.0
9612362,39,4,35,115,11,28,100,4,17.0,3.0,14.0,45.0,5.0,12.0,30.0,59,39,20,7.0,6.0,1.0
9911262,63,5,58,361,1,62,478,2,43.0,2.0,41.0,276.0,1.0,42.0,92.0,110,63,47,31.0,29.0,2.0
10338,149,57,92,308,21,128,1051,4,27.0,8.0,19.0,44.0,0.0,27.0,390.0,293,149,144,36.0,12.0,24.0
111314,10,7,3,5,0,10,79,30,1.0,1.0,0.0,0.0,0.0,1.0,13.0,65,10,55,8.0,2.0,6.0
9907422,63,14,49,282,9,54,431,4,31.0,4.0,27.0,178.0,0.0,31.0,299.0,95,63,32,28.0,18.0,10.0
9804290,83,9,74,300,6,77,175,20,30.0,2.0,28.0,125.0,2.0,28.0,77.0,89,83,6,14.0,14.0,0.0
9403373,6,1,5,6,6,0,0,63,1.0,1.0,0.0,0.0,1.0,0.0,0.0,6,6,0,2.0,2.0,0.0
9206261,2,2,0,0,2,0,0,364,1.0,1.0,0.0,0.0,1.0,0.0,0.0,3,2,1,1.0,1.0,0.0
9501201,34,5,29,106,0,34,112,25,15.0,2.0,13.0,39.0,0.0,15.0,48.0,43,34,9,18.0,13.0,5.0
9311341,59,11,48,197,59,0,0,43,15.0,3.0,12.0,32.0,15.0,0.0,0.0,59,59,0,12.0,12.0,0.0
9505366,1,1,0,0,0,1,3,25,1.0,1.0,0.0,0.0,0.0,1.0,3.0,33,1,32,4.0,0.0,4.0
9211266,68,15,53,221,68,0,0,60,26.0,4.0,22.0,92.0,26.0,0.0,0.0,68,68,0,17.0,17.0,0.0
9303303,57,9,48,150,44,13,22,3,13.0,1.0,12.0,39.0,13.0,0.0,0.0,61,57,4,5.0,5.0,0.0
9507238,27,7,20,47,0,27,125,3,13.0,3.0,10.0,27.0,0.0,13.0,69.0,40,27,13,14.0,8.0,6.0
9601387,92,19,73,342,22,70,171,12,39.0,8.0,31.0,111.0,2.0,37.0,87.0,101,92,9,23.0,19.0,4.0
9608253,43,13,30,102,11,32,32,0,9.0,4.0,5.0,9.0,1.0,8.0,8.0,44,43,1,5.0,5.0,0.0
9807353,131,10,121,882,6,125,436,3,79.0,2.0,77.0,662.0,3.0,76.0,308.0,142,131,11,54.0,46.0,8.0
9910554,15,2,13,38,0,15,80,0,10.0,1.0,9.0,29.0,0.0,10.0,40.0,27,15,12,2.0,2.0,0.0
9305204,76,16,60,197,72,4,4,0,17.0,2.0,15.0,56.0,17.0,0.0,0.0,78,76,2,13.0,13.0,0.0
2064,78,8,70,283,18,60,175,0,35.0,3.0,32.0,141.0,8.0,27.0,62.0,87,78,9,19.0,17.0,2.0
9802340,12,4,8,12,1,11,18,3,1.0,1.0,0.0,0.0,0.0,1.0,2.0,23,12,11,3.0,2.0,1.0
9903334,15,5,10,17,0,15,77,3,6.0,2.0,4.0,6.0,0.0,6.0,33.0,39,15,24,2.0,1.0,1.0
9911465,8,3,5,5,1,7,39,3,6.0,2.0,4.0,4.0,0.0,6.0,35.0,31,8,23,1.0,0.0,1.0
9612471,3,2,1,1,1,2,5,82,2.0,2.0,0.0,0.0,1.0,1.0,3.0,15,3,12,4.0,1.0,3.0
9811428,178,5,173,1254,33,145,917,2,47.0,2.0,45.0,203.0,0.0,47.0,568.0,207,178,29,49.0,49.0,0.0
9508247,48,2,46,291,4,44,106,3,41.0,3.0,38.0,255.0,4.0,37.0,65.0,58,48,10,13.0,11.0,2.0
9811407,2,2,0,0,0,2,6,0,1.0,1.0,0.0,0.0,0.0,1.0,1.0,12,2,10,4.0,0.0,4.0
9801320,1,1,0,0,0,1,2,358,1.0,1.0,0.0,0.0,0.0,1.0,2.0,13,1,12,2.0,0.0,2.0
9903454,71,9,62,324,11,60,318,0,38.0,3.0,35.0,184.0,0.0,38.0,273.0,85,71,14,38.0,24.0,14.0
9305276,47,6,41,218,47,0,0,82,36.0,3.0,33.0,196.0,36.0,0.0,0.0,47,47,0,23.0,23.0,0.0
9806516,20,6,14,25,8,12,25,182,2.0,2.0,0.0,0.0,0.0,2.0,12.0,33,20,13,9.0,2.0,7.0
9601243,108,15,93,467,5,103,535,3,35.0,9.0,26.0,87.0,0.0,35.0,241.0,131,108,23,39.0,27.0,12.0
9807415,53,5,48,262,2,51,232,2,36.0,2.0,34.0,205.0,0.0,36.0,182.0,60,53,7,21.0,17.0,4.0
9405374,13,7,6,13,1,12,16,81,4.0,1.0,3.0,5.0,1.0,3.0,3.0,18,13,5,7.0,5.0,2.0
9402351,10,4,6,6,8,2,2,172,3.0,2.0,1.0,1.0,3.0,0.0,0.0,11,10,1,3.0,3.0,0.0
9702400,15,9,6,9,4,11,35,0,2.0,2.0,0.0,0.0,1.0,1.0,4.0,29,15,14,8.0,1.0,7.0
9706385,22,6,16,51,0,22,80,42,12.0,3.0,9.0,33.0,0.0,12.0,33.0,33,22,11,13.0,11.0,2.0
9506416,106,8,98,693,58,48,103,12,65.0,2.0,63.0,536.0,65.0,0.0,0.0,117,106,11,33.0,33.0,0.0
9508316,14,2,12,21,4,10,14,46,8.0,1.0,7.0,15.0,2.0,6.0,6.0,22,14,8,3.0,2.0,1.0
9306309,273,34,239,1385,179,94,128,10,44.0,6.0,38.0,241.0,44.0,0.0,0.0,279,273,6,14.0,14.0,0.0
9601208,8,8,0,0,1,7,81,10,1.0,1.0,0.0,0.0,0.0,1.0,18.0,175,8,167,8.0,0.0,8.0
9508391,41,29,12,18,37,4,4,98,6.0,6.0,0.0,0.0,6.0,0.0,0.0,45,41,4,3.0,3.0,0.0
9811463,20,4,16,45,3,17,75,3,1.0,1.0,0.0,0.0,0.0,1.0,2.0,38,20,18,13.0,11.0,2.0
9502210,27,7,20,40,8,19,38,10,13.0,3.0,10.0,19.0,5.0,8.0,8.0,36,27,9,6.0,5.0,1.0
9906209,93,29,64,167,17,76,278,12,11.0,9.0,2.0,2.0,0.0,11.0,44.0,127,93,34,20.0,2.0,18.0
9612397,62,8,54,232,24,38,72,12,18.0,2.0,16.0,59.0,18.0,0.0,0.0,70,62,8,15.0,15.0,0.0
9206238,14,13,1,1,14,0,0,10,3.0,3.0,0.0,0.0,3.0,0.0,0.0,14,14,0,2.0,2.0,0.0
108141,14,7,7,16,0,14,187,1,12.0,6.0,6.0,14.0,0.0,12.0,118.0,75,14,61,27.0,9.0,18.0
9505369,46,4,42,208,2,44,128,1,40.0,4.0,36.0,181.0,2.0,38.0,98.0,52,46,6,26.0,23.0,3.0
9708209,10,2,8,26,1,9,26,48,7.0,1.0,6.0,12.0,0.0,7.0,16.0,15,10,5,9.0,7.0,2.0
9804330,4,3,1,1,0,4,7,1,,,,,,,,9,4,5,,,
8210,7,4,3,4,0,7,31,7,3.0,2.0,1.0,1.0,0.0,3.0,13.0,33,7,26,3.0,0.0,3.0
9910221,96,16,80,310,3,93,635,7,21.0,7.0,14.0,39.0,0.0,21.0,122.0,145,96,49,16.0,9.0,7.0
9909244,37,8,29,118,2,35,266,67,17.0,3.0,14.0,59.0,0.0,17.0,162.0,68,37,31,32.0,14.0,18.0
9802447,34,15,19,62,23,11,23,34,9.0,4.0,5.0,10.0,9.0,0.0,0.0,45,34,11,11.0,11.0,0.0
9607448,25,5,20,73,8,17,51,158,14.0,1.0,13.0,53.0,12.0,2.0,2.0,33,25,8,13.0,13.0,0.0
9703286,20,1,19,86,1,19,71,158,18.0,1.0,17.0,75.0,1.0,17.0,37.0,34,20,14,23.0,17.0,6.0
9712254,31,6,25,53,10,21,37,62,9.0,3.0,6.0,11.0,5.0,4.0,4.0,36,31,5,10.0,9.0,1.0
9905296,27,3,24,101,1,26,259,1,21.0,1.0,20.0,85.0,0.0,21.0,214.0,69,27,42,31.0,15.0,16.0
9508314,24,8,16,51,9,15,27,33,7.0,1.0,6.0,7.0,3.0,4.0,5.0,31,24,7,3.0,2.0,1.0
9803457,65,6,59,243,2,63,497,1,28.0,3.0,25.0,78.0,0.0,28.0,255.0,109,65,44,23.0,8.0,15.0
9812392,23,8,15,34,1,22,219,1,4.0,3.0,1.0,1.0,0.0,4.0,18.0,79,23,56,10.0,1.0,9.0
9204207,51,13,38,136,51,0,0,29,27.0,4.0,23.0,85.0,27.0,0.0,0.0,51,51,0,13.0,13.0,0.0
9403295,85,33,52,150,68,17,21,1,25.0,8.0,17.0,45.0,14.0,11.0,14.0,88,85,3,10.0,10.0,0.0
9801363,41,4,37,170,9,32,56,1,22.0,1.0,21.0,123.0,2.0,20.0,34.0,51,41,10,9.0,9.0,0.0
110411,7,6,1,1,0,7,59,1,4.0,4.0,0.0,0.0,0.0,4.0,28.0,39,7,32,7.0,4.0,3.0
9904214,8,5,3,5,1,7,30,1,3.0,2.0,1.0,1.0,3.0,0.0,0.0,20,8,12,3.0,3.0,0.0
9801416,24,4,20,50,2,22,116,5,15.0,3.0,12.0,28.0,0.0,15.0,84.0,35,24,11,22.0,13.0,9.0
8226,15,3,12,26,0,15,123,1,11.0,2.0,9.0,16.0,0.0,11.0,46.0,72,15,57,15.0,10.0,5.0
9704304,12,7,5,10,3,9,16,141,8.0,5.0,3.0,8.0,0.0,8.0,13.0,18,12,6,7.0,6.0,1.0
9712294,4,3,1,1,4,0,0,349,3.0,2.0,1.0,1.0,3.0,0.0,0.0,4,4,0,2.0,2.0,0.0
9811273,37,10,27,63,0,37,225,21,19.0,4.0,15.0,35.0,0.0,19.0,81.0,71,37,34,23.0,13.0,10.0
9907386,16,10,6,11,4,12,31,7,4.0,4.0,0.0,0.0,0.0,4.0,8.0,33,16,17,3.0,1.0,2.0
9304302,23,9,14,41,20,3,5,7,12.0,1.0,11.0,37.0,12.0,0.0,0.0,26,23,3,12.0,12.0,0.0
9307310,8,4,4,6,8,0,0,7,,,,,,,,8,8,0,1.0,1.0,0.0
9807344,503,18,485,5227,18,485,1268,2,172.0,2.0,170.0,2668.0,1.0,171.0,591.0,510,503,7,61.0,57.0,4.0
9602270,6,5,1,1,4,2,2,300,2.0,1.0,1.0,1.0,2.0,0.0,0.0,8,6,2,2.0,2.0,0.0
9510372,61,9,52,181,13,48,177,61,26.0,2.0,24.0,74.0,0.0,26.0,97.0,76,61,15,18.0,13.0,5.0
9409361,14,4,10,32,5,9,9,256,11.0,2.0,9.0,30.0,2.0,9.0,9.0,19,14,5,11.0,10.0,1.0
9706425,3,3,0,0,2,1,2,17,1.0,1.0,0.0,0.0,1.0,0.0,0.0,20,3,17,1.0,1.0,0.0
9704424,25,4,21,66,13,12,21,98,19.0,4.0,15.0,55.0,8.0,11.0,19.0,27,25,2,10.0,10.0,0.0
9708390,36,5,31,138,7,29,34,80,19.0,4.0,15.0,81.0,4.0,15.0,15.0,39,36,3,15.0,14.0,1.0
9512328,100,5,95,496,32,68,169,19,34.0,2.0,32.0,184.0,6.0,28.0,88.0,112,100,12,19.0,19.0,0.0
9607309,17,4,13,25,8,9,42,19,6.0,1.0,5.0,12.0,0.0,6.0,14.0,28,17,11,8.0,5.0,3.0
3028,18,5,13,33,5,13,26,218,9.0,2.0,7.0,21.0,0.0,9.0,14.0,25,18,7,12.0,9.0,3.0
9804201,23,3,20,94,3,20,58,13,17.0,2.0,15.0,67.0,1.0,16.0,36.0,31,23,8,20.0,17.0,3.0
9806342,26,5,21,69,4,22,86,127,11.0,3.0,8.0,22.0,0.0,11.0,56.0,36,26,10,17.0,10.0,7.0
9305225,55,11,44,162,55,0,0,57,25.0,4.0,21.0,100.0,25.0,0.0,0.0,55,55,0,18.0,18.0,0.0
9501376,42,9,33,87,27,15,17,258,17.0,2.0,15.0,47.0,17.0,0.0,0.0,44,42,2,14.0,14.0,0.0
9506203,13,6,7,8,2,11,31,98,3.0,2.0,1.0,1.0,0.0,3.0,7.0,20,13,7,7.0,3.0,4.0
9806366,54,21,33,87,14,40,78,5,10.0,5.0,5.0,5.0,1.0,9.0,16.0,64,54,10,3.0,3.0,0.0
9403394,22,12,10,15,6,16,23,98,7.0,5.0,2.0,2.0,0.0,7.0,9.0,25,22,3,9.0,6.0,3.0
9903218,20,5,15,33,0,20,159,4,8.0,1.0,7.0,14.0,0.0,8.0,46.0,63,20,43,11.0,7.0,4.0
9504204,25,6,19,50,0,25,54,30,20.0,4.0,16.0,43.0,0.0,20.0,43.0,30,25,5,11.0,9.0,2.0
9301226,6,5,1,3,6,0,0,86,4.0,4.0,0.0,0.0,4.0,0.0,0.0,6,6,0,5.0,5.0,0.0
6083,6,3,3,4,2,4,24,59,4.0,1.0,3.0,4.0,0.0,4.0,21.0,14,6,8,10.0,4.0,6.0
9512303,38,8,30,130,0,38,139,6,21.0,3.0,18.0,62.0,2.0,19.0,19.0,49,38,11,21.0,18.0,3.0
9610518,20,6,14,32,2,18,123,6,4.0,3.0,1.0,1.0,0.0,4.0,34.0,45,20,25,9.0,7.0,2.0
9911404,11,1,10,20,0,11,127,6,8.0,1.0,7.0,13.0,0.0,8.0,79.0,52,11,41,15.0,9.0,6.0
9408215,41,17,24,55,35,6,6,179,8.0,3.0,5.0,7.0,8.0,0.0,0.0,42,41,1,5.0,5.0,0.0
9508408,36,5,31,91,11,25,100,6,17.0,3.0,14.0,47.0,1.0,16.0,87.0,52,36,16,12.0,9.0,3.0
111061,0,0,0,0,0,0,0,96,0.0,0.0,0.0,0.0,0.0,0.0,0.0,4,0,4,2.0,0.0,2.0
9409405,7,4,3,3,7,0,0,287,1.0,1.0,0.0,0.0,1.0,0.0,0.0,7,7,0,1.0,1.0,0.0
9511345,14,7,7,12,0,14,73,14,7.0,3.0,4.0,6.0,0.0,7.0,40.0,44,14,30,4.0,3.0,1.0
103314,29,18,11,15,20,9,19,38,6.0,4.0,2.0,2.0,6.0,0.0,0.0,35,29,6,4.0,4.0,0.0
9509313,44,13,31,96,8,36,86,22,22.0,3.0,19.0,57.0,2.0,20.0,34.0,50,44,6,18.0,16.0,2.0
9706348,14,10,4,5,1,13,26,172,5.0,4.0,1.0,1.0,0.0,5.0,11.0,24,14,10,10.0,4.0,6.0
9809291,31,9,22,55,8,23,50,15,16.0,3.0,13.0,44.0,3.0,13.0,31.0,36,31,5,5.0,5.0,0.0
9809573,2,2,0,0,0,2,12,22,0.0,0.0,0.0,0.0,0.0,0.0,0.0,15,2,13,6.0,0.0,6.0
9609369,15,3,12,27,7,8,14,22,4.0,1.0,3.0,3.0,4.0,0.0,0.0,18,15,3,8.0,8.0,0.0
9911463,8,3,5,8,0,8,79,22,5.0,1.0,4.0,5.0,0.0,5.0,61.0,44,8,36,20.0,3.0,17.0
9508353,17,6,11,26,17,0,0,88,10.0,2.0,8.0,18.0,10.0,0.0,0.0,17,17,0,7.0,7.0,0.0
7069,29,13,16,29,14,15,23,51,13.0,4.0,9.0,15.0,5.0,8.0,8.0,66,29,37,7.0,0.0,7.0
9501262,10,7,3,5,10,0,0,254,6.0,4.0,2.0,3.0,6.0,0.0,0.0,10,10,0,4.0,4.0,0.0
9904315,21,5,16,37,0,21,104,21,11.0,5.0,6.0,10.0,0.0,11.0,47.0,48,21,27,17.0,3.0,14.0
9901207,11,4,7,8,0,11,65,21,6.0,2.0,4.0,5.0,0.0,6.0,55.0,26,11,15,17.0,4.0,13.0
9512295,10,5,5,9,10,0,0,539,2.0,1.0,1.0,1.0,2.0,0.0,0.0,10,10,0,2.0,2.0,0.0
9806259,36,11,25,68,3,33,141,39,18.0,6.0,12.0,29.0,0.0,18.0,83.0,50,36,14,20.0,13.0,7.0
9905310,54,8,46,172,6,48,335,66,15.0,7.0,8.0,26.0,1.0,14.0,61.0,106,54,52,21.0,9.0,12.0
9807417,21,5,16,52,4,17,42,30,6.0,2.0,4.0,5.0,1.0,5.0,9.0,31,21,10,16.0,12.0,4.0
9401314,21,11,10,18,21,0,0,101,3.0,3.0,0.0,0.0,3.0,0.0,0.0,21,21,0,3.0,3.0,0.0
9805233,19,7,12,28,0,19,100,39,16.0,7.0,9.0,18.0,0.0,16.0,72.0,29,19,10,16.0,10.0,6.0
103168,13,6,7,22,0,13,77,20,11.0,5.0,6.0,17.0,0.0,11.0,65.0,35,13,22,4.0,3.0,1.0
1318,20,4,16,45,0,20,137,20,17.0,2.0,15.0,42.0,0.0,17.0,122.0,39,20,19,26.0,15.0,11.0
9209241,77,21,56,211,77,0,0,29,35.0,13.0,22.0,93.0,35.0,0.0,0.0,77,77,0,14.0,14.0,0.0
9405425,25,3,22,73,22,3,6,7,15.0,2.0,13.0,42.0,15.0,0.0,0.0,31,25,6,11.0,11.0,0.0
8207,17,1,16,45,1,16,81,20,14.0,1.0,13.0,42.0,0.0,14.0,74.0,26,17,9,1.0,1.0,0.0
9811387,17,3,14,46,0,17,88,20,4.0,1.0,3.0,4.0,0.0,4.0,18.0,31,17,14,9.0,3.0,6.0
9504310,21,9,12,19,6,15,51,40,2.0,1.0,1.0,1.0,0.0,2.0,21.0,55,21,34,5.0,0.0,5.0
9303261,4,3,1,1,4,0,0,459,2.0,2.0,0.0,0.0,2.0,0.0,0.0,4,4,0,1.0,1.0,0.0
207164,3,2,1,1,0,3,16,37,1.0,1.0,0.0,0.0,0.0,1.0,6.0,21,3,18,8.0,2.0,6.0
9905577,6,4,2,2,0,6,76,2,3.0,2.0,1.0,1.0,0.0,3.0,42.0,52,6,46,27.0,1.0,26.0
9505289,40,12,28,71,4,36,181,6,13.0,4.0,9.0,18.0,0.0,13.0,121.0,67,40,27,27.0,8.0,19.0
9609463,14,10,4,7,7,7,31,4,3.0,3.0,0.0,0.0,0.0,3.0,9.0,29,14,15,2.0,2.0,0.0
111190,47,10,37,139,47,0,0,25,17.0,1.0,16.0,57.0,17.0,0.0,0.0,47,47,0,15.0,15.0,0.0
9510220,69,10,59,229,30,39,85,32,30.0,4.0,26.0,117.0,24.0,6.0,6.0,84,69,15,7.0,7.0,0.0
9307317,48,9,39,169,48,0,0,69,11.0,2.0,9.0,20.0,11.0,0.0,0.0,48,48,0,16.0,16.0,0.0
108171,2,2,0,0,0,2,29,73,2.0,2.0,0.0,0.0,0.0,2.0,17.0,22,2,20,8.0,1.0,7.0
9904438,4,2,2,3,0,4,26,99,3.0,1.0,2.0,3.0,0.0,3.0,18.0,27,4,23,11.0,3.0,8.0
9706408,17,4,13,35,0,17,72,42,13.0,3.0,10.0,25.0,0.0,13.0,53.0,30,17,13,13.0,7.0,6.0
9610247,18,9,9,18,3,15,101,15,7.0,2.0,5.0,9.0,0.0,7.0,47.0,39,18,21,2.0,2.0,0.0
9505322,23,12,11,26,13,10,16,114,8.0,4.0,4.0,10.0,8.0,0.0,0.0,25,23,2,7.0,7.0,0.0
9611437,31,15,16,53,1,30,161,5,14.0,11.0,3.0,4.0,0.0,14.0,85.0,47,31,16,16.0,12.0,4.0
9310210,56,10,46,325,56,0,0,71,34.0,4.0,30.0,261.0,34.0,0.0,0.0,56,56,0,28.0,28.0,0.0
9205201,12,7,5,9,12,0,0,190,4.0,3.0,1.0,1.0,4.0,0.0,0.0,12,12,0,5.0,5.0,0.0
9312201,37,12,25,150,33,4,5,4,21.0,3.0,18.0,98.0,21.0,0.0,0.0,40,37,3,19.0,19.0,0.0
9812263,16,6,10,18,0,16,103,4,3.0,3.0,0.0,0.0,0.0,3.0,10.0,55,16,39,9.0,2.0,7.0
9810269,41,5,36,207,1,40,318,70,39.0,5.0,34.0,204.0,0.0,39.0,317.0,50,41,9,43.0,34.0,9.0
9309289,294,15,279,3322,289,5,5,11,163.0,3.0,160.0,2598.0,163.0,0.0,0.0,295,294,1,89.0,89.0,0.0
9808292,41,10,31,181,3,38,397,12,33.0,7.0,26.0,168.0,0.0,33.0,364.0,71,41,30,44.0,26.0,18.0
9803333,51,6,45,210,15,36,80,28,23.0,4.0,19.0,73.0,3.0,20.0,35.0,56,51,5,19.0,16.0,3.0
9405295,6,6,0,0,0,6,10,293,3.0,3.0,0.0,0.0,0.0,3.0,7.0,11,6,5,7.0,2.0,5.0
9206219,9,8,1,2,9,0,0,41,7.0,7.0,0.0,0.0,7.0,0.0,0.0,9,9,0,5.0,5.0,0.0
9902323,83,3,80,672,6,77,247,2,57.0,3.0,54.0,452.0,1.0,56.0,197.0,91,83,8,35.0,31.0,4.0
9807326,20,10,10,20,1,19,66,31,11.0,4.0,7.0,14.0,0.0,11.0,44.0,27,20,7,12.0,6.0,6.0
9807544,4,2,2,5,0,4,25,42,4.0,2.0,2.0,5.0,0.0,4.0,12.0,15,4,11,9.0,4.0,5.0
9305260,23,9,14,51,23,0,0,17,5.0,4.0,1.0,2.0,5.0,0.0,0.0,23,23,0,7.0,7.0,0.0
9604202,45,9,36,96,3,42,194,6,15.0,4.0,11.0,26.0,0.0,15.0,121.0,67,45,22,20.0,7.0,13.0
8262,23,3,20,64,6,17,34,23,17.0,2.0,15.0,54.0,4.0,13.0,18.0,29,23,6,13.0,10.0,3.0
9711327,28,10,18,32,4,24,128,25,10.0,3.0,7.0,8.0,0.0,10.0,61.0,49,28,21,17.0,5.0,12.0
9308208,38,11,27,117,28,10,10,60,18.0,3.0,15.0,69.0,10.0,8.0,8.0,39,38,1,13.0,12.0,1.0
9506217,46,9,37,128,3,43,186,61,21.0,5.0,16.0,55.0,0.0,21.0,88.0,68,46,22,18.0,12.0,6.0
12333,38,8,30,107,0,38,353,3,17.0,1.0,16.0,40.0,0.0,17.0,145.0,95,38,57,26.0,15.0,11.0
9711208,8,7,1,1,1,7,12,46,3.0,2.0,1.0,1.0,1.0,2.0,5.0,20,8,12,3.0,0.0,3.0
7227,29,7,22,49,4,25,140,0,14.0,3.0,11.0,20.0,1.0,13.0,57.0,68,29,39,11.0,4.0,7.0
9603431,53,8,45,176,24,29,32,55,20.0,2.0,18.0,84.0,9.0,11.0,13.0,59,53,6,14.0,13.0,1.0
6251,22,6,16,54,7,15,63,10,13.0,2.0,11.0,43.0,5.0,8.0,45.0,59,22,37,13.0,7.0,6.0
9705372,22,4,18,57,2,20,49,161,15.0,2.0,13.0,44.0,1.0,14.0,30.0,55,22,33,13.0,11.0,2.0
9501356,8,4,4,15,0,8,79,124,8.0,4.0,4.0,15.0,0.0,8.0,79.0,22,8,14,22.0,8.0,14.0
9911307,2,2,0,0,0,2,9,18,1.0,1.0,0.0,0.0,0.0,1.0,6.0,46,2,44,2.0,1.0,1.0
12377,11,3,8,17,0,11,58,18,8.0,3.0,5.0,8.0,0.0,8.0,50.0,25,11,14,14.0,4.0,10.0
104271,12,7,5,8,1,11,76,27,11.0,6.0,5.0,8.0,0.0,11.0,69.0,43,12,31,8.0,6.0,2.0
9811402,22,9,13,34,10,12,20,18,2.0,2.0,0.0,0.0,0.0,2.0,7.0,30,22,8,3.0,3.0,0.0
9801246,27,7,20,73,1,26,134,18,24.0,5.0,19.0,68.0,0.0,24.0,102.0,48,27,21,9.0,7.0,2.0
9401262,37,4,33,132,37,0,0,18,22.0,3.0,19.0,72.0,22.0,0.0,0.0,37,37,0,6.0,6.0,0.0
9902352,13,4,9,16,3,10,23,18,1.0,1.0,0.0,0.0,0.0,1.0,3.0,36,13,23,10.0,1.0,9.0
8336,16,7,9,18,1,15,60,18,14.0,5.0,9.0,18.0,0.0,14.0,53.0,31,16,15,8.0,4.0,4.0
9809438,51,13,38,91,6,45,90,7,18.0,6.0,12.0,23.0,3.0,15.0,42.0,55,51,4,17.0,13.0,4.0
9902310,68,5,63,400,3,65,529,2,36.0,3.0,33.0,260.0,0.0,36.0,441.0,90,68,22,35.0,20.0,15.0
102288,19,4,15,39,2,17,45,0,13.0,3.0,10.0,29.0,0.0,13.0,36.0,35,19,16,11.0,5.0,6.0
9911248,40,10,30,90,15,25,70,0,18.0,1.0,17.0,63.0,8.0,10.0,25.0,51,40,11,10.0,6.0,4.0
9901256,3,2,1,1,0,3,11,111,3.0,2.0,1.0,1.0,0.0,3.0,11.0,10,3,7,8.0,3.0,5.0
9505242,22,3,19,37,1,21,81,10,8.0,1.0,7.0,10.0,0.0,8.0,12.0,43,22,21,6.0,5.0,1.0
9507250,14,4,10,26,14,0,0,118,7.0,2.0,5.0,12.0,7.0,0.0,0.0,14,14,0,6.0,6.0,0.0
6247,2,2,0,0,2,0,0,259,0.0,0.0,0.0,0.0,0.0,0.0,0.0,5,2,3,1.0,0.0,1.0
9307368,9,1,8,20,9,0,0,19,1.0,1.0,0.0,0.0,1.0,0.0,0.0,9,9,0,3.0,3.0,0.0
9708392,12,8,4,5,3,9,21,19,0.0,0.0,0.0,0.0,0.0,0.0,0.0,21,12,9,2.0,1.0,1.0
9905354,11,7,4,5,10,1,1,333,1.0,1.0,0.0,0.0,0.0,1.0,1.0,15,11,4,1.0,1.0,0.0
9712283,16,11,5,11,15,1,1,61,6.0,2.0,4.0,9.0,6.0,0.0,0.0,18,16,2,4.0,4.0,0.0
9507382,17,4,13,53,1,16,69,94,12.0,2.0,10.0,33.0,2.0,10.0,43.0,27,17,10,14.0,8.0,6.0
9802408,9,4,5,9,0,9,27,114,7.0,3.0,4.0,6.0,0.0,7.0,15.0,18,9,9,10.0,5.0,5.0
9211254,27,5,22,51,27,0,0,8,10.0,1.0,9.0,21.0,10.0,0.0,0.0,27,27,0,6.0,6.0,0.0
9602317,5,1,4,10,5,0,0,290,2.0,1.0,1.0,1.0,2.0,0.0,0.0,5,5,0,5.0,5.0,0.0
9404228,19,4,15,46,2,17,32,135,10.0,1.0,9.0,24.0,0.0,10.0,19.0,22,19,3,12.0,10.0,2.0
6122,11,5,6,11,3,8,71,2,5.0,2.0,3.0,4.0,0.0,5.0,23.0,24,11,13,15.0,5.0,10.0
9905388,12,6,6,8,1,11,50,0,2.0,1.0,1.0,1.0,0.0,2.0,7.0,41,12,29,6.0,3.0,3.0
9906238,19,12,7,11,0,19,77,2,7.0,2.0,5.0,7.0,1.0,6.0,6.0,29,19,10,7.0,6.0,1.0
102262,4,4,0,0,0,4,4,11,2.0,2.0,0.0,0.0,2.0,0.0,0.0,29,4,25,3.0,1.0,2.0
9509286,30,8,22,86,15,15,30,11,19.0,2.0,17.0,70.0,19.0,0.0,0.0,37,30,7,4.0,2.0,2.0
9809403,30,9,21,41,30,0,0,44,12.0,3.0,9.0,23.0,12.0,0.0,0.0,31,30,1,11.0,11.0,0.0
211412,3,3,0,0,1,2,20,19,3.0,3.0,0.0,0.0,1.0,2.0,19.0,44,3,41,30.0,1.0,29.0
109231,11,5,6,17,0,11,103,80,7.0,3.0,4.0,10.0,0.0,7.0,80.0,36,11,25,25.0,8.0,17.0
9305323,9,5,4,4,9,0,0,413,5.0,2.0,3.0,3.0,5.0,0.0,0.0,9,9,0,5.0,5.0,0.0
112191,6,6,0,0,3,3,21,39,2.0,2.0,0.0,0.0,0.0,2.0,7.0,43,6,37,13.0,0.0,13.0
9811245,9,5,4,5,3,6,13,102,2.0,1.0,1.0,1.0,0.0,2.0,4.0,15,9,6,3.0,0.0,3.0
112247,40,4,36,238,0,40,643,28,36.0,4.0,32.0,228.0,0.0,36.0,462.0,89,40,49,50.0,32.0,18.0
103104,13,8,5,8,2,11,73,2,5.0,2.0,3.0,4.0,1.0,4.0,8.0,36,13,23,8.0,4.0,4.0
3249,4,3,1,1,1,3,21,26,1.0,1.0,0.0,0.0,0.0,1.0,3.0,36,4,32,7.0,1.0,6.0
9502213,11,7,4,5,11,0,0,287,3.0,3.0,0.0,0.0,3.0,0.0,0.0,12,11,1,3.0,3.0,0.0
9305269,54,9,45,212,54,0,0,108,37.0,3.0,34.0,174.0,37.0,0.0,0.0,54,54,0,20.0,20.0,0.0
9603396,25,1,24,103,8,17,17,142,23.0,1.0,22.0,100.0,7.0,16.0,16.0,26,25,1,16.0,15.0,1.0
106165,2,2,0,0,0,2,26,2,2.0,2.0,0.0,0.0,0.0,2.0,17.0,25,2,23,3.0,1.0,2.0
9232,25,4,21,91,0,25,175,2,17.0,3.0,14.0,61.0,0.0,17.0,107.0,39,25,14,23.0,16.0,7.0
9911540,1,1,0,0,0,1,4,276,0.0,0.0,0.0,0.0,0.0,0.0,0.0,14,1,13,7.0,0.0,7.0
103031,11,2,9,16,0,11,135,32,10.0,2.0,8.0,15.0,0.0,10.0,122.0,37,11,26,21.0,7.0,14.0
5009,6,3,3,7,0,6,29,10,4.0,1.0,3.0,4.0,1.0,3.0,6.0,35,6,29,5.0,1.0,4.0
9506206,1,1,0,0,0,1,6,10,1.0,1.0,0.0,0.0,0.0,1.0,3.0,15,1,14,4.0,1.0,3.0
9909490,2,2,0,0,2,0,0,94,0.0,0.0,0.0,0.0,0.0,0.0,0.0,26,2,24,2.0,0.0,2.0
9411432,13,5,8,13,13,0,0,28,8.0,2.0,6.0,10.0,8.0,0.0,0.0,15,13,2,2.0,2.0,0.0
9310280,1,1,0,0,1,0,0,943,,,,,,,,1,1,0,,,
9405385,30,12,18,42,22,8,9,99,6.0,3.0,3.0,4.0,6.0,0.0,0.0,33,30,3,4.0,4.0,0.0
9310207,14,8,6,8,14,0,0,0,3.0,2.0,1.0,1.0,3.0,0.0,0.0,14,14,0,3.0,3.0,0.0
9909243,11,4,7,10,2,9,49,86,7.0,3.0,4.0,6.0,0.0,7.0,24.0,28,11,17,12.0,6.0,6.0
9308237,1,1,0,0,1,0,0,1422,,,,,,,,1,1,0,,,
9907432,43,10,33,79,6,37,305,12,18.0,4.0,14.0,38.0,0.0,18.0,186.0,73,43,30,18.0,12.0,6.0
2007,10,6,4,8,2,8,94,7,3.0,1.0,2.0,3.0,0.0,3.0,52.0,35,10,25,21.0,3.0,18.0
11400,3,3,0,0,2,1,1,196,1.0,1.0,0.0,0.0,1.0,0.0,0.0,6,3,3,1.0,1.0,0.0
9709215,44,14,30,94,11,33,122,67,15.0,7.0,8.0,28.0,1.0,14.0,58.0,57,44,13,13.0,9.0,4.0
112295,10,4,6,7,1,9,25,1,2.0,1.0,1.0,1.0,0.0,2.0,2.0,17,10,7,4.0,4.0,0.0
9304298,19,10,9,24,13,6,13,75,13.0,7.0,6.0,18.0,8.0,5.0,12.0,24,19,5,7.0,7.0,0.0
9204219,25,11,14,25,25,0,0,273,7.0,3.0,4.0,7.0,7.0,0.0,0.0,25,25,0,6.0,6.0,0.0
7031,40,2,38,203,0,40,246,9,33.0,2.0,31.0,173.0,0.0,33.0,212.0,65,40,25,20.0,18.0,2.0
9604209,6,1,5,11,0,6,39,11,6.0,1.0,5.0,11.0,0.0,6.0,37.0,22,6,16,9.0,6.0,3.0
9608433,28,10,18,41,0,28,243,17,23.0,6.0,17.0,40.0,0.0,23.0,209.0,44,28,16,29.0,16.0,13.0
9609415,8,3,5,7,3,5,18,17,0.0,0.0,0.0,0.0,0.0,0.0,0.0,25,8,17,3.0,1.0,2.0
9707484,10,5,5,10,0,10,59,26,6.0,3.0,3.0,7.0,0.0,6.0,29.0,28,10,18,10.0,4.0,6.0
9503337,8,3,5,10,7,1,2,229,3.0,2.0,1.0,1.0,3.0,0.0,0.0,10,8,2,2.0,2.0,0.0
101048,7,4,3,3,1,6,19,56,3.0,1.0,2.0,2.0,1.0,2.0,5.0,17,7,10,5.0,4.0,1.0
9706227,11,4,7,13,3,8,30,6,4.0,2.0,2.0,2.0,3.0,1.0,1.0,22,11,11,9.0,6.0,3.0
9403262,6,4,2,3,6,0,0,171,5.0,3.0,2.0,3.0,5.0,0.0,0.0,6,6,0,3.0,3.0,0.0
9401305,10,5,5,16,2,8,9,34,7.0,3.0,4.0,10.0,7.0,0.0,0.0,12,10,2,5.0,5.0,0.0
9505333,9,8,1,1,1,8,21,182,7.0,6.0,1.0,1.0,0.0,7.0,20.0,17,9,8,9.0,6.0,3.0
101311,11,5,6,10,1,10,14,93,5.0,3.0,2.0,3.0,1.0,4.0,4.0,14,11,3,8.0,7.0,1.0
9203219,21,15,6,10,21,0,0,44,6.0,5.0,1.0,1.0,6.0,0.0,0.0,21,21,0,5.0,5.0,0.0
9807377,32,7,25,76,2,30,197,1,3.0,2.0,1.0,1.0,0.0,3.0,32.0,78,32,46,7.0,5.0,2.0
9809377,9,7,2,2,0,9,61,7,3.0,3.0,0.0,0.0,0.0,3.0,29.0,42,9,33,22.0,1.0,21.0
9505330,7,3,4,4,7,0,0,89,1.0,1.0,0.0,0.0,1.0,0.0,0.0,9,7,2,2.0,1.0,1.0
9707239,10,1,9,21,0,10,134,5,10.0,1.0,9.0,21.0,0.0,10.0,134.0,39,10,29,27.0,9.0,18.0
9804288,54,21,33,74,33,21,33,101,15.0,2.0,13.0,29.0,8.0,7.0,7.0,57,54,3,12.0,11.0,1.0
9301229,41,8,33,174,41,0,0,113,27.0,4.0,23.0,125.0,27.0,0.0,0.0,41,41,0,23.0,23.0,0.0
9608461,1,1,0,0,0,1,1,1672,,,,,,,,3,1,2,,,
108084,16,6,10,20,1,15,202,24,12.0,4.0,8.0,17.0,0.0,12.0,168.0,53,16,37,28.0,9.0,19.0
9910209,64,8,56,255,5,59,449,24,39.0,4.0,35.0,192.0,0.0,39.0,335.0,87,64,23,43.0,26.0,17.0
9609202,26,7,19,52,5,21,48,25,9.0,1.0,8.0,19.0,1.0,8.0,12.0,34,26,8,9.0,8.0,1.0
9303247,11,7,4,7,11,0,0,172,3.0,2.0,1.0,2.0,3.0,0.0,0.0,11,11,0,2.0,2.0,0.0
9303237,14,7,7,12,14,0,0,16,7.0,2.0,5.0,7.0,7.0,0.0,0.0,14,14,0,3.0,3.0,0.0
9801369,38,6,32,123,2,36,317,9,27.0,4.0,23.0,99.0,0.0,27.0,252.0,61,38,23,35.0,15.0,20.0
9705475,8,2,6,10,5,3,5,286,0.0,0.0,0.0,0.0,0.0,0.0,0.0,16,8,8,6.0,4.0,2.0
9502323,39,14,25,49,2,37,136,14,14.0,6.0,8.0,11.0,0.0,14.0,51.0,49,39,10,17.0,11.0,6.0
9402308,5,3,2,5,0,5,12,147,3.0,1.0,2.0,2.0,0.0,3.0,3.0,9,5,4,2.0,2.0,0.0
9302232,68,7,61,387,68,0,0,68,38.0,2.0,36.0,266.0,38.0,0.0,0.0,68,68,0,28.0,28.0,0.0
9806356,44,5,39,132,6,38,106,27,22.0,2.0,20.0,73.0,0.0,22.0,65.0,68,44,24,9.0,9.0,0.0
9806345,20,10,10,16,8,12,45,14,9.0,4.0,5.0,9.0,1.0,8.0,32.0,29,20,9,3.0,3.0,0.0
9403390,73,13,60,348,36,37,59,13,36.0,4.0,32.0,204.0,22.0,14.0,17.0,79,73,6,19.0,18.0,1.0
9306268,16,8,8,16,16,0,0,10,4.0,2.0,2.0,3.0,4.0,0.0,0.0,16,16,0,5.0,5.0,0.0
5129,28,5,23,67,0,28,184,45,22.0,2.0,20.0,60.0,0.0,22.0,147.0,48,28,20,32.0,16.0,16.0
9234,4,1,3,4,0,4,6,11,3.0,1.0,2.0,2.0,3.0,0.0,0.0,13,4,9,2.0,1.0,1.0
9503266,36,14,22,71,23,13,22,16,15.0,3.0,12.0,49.0,15.0,0.0,0.0,39,36,3,10.0,10.0,0.0
9706289,0,0,0,0,0,0,0,202,,,,,,,,3,0,3,,,
9705205,4,3,1,1,1,3,4,505,2.0,1.0,1.0,1.0,2.0,0.0,0.0,9,4,5,2.0,2.0,0.0
9503381,17,5,12,25,14,3,3,11,4.0,2.0,2.0,3.0,4.0,0.0,0.0,19,17,2,2.0,2.0,0.0
9701201,3,3,0,0,2,1,1,138,1.0,1.0,0.0,0.0,1.0,0.0,0.0,6,3,3,1.0,1.0,0.0
9707488,34,10,24,70,11,23,99,16,5.0,3.0,2.0,3.0,0.0,5.0,28.0,55,34,21,14.0,1.0,13.0
9408368,6,2,4,5,1,5,7,329,1.0,1.0,0.0,0.0,0.0,1.0,1.0,8,6,2,4.0,3.0,1.0
9709345,5,2,3,4,0,5,20,44,2.0,1.0,1.0,1.0,0.0,2.0,14.0,13,5,8,3.0,0.0,3.0
9905367,9,6,3,3,1,8,16,97,2.0,2.0,0.0,0.0,0.0,2.0,4.0,13,9,4,3.0,1.0,2.0
9711277,18,6,12,23,5,13,34,115,11.0,2.0,9.0,16.0,1.0,10.0,28.0,24,18,6,11.0,7.0,4.0
9306307,2,1,1,1,2,0,0,1241,,,,,,,,2,2,0,,,
9412266,24,5,19,43,2,22,46,15,9.0,5.0,4.0,4.0,4.0,5.0,6.0,29,24,5,8.0,6.0,2.0
9706298,20,4,16,40,1,19,252,36,16.0,3.0,13.0,37.0,0.0,16.0,242.0,44,20,24,35.0,14.0,21.0
9705266,9,6,3,4,5,4,8,10,4.0,2.0,2.0,2.0,4.0,0.0,0.0,14,9,5,2.0,2.0,0.0
9512361,2,2,0,0,2,0,0,302,1.0,1.0,0.0,0.0,1.0,0.0,0.0,5,2,3,1.0,1.0,0.0
101093,9,6,3,6,1,8,41,0,7.0,4.0,3.0,6.0,0.0,7.0,27.0,33,9,24,9.0,1.0,8.0
9610542,6,3,3,6,3,3,3,366,2.0,1.0,1.0,1.0,2.0,0.0,0.0,8,6,2,2.0,2.0,0.0
9709466,2,2,0,0,0,2,2,255,0.0,0.0,0.0,0.0,0.0,0.0,0.0,7,2,5,2.0,0.0,2.0
9912227,16,9,7,9,7,9,36,25,1.0,1.0,0.0,0.0,0.0,1.0,7.0,43,16,27,6.0,5.0,1.0
9408210,9,2,7,12,9,0,0,228,8.0,1.0,7.0,12.0,8.0,0.0,0.0,9,9,0,6.0,6.0,0.0
9810437,17,2,15,58,0,17,26,201,11.0,1.0,10.0,45.0,0.0,11.0,15.0,20,17,3,12.0,11.0,1.0
9707379,16,9,7,11,8,8,17,204,1.0,1.0,0.0,0.0,0.0,1.0,3.0,30,16,14,4.0,4.0,0.0
9512434,14,6,8,30,0,14,136,71,12.0,4.0,8.0,30.0,0.0,12.0,121.0,32,14,18,26.0,12.0,14.0
1334,10,7,3,4,2,8,50,6,0.0,0.0,0.0,0.0,0.0,0.0,0.0,82,10,72,27.0,0.0,27.0
9707380,12,4,8,16,12,0,0,146,8.0,3.0,5.0,9.0,8.0,0.0,0.0,17,12,5,7.0,7.0,0.0
9311318,7,4,3,4,3,4,6,58,5.0,2.0,3.0,4.0,1.0,4.0,6.0,10,7,3,1.0,1.0,0.0
9912204,6,2,4,5,1,5,11,87,2.0,1.0,1.0,1.0,0.0,2.0,4.0,13,6,7,4.0,2.0,2.0
9310359,3,2,1,2,3,0,0,145,2.0,1.0,1.0,1.0,2.0,0.0,0.0,3,3,0,3.0,3.0,0.0
9409314,17,3,14,26,3,14,18,25,5.0,1.0,4.0,4.0,0.0,5.0,5.0,20,17,3,4.0,3.0,1.0
9910223,10,2,8,11,0,10,68,25,2.0,1.0,1.0,1.0,0.0,2.0,18.0,48,10,38,22.0,1.0,21.0
9807427,18,9,9,15,10,8,20,61,5.0,1.0,4.0,10.0,5.0,0.0,0.0,35,18,17,6.0,6.0,0.0
9212279,15,2,13,33,11,4,4,123,10.0,2.0,8.0,18.0,10.0,0.0,0.0,16,15,1,5.0,5.0,0.0
9912483,12,7,5,5,1,11,43,21,7.0,5.0,2.0,2.0,2.0,5.0,11.0,29,12,17,11.0,5.0,6.0
9209210,10,9,1,1,10,0,0,96,2.0,2.0,0.0,0.0,2.0,0.0,0.0,10,10,0,3.0,3.0,0.0
9804351,11,1,10,16,1,10,36,22,7.0,2.0,5.0,6.0,1.0,6.0,14.0,26,11,15,9.0,6.0,3.0
9303256,5,4,1,1,3,2,2,171,5.0,4.0,1.0,1.0,3.0,2.0,2.0,6,5,1,6.0,5.0,1.0
9709481,8,5,3,3,6,2,2,130,4.0,2.0,2.0,2.0,4.0,0.0,0.0,9,8,1,2.0,1.0,1.0
2058,2,1,1,1,0,2,7,30,1.0,1.0,0.0,0.0,0.0,1.0,2.0,10,2,8,3.0,1.0,2.0
9912406,3,3,0,0,0,3,6,4,1.0,1.0,0.0,0.0,0.0,1.0,3.0,30,3,27,7.0,1.0,6.0
9911489,10,1,9,27,0,10,76,30,8.0,1.0,7.0,18.0,0.0,8.0,39.0,25,10,15,12.0,6.0,6.0
9905227,22,1,21,96,0,22,286,2,19.0,1.0,18.0,90.0,0.0,19.0,264.0,42,22,20,33.0,17.0,16.0
9909562,14,7,7,12,0,14,86,32,4.0,4.0,0.0,0.0,0.0,4.0,22.0,38,14,24,16.0,5.0,11.0
107153,10,9,1,1,6,4,6,46,0.0,0.0,0.0,0.0,0.0,0.0,0.0,34,10,24,4.0,3.0,1.0
9903276,14,3,11,20,0,14,81,15,10.0,2.0,8.0,13.0,0.0,10.0,65.0,32,14,18,8.0,1.0,7.0
103157,14,7,7,12,0,14,114,13,10.0,4.0,6.0,10.0,0.0,10.0,81.0,52,14,38,20.0,4.0,16.0
9905472,25,12,13,20,0,25,150,25,6.0,4.0,2.0,3.0,0.0,6.0,45.0,72,25,47,13.0,1.0,12.0
9909282,1,1,0,0,1,0,0,21,0.0,0.0,0.0,0.0,0.0,0.0,0.0,12,1,11,1.0,0.0,1.0
9503217,13,7,6,10,1,12,20,112,5.0,2.0,3.0,4.0,0.0,5.0,7.0,18,13,5,7.0,6.0,1.0
9703397,7,4,3,3,3,4,4,145,4.0,2.0,2.0,2.0,0.0,4.0,4.0,8,7,1,5.0,4.0,1.0
207036,21,6,15,38,0,21,182,7,7.0,1.0,6.0,13.0,0.0,7.0,36.0,65,21,44,15.0,7.0,8.0
9609517,12,4,8,24,1,11,90,36,7.0,3.0,4.0,10.0,0.0,7.0,58.0,26,12,14,18.0,7.0,11.0
9705236,26,6,20,84,0,26,288,36,23.0,5.0,18.0,81.0,0.0,23.0,282.0,43,26,17,35.0,18.0,17.0
9311297,11,3,8,21,4,7,14,36,7.0,2.0,5.0,10.0,2.0,5.0,8.0,15,11,4,2.0,2.0,0.0
9407257,1,1,0,0,1,0,0,208,0.0,0.0,0.0,0.0,0.0,0.0,0.0,13,1,12,5.0,0.0,5.0
9601323,1,1,0,0,1,0,0,546,0.0,0.0,0.0,0.0,0.0,0.0,0.0,5,1,4,1.0,0.0,1.0
108232,2,1,1,1,0,2,5,67,0.0,0.0,0.0,0.0,0.0,0.0,0.0,29,2,27,3.0,0.0,3.0
9702341,6,2,4,4,0,6,53,6,4.0,2.0,2.0,2.0,0.0,4.0,39.0,26,6,20,3.0,2.0,1.0
10136,6,6,0,0,2,4,6,0,1.0,1.0,0.0,0.0,1.0,0.0,0.0,12,6,6,,,
9603351,11,8,3,5,0,11,21,30,3.0,2.0,1.0,1.0,1.0,2.0,3.0,17,11,6,4.0,4.0,0.0
109137,7,6,1,1,0,7,59,21,4.0,3.0,1.0,1.0,0.0,4.0,39.0,41,7,34,12.0,0.0,12.0
9708205,7,2,5,13,1,6,13,206,6.0,1.0,5.0,13.0,1.0,5.0,11.0,14,7,7,9.0,6.0,3.0
9412287,2,2,0,0,1,1,2,14,1.0,1.0,0.0,0.0,1.0,0.0,0.0,8,2,6,1.0,1.0,0.0
9710563,5,5,0,0,2,3,6,137,2.0,2.0,0.0,0.0,1.0,1.0,2.0,10,5,5,3.0,1.0,2.0
9707316,43,3,40,148,0,43,220,1,27.0,4.0,23.0,90.0,0.0,27.0,119.0,68,43,25,21.0,15.0,6.0
9611255,4,1,3,5,0,4,75,1,4.0,1.0,3.0,5.0,0.0,4.0,75.0,42,4,38,28.0,2.0,26.0
9705311,34,14,20,54,6,28,54,47,13.0,6.0,7.0,18.0,1.0,12.0,19.0,41,34,7,14.0,12.0,2.0
9212276,1,1,0,0,1,0,0,154,,,,,,,,1,1,0,,,
9309333,18,7,11,20,14,4,4,172,6.0,2.0,4.0,8.0,3.0,3.0,3.0,20,18,2,5.0,5.0,0.0
9709240,8,3,5,8,1,7,37,150,0.0,0.0,0.0,0.0,0.0,0.0,0.0,22,8,14,1.0,0.0,1.0
9802291,21,9,12,30,3,18,50,74,10.0,3.0,7.0,21.0,0.0,10.0,33.0,34,21,13,17.0,9.0,8.0
9304258,11,6,5,9,7,4,4,67,2.0,2.0,0.0,0.0,1.0,1.0,1.0,12,11,1,2.0,1.0,1.0
206171,7,6,1,1,7,0,0,257,1.0,1.0,0.0,0.0,1.0,0.0,0.0,12,7,5,2.0,2.0,0.0
9605243,4,3,1,1,4,0,0,759,2.0,1.0,1.0,1.0,2.0,0.0,0.0,5,4,1,2.0,2.0,0.0
9909307,7,3,4,8,0,7,62,85,4.0,2.0,2.0,3.0,0.0,4.0,38.0,25,7,18,11.0,3.0,8.0
9406254,8,4,4,4,0,8,24,75,1.0,1.0,0.0,0.0,0.0,1.0,1.0,23,8,15,4.0,1.0,3.0
9708439,13,1,12,66,0,13,96,43,13.0,1.0,12.0,66.0,0.0,13.0,96.0,27,13,14,26.0,13.0,13.0
9806461,8,4,4,13,0,8,41,42,4.0,2.0,2.0,3.0,0.0,4.0,22.0,25,8,17,18.0,4.0,14.0
204146,7,3,4,5,0,7,43,22,7.0,3.0,4.0,5.0,0.0,7.0,43.0,22,7,15,11.0,5.0,6.0
9608424,7,6,1,1,4,3,3,172,2.0,2.0,0.0,0.0,2.0,0.0,0.0,8,7,1,2.0,2.0,0.0
9608309,3,2,1,1,2,1,2,319,3.0,2.0,1.0,1.0,2.0,1.0,2.0,7,3,4,5.0,3.0,2.0
8016,13,6,7,15,1,12,75,0,10.0,4.0,6.0,13.0,0.0,10.0,61.0,26,13,13,18.0,6.0,12.0
9409451,15,2,13,25,15,0,0,200,13.0,1.0,12.0,24.0,13.0,0.0,0.0,15,15,0,11.0,11.0,0.0
9712478,13,6,7,16,1,12,89,1,8.0,2.0,6.0,13.0,0.0,8.0,67.0,29,13,16,20.0,8.0,12.0
9802415,11,7,4,12,3,8,61,42,7.0,3.0,4.0,12.0,0.0,7.0,35.0,30,11,19,13.0,7.0,6.0
9408321,8,4,4,6,2,6,6,46,1.0,1.0,0.0,0.0,1.0,0.0,0.0,9,8,1,1.0,1.0,0.0
9903486,2,2,0,0,1,1,22,22,1.0,1.0,0.0,0.0,0.0,1.0,18.0,32,2,30,19.0,1.0,18.0
207015,2,1,1,1,0,2,11,0,1.0,1.0,0.0,0.0,0.0,1.0,3.0,31,2,29,5.0,2.0,3.0
203258,27,15,12,14,0,27,80,11,11.0,7.0,4.0,5.0,0.0,11.0,24.0,39,27,12,3.0,2.0,1.0
9705451,25,14,11,19,15,10,21,242,8.0,4.0,4.0,8.0,2.0,6.0,12.0,33,25,8,4.0,0.0,4.0
9910307,2,2,0,0,0,2,5,226,1.0,1.0,0.0,0.0,1.0,0.0,0.0,8,2,6,1.0,1.0,0.0
9807440,6,2,4,7,0,6,17,25,2.0,1.0,1.0,1.0,0.0,2.0,3.0,15,6,9,4.0,2.0,2.0
9292,18,2,16,51,3,15,87,23,11.0,1.0,10.0,34.0,5.0,6.0,28.0,43,18,25,6.0,2.0,4.0
107241,3,2,1,1,0,3,12,122,2.0,2.0,0.0,0.0,0.0,2.0,8.0,8,3,5,8.0,3.0,5.0
105262,8,4,4,5,2,6,16,69,0.0,0.0,0.0,0.0,0.0,0.0,0.0,38,8,30,8.0,0.0,8.0
108079,3,3,0,0,0,3,12,23,1.0,1.0,0.0,0.0,0.0,1.0,1.0,11,3,8,2.0,0.0,2.0
9701409,5,4,1,1,2,3,6,30,0.0,0.0,0.0,0.0,0.0,0.0,0.0,40,5,35,2.0,0.0,2.0
9908334,15,2,13,31,0,15,59,9,8.0,1.0,7.0,10.0,3.0,5.0,6.0,30,15,15,14.0,10.0,4.0
9706548,7,5,2,2,4,3,10,74,1.0,1.0,0.0,0.0,0.0,1.0,6.0,27,7,20,10.0,1.0,9.0
9709355,6,3,3,6,3,3,14,43,1.0,1.0,0.0,0.0,0.0,1.0,4.0,22,6,16,2.0,1.0,1.0
9702261,2,2,0,0,0,2,4,26,1.0,1.0,0.0,0.0,0.0,1.0,3.0,11,2,9,2.0,0.0,2.0
9806313,3,2,1,1,2,1,1,141,1.0,1.0,0.0,0.0,1.0,0.0,0.0,8,3,5,1.0,1.0,0.0
9307367,1,1,0,0,1,0,0,75,0.0,0.0,0.0,0.0,0.0,0.0,0.0,8,1,7,,,
9709411,3,2,1,1,1,2,7,248,2.0,1.0,1.0,1.0,0.0,2.0,6.0,12,3,9,6.0,2.0,4.0
12381,8,3,5,5,0,8,57,70,7.0,2.0,5.0,5.0,0.0,7.0,56.0,17,8,9,14.0,6.0,8.0
202198,3,3,0,0,0,3,27,33,0.0,0.0,0.0,0.0,0.0,0.0,0.0,41,3,38,10.0,1.0,9.0
9901326,3,1,2,3,0,3,31,15,3.0,1.0,2.0,3.0,0.0,3.0,29.0,21,3,18,6.0,3.0,3.0
9805414,8,5,3,4,8,0,0,80,0.0,0.0,0.0,0.0,0.0,0.0,0.0,10,8,2,1.0,0.0,1.0
9408219,18,3,15,50,18,0,0,58,16.0,3.0,13.0,44.0,16.0,0.0,0.0,18,18,0,11.0,11.0,0.0
9605400,5,1,4,8,0,5,7,10,2.0,1.0,1.0,1.0,0.0,2.0,3.0,7,5,2,6.0,4.0,2.0
9511420,19,3,16,31,0,19,56,27,16.0,1.0,15.0,30.0,0.0,16.0,50.0,26,19,7,9.0,5.0,4.0
9912311,16,2,14,22,2,14,73,27,14.0,3.0,11.0,18.0,1.0,13.0,70.0,29,16,13,9.0,5.0,4.0
9308215,9,6,3,7,8,1,1,10,3.0,2.0,1.0,1.0,3.0,0.0,0.0,10,9,1,4.0,4.0,0.0
110146,6,4,2,2,3,3,10,23,0.0,0.0,0.0,0.0,0.0,0.0,0.0,24,6,18,5.0,0.0,5.0
9905329,18,6,12,21,4,14,111,54,7.0,7.0,0.0,0.0,0.0,7.0,78.0,46,18,28,21.0,7.0,14.0
204077,3,1,2,2,0,3,13,119,1.0,1.0,0.0,0.0,0.0,1.0,4.0,27,3,24,9.0,1.0,8.0
112338,20,8,12,23,4,16,65,0,8.0,2.0,6.0,10.0,1.0,7.0,45.0,76,20,56,24.0,4.0,20.0
9206244,16,5,11,21,16,0,0,56,10.0,3.0,7.0,14.0,10.0,0.0,0.0,16,16,0,2.0,2.0,0.0
104130,13,2,11,32,0,13,76,37,10.0,1.0,9.0,25.0,0.0,10.0,30.0,21,13,8,12.0,10.0,2.0
9404278,22,8,14,23,22,0,0,346,6.0,1.0,5.0,8.0,6.0,0.0,0.0,22,22,0,1.0,1.0,0.0
9702286,7,2,5,10,0,7,21,47,6.0,1.0,5.0,10.0,0.0,6.0,17.0,21,7,14,3.0,1.0,2.0
9607399,9,6,3,4,3,6,18,47,3.0,3.0,0.0,0.0,2.0,1.0,2.0,15,9,6,3.0,1.0,2.0
110272,6,3,3,7,0,6,65,0,2.0,1.0,1.0,1.0,0.0,2.0,19.0,36,6,30,3.0,1.0,2.0
202264,25,9,16,36,7,18,65,0,4.0,2.0,2.0,5.0,0.0,4.0,6.0,37,25,12,4.0,4.0,0.0
11353,7,7,0,0,0,7,16,0,0.0,0.0,0.0,0.0,0.0,0.0,0.0,33,7,26,2.0,0.0,2.0
9501280,8,3,5,8,1,7,11,228,8.0,3.0,5.0,8.0,1.0,7.0,11.0,10,8,2,7.0,5.0,2.0
9811264,9,4,5,7,1,8,13,24,2.0,2.0,0.0,0.0,2.0,0.0,0.0,15,9,6,1.0,1.0,0.0
107056,16,3,13,33,1,15,63,2,11.0,2.0,9.0,23.0,1.0,10.0,38.0,26,16,10,17.0,10.0,7.0
9707385,23,7,16,38,8,15,36,100,16.0,4.0,12.0,26.0,2.0,14.0,30.0,29,23,6,10.0,7.0,3.0
9501347,20,11,9,14,9,11,18,48,3.0,3.0,0.0,0.0,0.0,3.0,6.0,23,20,3,3.0,3.0,0.0
9710377,1,1,0,0,0,1,1,126,1.0,1.0,0.0,0.0,0.0,1.0,1.0,2,1,1,2.0,1.0,1.0
9908317,57,2,55,421,0,57,617,11,53.0,2.0,51.0,414.0,0.0,53.0,551.0,84,57,27,62.0,46.0,16.0
9808455,14,6,8,12,4,10,30,258,6.0,2.0,4.0,4.0,1.0,5.0,18.0,22,14,8,10.0,5.0,5.0
9805356,27,4,23,100,0,27,101,13,23.0,4.0,19.0,85.0,0.0,23.0,49.0,35,27,8,23.0,20.0,3.0
8035,1,1,0,0,0,1,11,2,1.0,1.0,0.0,0.0,0.0,1.0,6.0,12,1,11,7.0,1.0,6.0
8220,7,3,4,10,2,5,7,59,6.0,2.0,4.0,10.0,4.0,2.0,2.0,19,7,12,7.0,6.0,1.0
9611440,0,0,0,0,0,0,0,250,0.0,0.0,0.0,0.0,0.0,0.0,0.0,6,0,6,1.0,0.0,1.0
9903274,8,6,2,3,3,5,111,15,5.0,3.0,2.0,3.0,1.0,4.0,104.0,56,8,48,45.0,3.0,42.0
101088,5,4,1,2,0,5,34,39,2.0,1.0,1.0,1.0,0.0,2.0,15.0,50,5,45,16.0,1.0,15.0
9610236,4,3,1,1,2,2,6,62,2.0,1.0,1.0,1.0,0.0,2.0,6.0,10,4,6,7.0,2.0,5.0
9710229,4,4,0,0,2,2,8,41,2.0,2.0,0.0,0.0,1.0,1.0,3.0,14,4,10,6.0,1.0,5.0
9908289,7,0,7,17,0,7,60,102,7.0,0.0,7.0,17.0,0.0,7.0,56.0,19,7,12,16.0,7.0,9.0
9503235,11,6,5,5,9,2,2,111,5.0,5.0,0.0,0.0,5.0,0.0,0.0,13,11,2,4.0,4.0,0.0
109007,7,2,5,8,2,5,14,257,6.0,2.0,4.0,6.0,6.0,0.0,0.0,24,7,17,6.0,6.0,0.0
9803298,24,11,13,36,7,17,39,129,7.0,3.0,4.0,9.0,0.0,7.0,22.0,34,24,10,11.0,6.0,5.0
9712253,8,3,5,8,0,8,29,7,6.0,2.0,4.0,7.0,0.0,6.0,20.0,21,8,13,2.0,0.0,2.0
9609353,5,3,2,2,1,4,8,260,2.0,1.0,1.0,1.0,0.0,2.0,4.0,12,5,7,3.0,1.0,2.0
9910311,2,2,0,0,0,2,3,21,0.0,0.0,0.0,0.0,0.0,0.0,0.0,23,2,21,8.0,0.0,8.0
104245,12,2,10,25,0,12,156,109,12.0,2.0,10.0,25.0,0.0,12.0,156.0,31,12,19,28.0,11.0,17.0
12196,4,3,1,1,0,4,34,109,4.0,3.0,1.0,1.0,0.0,4.0,32.0,15,4,11,13.0,4.0,9.0
9308340,13,9,4,5,12,1,1,63,6.0,3.0,3.0,4.0,6.0,0.0,0.0,14,13,1,4.0,4.0,0.0
9802390,6,1,5,11,0,6,14,12,0.0,0.0,0.0,0.0,0.0,0.0,0.0,32,6,26,3.0,0.0,3.0
9904411,23,7,16,32,7,16,65,50,7.0,2.0,5.0,8.0,0.0,7.0,25.0,31,23,8,8.0,5.0,3.0
9505365,1,1,0,0,0,1,4,17,0.0,0.0,0.0,0.0,0.0,0.0,0.0,33,1,32,7.0,0.0,7.0
9811415,5,5,0,0,1,4,9,168,1.0,1.0,0.0,0.0,0.0,1.0,3.0,10,5,5,4.0,1.0,3.0
102231,3,3,0,0,3,0,0,210,0.0,0.0,0.0,0.0,0.0,0.0,0.0,5,3,2,2.0,0.0,2.0
9705395,11,2,9,24,0,11,48,36,11.0,2.0,9.0,24.0,0.0,11.0,44.0,19,11,8,15.0,11.0,4.0
8294,19,3,16,28,3,16,192,11,10.0,1.0,9.0,17.0,0.0,10.0,134.0,53,19,34,13.0,3.0,10.0
9803360,5,3,2,2,0,5,34,6,3.0,2.0,1.0,1.0,0.0,3.0,10.0,23,5,18,5.0,3.0,2.0
9809495,1,1,0,0,0,1,7,10,0.0,0.0,0.0,0.0,0.0,0.0,0.0,12,1,11,8.0,0.0,8.0
9805245,11,4,7,11,0,11,30,127,9.0,2.0,7.0,10.0,0.0,9.0,25.0,17,11,6,12.0,7.0,5.0
9501360,5,3,2,3,3,2,5,179,2.0,2.0,0.0,0.0,0.0,2.0,4.0,15,5,10,8.0,3.0,5.0
9908208,9,3,6,7,0,9,82,50,4.0,3.0,1.0,1.0,0.0,4.0,12.0,37,9,28,11.0,5.0,6.0
9811212,14,2,12,55,0,14,132,49,11.0,1.0,10.0,40.0,0.0,11.0,84.0,32,14,18,19.0,10.0,9.0
9908463,9,5,4,12,3,6,10,8,4.0,1.0,3.0,6.0,3.0,1.0,1.0,13,9,4,2.0,1.0,1.0
4012,1,1,0,0,0,1,10,9,1.0,1.0,0.0,0.0,0.0,1.0,10.0,19,1,18,2.0,0.0,2.0
10091,2,2,0,0,0,2,8,598,0.0,0.0,0.0,0.0,0.0,0.0,0.0,10,2,8,4.0,1.0,3.0
5317,2,2,0,0,0,2,6,17,1.0,1.0,0.0,0.0,0.0,1.0,1.0,13,2,11,2.0,0.0,2.0
9006,28,16,12,20,3,25,115,9,3.0,3.0,0.0,0.0,0.0,3.0,15.0,65,28,37,7.0,6.0,1.0
9902394,5,4,1,1,0,5,12,154,1.0,1.0,0.0,0.0,0.0,1.0,1.0,25,5,20,8.0,0.0,8.0
9126,1,1,0,0,1,0,0,213,0.0,0.0,0.0,0.0,0.0,0.0,0.0,3,1,2,1.0,0.0,1.0
9405271,22,3,19,61,0,22,103,53,19.0,3.0,16.0,55.0,0.0,19.0,95.0,29,22,7,18.0,12.0,6.0
9301249,2,1,1,1,2,0,0,554,1.0,1.0,0.0,0.0,1.0,0.0,0.0,2,2,0,2.0,2.0,0.0
9703383,5,2,3,5,4,1,1,186,0.0,0.0,0.0,0.0,0.0,0.0,0.0,12,5,7,3.0,0.0,3.0
106082,5,5,0,0,2,3,34,10,2.0,2.0,0.0,0.0,0.0,2.0,14.0,35,5,30,12.0,1.0,11.0
9711418,5,3,2,3,1,4,9,14,2.0,2.0,0.0,0.0,1.0,1.0,2.0,10,5,5,3.0,1.0,2.0
7125,2,2,0,0,0,2,3,9,1.0,1.0,0.0,0.0,1.0,0.0,0.0,9,2,7,,,
105027,3,2,1,1,1,2,16,119,0.0,0.0,0.0,0.0,0.0,0.0,0.0,28,3,25,6.0,0.0,6.0
9604321,9,3,6,10,3,6,13,41,9.0,3.0,6.0,10.0,3.0,6.0,7.0,17,9,8,11.0,9.0,2.0
9610258,2,2,0,0,1,1,1,141,2.0,2.0,0.0,0.0,1.0,1.0,1.0,3,2,1,2.0,1.0,1.0
9610410,5,5,0,0,4,1,2,92,1.0,1.0,0.0,0.0,0.0,1.0,1.0,13,5,8,1.0,0.0,1.0
9505355,11,5,6,9,10,1,1,151,5.0,4.0,1.0,1.0,5.0,0.0,0.0,18,11,7,4.0,3.0,1.0
9606263,27,7,20,44,3,24,169,40,20.0,4.0,16.0,36.0,0.0,20.0,154.0,46,27,19,26.0,15.0,11.0
9602259,25,10,15,21,18,7,8,113,6.0,1.0,5.0,6.0,6.0,0.0,0.0,29,25,4,3.0,3.0,0.0
9911473,4,1,3,5,0,4,6,46,0.0,0.0,0.0,0.0,0.0,0.0,0.0,8,4,4,3.0,2.0,1.0
7050,5,4,1,1,0,5,33,14,3.0,2.0,1.0,1.0,0.0,3.0,16.0,21,5,16,9.0,4.0,5.0
109221,5,3,2,2,0,5,38,27,4.0,2.0,2.0,2.0,0.0,4.0,31.0,19,5,14,10.0,3.0,7.0
9803286,13,3,10,17,0,13,25,106,7.0,1.0,6.0,11.0,5.0,2.0,2.0,21,13,8,4.0,2.0,2.0
9812354,13,4,9,25,3,10,24,83,8.0,2.0,6.0,18.0,2.0,6.0,8.0,22,13,9,8.0,8.0,0.0
3144,5,4,1,1,0,5,18,143,2.0,2.0,0.0,0.0,0.0,2.0,7.0,17,5,12,4.0,1.0,3.0
9709335,7,4,3,6,3,4,6,5,0.0,0.0,0.0,0.0,0.0,0.0,0.0,17,7,10,2.0,1.0,1.0
9203224,3,2,1,1,3,0,0,1754,,,,,,,,3,3,0,,,
9810282,10,2,8,28,0,10,79,56,4.0,1.0,3.0,5.0,0.0,4.0,28.0,55,10,45,21.0,2.0,19.0
9805397,8,6,2,3,0,8,20,60,4.0,2.0,2.0,3.0,1.0,3.0,8.0,20,8,12,6.0,3.0,3.0
9805440,3,3,0,0,0,3,15,13,3.0,3.0,0.0,0.0,0.0,3.0,15.0,16,3,13,13.0,3.0,10.0
209216,10,1,9,14,0,10,87,193,6.0,1.0,5.0,9.0,0.0,6.0,23.0,36,10,26,10.0,5.0,5.0
9802319,4,3,1,1,1,3,6,246,2.0,1.0,1.0,1.0,0.0,2.0,4.0,6,4,2,4.0,2.0,2.0
108034,4,2,2,3,0,4,18,22,2.0,1.0,1.0,1.0,0.0,2.0,8.0,27,4,23,3.0,3.0,0.0
11211,5,3,2,3,1,4,17,20,3.0,1.0,2.0,2.0,0.0,3.0,9.0,31,5,26,3.0,1.0,2.0
105295,9,2,7,15,0,9,142,15,8.0,2.0,6.0,13.0,0.0,8.0,125.0,53,9,44,18.0,2.0,16.0
9305278,19,9,10,24,19,0,0,96,14.0,7.0,7.0,20.0,14.0,0.0,0.0,19,19,0,10.0,10.0,0.0
9606308,3,2,1,1,0,3,3,284,3.0,2.0,1.0,1.0,0.0,3.0,3.0,4,3,1,4.0,3.0,1.0
208038,17,10,7,10,0,17,107,27,15.0,9.0,6.0,9.0,0.0,15.0,92.0,39,17,22,18.0,10.0,8.0
9910343,1,1,0,0,0,1,4,150,,,,,,,,5,1,4,1.0,0.0,1.0
9711316,14,8,6,6,6,8,15,242,5.0,4.0,1.0,1.0,2.0,3.0,8.0,23,14,9,6.0,4.0,2.0
9405376,4,4,0,0,3,1,1,247,2.0,2.0,0.0,0.0,2.0,0.0,0.0,20,4,16,1.0,0.0,1.0
9904333,4,4,0,0,1,3,7,131,1.0,1.0,0.0,0.0,0.0,1.0,3.0,11,4,7,2.0,1.0,1.0
102130,5,4,1,1,0,5,31,17,2.0,2.0,0.0,0.0,0.0,2.0,16.0,21,5,16,5.0,0.0,5.0
12143,28,4,24,74,3,25,68,16,18.0,1.0,17.0,56.0,4.0,14.0,25.0,45,28,17,18.0,13.0,5.0
9406342,4,1,3,3,4,0,0,380,4.0,1.0,3.0,3.0,4.0,0.0,0.0,4,4,0,4.0,4.0,0.0
9905267,2,2,0,0,1,1,13,1,0.0,0.0,0.0,0.0,0.0,0.0,0.0,21,2,19,4.0,0.0,4.0
9910530,2,2,0,0,0,2,16,1,1.0,1.0,0.0,0.0,0.0,1.0,9.0,39,2,37,24.0,1.0,23.0
9408364,17,5,12,23,5,12,24,53,9.0,2.0,7.0,12.0,8.0,1.0,1.0,23,17,6,7.0,7.0,0.0
201290,4,3,1,1,1,3,5,0,0.0,0.0,0.0,0.0,0.0,0.0,0.0,25,4,21,1.0,0.0,1.0
110002,28,6,22,66,5,23,33,219,19.0,1.0,18.0,49.0,2.0,17.0,19.0,34,28,6,15.0,14.0,1.0
103272,11,7,4,5,6,5,5,206,4.0,2.0,2.0,3.0,1.0,3.0,3.0,16,11,5,1.0,1.0,0.0
9206,13,5,8,16,3,10,55,13,7.0,2.0,5.0,7.0,0.0,7.0,40.0,30,13,17,13.0,5.0,8.0
9708279,4,1,3,5,4,0,0,242,3.0,1.0,2.0,3.0,3.0,0.0,0.0,10,4,6,3.0,3.0,0.0
9906203,3,2,1,1,2,1,1,258,2.0,1.0,1.0,1.0,1.0,1.0,1.0,4,3,1,2.0,2.0,0.0
11006,4,4,0,0,0,4,26,81,2.0,2.0,0.0,0.0,0.0,2.0,22.0,21,4,17,11.0,2.0,9.0
101244,12,9,3,5,11,1,2,0,1.0,1.0,0.0,0.0,1.0,0.0,0.0,29,12,17,2.0,2.0,0.0
9808343,1,1,0,0,1,0,0,1342,,,,,,,,1,1,0,,,
9607345,2,1,1,1,1,1,2,92,0.0,0.0,0.0,0.0,0.0,0.0,0.0,6,2,4,,,
7305,8,2,6,10,0,8,25,130,4.0,1.0,3.0,4.0,0.0,4.0,15.0,20,8,12,7.0,2.0,5.0
9806496,10,3,7,20,2,8,28,255,9.0,3.0,6.0,18.0,1.0,8.0,28.0,17,10,7,11.0,9.0,2.0
9310372,3,2,1,1,3,0,0,245,1.0,1.0,0.0,0.0,1.0,0.0,0.0,5,3,2,1.0,1.0,0.0
9505421,5,3,2,2,5,0,0,194,5.0,3.0,2.0,2.0,5.0,0.0,0.0,5,5,0,5.0,5.0,0.0
9808341,5,5,0,0,0,5,45,5,2.0,2.0,0.0,0.0,0.0,2.0,25.0,27,5,22,4.0,1.0,3.0
209346,0,0,0,0,0,0,0,7,0.0,0.0,0.0,0.0,0.0,0.0,0.0,9,0,9,5.0,0.0,5.0
9706491,5,2,3,4,0,5,16,183,3.0,1.0,2.0,3.0,0.0,3.0,12.0,17,5,12,9.0,3.0,6.0
9910462,8,3,5,10,8,0,0,261,8.0,3.0,5.0,10.0,8.0,0.0,0.0,13,8,5,7.0,7.0,0.0
9309213,11,4,7,8,11,0,0,51,1.0,1.0,0.0,0.0,1.0,0.0,0.0,11,11,0,1.0,1.0,0.0
209255,3,2,1,1,0,3,13,67,0.0,0.0,0.0,0.0,0.0,0.0,0.0,18,3,15,2.0,1.0,1.0
9609403,4,3,1,1,0,4,20,14,2.0,2.0,0.0,0.0,0.0,2.0,12.0,13,4,9,3.0,2.0,1.0
9807476,4,4,0,0,4,0,0,221,2.0,2.0,0.0,0.0,2.0,0.0,0.0,4,4,0,1.0,1.0,0.0
9303290,3,2,1,1,3,0,0,48,,,,,,,,3,3,0,,,
9903388,21,6,15,26,0,21,35,72,11.0,2.0,9.0,12.0,0.0,11.0,18.0,31,21,10,10.0,8.0,2.0
9609289,7,2,5,8,1,6,10,72,6.0,2.0,4.0,6.0,1.0,5.0,9.0,11,7,4,8.0,6.0,2.0
9183,4,3,1,1,1,3,8,18,1.0,1.0,0.0,0.0,0.0,1.0,3.0,18,4,14,3.0,1.0,2.0
9406232,2,2,0,0,2,0,0,1749,,,,,,,,2,2,0,,,
203099,8,1,7,18,0,8,127,0,8.0,1.0,7.0,18.0,0.0,8.0,123.0,43,8,35,33.0,6.0,27.0
205207,1,1,0,0,0,1,1,283,0.0,0.0,0.0,0.0,0.0,0.0,0.0,10,1,9,4.0,0.0,4.0
9301223,1,1,0,0,1,0,0,1091,,,,,,,,3,1,2,,,
1075,16,2,14,31,0,16,30,65,12.0,3.0,9.0,22.0,0.0,12.0,17.0,31,16,15,13.0,10.0,3.0
9605272,2,2,0,0,0,2,7,26,1.0,1.0,0.0,0.0,0.0,1.0,6.0,14,2,12,2.0,0.0,2.0
1112,9,4,5,11,0,9,13,51,6.0,1.0,5.0,11.0,0.0,6.0,6.0,14,9,5,7.0,6.0,1.0
111373,2,2,0,0,0,2,18,3,0.0,0.0,0.0,0.0,0.0,0.0,0.0,27,2,25,10.0,0.0,10.0
8080,5,4,1,1,2,3,14,63,2.0,2.0,0.0,0.0,0.0,2.0,11.0,14,5,9,10.0,2.0,8.0
7135,1,1,0,0,0,1,4,3,1.0,1.0,0.0,0.0,0.0,1.0,3.0,11,1,10,1.0,0.0,1.0
106326,10,3,7,17,0,10,20,81,3.0,2.0,1.0,1.0,1.0,2.0,2.0,19,10,9,6.0,4.0,2.0
9903450,13,8,5,10,1,12,22,129,5.0,3.0,2.0,3.0,5.0,0.0,0.0,27,13,14,5.0,4.0,1.0
9608476,2,2,0,0,1,1,1,82,1.0,1.0,0.0,0.0,1.0,0.0,0.0,3,2,1,1.0,1.0,0.0
107163,7,1,6,10,0,7,61,1,6.0,1.0,5.0,9.0,0.0,6.0,52.0,23,7,16,16.0,5.0,11.0
12324,3,3,0,0,0,3,6,31,1.0,1.0,0.0,0.0,0.0,1.0,2.0,8,3,5,2.0,1.0,1.0
207324,1,1,0,0,0,1,23,1,1.0,1.0,0.0,0.0,0.0,1.0,17.0,38,1,37,24.0,0.0,24.0
207245,1,1,0,0,1,0,0,17,0.0,0.0,0.0,0.0,0.0,0.0,0.0,14,1,13,6.0,0.0,6.0
108188,7,4,3,4,0,7,33,59,6.0,3.0,3.0,4.0,0.0,6.0,31.0,19,7,12,14.0,4.0,10.0
3115,8,6,2,3,0,8,55,25,2.0,2.0,0.0,0.0,0.0,2.0,10.0,39,8,31,8.0,2.0,6.0
104190,1,1,0,0,0,1,3,0,1.0,1.0,0.0,0.0,0.0,1.0,1.0,18,1,17,2.0,0.0,2.0
9812435,3,1,2,3,3,0,0,30,3.0,1.0,2.0,3.0,3.0,0.0,0.0,9,3,6,3.0,3.0,0.0
106266,2,1,1,1,0,2,2,259,2.0,1.0,1.0,1.0,0.0,2.0,2.0,6,2,4,3.0,2.0,1.0
9706357,3,2,1,1,0,3,18,36,3.0,2.0,1.0,1.0,0.0,3.0,18.0,10,3,7,1.0,1.0,0.0
9511384,4,3,1,1,2,2,2,57,2.0,1.0,1.0,1.0,0.0,2.0,2.0,7,4,3,1.0,1.0,0.0
9404294,4,2,2,3,4,0,0,54,2.0,1.0,1.0,1.0,2.0,0.0,0.0,4,4,0,2.0,2.0,0.0
9909256,2,2,0,0,0,2,13,21,1.0,1.0,0.0,0.0,0.0,1.0,5.0,33,2,31,3.0,0.0,3.0
208080,27,12,15,57,5,22,112,1,10.0,1.0,9.0,36.0,3.0,7.0,7.0,76,27,49,13.0,10.0,3.0
110224,0,0,0,0,0,0,0,22,0.0,0.0,0.0,0.0,0.0,0.0,0.0,7,0,7,2.0,0.0,2.0
9408216,15,5,10,16,15,0,0,24,7.0,3.0,4.0,5.0,7.0,0.0,0.0,15,15,0,3.0,3.0,0.0
9712261,7,6,1,1,2,5,13,101,1.0,1.0,0.0,0.0,0.0,1.0,1.0,23,7,16,5.0,0.0,5.0
9903504,4,3,1,1,0,4,38,4,2.0,1.0,1.0,1.0,0.0,2.0,25.0,27,4,23,18.0,1.0,17.0
9412285,8,1,7,19,8,0,0,174,8.0,1.0,7.0,19.0,8.0,0.0,0.0,8,8,0,7.0,7.0,0.0
9612354,2,2,0,0,0,2,2,59,0.0,0.0,0.0,0.0,0.0,0.0,0.0,10,2,8,2.0,0.0,2.0
109096,4,1,3,4,0,4,24,5,2.0,1.0,1.0,1.0,0.0,2.0,13.0,20,4,16,4.0,3.0,1.0
10352,11,1,10,40,0,11,90,66,10.0,1.0,9.0,33.0,0.0,10.0,65.0,26,11,15,18.0,10.0,8.0
1211,5,4,1,1,0,5,69,20,4.0,3.0,1.0,1.0,0.0,4.0,67.0,50,5,45,41.0,2.0,39.0
3120,2,1,1,1,0,2,2,2,0.0,0.0,0.0,0.0,0.0,0.0,0.0,35,2,33,7.0,0.0,7.0
107218,5,2,3,5,0,5,44,12,5.0,2.0,3.0,5.0,0.0,5.0,31.0,45,5,40,3.0,0.0,3.0
211290,2,1,1,1,0,2,5,268,2.0,1.0,1.0,1.0,0.0,2.0,5.0,6,2,4,4.0,2.0,2.0
3273,3,3,0,0,2,1,1,31,1.0,1.0,0.0,0.0,1.0,0.0,0.0,13,3,10,3.0,0.0,3.0
9602285,6,5,1,1,1,5,11,47,2.0,1.0,1.0,1.0,2.0,0.0,0.0,11,6,5,3.0,2.0,1.0
110284,5,2,3,4,0,5,39,1,2.0,1.0,1.0,1.0,0.0,2.0,13.0,30,5,25,7.0,2.0,5.0
104054,2,2,0,0,0,2,7,119,0.0,0.0,0.0,0.0,0.0,0.0,0.0,26,2,24,14.0,0.0,14.0
9502395,14,7,7,10,1,13,37,3,5.0,1.0,4.0,6.0,0.0,5.0,8.0,25,14,11,4.0,3.0,1.0
103018,4,2,2,2,0,4,24,4,0.0,0.0,0.0,0.0,0.0,0.0,0.0,24,4,20,2.0,0.0,2.0
9602304,4,2,2,3,1,3,18,94,3.0,1.0,2.0,3.0,0.0,3.0,17.0,16,4,12,11.0,3.0,8.0
9910306,1,1,0,0,0,1,1,260,0.0,0.0,0.0,0.0,0.0,0.0,0.0,7,1,6,1.0,0.0,1.0
9812505,3,1,2,2,0,3,10,17,0.0,0.0,0.0,0.0,0.0,0.0,0.0,11,3,8,1.0,0.0,1.0
9712421,2,2,0,0,2,0,0,212,2.0,2.0,0.0,0.0,2.0,0.0,0.0,6,2,4,2.0,1.0,1.0
210205,9,7,2,2,0,9,150,18,5.0,4.0,1.0,1.0,0.0,5.0,86.0,64,9,55,29.0,5.0,24.0
9903234,16,5,11,19,4,12,24,31,9.0,3.0,6.0,9.0,1.0,8.0,16.0,29,16,13,6.0,5.0,1.0
9909366,6,2,4,7,1,5,23,34,5.0,1.0,4.0,7.0,0.0,5.0,19.0,12,6,6,9.0,5.0,4.0
2144,4,3,1,1,1,3,9,68,2.0,1.0,1.0,1.0,0.0,2.0,8.0,12,4,8,,,
109186,12,8,4,4,0,12,65,27,8.0,4.0,4.0,4.0,0.0,8.0,42.0,41,12,29,12.0,6.0,6.0
9811214,4,1,3,5,3,1,1,118,4.0,1.0,3.0,5.0,3.0,1.0,1.0,7,4,3,3.0,3.0,0.0
101138,4,3,1,1,1,3,4,376,0.0,0.0,0.0,0.0,0.0,0.0,0.0,11,4,7,3.0,0.0,3.0
9711323,5,3,2,4,0,5,5,57,2.0,1.0,1.0,1.0,2.0,0.0,0.0,6,5,1,2.0,1.0,1.0
9405244,3,3,0,0,0,3,11,40,3.0,3.0,0.0,0.0,0.0,3.0,11.0,7,3,4,1.0,1.0,0.0
106217,2,1,1,1,2,0,0,1621,,,,,,,,2,2,0,,,
9505279,17,8,9,25,14,3,4,39,12.0,3.0,9.0,25.0,12.0,0.0,0.0,20,17,3,7.0,7.0,0.0
9705316,1,1,0,0,0,1,4,167,0.0,0.0,0.0,0.0,0.0,0.0,0.0,8,1,7,6.0,0.0,6.0
9902431,11,8,3,5,6,5,9,233,5.0,4.0,1.0,3.0,5.0,0.0,0.0,16,11,5,4.0,4.0,0.0
102106,3,2,1,1,0,3,13,28,2.0,2.0,0.0,0.0,0.0,2.0,8.0,18,3,15,2.0,1.0,1.0
9702330,2,2,0,0,2,0,0,364,1.0,1.0,0.0,0.0,1.0,0.0,0.0,6,2,4,,,
9805279,3,1,2,3,0,3,21,43,3.0,1.0,2.0,3.0,0.0,3.0,21.0,11,3,8,10.0,3.0,7.0
9902346,5,3,2,4,0,5,8,307,5.0,3.0,2.0,4.0,0.0,5.0,8.0,7,5,2,6.0,4.0,2.0
9704407,2,2,0,0,1,1,1,152,1.0,1.0,0.0,0.0,1.0,0.0,0.0,3,2,1,1.0,1.0,0.0
106331,2,2,0,0,0,2,11,2,2.0,2.0,0.0,0.0,0.0,2.0,7.0,26,2,24,7.0,0.0,7.0
9909394,2,2,0,0,0,2,2,57,0.0,0.0,0.0,0.0,0.0,0.0,0.0,17,2,15,1.0,1.0,0.0
9303228,1,1,0,0,1,0,0,1037,,,,,,,,1,1,0,,,
212396,0,0,0,0,0,0,0,1182,0.0,0.0,0.0,0.0,0.0,0.0,0.0,5,0,5,1.0,0.0,1.0
9908233,1,1,0,0,1,0,0,327,1.0,1.0,0.0,0.0,1.0,0.0,0.0,2,1,1,1.0,1.0,0.0
9907552,4,1,3,3,0,4,31,137,4.0,1.0,3.0,3.0,0.0,4.0,30.0,25,4,21,14.0,1.0,13.0
9402258,4,1,3,3,1,3,8,35,2.0,1.0,1.0,1.0,0.0,2.0,5.0,10,4,6,5.0,2.0,3.0
107105,6,5,1,2,0,6,18,20,3.0,2.0,1.0,1.0,0.0,3.0,9.0,19,6,13,7.0,3.0,4.0
9209246,4,1,3,5,3,1,1,123,4.0,1.0,3.0,5.0,4.0,0.0,0.0,5,4,1,4.0,4.0,0.0
9811442,5,2,3,4,0,5,68,10,4.0,2.0,2.0,2.0,0.0,4.0,28.0,32,5,27,14.0,4.0,10.0
9511286,2,2,0,0,1,1,1,314,2.0,2.0,0.0,0.0,2.0,0.0,0.0,4,2,2,1.0,1.0,0.0
109275,4,3,1,1,0,4,10,0,,,,,,,,8,4,4,4.0,1.0,3.0
206241,11,6,5,7,0,11,171,11,8.0,6.0,2.0,3.0,0.0,8.0,140.0,53,11,42,39.0,6.0,33.0
9907280,3,3,0,0,0,3,6,150,1.0,1.0,0.0,0.0,1.0,0.0,0.0,8,3,5,1.0,1.0,0.0
201214,2,2,0,0,0,2,3,101,0.0,0.0,0.0,0.0,0.0,0.0,0.0,11,2,9,2.0,1.0,1.0
9905243,2,2,0,0,1,1,2,149,1.0,1.0,0.0,0.0,0.0,1.0,2.0,4,2,2,3.0,1.0,2.0
9810470,4,3,1,1,2,2,4,240,2.0,1.0,1.0,1.0,0.0,2.0,2.0,6,4,2,1.0,1.0,0.0
9601347,7,2,5,8,7,0,0,94,4.0,1.0,3.0,6.0,4.0,0.0,0.0,7,7,0,2.0,2.0,0.0
209270,2,1,1,1,0,2,11,20,0.0,0.0,0.0,0.0,0.0,0.0,0.0,18,2,16,7.0,1.0,6.0
111021,0,0,0,0,0,0,0,9,0.0,0.0,0.0,0.0,0.0,0.0,0.0,6,0,6,6.0,0.0,6.0
104290,8,4,4,5,0,8,26,129,3.0,1.0,2.0,2.0,0.0,3.0,8.0,17,8,9,4.0,1.0,3.0
212020,5,4,1,2,0,5,81,4,5.0,4.0,1.0,2.0,0.0,5.0,81.0,44,5,39,34.0,2.0,32.0
206135,11,3,8,15,0,11,49,4,5.0,2.0,3.0,7.0,0.0,5.0,21.0,23,11,12,6.0,1.0,5.0
211108,2,2,0,0,0,2,19,95,1.0,1.0,0.0,0.0,0.0,1.0,6.0,35,2,33,11.0,1.0,10.0
103261,9,7,2,2,0,9,53,7,6.0,5.0,1.0,1.0,0.0,6.0,39.0,28,9,19,18.0,5.0,13.0
204100,6,5,1,1,1,5,72,55,4.0,3.0,1.0,1.0,0.0,4.0,51.0,82,6,76,25.0,3.0,22.0
9909357,6,4,2,3,4,2,2,152,3.0,1.0,2.0,3.0,3.0,0.0,0.0,19,6,13,2.0,0.0,2.0
9908407,4,1,3,4,0,4,11,17,0.0,0.0,0.0,0.0,0.0,0.0,0.0,20,4,16,6.0,0.0,6.0
10265,3,3,0,0,0,3,18,34,2.0,2.0,0.0,0.0,0.0,2.0,15.0,47,3,44,20.0,0.0,20.0
9810245,2,1,1,1,0,2,9,20,2.0,1.0,1.0,1.0,0.0,2.0,3.0,11,2,9,3.0,0.0,3.0
9505399,4,3,1,1,4,0,0,397,2.0,1.0,1.0,1.0,2.0,0.0,0.0,4,4,0,2.0,2.0,0.0
9358,6,1,5,10,0,6,53,45,6.0,1.0,5.0,10.0,0.0,6.0,30.0,57,6,51,13.0,6.0,7.0
9903383,7,2,5,9,1,6,12,105,4.0,1.0,3.0,5.0,0.0,4.0,7.0,11,7,4,6.0,4.0,2.0
203129,2,1,1,1,0,2,13,59,2.0,1.0,1.0,1.0,0.0,2.0,13.0,10,2,8,8.0,2.0,6.0
202178,8,2,6,11,2,6,57,37,6.0,1.0,5.0,8.0,0.0,6.0,55.0,28,8,20,18.0,6.0,12.0
205338,0,0,0,0,0,0,0,169,0.0,0.0,0.0,0.0,0.0,0.0,0.0,1,0,1,1.0,0.0,1.0
9906231,13,9,4,5,3,10,17,66,3.0,2.0,1.0,1.0,2.0,1.0,1.0,20,13,7,2.0,0.0,2.0
109058,13,4,9,12,0,13,103,7,7.0,2.0,5.0,5.0,0.0,7.0,83.0,42,13,29,21.0,7.0,14.0
203131,12,7,5,7,0,12,123,18,7.0,4.0,3.0,3.0,0.0,7.0,53.0,59,12,47,18.0,6.0,12.0
9708487,3,2,1,1,0,3,6,315,2.0,1.0,1.0,1.0,0.0,2.0,3.0,6,3,3,4.0,2.0,2.0
9911502,3,3,0,0,0,3,16,29,1.0,1.0,0.0,0.0,0.0,1.0,5.0,23,3,20,6.0,1.0,5.0
11345,2,2,0,0,0,2,2,58,1.0,1.0,0.0,0.0,1.0,0.0,0.0,8,2,6,1.0,1.0,0.0
9909220,2,2,0,0,1,1,1,160,1.0,1.0,0.0,0.0,0.0,1.0,1.0,3,2,1,2.0,1.0,1.0
9210249,6,3,3,4,6,0,0,341,5.0,3.0,2.0,3.0,5.0,0.0,0.0,6,6,0,5.0,5.0,0.0
207258,0,0,0,0,0,0,0,285,0.0,0.0,0.0,0.0,0.0,0.0,0.0,6,0,6,1.0,0.0,1.0
1242,1,1,0,0,0,1,1,88,0.0,0.0,0.0,0.0,0.0,0.0,0.0,6,1,5,,,
10261,11,6,5,6,0,11,102,27,10.0,5.0,5.0,6.0,0.0,10.0,88.0,37,11,26,17.0,5.0,12.0
9910524,3,2,1,1,1,2,15,13,2.0,1.0,1.0,1.0,0.0,2.0,11.0,15,3,12,10.0,1.0,9.0
206086,3,2,1,2,1,2,6,32,1.0,1.0,0.0,0.0,0.0,1.0,4.0,29,3,26,5.0,0.0,5.0
9512381,12,4,8,18,12,0,0,277,7.0,1.0,6.0,12.0,7.0,0.0,0.0,12,12,0,6.0,6.0,0.0
9804258,4,2,2,3,0,4,14,62,4.0,2.0,2.0,3.0,2.0,2.0,4.0,21,4,17,4.0,1.0,3.0
9305337,7,5,2,3,7,0,0,235,3.0,2.0,1.0,1.0,3.0,0.0,0.0,7,7,0,3.0,3.0,0.0
9409307,3,3,0,0,3,0,0,326,2.0,2.0,0.0,0.0,2.0,0.0,0.0,3,3,0,1.0,1.0,0.0
206090,1,1,0,0,0,1,1,220,1.0,1.0,0.0,0.0,0.0,1.0,1.0,4,1,3,4.0,1.0,3.0
212059,1,1,0,0,0,1,18,1,1.0,1.0,0.0,0.0,0.0,1.0,4.0,30,1,29,4.0,0.0,4.0
7013,1,1,0,0,0,1,7,130,0.0,0.0,0.0,0.0,0.0,0.0,0.0,21,1,20,7.0,0.0,7.0
4160,1,1,0,0,0,1,6,0,1.0,1.0,0.0,0.0,0.0,1.0,6.0,15,1,14,2.0,0.0,2.0
9906442,8,1,7,12,1,7,16,76,7.0,1.0,6.0,10.0,0.0,7.0,7.0,19,8,11,9.0,7.0,2.0
9803455,4,3,1,1,2,2,3,22,2.0,2.0,0.0,0.0,2.0,0.0,0.0,7,4,3,2.0,2.0,0.0
12262,2,2,0,0,0,2,14,135,1.0,1.0,0.0,0.0,0.0,1.0,7.0,14,2,12,4.0,2.0,2.0
9802297,1,1,0,0,1,0,0,387,1.0,1.0,0.0,0.0,1.0,0.0,0.0,3,1,2,3.0,1.0,2.0
103112,1,1,0,0,0,1,4,112,,,,,,,,6,1,5,,,
9708408,1,1,0,0,0,1,3,140,1.0,1.0,0.0,0.0,0.0,1.0,3.0,7,1,6,6.0,1.0,5.0
9711451,5,3,2,2,5,0,0,145,2.0,1.0,1.0,1.0,2.0,0.0,0.0,5,5,0,2.0,2.0,0.0
202223,4,1,3,5,0,4,15,165,4.0,1.0,3.0,5.0,0.0,4.0,15.0,13,4,9,13.0,4.0,9.0
9605461,0,0,0,0,0,0,0,104,0.0,0.0,0.0,0.0,0.0,0.0,0.0,1,0,1,1.0,0.0,1.0
11032,2,1,1,1,0,2,22,192,2.0,1.0,1.0,1.0,0.0,2.0,13.0,15,2,13,9.0,2.0,7.0
104276,1,1,0,0,0,1,12,12,1.0,1.0,0.0,0.0,0.0,1.0,6.0,14,1,13,11.0,1.0,10.0
7194,0,0,0,0,0,0,0,74,0.0,0.0,0.0,0.0,0.0,0.0,0.0,13,0,13,1.0,0.0,1.0
9807311,4,1,3,4,2,2,2,139,4.0,1.0,3.0,4.0,2.0,2.0,2.0,5,4,1,5.0,4.0,1.0
8057,6,2,4,4,0,6,58,16,6.0,2.0,4.0,4.0,0.0,6.0,58.0,20,6,14,16.0,5.0,11.0
205180,4,3,1,1,0,4,14,181,1.0,1.0,0.0,0.0,0.0,1.0,2.0,22,4,18,6.0,1.0,5.0
206233,1,1,0,0,0,1,1,54,0.0,0.0,0.0,0.0,0.0,0.0,0.0,9,1,8,4.0,0.0,4.0
9611215,7,1,6,11,1,6,19,8,4.0,1.0,3.0,4.0,4.0,0.0,0.0,16,7,9,7.0,7.0,0.0
9601297,10,3,7,15,6,4,6,141,8.0,2.0,6.0,13.0,4.0,4.0,6.0,14,10,4,6.0,5.0,1.0
9805206,8,5,3,4,3,5,20,258,6.0,3.0,3.0,4.0,1.0,5.0,14.0,27,8,19,8.0,4.0,4.0
9605252,8,2,6,7,1,7,14,160,4.0,2.0,2.0,3.0,0.0,4.0,6.0,12,8,4,4.0,3.0,1.0
9712534,9,2,7,21,0,9,34,8,6.0,3.0,3.0,9.0,0.0,6.0,20.0,16,9,7,10.0,7.0,3.0
9707439,3,1,2,2,1,2,17,5,2.0,1.0,1.0,1.0,0.0,2.0,17.0,15,3,12,7.0,1.0,6.0
9909219,1,1,0,0,1,0,0,920,,,,,,,,2,1,1,,,
9912248,2,1,1,1,0,2,6,106,2.0,1.0,1.0,1.0,0.0,2.0,2.0,9,2,7,1.0,0.0,1.0
102048,7,2,5,10,1,6,37,82,5.0,1.0,4.0,9.0,0.0,5.0,35.0,27,7,20,11.0,4.0,7.0
105330,3,1,2,2,0,3,6,59,3.0,1.0,2.0,2.0,0.0,3.0,6.0,7,3,4,5.0,2.0,3.0
112145,0,0,0,0,0,0,0,1,0.0,0.0,0.0,0.0,0.0,0.0,0.0,29,0,29,5.0,0.0,5.0
9907246,0,0,0,0,0,0,0,187,0.0,0.0,0.0,0.0,0.0,0.0,0.0,4,0,4,,,
9708429,1,1,0,0,0,1,2,3,0.0,0.0,0.0,0.0,0.0,0.0,0.0,26,1,25,2.0,0.0,2.0
3053,3,3,0,0,0,3,22,7,1.0,1.0,0.0,0.0,0.0,1.0,8.0,28,3,25,7.0,2.0,5.0
6070,4,4,0,0,0,4,8,84,3.0,3.0,0.0,0.0,0.0,3.0,3.0,13,4,9,3.0,2.0,1.0
12047,2,1,1,1,0,2,12,125,1.0,1.0,0.0,0.0,0.0,1.0,7.0,10,2,8,8.0,1.0,7.0
210240,1,1,0,0,0,1,5,37,1.0,1.0,0.0,0.0,0.0,1.0,5.0,8,1,7,6.0,1.0,5.0
103270,2,2,0,0,0,2,6,636,1.0,1.0,0.0,0.0,0.0,1.0,1.0,7,2,5,1.0,1.0,0.0
209087,0,0,0,0,0,0,0,80,0.0,0.0,0.0,0.0,0.0,0.0,0.0,7,0,7,2.0,0.0,2.0
9405375,4,3,1,1,4,0,0,173,2.0,2.0,0.0,0.0,2.0,0.0,0.0,5,4,1,1.0,1.0,0.0
108028,2,1,1,1,0,2,8,12,,,,,,,,18,2,16,3.0,0.0,3.0
9809512,1,1,0,0,1,0,0,230,1.0,1.0,0.0,0.0,1.0,0.0,0.0,4,1,3,1.0,0.0,1.0
206112,1,1,0,0,1,0,0,122,1.0,1.0,0.0,0.0,1.0,0.0,0.0,2,1,1,1.0,1.0,0.0
9304306,1,1,0,0,1,0,0,103,1.0,1.0,0.0,0.0,1.0,0.0,0.0,1,1,0,1.0,1.0,0.0
111063,6,4,2,2,2,4,7,66,4.0,3.0,1.0,1.0,2.0,2.0,2.0,18,6,12,3.0,2.0,1.0
9601244,3,2,1,1,1,2,6,14,2.0,1.0,1.0,1.0,0.0,2.0,4.0,9,3,6,4.0,2.0,2.0
9709311,2,1,1,1,1,1,1,59,0.0,0.0,0.0,0.0,0.0,0.0,0.0,8,2,6,2.0,0.0,2.0
10004,6,4,2,3,1,5,21,3,1.0,1.0,0.0,0.0,0.0,1.0,1.0,28,6,22,4.0,2.0,2.0
112284,5,3,2,2,1,4,19,80,3.0,2.0,1.0,1.0,0.0,3.0,14.0,19,5,14,14.0,3.0,11.0
205170,4,3,1,1,1,3,14,48,3.0,2.0,1.0,1.0,0.0,3.0,8.0,21,4,17,7.0,3.0,4.0
9408241,4,3,1,1,3,1,1,123,1.0,1.0,0.0,0.0,1.0,0.0,0.0,5,4,1,1.0,1.0,0.0
9803275,1,1,0,0,0,1,1,212,1.0,1.0,0.0,0.0,0.0,1.0,1.0,2,1,1,2.0,1.0,1.0
12120,9,4,5,11,2,7,28,31,5.0,3.0,2.0,5.0,1.0,4.0,11.0,32,9,23,8.0,1.0,7.0
9903458,4,4,0,0,0,4,5,58,2.0,2.0,0.0,0.0,0.0,2.0,3.0,6,4,2,4.0,2.0,2.0
9904511,1,1,0,0,1,0,0,226,1.0,1.0,0.0,0.0,1.0,0.0,0.0,1,1,0,1.0,1.0,0.0
9904239,1,1,0,0,0,1,9,9,1.0,1.0,0.0,0.0,0.0,1.0,5.0,29,1,28,11.0,0.0,11.0
9911361,7,2,5,12,0,7,23,4,1.0,1.0,0.0,0.0,0.0,1.0,5.0,25,7,18,4.0,2.0,2.0
9809222,6,3,3,4,0,6,18,77,3.0,1.0,2.0,3.0,0.0,3.0,6.0,13,6,7,4.0,4.0,0.0
9907437,6,3,3,3,1,5,12,123,4.0,2.0,2.0,2.0,0.0,4.0,10.0,21,6,15,9.0,3.0,6.0
209190,6,2,4,8,0,6,47,38,6.0,2.0,4.0,8.0,0.0,6.0,45.0,27,6,21,16.0,3.0,13.0
11213,5,5,0,0,1,4,16,63,1.0,1.0,0.0,0.0,0.0,1.0,4.0,24,5,19,10.0,1.0,9.0
203167,7,4,3,4,0,7,30,147,3.0,2.0,1.0,2.0,0.0,3.0,8.0,16,7,9,7.0,3.0,4.0
9911219,4,3,1,1,1,3,4,84,2.0,2.0,0.0,0.0,0.0,2.0,2.0,7,4,3,3.0,2.0,1.0
2073,3,3,0,0,1,2,5,119,0.0,0.0,0.0,0.0,0.0,0.0,0.0,16,3,13,12.0,0.0,12.0
9143,1,1,0,0,0,1,33,24,1.0,1.0,0.0,0.0,0.0,1.0,27.0,39,1,38,11.0,1.0,10.0
212144,0,0,0,0,0,0,0,112,0.0,0.0,0.0,0.0,0.0,0.0,0.0,8,0,8,7.0,0.0,7.0
111269,10,3,7,21,0,10,120,0,7.0,2.0,5.0,16.0,0.0,7.0,79.0,45,10,35,23.0,7.0,16.0
9806330,1,1,0,0,0,1,1,5,0.0,0.0,0.0,0.0,0.0,0.0,0.0,59,1,58,11.0,0.0,11.0
203112,1,1,0,0,0,1,1,66,0.0,0.0,0.0,0.0,0.0,0.0,0.0,13,1,12,3.0,0.0,3.0
9710444,2,1,1,1,1,1,1,290,2.0,1.0,1.0,1.0,1.0,1.0,1.0,3,2,1,2.0,2.0,0.0
9511411,4,4,0,0,1,3,10,17,1.0,1.0,0.0,0.0,1.0,0.0,0.0,8,4,4,2.0,1.0,1.0
9064,0,0,0,0,0,0,0,108,0.0,0.0,0.0,0.0,0.0,0.0,0.0,7,0,7,6.0,0.0,6.0
3109,5,4,1,1,1,4,11,61,1.0,1.0,0.0,0.0,0.0,1.0,2.0,69,5,64,10.0,0.0,10.0
301128,0,0,0,0,0,0,0,38,0.0,0.0,0.0,0.0,0.0,0.0,0.0,13,0,13,4.0,0.0,4.0
9906264,2,2,0,0,1,1,2,8,1.0,1.0,0.0,0.0,0.0,1.0,2.0,16,2,14,7.0,0.0,7.0
3252,0,0,0,0,0,0,0,21,0.0,0.0,0.0,0.0,0.0,0.0,0.0,36,0,36,29.0,0.0,29.0
209127,2,2,0,0,0,2,16,0,2.0,2.0,0.0,0.0,0.0,2.0,15.0,50,2,48,33.0,0.0,33.0
9506237,2,2,0,0,0,2,5,329,1.0,1.0,0.0,0.0,0.0,1.0,1.0,7,2,5,4.0,1.0,3.0
9710393,0,0,0,0,0,0,0,515,0.0,0.0,0.0,0.0,0.0,0.0,0.0,4,0,4,1.0,0.0,1.0
205319,3,3,0,0,0,3,22,11,3.0,3.0,0.0,0.0,0.0,3.0,21.0,23,3,20,1.0,0.0,1.0
109210,3,3,0,0,0,3,3,43,1.0,1.0,0.0,0.0,0.0,1.0,1.0,9,3,6,1.0,0.0,1.0
209111,2,2,0,0,0,2,9,122,1.0,1.0,0.0,0.0,0.0,1.0,6.0,16,2,14,8.0,1.0,7.0
206235,3,2,1,1,0,3,20,27,3.0,2.0,1.0,1.0,0.0,3.0,19.0,32,3,29,11.0,0.0,11.0
9605212,2,2,0,0,0,2,6,43,0.0,0.0,0.0,0.0,0.0,0.0,0.0,9,2,7,1.0,1.0,0.0
9405350,1,1,0,0,1,0,0,1185,,,,,,,,3,1,2,,,
9408278,1,1,0,0,1,0,0,65,,,,,,,,2,1,1,1.0,1.0,0.0
9409311,0,0,0,0,0,0,0,16,,,,,,,,4,0,4,1.0,0.0,1.0
111026,15,5,10,16,2,13,234,70,13.0,4.0,9.0,15.0,0.0,13.0,227.0,37,15,22,32.0,11.0,21.0
9905230,3,2,1,1,0,3,4,16,1.0,1.0,0.0,0.0,1.0,0.0,0.0,9,3,6,1.0,1.0,0.0
9410383,1,1,0,0,1,0,0,1838,,,,,,,,2,1,1,,,
208044,2,2,0,0,0,2,2,1861,,,,,,,,4,2,2,,,
7287,1,1,0,0,0,1,7,109,1.0,1.0,0.0,0.0,0.0,1.0,7.0,15,1,14,6.0,0.0,6.0
9607277,0,0,0,0,0,0,0,155,0.0,0.0,0.0,0.0,0.0,0.0,0.0,4,0,4,1.0,0.0,1.0
204044,4,3,1,2,0,4,70,53,3.0,2.0,1.0,1.0,0.0,3.0,60.0,32,4,28,28.0,3.0,25.0
12224,1,1,0,0,0,1,11,161,1.0,1.0,0.0,0.0,0.0,1.0,8.0,28,1,27,10.0,0.0,10.0
9405417,0,0,0,0,0,0,0,18,0.0,0.0,0.0,0.0,0.0,0.0,0.0,6,0,6,1.0,0.0,1.0
9503239,4,1,3,6,3,1,1,206,4.0,1.0,3.0,6.0,3.0,1.0,1.0,5,4,1,5.0,4.0,1.0
102305,0,0,0,0,0,0,0,161,0.0,0.0,0.0,0.0,0.0,0.0,0.0,13,0,13,12.0,0.0,12.0
206151,2,2,0,0,0,2,2,18,,,,,,,,7,2,5,1.0,1.0,0.0
111102,1,1,0,0,0,1,4,31,0.0,0.0,0.0,0.0,0.0,0.0,0.0,18,1,17,2.0,0.0,2.0
9909546,3,3,0,0,0,3,12,46,1.0,1.0,0.0,0.0,0.0,1.0,2.0,16,3,13,4.0,2.0,2.0
9801357,5,1,4,7,0,5,15,76,5.0,1.0,4.0,7.0,0.0,5.0,15.0,9,5,4,8.0,5.0,3.0
9908304,4,3,1,1,0,4,11,127,3.0,3.0,0.0,0.0,0.0,3.0,9.0,10,4,6,6.0,1.0,5.0
9910480,0,0,0,0,0,0,0,372,0.0,0.0,0.0,0.0,0.0,0.0,0.0,9,0,9,1.0,0.0,1.0
212273,0,0,0,0,0,0,0,4,0.0,0.0,0.0,0.0,0.0,0.0,0.0,9,0,9,4.0,0.0,4.0
9409341,0,0,0,0,0,0,0,946,,,,,,,,3,0,3,,,
9075,3,2,1,1,0,3,15,294,3.0,2.0,1.0,1.0,0.0,3.0,15.0,12,3,9,9.0,2.0,7.0
102158,5,2,3,4,0,5,12,125,1.0,1.0,0.0,0.0,0.0,1.0,1.0,21,5,16,8.0,1.0,7.0
9812434,2,2,0,0,1,1,1,83,0.0,0.0,0.0,0.0,0.0,0.0,0.0,18,2,16,1.0,1.0,0.0
4084,3,3,0,0,1,2,4,138,3.0,3.0,0.0,0.0,1.0,2.0,3.0,7,3,4,4.0,2.0,2.0
9809210,0,0,0,0,0,0,0,264,,,,,,,,1,0,1,,,
212203,2,2,0,0,0,2,2,17,0.0,0.0,0.0,0.0,0.0,0.0,0.0,24,2,22,14.0,0.0,14.0
12359,1,1,0,0,1,0,0,152,0.0,0.0,0.0,0.0,0.0,0.0,0.0,6,1,5,1.0,1.0,0.0
110268,2,2,0,0,1,1,1,240,1.0,1.0,0.0,0.0,1.0,0.0,0.0,4,2,2,1.0,0.0,1.0
205034,7,2,5,7,1,6,16,37,6.0,2.0,4.0,6.0,2.0,4.0,5.0,15,7,8,5.0,4.0,1.0
9811231,0,0,0,0,0,0,0,291,0.0,0.0,0.0,0.0,0.0,0.0,0.0,6,0,6,4.0,0.0,4.0
1114,0,0,0,0,0,0,0,18,,,,,,,,7,0,7,7.0,0.0,7.0
9707267,1,1,0,0,0,1,2,38,,,,,,,,4,1,3,,,
9611271,2,1,1,1,2,0,0,90,,,,,,,,2,2,0,,,
9321,2,2,0,0,1,1,11,34,1.0,1.0,0.0,0.0,0.0,1.0,11.0,25,2,23,20.0,1.0,19.0
204151,1,1,0,0,0,1,7,23,1.0,1.0,0.0,0.0,0.0,1.0,5.0,15,1,14,3.0,1.0,2.0
9808243,5,2,3,5,0,5,17,25,1.0,1.0,0.0,0.0,0.0,1.0,5.0,19,5,14,12.0,1.0,11.0
9601378,2,2,0,0,1,1,2,35,0.0,0.0,0.0,0.0,0.0,0.0,0.0,7,2,5,2.0,0.0,2.0
109237,1,1,0,0,0,1,6,4,0.0,0.0,0.0,0.0,0.0,0.0,0.0,33,1,32,4.0,0.0,4.0
205329,6,3,3,5,0,6,48,2,6.0,3.0,3.0,5.0,0.0,6.0,46.0,26,6,20,20.0,6.0,14.0
209179,2,2,0,0,0,2,11,9,1.0,1.0,0.0,0.0,0.0,1.0,5.0,26,2,24,7.0,2.0,5.0
9408295,0,0,0,0,0,0,0,163,,,,,,,,1,0,1,,,
12253,3,2,1,1,0,3,7,166,3.0,2.0,1.0,1.0,0.0,3.0,6.0,9,3,6,6.0,3.0,3.0
9804248,5,2,3,5,0,5,8,84,3.0,2.0,1.0,2.0,0.0,3.0,5.0,27,5,22,4.0,3.0,1.0
9812492,3,1,2,3,3,0,0,151,1.0,1.0,0.0,0.0,1.0,0.0,0.0,3,3,0,,,
7203,1,1,0,0,1,0,0,338,1.0,1.0,0.0,0.0,1.0,0.0,0.0,1,1,0,1.0,1.0,0.0
9711235,3,3,0,0,3,0,0,310,1.0,1.0,0.0,0.0,1.0,0.0,0.0,3,3,0,1.0,1.0,0.0
9909487,2,2,0,0,0,2,3,435,1.0,1.0,0.0,0.0,0.0,1.0,2.0,4,2,2,3.0,1.0,2.0
3230,0,0,0,0,0,0,0,262,0.0,0.0,0.0,0.0,0.0,0.0,0.0,3,0,3,2.0,0.0,2.0
107120,0,0,0,0,0,0,0,23,0.0,0.0,0.0,0.0,0.0,0.0,0.0,37,0,37,17.0,0.0,17.0
209355,0,0,0,0,0,0,0,447,0.0,0.0,0.0,0.0,0.0,0.0,0.0,3,0,3,2.0,0.0,2.0
9912334,0,0,0,0,0,0,0,14,,,,,,,,4,0,4,1.0,0.0,1.0
9910350,2,2,0,0,1,1,6,267,0.0,0.0,0.0,0.0,0.0,0.0,0.0,14,2,12,2.0,0.0,2.0
205014,5,5,0,0,0,5,22,82,4.0,4.0,0.0,0.0,0.0,4.0,21.0,20,5,15,12.0,2.0,10.0
204300,1,1,0,0,0,1,1,76,0.0,0.0,0.0,0.0,0.0,0.0,0.0,9,1,8,7.0,0.0,7.0
104272,0,0,0,0,0,0,0,177,0.0,0.0,0.0,0.0,0.0,0.0,0.0,4,0,4,3.0,0.0,3.0
9701386,2,2,0,0,1,1,1,87,0.0,0.0,0.0,0.0,0.0,0.0,0.0,7,2,5,2.0,0.0,2.0
9905203,2,2,0,0,0,2,5,49,0.0,0.0,0.0,0.0,0.0,0.0,0.0,17,2,15,6.0,0.0,6.0
212347,0,0,0,0,0,0,0,392,0.0,0.0,0.0,0.0,0.0,0.0,0.0,6,0,6,5.0,0.0,5.0
204064,4,3,1,1,0,4,42,20,3.0,2.0,1.0,1.0,0.0,3.0,36.0,26,4,22,9.0,2.0,7.0
9711305,3,3,0,0,0,3,15,102,2.0,2.0,0.0,0.0,0.0,2.0,10.0,14,3,11,8.0,2.0,6.0
9604219,2,2,0,0,2,0,0,552,2.0,2.0,0.0,0.0,2.0,0.0,0.0,2,2,0,2.0,2.0,0.0
9411389,1,1,0,0,1,0,0,58,,,,,,,,6,1,5,1.0,0.0,1.0
12347,0,0,0,0,0,0,0,214,0.0,0.0,0.0,0.0,0.0,0.0,0.0,4,0,4,2.0,0.0,2.0
112326,0,0,0,0,0,0,0,1237,,,,,,,,3,0,3,1.0,0.0,1.0
101061,2,2,0,0,0,2,5,104,2.0,2.0,0.0,0.0,0.0,2.0,2.0,7,2,5,3.0,2.0,1.0
9607396,2,1,1,1,0,2,2,402,2.0,1.0,1.0,1.0,0.0,2.0,2.0,3,2,1,3.0,2.0,1.0
9709488,1,1,0,0,0,1,5,8,1.0,1.0,0.0,0.0,0.0,1.0,3.0,14,1,13,1.0,0.0,1.0
9406344,3,3,0,0,0,3,6,26,1.0,1.0,0.0,0.0,0.0,1.0,2.0,7,3,4,3.0,1.0,2.0
9808319,1,1,0,0,0,1,1,159,0.0,0.0,0.0,0.0,0.0,0.0,0.0,5,1,4,1.0,0.0,1.0
7167,2,1,1,1,2,0,0,290,2.0,1.0,1.0,1.0,2.0,0.0,0.0,3,2,1,2.0,2.0,0.0
203253,2,2,0,0,0,2,6,49,1.0,1.0,0.0,0.0,0.0,1.0,5.0,11,2,9,4.0,1.0,3.0
9507273,2,2,0,0,1,1,2,270,1.0,1.0,0.0,0.0,0.0,1.0,2.0,4,2,2,3.0,1.0,2.0
302005,0,0,0,0,0,0,0,311,0.0,0.0,0.0,0.0,0.0,0.0,0.0,4,0,4,4.0,0.0,4.0
9906387,10,9,1,1,2,8,9,145,7.0,7.0,0.0,0.0,0.0,7.0,7.0,12,10,2,7.0,6.0,1.0
9706292,2,1,1,1,0,2,13,44,0.0,0.0,0.0,0.0,0.0,0.0,0.0,18,2,16,8.0,1.0,7.0
11129,1,1,0,0,0,1,1,59,0.0,0.0,0.0,0.0,0.0,0.0,0.0,9,1,8,2.0,0.0,2.0
8261,0,0,0,0,0,0,0,1245,0.0,0.0,0.0,0.0,0.0,0.0,0.0,5,0,5,,,
104193,3,1,2,3,0,3,15,136,3.0,1.0,2.0,3.0,0.0,3.0,14.0,11,3,8,8.0,3.0,5.0
112232,5,4,1,1,2,3,5,263,2.0,2.0,0.0,0.0,2.0,0.0,0.0,12,5,7,3.0,3.0,0.0
9910525,4,2,2,3,1,3,6,282,3.0,1.0,2.0,3.0,1.0,2.0,3.0,14,4,10,4.0,3.0,1.0
2222,4,1,3,3,0,4,11,72,4.0,1.0,3.0,3.0,4.0,0.0,0.0,7,4,3,6.0,4.0,2.0
9506241,3,1,2,2,0,3,3,44,3.0,1.0,2.0,2.0,3.0,0.0,0.0,6,3,3,1.0,0.0,1.0
9705322,1,1,0,0,1,0,0,105,1.0,1.0,0.0,0.0,1.0,0.0,0.0,4,1,3,1.0,1.0,0.0
7126,0,0,0,0,0,0,0,5,0.0,0.0,0.0,0.0,0.0,0.0,0.0,16,0,16,2.0,0.0,2.0
9302242,0,0,0,0,0,0,0,1806,,,,,,,,1,0,1,,,
106252,1,1,0,0,0,1,1,431,0.0,0.0,0.0,0.0,0.0,0.0,0.0,9,1,8,1.0,0.0,1.0
102006,4,4,0,0,0,4,20,3,1.0,1.0,0.0,0.0,0.0,1.0,1.0,33,4,29,5.0,1.0,4.0
9304214,6,3,3,4,5,1,1,96,4.0,2.0,2.0,2.0,4.0,0.0,0.0,7,6,1,3.0,3.0,0.0
9910500,2,1,1,1,1,1,6,4,1.0,1.0,0.0,0.0,0.0,1.0,5.0,30,2,28,4.0,0.0,4.0
212324,1,1,0,0,0,1,5,13,1.0,1.0,0.0,0.0,0.0,1.0,5.0,28,1,27,4.0,0.0,4.0
206157,3,3,0,0,0,3,4,185,3.0,3.0,0.0,0.0,0.0,3.0,4.0,7,3,4,3.0,1.0,2.0
203050,5,3,2,3,1,4,9,16,1.0,1.0,0.0,0.0,1.0,0.0,0.0,14,5,9,1.0,1.0,0.0
108190,2,2,0,0,1,1,8,30,1.0,1.0,0.0,0.0,0.0,1.0,8.0,33,2,31,13.0,0.0,13.0
9511373,0,0,0,0,0,0,0,27,0.0,0.0,0.0,0.0,0.0,0.0,0.0,9,0,9,2.0,0.0,2.0
9710455,0,0,0,0,0,0,0,1,0.0,0.0,0.0,0.0,0.0,0.0,0.0,32,0,32,10.0,0.0,10.0
9505265,0,0,0,0,0,0,0,307,0.0,0.0,0.0,0.0,0.0,0.0,0.0,4,0,4,2.0,0.0,2.0
102153,3,1,2,3,0,3,69,187,3.0,1.0,2.0,3.0,0.0,3.0,31.0,39,3,36,13.0,3.0,10.0
9810447,1,1,0,0,0,1,2,396,1.0,1.0,0.0,0.0,0.0,1.0,1.0,5,1,4,2.0,1.0,1.0
102215,2,2,0,0,0,2,11,3,0.0,0.0,0.0,0.0,0.0,0.0,0.0,17,2,15,6.0,1.0,5.0
9401207,0,0,0,0,0,0,0,124,0.0,0.0,0.0,0.0,0.0,0.0,0.0,6,0,6,,,
10039,1,1,0,0,0,1,2,31,0.0,0.0,0.0,0.0,0.0,0.0,0.0,10,1,9,4.0,0.0,4.0
208105,0,0,0,0,0,0,0,156,0.0,0.0,0.0,0.0,0.0,0.0,0.0,12,0,12,3.0,0.0,3.0
112237,0,0,0,0,0,0,0,79,0.0,0.0,0.0,0.0,0.0,0.0,0.0,16,0,16,11.0,0.0,11.0
108256,4,2,2,4,0,4,20,20,4.0,2.0,2.0,4.0,0.0,4.0,20.0,23,4,19,4.0,3.0,1.0
9506238,2,1,1,1,2,0,0,83,2.0,1.0,1.0,1.0,2.0,0.0,0.0,2,2,0,2.0,2.0,0.0
4219,2,1,1,1,2,0,0,512,2.0,1.0,1.0,1.0,2.0,0.0,0.0,2,2,0,2.0,2.0,0.0
9707506,0,0,0,0,0,0,0,59,0.0,0.0,0.0,0.0,0.0,0.0,0.0,6,0,6,3.0,0.0,3.0
9607464,1,1,0,0,1,0,0,1272,1.0,1.0,0.0,0.0,1.0,0.0,0.0,2,1,1,1.0,1.0,0.0
205115,0,0,0,0,0,0,0,43,0.0,0.0,0.0,0.0,0.0,0.0,0.0,5,0,5,3.0,0.0,3.0
111006,1,1,0,0,0,1,7,260,1.0,1.0,0.0,0.0,0.0,1.0,6.0,13,1,12,8.0,1.0,7.0
212323,0,0,0,0,0,0,0,13,0.0,0.0,0.0,0.0,0.0,0.0,0.0,11,0,11,1.0,0.0,1.0
9812537,2,2,0,0,2,0,0,359,1.0,1.0,0.0,0.0,1.0,0.0,0.0,16,2,14,5.0,0.0,5.0
209055,0,0,0,0,0,0,0,14,0.0,0.0,0.0,0.0,0.0,0.0,0.0,9,0,9,3.0,0.0,3.0
9611290,2,2,0,0,0,2,5,97,1.0,1.0,0.0,0.0,0.0,1.0,3.0,7,2,5,3.0,1.0,2.0
9808461,2,2,0,0,0,2,2,464,2.0,2.0,0.0,0.0,0.0,2.0,2.0,3,2,1,3.0,2.0,1.0
9410336,0,0,0,0,0,0,0,159,0.0,0.0,0.0,0.0,0.0,0.0,0.0,1,0,1,1.0,0.0,1.0
204016,0,0,0,0,0,0,0,7,0.0,0.0,0.0,0.0,0.0,0.0,0.0,28,0,28,3.0,0.0,3.0
6228,1,1,0,0,1,0,0,143,0.0,0.0,0.0,0.0,0.0,0.0,0.0,8,1,7,7.0,0.0,7.0
5273,6,5,1,1,1,5,17,252,6.0,5.0,1.0,1.0,1.0,5.0,10.0,14,6,8,8.0,4.0,4.0
104003,0,0,0,0,0,0,0,420,0.0,0.0,0.0,0.0,0.0,0.0,0.0,3,0,3,2.0,0.0,2.0
201180,0,0,0,0,0,0,0,24,0.0,0.0,0.0,0.0,0.0,0.0,0.0,20,0,20,15.0,0.0,15.0
9710433,0,0,0,0,0,0,0,681,0.0,0.0,0.0,0.0,0.0,0.0,0.0,1,0,1,1.0,0.0,1.0
9801441,2,1,1,1,2,0,0,204,0.0,0.0,0.0,0.0,0.0,0.0,0.0,8,2,6,4.0,0.0,4.0
208065,0,0,0,0,0,0,0,70,0.0,0.0,0.0,0.0,0.0,0.0,0.0,26,0,26,24.0,0.0,24.0
9909360,0,0,0,0,0,0,0,140,0.0,0.0,0.0,0.0,0.0,0.0,0.0,6,0,6,2.0,0.0,2.0
101188,1,1,0,0,0,1,4,52,1.0,1.0,0.0,0.0,0.0,1.0,3.0,8,1,7,6.0,0.0,6.0
9506331,4,4,0,0,4,0,0,342,3.0,3.0,0.0,0.0,3.0,0.0,0.0,4,4,0,2.0,2.0,0.0
9604249,0,0,0,0,0,0,0,15,,,,,,,,7,0,7,,,
206246,2,1,1,1,0,2,18,209,2.0,1.0,1.0,1.0,0.0,2.0,9.0,14,2,12,6.0,2.0,4.0
9805379,2,2,0,0,1,1,1,60,1.0,1.0,0.0,0.0,0.0,1.0,1.0,10,2,8,3.0,1.0,2.0
301047,1,1,0,0,0,1,1,8,0.0,0.0,0.0,0.0,0.0,0.0,0.0,39,1,38,17.0,0.0,17.0
9710210,2,2,0,0,2,0,0,4,0.0,0.0,0.0,0.0,0.0,0.0,0.0,18,2,16,1.0,0.0,1.0
9901247,2,2,0,0,2,0,0,362,1.0,1.0,0.0,0.0,1.0,0.0,0.0,2,2,0,1.0,1.0,0.0
205154,0,0,0,0,0,0,0,20,0.0,0.0,0.0,0.0,0.0,0.0,0.0,12,0,12,,,
101271,0,0,0,0,0,0,0,180,0.0,0.0,0.0,0.0,0.0,0.0,0.0,8,0,8,2.0,0.0,2.0
302121,0,0,0,0,0,0,0,19,0.0,0.0,0.0,0.0,0.0,0.0,0.0,17,0,17,6.0,0.0,6.0
9508345,2,1,1,1,1,1,1,75,0.0,0.0,0.0,0.0,0.0,0.0,0.0,11,2,9,3.0,0.0,3.0
9803388,0,0,0,0,0,0,0,36,0.0,0.0,0.0,0.0,0.0,0.0,0.0,13,0,13,1.0,0.0,1.0
212047,2,1,1,1,0,2,26,2,2.0,1.0,1.0,1.0,0.0,2.0,11.0,35,2,33,13.0,1.0,12.0
6267,2,2,0,0,0,2,16,53,1.0,1.0,0.0,0.0,0.0,1.0,10.0,27,2,25,14.0,0.0,14.0
109098,0,0,0,0,0,0,0,267,0.0,0.0,0.0,0.0,0.0,0.0,0.0,9,0,9,1.0,0.0,1.0
106106,1,1,0,0,1,0,0,20,0.0,0.0,0.0,0.0,0.0,0.0,0.0,10,1,9,2.0,0.0,2.0
106073,6,3,3,4,0,6,9,178,5.0,2.0,3.0,4.0,0.0,5.0,6.0,15,6,9,7.0,5.0,2.0
3088,2,1,1,1,0,2,9,101,2.0,1.0,1.0,1.0,0.0,2.0,4.0,10,2,8,4.0,2.0,2.0
9810327,0,0,0,0,0,0,0,70,0.0,0.0,0.0,0.0,0.0,0.0,0.0,10,0,10,,,
208200,0,0,0,0,0,0,0,10,0.0,0.0,0.0,0.0,0.0,0.0,0.0,26,0,26,15.0,0.0,15.0
111345,0,0,0,0,0,0,0,12,0.0,0.0,0.0,0.0,0.0,0.0,0.0,18,0,18,1.0,0.0,1.0
111124,1,1,0,0,0,1,6,95,1.0,1.0,0.0,0.0,0.0,1.0,4.0,24,1,23,4.0,1.0,3.0
210077,2,2,0,0,0,2,2,93,0.0,0.0,0.0,0.0,0.0,0.0,0.0,13,2,11,2.0,0.0,2.0
9022,1,1,0,0,1,0,0,102,1.0,1.0,0.0,0.0,1.0,0.0,0.0,2,1,1,,,
109198,3,2,1,1,2,1,2,45,2.0,2.0,0.0,0.0,1.0,1.0,1.0,9,3,6,3.0,1.0,2.0
9806312,1,1,0,0,1,0,0,322,0.0,0.0,0.0,0.0,0.0,0.0,0.0,7,1,6,1.0,0.0,1.0
209089,1,1,0,0,0,1,7,34,1.0,1.0,0.0,0.0,0.0,1.0,7.0,26,1,25,3.0,1.0,2.0
211246,0,0,0,0,0,0,0,27,0.0,0.0,0.0,0.0,0.0,0.0,0.0,11,0,11,3.0,0.0,3.0
207161,1,1,0,0,0,1,2,16,,,,,,,,7,1,6,1.0,1.0,0.0
9910317,3,1,2,2,3,0,0,465,3.0,1.0,2.0,2.0,3.0,0.0,0.0,3,3,0,3.0,3.0,0.0
112154,2,2,0,0,0,2,14,13,1.0,1.0,0.0,0.0,0.0,1.0,6.0,19,2,17,9.0,1.0,8.0
9505403,0,0,0,0,0,0,0,235,0.0,0.0,0.0,0.0,0.0,0.0,0.0,9,0,9,4.0,0.0,4.0
9711284,0,0,0,0,0,0,0,68,0.0,0.0,0.0,0.0,0.0,0.0,0.0,22,0,22,6.0,0.0,6.0
9305261,0,0,0,0,0,0,0,248,0.0,0.0,0.0,0.0,0.0,0.0,0.0,1,0,1,1.0,0.0,1.0
112336,3,3,0,0,2,1,6,37,0.0,0.0,0.0,0.0,0.0,0.0,0.0,12,3,9,5.0,1.0,4.0
9904506,0,0,0,0,0,0,0,9,0.0,0.0,0.0,0.0,0.0,0.0,0.0,11,0,11,,,
9612240,0,0,0,0,0,0,0,35,0.0,0.0,0.0,0.0,0.0,0.0,0.0,6,0,6,2.0,0.0,2.0
9512240,0,0,0,0,0,0,0,47,0.0,0.0,0.0,0.0,0.0,0.0,0.0,7,0,7,1.0,0.0,1.0
202051,0,0,0,0,0,0,0,23,0.0,0.0,0.0,0.0,0.0,0.0,0.0,8,0,8,2.0,0.0,2.0
104140,0,0,0,0,0,0,0,142,0.0,0.0,0.0,0.0,0.0,0.0,0.0,15,0,15,2.0,0.0,2.0
105315,0,0,0,0,0,0,0,128,0.0,0.0,0.0,0.0,0.0,0.0,0.0,2,0,2,2.0,0.0,2.0
9904205,1,1,0,0,0,1,1,334,0.0,0.0,0.0,0.0,0.0,0.0,0.0,4,1,3,3.0,0.0,3.0
212307,3,2,1,2,0,3,21,2,3.0,2.0,1.0,2.0,0.0,3.0,16.0,26,3,23,11.0,3.0,8.0
206158,2,2,0,0,0,2,38,29,1.0,1.0,0.0,0.0,0.0,1.0,8.0,36,2,34,4.0,1.0,3.0
9910493,3,1,2,2,0,3,3,191,3.0,1.0,2.0,2.0,0.0,3.0,3.0,5,3,2,5.0,3.0,2.0
9608456,0,0,0,0,0,0,0,237,0.0,0.0,0.0,0.0,0.0,0.0,0.0,5,0,5,2.0,0.0,2.0
9906334,1,1,0,0,0,1,8,19,0.0,0.0,0.0,0.0,0.0,0.0,0.0,15,1,14,8.0,0.0,8.0
105290,0,0,0,0,0,0,0,131,0.0,0.0,0.0,0.0,0.0,0.0,0.0,8,0,8,3.0,0.0,3.0
5165,2,2,0,0,2,0,0,467,1.0,1.0,0.0,0.0,1.0,0.0,0.0,2,2,0,1.0,1.0,0.0
301274,1,1,0,0,1,0,0,82,1.0,1.0,0.0,0.0,1.0,0.0,0.0,8,1,7,2.0,1.0,1.0
202169,1,1,0,0,0,1,3,194,1.0,1.0,0.0,0.0,0.0,1.0,2.0,8,1,7,4.0,1.0,3.0
204082,0,0,0,0,0,0,0,68,0.0,0.0,0.0,0.0,0.0,0.0,0.0,7,0,7,6.0,0.0,6.0
9405432,1,1,0,0,1,0,0,1627,1.0,1.0,0.0,0.0,1.0,0.0,0.0,1,1,0,1.0,1.0,0.0
11163,0,0,0,0,0,0,0,233,0.0,0.0,0.0,0.0,0.0,0.0,0.0,11,0,11,4.0,0.0,4.0
212353,1,1,0,0,0,1,2,70,,,,,,,,3,1,2,,,
105211,0,0,0,0,0,0,0,501,0.0,0.0,0.0,0.0,0.0,0.0,0.0,5,0,5,2.0,0.0,2.0
104077,0,0,0,0,0,0,0,143,0.0,0.0,0.0,0.0,0.0,0.0,0.0,8,0,8,4.0,0.0,4.0
205138,2,2,0,0,0,2,4,110,2.0,2.0,0.0,0.0,0.0,2.0,3.0,17,2,15,11.0,1.0,10.0
211425,0,0,0,0,0,0,0,165,0.0,0.0,0.0,0.0,0.0,0.0,0.0,17,0,17,13.0,0.0,13.0
209175,2,2,0,0,1,1,8,2,0.0,0.0,0.0,0.0,0.0,0.0,0.0,23,2,21,3.0,1.0,2.0
9109,1,1,0,0,0,1,2,251,0.0,0.0,0.0,0.0,0.0,0.0,0.0,4,1,3,1.0,0.0,1.0
9802337,1,1,0,0,0,1,1,64,1.0,1.0,0.0,0.0,1.0,0.0,0.0,8,1,7,3.0,1.0,2.0
6082,0,0,0,0,0,0,0,44,0.0,0.0,0.0,0.0,0.0,0.0,0.0,8,0,8,2.0,0.0,2.0
302181,1,1,0,0,0,1,4,3,0.0,0.0,0.0,0.0,0.0,0.0,0.0,66,1,65,20.0,0.0,20.0
9908332,1,1,0,0,1,0,0,52,0.0,0.0,0.0,0.0,0.0,0.0,0.0,14,1,13,2.0,0.0,2.0
9810226,0,0,0,0,0,0,0,334,0.0,0.0,0.0,0.0,0.0,0.0,0.0,3,0,3,3.0,0.0,3.0
9804373,1,1,0,0,0,1,7,44,1.0,1.0,0.0,0.0,0.0,1.0,5.0,18,1,17,5.0,1.0,4.0
10021,1,1,0,0,0,1,3,5,0.0,0.0,0.0,0.0,0.0,0.0,0.0,19,1,18,1.0,0.0,1.0
9806343,0,0,0,0,0,0,0,15,,,,,,,,7,0,7,,,
9601272,1,1,0,0,0,1,2,340,1.0,1.0,0.0,0.0,0.0,1.0,2.0,5,1,4,3.0,1.0,2.0
107088,2,2,0,0,1,1,1,13,0.0,0.0,0.0,0.0,0.0,0.0,0.0,25,2,23,2.0,0.0,2.0
9810213,0,0,0,0,0,0,0,14,,,,,,,,6,0,6,1.0,0.0,1.0
9909402,0,0,0,0,0,0,0,31,0.0,0.0,0.0,0.0,0.0,0.0,0.0,4,0,4,1.0,0.0,1.0
207039,1,1,0,0,0,1,13,12,,,,,,,,18,1,17,5.0,1.0,4.0
204197,0,0,0,0,0,0,0,9,0.0,0.0,0.0,0.0,0.0,0.0,0.0,49,0,49,3.0,0.0,3.0
5329,0,0,0,0,0,0,0,700,0.0,0.0,0.0,0.0,0.0,0.0,0.0,1,0,1,1.0,0.0,1.0
9712274,1,1,0,0,0,1,1,120,0.0,0.0,0.0,0.0,0.0,0.0,0.0,4,1,3,,,
9906454,0,0,0,0,0,0,0,702,0.0,0.0,0.0,0.0,0.0,0.0,0.0,1,0,1,1.0,0.0,1.0
9605254,0,0,0,0,0,0,0,302,0.0,0.0,0.0,0.0,0.0,0.0,0.0,4,0,4,3.0,0.0,3.0
212074,0,0,0,0,0,0,0,20,0.0,0.0,0.0,0.0,0.0,0.0,0.0,22,0,22,8.0,0.0,8.0
9506274,1,1,0,0,0,1,2,99,1.0,1.0,0.0,0.0,1.0,0.0,0.0,8,1,7,1.0,1.0,0.0
9812431,0,0,0,0,0,0,0,6,0.0,0.0,0.0,0.0,0.0,0.0,0.0,16,0,16,5.0,0.0,5.0
9907357,0,0,0,0,0,0,0,135,0.0,0.0,0.0,0.0,0.0,0.0,0.0,6,0,6,3.0,0.0,3.0
9909311,1,1,0,0,0,1,3,8,1.0,1.0,0.0,0.0,0.0,1.0,3.0,12,1,11,1.0,0.0,1.0
212383,0,0,0,0,0,0,0,31,0.0,0.0,0.0,0.0,0.0,0.0,0.0,22,0,22,2.0,0.0,2.0
9712460,0,0,0,0,0,0,0,311,0.0,0.0,0.0,0.0,0.0,0.0,0.0,1,0,1,1.0,0.0,1.0
202091,0,0,0,0,0,0,0,29,0.0,0.0,0.0,0.0,0.0,0.0,0.0,9,0,9,1.0,0.0,1.0
301272,0,0,0,0,0,0,0,2,0.0,0.0,0.0,0.0,0.0,0.0,0.0,14,0,14,,,
9408400,0,0,0,0,0,0,0,100,0.0,0.0,0.0,0.0,0.0,0.0,0.0,1,0,1,,,
9509243,1,1,0,0,0,1,1,1191,1.0,1.0,0.0,0.0,0.0,1.0,1.0,2,1,1,2.0,1.0,1.0
302224,0,0,0,0,0,0,0,16,0.0,0.0,0.0,0.0,0.0,0.0,0.0,22,0,22,11.0,0.0,11.0
9606338,1,1,0,0,0,1,2,41,0.0,0.0,0.0,0.0,0.0,0.0,0.0,17,1,16,9.0,0.0,9.0
9411208,1,1,0,0,0,1,3,62,1.0,1.0,0.0,0.0,0.0,1.0,3.0,5,1,4,2.0,1.0,1.0
212272,0,0,0,0,0,0,0,23,0.0,0.0,0.0,0.0,0.0,0.0,0.0,13,0,13,1.0,0.0,1.0
11024,1,1,0,0,0,1,6,13,1.0,1.0,0.0,0.0,0.0,1.0,6.0,15,1,14,7.0,1.0,6.0
9213,0,0,0,0,0,0,0,868,,,,,,,,1,0,1,,,
201027,1,1,0,0,0,1,7,17,1.0,1.0,0.0,0.0,0.0,1.0,4.0,11,1,10,5.0,1.0,4.0
101296,0,0,0,0,0,0,0,111,0.0,0.0,0.0,0.0,0.0,0.0,0.0,3,0,3,1.0,0.0,1.0
9403317,1,1,0,0,1,0,0,2077,,,,,,,,2,1,1,,,
102197,1,1,0,0,0,1,10,48,1.0,1.0,0.0,0.0,0.0,1.0,10.0,31,1,30,18.0,1.0,17.0
9912549,0,0,0,0,0,0,0,51,0.0,0.0,0.0,0.0,0.0,0.0,0.0,7,0,7,5.0,0.0,5.0
301127,1,1,0,0,1,0,0,261,,,,,,,,1,1,0,,,
9308202,0,0,0,0,0,0,0,63,0.0,0.0,0.0,0.0,0.0,0.0,0.0,1,0,1,1.0,0.0,1.0
301024,1,1,0,0,0,1,1,1,1.0,1.0,0.0,0.0,0.0,1.0,1.0,15,1,14,2.0,1.0,1.0
9303318,0,0,0,0,0,0,0,75,0.0,0.0,0.0,0.0,0.0,0.0,0.0,7,0,7,1.0,0.0,1.0
10285,0,0,0,0,0,0,0,29,0.0,0.0,0.0,0.0,0.0,0.0,0.0,9,0,9,5.0,0.0,5.0
203120,1,1,0,0,0,1,1,30,0.0,0.0,0.0,0.0,0.0,0.0,0.0,46,1,45,2.0,0.0,2.0
203127,0,0,0,0,0,0,0,160,0.0,0.0,0.0,0.0,0.0,0.0,0.0,6,0,6,1.0,0.0,1.0
212255,0,0,0,0,0,0,0,193,0.0,0.0,0.0,0.0,0.0,0.0,0.0,10,0,10,6.0,0.0,6.0
9812511,0,0,0,0,0,0,0,957,,,,,,,,2,0,2,,,
210280,0,0,0,0,0,0,0,28,0.0,0.0,0.0,0.0,0.0,0.0,0.0,12,0,12,8.0,0.0,8.0
211436,0,0,0,0,0,0,0,110,0.0,0.0,0.0,0.0,0.0,0.0,0.0,5,0,5,1.0,0.0,1.0
9118,1,1,0,0,1,0,0,151,0.0,0.0,0.0,0.0,0.0,0.0,0.0,6,1,5,1.0,1.0,0.0
9608312,1,1,0,0,0,1,2,41,,,,,,,,5,1,4,1.0,1.0,0.0
4168,0,0,0,0,0,0,0,3,0.0,0.0,0.0,0.0,0.0,0.0,0.0,11,0,11,1.0,0.0,1.0
105185,2,2,0,0,1,1,1,83,0.0,0.0,0.0,0.0,0.0,0.0,0.0,22,2,20,3.0,1.0,2.0
301202,0,0,0,0,0,0,0,129,0.0,0.0,0.0,0.0,0.0,0.0,0.0,22,0,22,5.0,0.0,5.0
5289,0,0,0,0,0,0,0,79,0.0,0.0,0.0,0.0,0.0,0.0,0.0,2,0,2,,,
207065,1,1,0,0,1,0,0,852,1.0,1.0,0.0,0.0,1.0,0.0,0.0,5,1,4,,,
9701302,0,0,0,0,0,0,0,120,0.0,0.0,0.0,0.0,0.0,0.0,0.0,2,0,2,,,
203241,0,0,0,0,0,0,0,38,0.0,0.0,0.0,0.0,0.0,0.0,0.0,13,0,13,4.0,0.0,4.0
211161,0,0,0,0,0,0,0,17,0.0,0.0,0.0,0.0,0.0,0.0,0.0,19,0,19,12.0,0.0,12.0
9511450,0,0,0,0,0,0,0,274,0.0,0.0,0.0,0.0,0.0,0.0,0.0,1,0,1,,,
9909565,0,0,0,0,0,0,0,67,0.0,0.0,0.0,0.0,0.0,0.0,0.0,9,0,9,3.0,0.0,3.0
102132,0,0,0,0,0,0,0,16,0.0,0.0,0.0,0.0,0.0,0.0,0.0,11,0,11,2.0,0.0,2.0
205135,2,1,1,1,0,2,8,7,0.0,0.0,0.0,0.0,0.0,0.0,0.0,12,2,10,2.0,0.0,2.0
9704279,0,0,0,0,0,0,0,202,0.0,0.0,0.0,0.0,0.0,0.0,0.0,4,0,4,1.0,0.0,1.0
5117,0,0,0,0,0,0,0,54,0.0,0.0,0.0,0.0,0.0,0.0,0.0,5,0,5,,,
9406221,0,0,0,0,0,0,0,808,,,,,,,,2,0,2,,,
12284,0,0,0,0,0,0,0,312,0.0,0.0,0.0,0.0,0.0,0.0,0.0,1,0,1,1.0,0.0,1.0
6169,0,0,0,0,0,0,0,90,0.0,0.0,0.0,0.0,0.0,0.0,0.0,7,0,7,,,
109152,0,0,0,0,0,0,0,77,0.0,0.0,0.0,0.0,0.0,0.0,0.0,5,0,5,1.0,0.0,1.0
212141,0,0,0,0,0,0,0,3,0.0,0.0,0.0,0.0,0.0,0.0,0.0,44,0,44,10.0,0.0,10.0
210188,0,0,0,0,0,0,0,3,0.0,0.0,0.0,0.0,0.0,0.0,0.0,18,0,18,6.0,0.0,6.0
209285,0,0,0,0,0,0,0,285,0.0,0.0,0.0,0.0,0.0,0.0,0.0,6,0,6,5.0,0.0,5.0
9806261,0,0,0,0,0,0,0,601,0.0,0.0,0.0,0.0,0.0,0.0,0.0,7,0,7,1.0,0.0,1.0
10119,0,0,0,0,0,0,0,14,0.0,0.0,0.0,0.0,0.0,0.0,0.0,8,0,8,6.0,0.0,6.0
9810380,0,0,0,0,0,0,0,421,0.0,0.0,0.0,0.0,0.0,0.0,0.0,6,0,6,2.0,0.0,2.0
107170,0,0,0,0,0,0,0,259,0.0,0.0,0.0,0.0,0.0,0.0,0.0,1,0,1,1.0,0.0,1.0
9506435,0,0,0,0,0,0,0,1332,0.0,0.0,0.0,0.0,0.0,0.0,0.0,1,0,1,1.0,0.0,1.0
9906425,1,1,0,0,1,0,0,269,1.0,1.0,0.0,0.0,1.0,0.0,0.0,1,1,0,1.0,1.0,0.0
210247,0,0,0,0,0,0,0,183,0.0,0.0,0.0,0.0,0.0,0.0,0.0,10,0,10,2.0,0.0,2.0
9810254,2,1,1,1,0,2,6,13,0.0,0.0,0.0,0.0,0.0,0.0,0.0,17,2,15,4.0,2.0,2.0
9809305,0,0,0,0,0,0,0,262,0.0,0.0,0.0,0.0,0.0,0.0,0.0,3,0,3,1.0,0.0,1.0
9501352,0,0,0,0,0,0,0,58,0.0,0.0,0.0,0.0,0.0,0.0,0.0,10,0,10,1.0,0.0,1.0
106046,0,0,0,0,0,0,0,35,0.0,0.0,0.0,0.0,0.0,0.0,0.0,11,0,11,3.0,0.0,3.0
10139,0,0,0,0,0,0,0,46,0.0,0.0,0.0,0.0,0.0,0.0,0.0,6,0,6,1.0,0.0,1.0
207068,0,0,0,0,0,0,0,97,0.0,0.0,0.0,0.0,0.0,0.0,0.0,7,0,7,1.0,0.0,1.0
9901227,0,0,0,0,0,0,0,58,,,,,,,,2,0,2,2.0,0.0,2.0
109255,0,0,0,0,0,0,0,9,0.0,0.0,0.0,0.0,0.0,0.0,0.0,36,0,36,20.0,0.0,20.0
9507247,0,0,0,0,0,0,0,48,0.0,0.0,0.0,0.0,0.0,0.0,0.0,5,0,5,1.0,0.0,1.0
11344,0,0,0,0,0,0,0,126,0.0,0.0,0.0,0.0,0.0,0.0,0.0,3,0,3,2.0,0.0,2.0
9905419,0,0,0,0,0,0,0,185,0.0,0.0,0.0,0.0,0.0,0.0,0.0,1,0,1,1.0,0.0,1.0
201082,1,1,0,0,0,1,5,2,0.0,0.0,0.0,0.0,0.0,0.0,0.0,27,1,26,3.0,1.0,2.0
112099,0,0,0,0,0,0,0,196,0.0,0.0,0.0,0.0,0.0,0.0,0.0,3,0,3,,,
6282,0,0,0,0,0,0,0,101,0.0,0.0,0.0,0.0,0.0,0.0,0.0,13,0,13,7.0,0.0,7.0
110234,0,0,0,0,0,0,0,42,0.0,0.0,0.0,0.0,0.0,0.0,0.0,12,0,12,2.0,0.0,2.0
9611413,0,0,0,0,0,0,0,111,,,,,,,,1,0,1,,,
204333,0,0,0,0,0,0,0,95,0.0,0.0,0.0,0.0,0.0,0.0,0.0,9,0,9,7.0,0.0,7.0
9807521,0,0,0,0,0,0,0,103,0.0,0.0,0.0,0.0,0.0,0.0,0.0,4,0,4,1.0,0.0,1.0
9706493,0,0,0,0,0,0,0,9,,,,,,,,6,0,6,,,
9705352,1,1,0,0,0,1,9,67,1.0,1.0,0.0,0.0,0.0,1.0,5.0,19,1,18,3.0,0.0,3.0
9803317,1,1,0,0,0,1,3,117,1.0,1.0,0.0,0.0,0.0,1.0,2.0,6,1,5,3.0,1.0,2.0
9808210,0,0,0,0,0,0,0,220,0.0,0.0,0.0,0.0,0.0,0.0,0.0,7,0,7,2.0,0.0,2.0
9407371,0,0,0,0,0,0,0,1117,,,,,,,,2,0,2,,,
106111,0,0,0,0,0,0,0,38,0.0,0.0,0.0,0.0,0.0,0.0,0.0,4,0,4,1.0,0.0,1.0
302152,0,0,0,0,0,0,0,167,0.0,0.0,0.0,0.0,0.0,0.0,0.0,9,0,9,5.0,0.0,5.0
9603403,0,0,0,0,0,0,0,203,0.0,0.0,0.0,0.0,0.0,0.0,0.0,2,0,2,1.0,0.0,1.0
8172,0,0,0,0,0,0,0,87,0.0,0.0,0.0,0.0,0.0,0.0,0.0,28,0,28,6.0,0.0,6.0
9902438,0,0,0,0,0,0,0,17,0.0,0.0,0.0,0.0,0.0,0.0,0.0,37,0,37,29.0,0.0,29.0
9904372,0,0,0,0,0,0,0,42,0.0,0.0,0.0,0.0,0.0,0.0,0.0,15,0,15,8.0,0.0,8.0
212281,1,1,0,0,1,0,0,338,0.0,0.0,0.0,0.0,0.0,0.0,0.0,6,1,5,,,
104177,0,0,0,0,0,0,0,108,0.0,0.0,0.0,0.0,0.0,0.0,0.0,5,0,5,,,
9512261,0,0,0,0,0,0,0,777,0.0,0.0,0.0,0.0,0.0,0.0,0.0,4,0,4,1.0,0.0,1.0
9901232,0,0,0,0,0,0,0,1,0.0,0.0,0.0,0.0,0.0,0.0,0.0,16,0,16,2.0,0.0,2.0
208179,0,0,0,0,0,0,0,3,0.0,0.0,0.0,0.0,0.0,0.0,0.0,12,0,12,8.0,0.0,8.0
210208,0,0,0,0,0,0,0,30,0.0,0.0,0.0,0.0,0.0,0.0,0.0,24,0,24,4.0,0.0,4.0
103152,1,1,0,0,0,1,14,1,1.0,1.0,0.0,0.0,0.0,1.0,11.0,38,1,37,5.0,0.0,5.0
9809216,0,0,0,0,0,0,0,1,0.0,0.0,0.0,0.0,0.0,0.0,0.0,63,0,63,11.0,0.0,11.0
209176,0,0,0,0,0,0,0,112,,,,,,,,3,0,3,2.0,0.0,2.0
210177,0,0,0,0,0,0,0,1871,0.0,0.0,0.0,0.0,0.0,0.0,0.0,5,0,5,,,
201050,2,1,1,1,2,0,0,412,2.0,1.0,1.0,1.0,2.0,0.0,0.0,2,2,0,2.0,2.0,0.0
205203,0,0,0,0,0,0,0,169,0.0,0.0,0.0,0.0,0.0,0.0,0.0,7,0,7,5.0,0.0,5.0
102302,0,0,0,0,0,0,0,2073,,,,,,,,2,0,2,,,
109143,1,1,0,0,0,1,5,155,1.0,1.0,0.0,0.0,0.0,1.0,5.0,6,1,5,6.0,1.0,5.0
9509425,0,0,0,0,0,0,0,69,0.0,0.0,0.0,0.0,0.0,0.0,0.0,6,0,6,1.0,0.0,1.0
9801310,0,0,0,0,0,0,0,249,0.0,0.0,0.0,0.0,0.0,0.0,0.0,7,0,7,1.0,0.0,1.0
9505312,0,0,0,0,0,0,0,26,0.0,0.0,0.0,0.0,0.0,0.0,0.0,7,0,7,3.0,0.0,3.0
9811466,0,0,0,0,0,0,0,8,0.0,0.0,0.0,0.0,0.0,0.0,0.0,10,0,10,,,
206013,0,0,0,0,0,0,0,7,0.0,0.0,0.0,0.0,0.0,0.0,0.0,33,0,33,7.0,0.0,7.0
212197,0,0,0,0,0,0,0,645,0.0,0.0,0.0,0.0,0.0,0.0,0.0,4,0,4,1.0,0.0,1.0
9906380,0,0,0,0,0,0,0,25,0.0,0.0,0.0,0.0,0.0,0.0,0.0,7,0,7,4.0,0.0,4.0
9329,0,0,0,0,0,0,0,3,0.0,0.0,0.0,0.0,0.0,0.0,0.0,16,0,16,13.0,0.0,13.0
212235,0,0,0,0,0,0,0,316,0.0,0.0,0.0,0.0,0.0,0.0,0.0,5,0,5,5.0,0.0,5.0
9609494,0,0,0,0,0,0,0,588,0.0,0.0,0.0,0.0,0.0,0.0,0.0,2,0,2,2.0,0.0,2.0
9912285,0,0,0,0,0,0,0,232,0.0,0.0,0.0,0.0,0.0,0.0,0.0,1,0,1,1.0,0.0,1.0
9710311,0,0,0,0,0,0,0,64,0.0,0.0,0.0,0.0,0.0,0.0,0.0,4,0,4,1.0,0.0,1.0
301222,0,0,0,0,0,0,0,123,0.0,0.0,0.0,0.0,0.0,0.0,0.0,14,0,14,5.0,0.0,5.0
9312310,0,0,0,0,0,0,0,200,0.0,0.0,0.0,0.0,0.0,0.0,0.0,3,0,3,1.0,0.0,1.0
210169,0,0,0,0,0,0,0,30,0.0,0.0,0.0,0.0,0.0,0.0,0.0,34,0,34,16.0,0.0,16.0
211435,0,0,0,0,0,0,0,80,,,,,,,,2,0,2,1.0,0.0,1.0
9601232,0,0,0,0,0,0,0,71,0.0,0.0,0.0,0.0,0.0,0.0,0.0,8,0,8,1.0,0.0,1.0
9904308,0,0,0,0,0,0,0,388,0.0,0.0,0.0,0.0,0.0,0.0,0.0,2,0,2,2.0,0.0,2.0
207089,0,0,0,0,0,0,0,27,0.0,0.0,0.0,0.0,0.0,0.0,0.0,27,0,27,5.0,0.0,5.0
1018,0,0,0,0,0,0,0,204,0.0,0.0,0.0,0.0,0.0,0.0,0.0,3,0,3,1.0,0.0,1.0
9611439,0,0,0,0,0,0,0,399,0.0,0.0,0.0,0.0,0.0,0.0,0.0,5,0,5,1.0,0.0,1.0
207371,0,0,0,0,0,0,0,66,,,,,,,,3,0,3,1.0,0.0,1.0
302269,0,0,0,0,0,0,0,9,0.0,0.0,0.0,0.0,0.0,0.0,0.0,31,0,31,10.0,0.0,10.0
109132,0,0,0,0,0,0,0,429,0.0,0.0,0.0,0.0,0.0,0.0,0.0,2,0,2,,,
106133,0,0,0,0,0,0,0,290,0.0,0.0,0.0,0.0,0.0,0.0,0.0,1,0,1,1.0,0.0,1.0
9811269,0,0,0,0,0,0,0,123,0.0,0.0,0.0,0.0,0.0,0.0,0.0,6,0,6,3.0,0.0,3.0
9706208,0,0,0,0,0,0,0,217,0.0,0.0,0.0,0.0,0.0,0.0,0.0,2,0,2,,,
203218,0,0,0,0,0,0,0,111,0.0,0.0,0.0,0.0,0.0,0.0,0.0,3,0,3,1.0,0.0,1.0
9301203,8,4,4,7,8,0,0,100,4.0,3.0,1.0,1.0,4.0,0.0,0.0,8,8,0,4.0,4.0,0.0
112008,5,5,0,0,0,5,17,1,1.0,1.0,0.0,0.0,0.0,1.0,2.0,60,5,55,4.0,1.0,3.0
6357,1,1,0,0,0,1,3,1,0.0,0.0,0.0,0.0,0.0,0.0,0.0,16,1,15,1.0,0.0,1.0
9509204,107,3,104,1005,7,100,481,1,84.0,3.0,81.0,787.0,4.0,80.0,404.0,129,107,22,49.0,47.0,2.0
9707225,52,12,40,116,6,46,112,5,4.0,2.0,2.0,3.0,4.0,0.0,0.0,66,52,14,10.0,9.0,1.0
9401204,43,5,38,208,43,0,0,58,23.0,3.0,20.0,58.0,23.0,0.0,0.0,43,43,0,17.0,17.0,0.0
9502338,79,11,68,307,2,77,336,6,36.0,4.0,32.0,125.0,0.0,36.0,193.0,93,79,14,24.0,15.0,9.0
9603256,8,3,5,5,6,2,3,196,2.0,2.0,0.0,0.0,2.0,0.0,0.0,11,8,3,4.0,3.0,1.0
9902256,56,8,48,173,9,47,117,1,20.0,4.0,16.0,42.0,1.0,19.0,44.0,65,56,9,11.0,10.0,1.0
6068,16,7,9,18,0,16,168,6,6.0,2.0,4.0,10.0,0.0,6.0,86.0,58,16,42,14.0,6.0,8.0
9612433,123,19,104,525,120,3,3,1,48.0,7.0,41.0,193.0,48.0,0.0,0.0,125,123,2,18.0,18.0,0.0
9509420,8,7,1,1,7,1,1,238,2.0,1.0,1.0,1.0,2.0,0.0,0.0,9,8,1,2.0,2.0,0.0
9312202,41,18,23,52,30,11,12,114,10.0,3.0,7.0,21.0,10.0,0.0,0.0,43,41,2,7.0,7.0,0.0
9407393,8,6,2,2,0,8,26,86,3.0,1.0,2.0,2.0,0.0,3.0,11.0,16,8,8,9.0,2.0,7.0
9502225,17,4,13,36,5,12,17,33,5.0,2.0,3.0,4.0,5.0,0.0,0.0,23,17,6,5.0,4.0,1.0
9608317,60,8,52,202,55,5,5,4,18.0,3.0,15.0,65.0,18.0,0.0,0.0,61,60,1,9.0,9.0,0.0
9811356,207,13,194,2168,8,199,919,2,131.0,4.0,127.0,1607.0,0.0,131.0,677.0,217,207,10,66.0,60.0,6.0
9312324,100,26,74,254,81,19,24,26,23.0,2.0,21.0,83.0,12.0,11.0,11.0,102,100,2,8.0,8.0,0.0
9604351,121,27,94,489,26,95,424,43,45.0,5.0,40.0,259.0,2.0,43.0,188.0,144,121,23,34.0,23.0,11.0
9704259,14,4,10,24,3,11,36,33,8.0,2.0,6.0,11.0,2.0,6.0,6.0,25,14,11,6.0,3.0,3.0
9804321,37,17,20,36,37,0,0,5,8.0,3.0,5.0,7.0,8.0,0.0,0.0,37,37,0,3.0,3.0,0.0
9902202,2,2,0,0,0,2,52,33,0.0,0.0,0.0,0.0,0.0,0.0,0.0,59,2,57,16.0,0.0,16.0
101229,9,4,5,7,2,7,12,4,1.0,1.0,0.0,0.0,0.0,1.0,2.0,29,9,20,9.0,2.0,7.0
6238,37,8,29,99,6,31,122,2,14.0,1.0,13.0,59.0,14.0,0.0,0.0,53,37,16,14.0,14.0,0.0
9207273,22,4,18,56,22,0,0,26,13.0,1.0,12.0,34.0,13.0,0.0,0.0,22,22,0,12.0,12.0,0.0
9602221,67,9,58,273,0,67,286,26,49.0,5.0,44.0,238.0,0.0,49.0,227.0,79,67,12,25.0,20.0,5.0
9809470,87,12,75,321,9,78,182,26,40.0,3.0,37.0,145.0,0.0,40.0,117.0,94,87,7,29.0,22.0,7.0
9303226,46,9,37,146,31,15,15,93,22.0,3.0,19.0,64.0,22.0,0.0,0.0,47,46,1,17.0,17.0,0.0
201227,7,5,2,2,1,6,53,4,0.0,0.0,0.0,0.0,0.0,0.0,0.0,81,7,74,5.0,1.0,4.0
9510308,29,2,27,152,5,24,48,60,16.0,1.0,15.0,94.0,3.0,13.0,13.0,39,29,10,17.0,16.0,1.0
9703288,123,7,116,1048,11,112,479,36,71.0,4.0,67.0,782.0,3.0,68.0,228.0,151,123,28,59.0,56.0,3.0
2205,2,2,0,0,0,2,8,4,1.0,1.0,0.0,0.0,0.0,1.0,7.0,14,2,12,10.0,1.0,9.0
101165,28,11,17,38,5,23,92,4,10.0,3.0,7.0,13.0,1.0,9.0,29.0,47,28,19,6.0,0.0,6.0
112054,9,6,3,4,0,9,74,2,1.0,1.0,0.0,0.0,0.0,1.0,7.0,55,9,46,5.0,0.0,5.0
9910301,28,12,16,35,3,25,43,4,10.0,6.0,4.0,5.0,1.0,9.0,14.0,33,28,5,10.0,8.0,2.0
9804403,224,9,215,2726,33,191,461,20,153.0,3.0,150.0,2376.0,14.0,139.0,329.0,229,224,5,84.0,81.0,3.0
9409310,39,10,29,52,17,22,26,63,16.0,3.0,13.0,29.0,10.0,6.0,6.0,42,39,3,7.0,7.0,0.0
9210265,12,6,6,7,12,0,0,233,3.0,2.0,1.0,1.0,3.0,0.0,0.0,12,12,0,3.0,3.0,0.0
9509248,62,15,47,168,17,45,46,23,13.0,3.0,10.0,23.0,2.0,11.0,11.0,64,62,2,12.0,11.0,1.0
9405390,16,12,4,6,12,4,4,109,6.0,5.0,1.0,1.0,6.0,0.0,0.0,17,16,1,2.0,2.0,0.0
9302288,41,10,31,95,19,22,22,25,12.0,4.0,8.0,15.0,2.0,10.0,10.0,42,41,1,7.0,7.0,0.0
9210211,26,11,15,23,26,0,0,12,3.0,1.0,2.0,2.0,3.0,0.0,0.0,26,26,0,3.0,3.0,0.0
9304211,43,5,38,129,43,0,0,36,24.0,3.0,21.0,78.0,24.0,0.0,0.0,43,43,0,17.0,17.0,0.0
9507462,153,9,144,703,49,104,289,5,33.0,5.0,28.0,78.0,4.0,29.0,85.0,175,153,22,26.0,26.0,0.0
9602260,132,39,93,320,51,81,151,21,16.0,2.0,14.0,42.0,15.0,1.0,1.0,185,132,53,13.0,13.0,0.0
9609276,55,6,49,307,21,34,79,0,28.0,2.0,26.0,161.0,8.0,20.0,44.0,71,55,16,22.0,21.0,1.0
9808272,122,16,106,589,6,116,330,3,67.0,2.0,65.0,357.0,5.0,62.0,171.0,136,122,14,35.0,31.0,4.0
9912457,62,6,56,292,1,61,363,0,42.0,3.0,39.0,218.0,0.0,42.0,259.0,83,62,21,34.0,23.0,11.0
9306282,2,2,0,0,2,0,0,366,1.0,1.0,0.0,0.0,1.0,0.0,0.0,2,2,0,1.0,1.0,0.0
9512364,92,24,68,247,47,45,78,28,24.0,7.0,17.0,52.0,18.0,6.0,6.0,104,92,12,10.0,10.0,0.0
9806294,41,4,37,246,4,37,119,3,33.0,2.0,31.0,213.0,5.0,28.0,59.0,63,41,22,28.0,27.0,1.0
9903435,43,7,36,150,0,43,280,12,30.0,3.0,27.0,113.0,0.0,30.0,161.0,64,43,21,21.0,15.0,6.0
9912205,28,8,20,26,6,22,51,3,8.0,4.0,4.0,4.0,8.0,0.0,0.0,42,28,14,6.0,6.0,0.0
9702308,13,7,6,12,9,4,6,82,1.0,1.0,0.0,0.0,1.0,0.0,0.0,20,13,7,4.0,0.0,4.0
9808251,76,4,72,476,3,73,555,3,59.0,1.0,58.0,397.0,0.0,59.0,390.0,120,76,44,39.0,27.0,12.0
9611277,48,3,45,188,7,41,162,3,9.0,2.0,7.0,13.0,0.0,9.0,43.0,67,48,19,15.0,14.0,1.0
9811460,13,8,5,8,1,12,99,0,2.0,2.0,0.0,0.0,0.0,2.0,19.0,100,13,87,5.0,0.0,5.0
9804433,8,3,5,9,0,8,36,3,2.0,2.0,0.0,0.0,0.0,2.0,11.0,25,8,17,4.0,1.0,3.0
9904328,15,1,14,41,1,14,36,0,14.0,1.0,13.0,40.0,2.0,12.0,30.0,20,15,5,1.0,1.0,0.0
9408386,7,3,4,4,0,7,7,0,5.0,2.0,3.0,3.0,0.0,5.0,5.0,8,7,1,1.0,1.0,0.0
9807360,34,3,31,131,20,14,19,0,25.0,1.0,24.0,97.0,14.0,11.0,16.0,37,34,3,11.0,9.0,2.0
9711259,25,2,23,110,14,11,21,3,22.0,1.0,21.0,102.0,12.0,10.0,10.0,36,25,11,3.0,3.0,0.0
9809217,73,4,69,597,3,70,159,2,55.0,4.0,51.0,512.0,1.0,54.0,115.0,79,73,6,35.0,33.0,2.0
2263,6,6,0,0,0,6,18,3,1.0,1.0,0.0,0.0,0.0,1.0,2.0,34,6,28,10.0,0.0,10.0
9408344,63,11,52,252,54,9,9,45,37.0,4.0,33.0,195.0,30.0,7.0,7.0,64,63,1,29.0,29.0,0.0
9703361,14,5,9,19,2,12,34,3,1.0,1.0,0.0,0.0,0.0,1.0,3.0,24,14,10,5.0,2.0,3.0
9710314,17,5,12,29,2,15,35,42,10.0,3.0,7.0,20.0,1.0,9.0,12.0,40,17,23,10.0,9.0,1.0
9511288,162,8,154,1602,56,106,131,12,104.0,3.0,101.0,1242.0,44.0,60.0,60.0,174,162,12,47.0,46.0,1.0
9602404,14,1,13,40,0,14,77,71,10.0,1.0,9.0,28.0,0.0,10.0,66.0,25,14,11,21.0,10.0,11.0
9307275,2,2,0,0,0,2,3,10,1.0,1.0,0.0,0.0,1.0,0.0,0.0,9,2,7,1.0,0.0,1.0
9602389,19,3,16,29,4,15,36,12,5.0,1.0,4.0,5.0,1.0,4.0,10.0,27,19,8,3.0,3.0,0.0
9706546,13,5,8,20,2,11,41,0,4.0,1.0,3.0,5.0,0.0,4.0,15.0,33,13,20,6.0,1.0,5.0
9506222,28,6,22,37,7,21,72,10,12.0,4.0,8.0,15.0,0.0,12.0,46.0,41,28,13,11.0,9.0,2.0
9505347,30,12,18,27,2,28,88,10,11.0,6.0,5.0,6.0,1.0,10.0,11.0,43,30,13,10.0,9.0,1.0
9907275,7,4,3,4,0,7,68,12,6.0,3.0,3.0,4.0,0.0,6.0,59.0,32,7,25,18.0,2.0,16.0
9701253,54,4,50,132,52,2,2,12,8.0,1.0,7.0,9.0,8.0,0.0,0.0,55,54,1,8.0,8.0,0.0
9205240,31,15,16,39,31,0,0,10,13.0,8.0,5.0,11.0,13.0,0.0,0.0,31,31,0,7.0,7.0,0.0
109113,19,7,12,27,0,19,119,34,16.0,7.0,9.0,19.0,0.0,16.0,97.0,39,19,20,6.0,4.0,2.0
9611373,6,3,3,7,4,2,11,6,0.0,0.0,0.0,0.0,0.0,0.0,0.0,21,6,15,3.0,0.0,3.0
9708326,38,7,31,135,7,31,66,58,13.0,2.0,11.0,38.0,3.0,10.0,12.0,44,38,6,7.0,5.0,2.0
9805235,6,2,4,7,1,5,20,1,1.0,1.0,0.0,0.0,1.0,0.0,0.0,12,6,6,,,
9337,119,4,115,752,32,87,492,7,20.0,3.0,17.0,58.0,0.0,20.0,209.0,153,119,34,38.0,16.0,22.0
1088,14,1,13,35,0,14,215,34,13.0,1.0,12.0,34.0,0.0,13.0,211.0,50,14,36,36.0,12.0,24.0
9911202,22,3,19,85,0,22,113,34,18.0,2.0,16.0,78.0,0.0,18.0,93.0,48,22,26,28.0,18.0,10.0
9805442,62,8,54,243,12,50,156,34,21.0,1.0,20.0,99.0,4.0,17.0,28.0,86,62,24,19.0,17.0,2.0
9607487,41,5,36,173,2,39,264,5,31.0,1.0,30.0,156.0,0.0,31.0,225.0,64,41,23,29.0,17.0,12.0
9703312,27,4,23,99,2,25,147,5,22.0,3.0,19.0,88.0,0.0,22.0,130.0,38,27,11,18.0,14.0,4.0
9712353,9,4,5,10,0,9,28,158,7.0,3.0,4.0,7.0,0.0,7.0,19.0,18,9,9,11.0,6.0,5.0
10074,4,3,1,1,4,0,0,377,1.0,1.0,0.0,0.0,1.0,0.0,0.0,11,4,7,2.0,1.0,1.0
9508411,19,7,12,17,5,14,27,152,9.0,3.0,6.0,8.0,0.0,9.0,19.0,24,19,5,10.0,7.0,3.0
9809364,21,5,16,31,0,21,179,1,8.0,3.0,5.0,6.0,0.0,8.0,82.0,53,21,32,9.0,5.0,4.0
9902239,42,7,35,111,3,39,168,1,16.0,2.0,14.0,43.0,1.0,15.0,31.0,57,42,15,9.0,4.0,5.0
9209271,27,8,19,61,27,0,0,6,5.0,3.0,2.0,2.0,5.0,0.0,0.0,27,27,0,3.0,3.0,0.0
9412340,31,4,27,142,26,5,5,1,24.0,1.0,23.0,126.0,24.0,0.0,0.0,32,31,1,18.0,18.0,0.0
9804253,37,9,28,116,7,30,168,1,17.0,4.0,13.0,70.0,1.0,16.0,88.0,59,37,22,3.0,2.0,1.0
9409443,41,16,25,127,22,19,22,1,13.0,9.0,4.0,7.0,4.0,9.0,12.0,46,41,5,13.0,13.0,0.0
9905343,7,7,0,0,0,7,49,9,0.0,0.0,0.0,0.0,0.0,0.0,0.0,33,7,26,5.0,2.0,3.0
9803370,15,5,10,18,2,13,74,7,7.0,2.0,5.0,9.0,0.0,7.0,40.0,46,15,31,3.0,0.0,3.0
5323,6,6,0,0,0,6,22,313,3.0,3.0,0.0,0.0,0.0,3.0,9.0,14,6,8,6.0,3.0,3.0
9801359,6,3,3,4,1,5,15,86,0.0,0.0,0.0,0.0,0.0,0.0,0.0,18,6,12,2.0,0.0,2.0
9912270,4,1,3,3,4,0,0,349,4.0,1.0,3.0,3.0,4.0,0.0,0.0,4,4,0,4.0,4.0,0.0
9211211,39,15,24,60,29,10,22,15,18.0,7.0,11.0,25.0,18.0,0.0,0.0,42,39,3,8.0,8.0,0.0
9908229,28,5,23,63,2,26,162,7,23.0,4.0,19.0,48.0,1.0,22.0,84.0,50,28,22,9.0,5.0,4.0
9305267,114,18,96,531,87,27,28,29,29.0,5.0,24.0,130.0,29.0,0.0,0.0,116,114,2,15.0,15.0,0.0
9508213,26,9,17,41,26,0,0,7,6.0,5.0,1.0,1.0,6.0,0.0,0.0,26,26,0,8.0,8.0,0.0
9208260,10,7,3,4,10,0,0,250,8.0,5.0,3.0,4.0,8.0,0.0,0.0,10,10,0,6.0,6.0,0.0
9606256,19,4,15,39,6,13,60,12,10.0,1.0,9.0,26.0,0.0,10.0,45.0,31,19,12,3.0,2.0,1.0
9511324,41,10,31,79,6,35,84,61,5.0,3.0,2.0,4.0,0.0,5.0,14.0,60,41,19,4.0,3.0,1.0
9504368,5,3,2,2,2,3,8,256,3.0,1.0,2.0,2.0,1.0,2.0,6.0,10,5,5,5.0,2.0,3.0
9709283,11,7,4,7,3,8,15,98,5.0,4.0,1.0,1.0,0.0,5.0,11.0,18,11,7,3.0,3.0,0.0
9705422,13,6,7,19,1,12,36,76,12.0,5.0,7.0,19.0,0.0,12.0,36.0,19,13,6,10.0,6.0,4.0
9712385,22,6,16,36,0,22,117,19,12.0,2.0,10.0,25.0,0.0,12.0,56.0,37,22,15,21.0,8.0,13.0
9410234,14,6,8,13,14,0,0,140,2.0,2.0,0.0,0.0,2.0,0.0,0.0,14,14,0,4.0,4.0,0.0
9610553,29,6,23,81,1,28,150,19,19.0,5.0,14.0,65.0,1.0,18.0,109.0,48,29,19,11.0,4.0,7.0
3277,12,4,8,17,1,11,19,24,5.0,2.0,3.0,4.0,0.0,5.0,9.0,17,12,5,7.0,5.0,2.0
9804251,5,2,3,4,0,5,32,24,1.0,1.0,0.0,0.0,1.0,0.0,0.0,12,5,7,2.0,2.0,0.0
9806344,113,28,85,307,35,78,178,11,18.0,2.0,16.0,52.0,8.0,10.0,10.0,127,113,14,14.0,13.0,1.0
9306230,82,20,62,199,82,0,0,57,34.0,6.0,28.0,107.0,34.0,0.0,0.0,82,82,0,12.0,12.0,0.0
9601201,27,9,18,39,5,22,32,258,14.0,3.0,11.0,26.0,2.0,12.0,18.0,30,27,3,13.0,11.0,2.0
9507327,10,6,4,9,2,8,14,98,5.0,1.0,4.0,6.0,5.0,0.0,0.0,14,10,4,4.0,4.0,0.0
9806528,28,7,21,68,0,28,89,108,24.0,6.0,18.0,62.0,0.0,24.0,81.0,35,28,7,23.0,18.0,5.0
9405257,41,10,31,75,41,0,0,30,10.0,2.0,8.0,16.0,10.0,0.0,0.0,41,41,0,7.0,7.0,0.0
9904348,23,3,20,53,0,23,137,4,14.0,2.0,12.0,28.0,0.0,14.0,50.0,74,23,51,8.0,4.0,4.0
9506208,25,9,16,51,10,15,46,30,16.0,7.0,9.0,22.0,3.0,13.0,41.0,29,25,4,13.0,9.0,4.0
9302302,13,10,3,3,9,4,4,190,4.0,3.0,1.0,1.0,3.0,1.0,1.0,14,13,1,3.0,3.0,0.0
9610414,35,6,29,116,22,13,20,59,26.0,3.0,23.0,101.0,14.0,12.0,19.0,37,35,2,18.0,16.0,2.0
9608247,23,3,20,66,0,23,155,6,12.0,2.0,10.0,28.0,0.0,12.0,75.0,49,23,26,5.0,5.0,0.0
9401246,33,10,23,82,2,31,166,6,26.0,6.0,20.0,75.0,0.0,26.0,139.0,49,33,16,19.0,11.0,8.0
9204229,70,28,42,211,60,10,10,6,29.0,7.0,22.0,149.0,29.0,0.0,0.0,71,70,1,19.0,19.0,0.0
9410297,15,8,7,9,7,8,13,85,4.0,2.0,2.0,2.0,0.0,4.0,4.0,23,15,8,5.0,4.0,1.0
9511233,33,8,25,48,8,25,112,6,14.0,3.0,11.0,20.0,1.0,13.0,65.0,42,33,9,4.0,4.0,0.0
2001,21,12,9,19,1,20,131,2,5.0,3.0,2.0,3.0,0.0,5.0,43.0,36,21,15,5.0,5.0,0.0
9402276,20,4,16,37,5,15,23,8,3.0,2.0,1.0,1.0,0.0,3.0,3.0,22,20,2,5.0,4.0,1.0
9601294,16,9,7,11,5,11,26,14,8.0,3.0,5.0,6.0,1.0,7.0,20.0,24,16,8,5.0,2.0,3.0
105183,3,2,1,1,0,3,32,22,0.0,0.0,0.0,0.0,0.0,0.0,0.0,49,3,46,5.0,0.0,5.0
9604327,28,7,21,62,17,11,11,45,12.0,2.0,10.0,22.0,5.0,7.0,7.0,29,28,1,5.0,5.0,0.0
9801435,8,4,4,7,4,4,7,45,4.0,3.0,1.0,2.0,3.0,1.0,1.0,15,8,7,5.0,4.0,1.0
9903513,12,5,7,7,1,11,67,15,7.0,2.0,5.0,5.0,0.0,7.0,44.0,27,12,15,6.0,4.0,2.0
9901263,1,1,0,0,1,0,0,418,0.0,0.0,0.0,0.0,0.0,0.0,0.0,4,1,3,1.0,0.0,1.0
9609481,108,7,101,659,45,63,91,22,55.0,2.0,53.0,418.0,23.0,32.0,32.0,111,108,3,32.0,31.0,1.0
9912305,12,3,9,25,0,12,153,22,10.0,1.0,9.0,23.0,0.0,10.0,116.0,47,12,35,26.0,10.0,16.0
9508354,21,4,17,27,6,15,32,13,6.0,1.0,5.0,7.0,6.0,0.0,0.0,29,21,8,8.0,7.0,1.0
9409430,11,9,2,3,6,5,7,90,2.0,2.0,0.0,0.0,2.0,0.0,0.0,14,11,3,1.0,0.0,1.0
9304315,29,12,17,45,29,0,0,52,12.0,3.0,9.0,24.0,12.0,0.0,0.0,29,29,0,5.0,5.0,0.0
9909353,24,2,22,89,0,24,244,21,22.0,2.0,20.0,84.0,0.0,22.0,229.0,58,24,34,39.0,17.0,22.0
101032,28,3,25,78,2,26,128,66,16.0,1.0,15.0,46.0,1.0,15.0,66.0,45,28,17,21.0,15.0,6.0
9603281,7,3,4,6,7,0,0,97,3.0,1.0,2.0,2.0,3.0,0.0,0.0,7,7,0,2.0,2.0,0.0
9806368,42,10,32,115,0,42,226,16,24.0,4.0,20.0,78.0,0.0,24.0,121.0,59,42,17,24.0,17.0,7.0
9905323,78,2,76,978,72,6,6,19,65.0,2.0,63.0,874.0,65.0,0.0,0.0,79,78,1,53.0,53.0,0.0
9612449,52,15,37,99,11,41,65,39,21.0,2.0,19.0,44.0,1.0,20.0,20.0,58,52,6,15.0,14.0,1.0
9506423,20,6,14,19,9,11,20,39,5.0,4.0,1.0,1.0,5.0,0.0,0.0,24,20,4,3.0,3.0,0.0
9806249,20,8,12,18,1,19,50,101,10.0,6.0,4.0,5.0,1.0,9.0,21.0,31,20,11,4.0,2.0,2.0
104073,24,5,19,70,0,24,269,20,23.0,5.0,18.0,69.0,0.0,23.0,263.0,57,24,33,33.0,6.0,27.0
2277,18,4,14,84,0,18,216,20,18.0,4.0,14.0,84.0,0.0,18.0,192.0,47,18,29,34.0,12.0,22.0
9209247,12,6,6,11,12,0,0,29,6.0,2.0,4.0,6.0,6.0,0.0,0.0,12,12,0,1.0,1.0,0.0
9406220,34,6,28,107,10,24,52,29,16.0,1.0,15.0,68.0,4.0,12.0,23.0,49,34,15,13.0,12.0,1.0
12039,38,5,33,136,0,38,295,20,29.0,3.0,26.0,116.0,0.0,29.0,276.0,63,38,25,36.0,13.0,23.0
9812305,15,4,11,31,1,14,95,20,12.0,4.0,8.0,27.0,0.0,12.0,84.0,24,15,9,3.0,3.0,0.0
9812516,4,3,1,2,0,4,21,20,2.0,2.0,0.0,0.0,2.0,0.0,0.0,15,4,11,2.0,2.0,0.0
9511208,5,5,0,0,2,3,17,22,0.0,0.0,0.0,0.0,0.0,0.0,0.0,31,5,26,2.0,1.0,1.0
207243,9,3,6,16,0,9,49,37,7.0,1.0,6.0,15.0,0.0,7.0,39.0,17,9,8,14.0,8.0,6.0
9906265,30,6,24,69,0,30,328,2,10.0,2.0,8.0,20.0,0.0,10.0,168.0,107,30,77,24.0,6.0,18.0
9509358,41,9,32,96,3,38,118,6,11.0,3.0,8.0,16.0,2.0,9.0,13.0,58,41,17,11.0,7.0,4.0
9712234,35,3,32,105,8,27,127,18,14.0,1.0,13.0,49.0,2.0,12.0,35.0,60,35,25,16.0,12.0,4.0
9606386,77,27,50,131,32,45,248,10,15.0,4.0,11.0,33.0,0.0,15.0,90.0,113,77,36,12.0,7.0,5.0
9707209,53,17,36,77,16,37,76,60,5.0,2.0,3.0,4.0,0.0,5.0,18.0,76,53,23,6.0,3.0,3.0
9409266,4,2,2,2,1,3,3,99,1.0,1.0,0.0,0.0,1.0,0.0,0.0,6,4,2,,,
5031,13,4,9,21,0,13,64,73,13.0,4.0,9.0,21.0,0.0,13.0,64.0,22,13,9,12.0,5.0,7.0
9607298,28,10,18,59,3,25,101,5,15.0,3.0,12.0,43.0,0.0,15.0,44.0,52,28,24,1.0,1.0,0.0
9706439,17,4,13,25,1,16,52,42,9.0,2.0,7.0,13.0,1.0,8.0,21.0,34,17,17,4.0,4.0,0.0
9410282,62,8,54,246,32,30,40,15,45.0,6.0,39.0,187.0,19.0,26.0,35.0,65,62,3,13.0,13.0,0.0
9511204,9,6,3,3,0,9,35,30,0.0,0.0,0.0,0.0,0.0,0.0,0.0,44,9,35,7.0,2.0,5.0
9612253,22,5,17,61,2,20,75,158,16.0,2.0,14.0,52.0,1.0,15.0,33.0,36,22,14,21.0,15.0,6.0
9312212,71,7,64,320,49,22,25,30,33.0,1.0,32.0,195.0,33.0,0.0,0.0,73,71,2,30.0,30.0,0.0
9308295,34,15,19,40,32,2,2,44,14.0,3.0,11.0,23.0,14.0,0.0,0.0,35,34,1,5.0,5.0,0.0
9412276,33,8,25,78,20,13,17,4,15.0,1.0,14.0,53.0,9.0,6.0,6.0,37,33,4,14.0,13.0,1.0
9901246,42,14,28,87,9,33,254,4,12.0,5.0,7.0,21.0,1.0,11.0,67.0,110,42,68,8.0,7.0,1.0
9812260,35,7,28,152,8,27,48,28,19.0,1.0,18.0,95.0,13.0,6.0,6.0,43,35,8,13.0,11.0,2.0
9311205,220,14,206,2306,214,6,6,11,137.0,3.0,134.0,1959.0,137.0,0.0,0.0,221,220,1,75.0,75.0,0.0
9902271,14,12,2,2,1,13,44,0,1.0,1.0,0.0,0.0,0.0,1.0,7.0,71,14,57,8.0,1.0,7.0
9804285,64,11,53,257,11,53,168,28,24.0,2.0,22.0,100.0,10.0,14.0,19.0,92,64,28,14.0,12.0,2.0
9405403,3,3,0,0,1,2,3,293,1.0,1.0,0.0,0.0,0.0,1.0,2.0,6,3,3,3.0,1.0,2.0
9206221,10,7,3,6,10,0,0,41,5.0,5.0,0.0,0.0,5.0,0.0,0.0,10,10,0,3.0,3.0,0.0
9607376,10,4,6,14,10,0,0,69,3.0,3.0,0.0,0.0,3.0,0.0,0.0,12,10,2,6.0,6.0,0.0
9909556,5,4,1,2,0,5,23,89,4.0,3.0,1.0,2.0,0.0,4.0,22.0,12,5,7,8.0,1.0,7.0
9702433,23,4,19,49,4,19,24,42,11.0,2.0,9.0,27.0,1.0,10.0,15.0,25,23,2,10.0,9.0,1.0
9408284,13,2,11,30,0,13,17,49,8.0,2.0,6.0,13.0,8.0,0.0,0.0,15,13,2,7.0,7.0,0.0
9609469,22,5,17,37,0,22,62,78,10.0,3.0,7.0,18.0,0.0,10.0,20.0,30,22,8,13.0,9.0,4.0
203075,6,3,3,4,0,6,16,23,1.0,1.0,0.0,0.0,0.0,1.0,1.0,20,6,14,5.0,3.0,2.0
9712263,1,1,0,0,0,1,1,100,1.0,1.0,0.0,0.0,0.0,1.0,1.0,2,1,1,,,
9501407,92,9,83,481,27,65,113,55,50.0,1.0,49.0,312.0,11.0,39.0,71.0,95,92,3,30.0,28.0,2.0
9509277,4,4,0,0,1,3,5,173,,,,,,,,6,4,2,,,
101250,11,2,9,12,0,11,94,55,6.0,1.0,5.0,6.0,0.0,6.0,44.0,46,11,35,16.0,3.0,13.0
9712322,12,10,2,2,0,12,101,10,0.0,0.0,0.0,0.0,0.0,0.0,0.0,99,12,87,8.0,0.0,8.0
7270,15,6,9,16,0,15,103,0,7.0,3.0,4.0,6.0,0.0,7.0,30.0,54,15,39,13.0,7.0,6.0
9704205,41,8,33,88,8,33,71,55,16.0,2.0,14.0,36.0,2.0,14.0,14.0,58,41,17,11.0,10.0,1.0
8269,14,9,5,5,0,14,86,3,5.0,3.0,2.0,2.0,0.0,5.0,24.0,56,14,42,10.0,0.0,10.0
9909438,10,4,6,10,0,10,40,161,6.0,3.0,3.0,7.0,0.0,6.0,24.0,18,10,8,9.0,5.0,4.0
9503307,16,4,12,38,1,15,90,124,15.0,4.0,11.0,36.0,0.0,15.0,87.0,29,16,13,24.0,14.0,10.0
9911496,43,6,37,200,0,43,186,18,34.0,2.0,32.0,179.0,0.0,34.0,160.0,56,43,13,35.0,29.0,6.0
101217,2,1,1,1,0,2,10,18,1.0,1.0,0.0,0.0,0.0,1.0,4.0,17,2,15,1.0,0.0,1.0
104283,35,14,21,37,0,35,340,27,21.0,7.0,14.0,25.0,0.0,21.0,197.0,168,35,133,20.0,2.0,18.0
9903238,29,4,25,88,8,21,60,5,11.0,2.0,9.0,27.0,1.0,10.0,30.0,36,29,7,3.0,2.0,1.0
9808459,48,3,45,279,7,41,158,18,38.0,2.0,36.0,238.0,2.0,36.0,102.0,76,48,28,29.0,26.0,3.0
9609465,10,7,3,4,9,1,3,13,0.0,0.0,0.0,0.0,0.0,0.0,0.0,32,10,22,5.0,0.0,5.0
9907428,28,10,18,57,4,24,100,92,6.0,3.0,3.0,6.0,0.0,6.0,25.0,52,28,24,16.0,10.0,6.0
10203,34,11,23,67,1,33,287,18,25.0,7.0,18.0,52.0,0.0,25.0,210.0,69,34,35,25.0,10.0,15.0
9903385,30,8,22,63,0,30,247,7,9.0,2.0,7.0,22.0,0.0,9.0,104.0,61,30,31,11.0,5.0,6.0
9403316,5,2,3,6,5,0,0,18,2.0,2.0,0.0,0.0,2.0,0.0,0.0,5,5,0,2.0,2.0,0.0
104085,4,3,1,1,3,1,2,107,,,,,,,,7,4,3,,,
8012,22,8,14,19,12,10,39,0,6.0,2.0,4.0,6.0,1.0,5.0,21.0,37,22,15,8.0,2.0,6.0
9912275,4,3,1,1,1,3,8,111,2.0,2.0,0.0,0.0,0.0,2.0,7.0,12,4,8,7.0,2.0,5.0
9607488,11,5,6,7,3,8,17,41,4.0,2.0,2.0,2.0,0.0,4.0,7.0,27,11,16,6.0,4.0,2.0
9606333,1,1,0,0,1,0,0,118,,,,,,,,1,1,0,,,
7198,21,15,6,8,17,4,7,259,12.0,8.0,4.0,4.0,12.0,0.0,0.0,29,21,8,5.0,5.0,0.0
9408239,6,4,2,3,0,6,16,16,5.0,3.0,2.0,3.0,0.0,5.0,13.0,9,6,3,7.0,4.0,3.0
9710368,15,3,12,38,4,11,31,4,2.0,2.0,0.0,0.0,0.0,2.0,4.0,31,15,16,6.0,1.0,5.0
9905566,90,20,70,271,3,87,511,16,48.0,8.0,40.0,150.0,1.0,47.0,340.0,117,90,27,33.0,19.0,14.0
9310246,18,4,14,21,18,0,0,14,3.0,1.0,2.0,2.0,3.0,0.0,0.0,18,18,0,4.0,4.0,0.0
9508241,20,6,14,57,4,16,94,94,12.0,2.0,10.0,33.0,2.0,10.0,59.0,40,20,20,19.0,8.0,11.0
9803324,5,3,2,4,1,4,18,162,3.0,1.0,2.0,3.0,0.0,3.0,8.0,15,5,10,6.0,2.0,4.0
9505317,31,4,27,60,10,21,52,8,11.0,1.0,10.0,26.0,3.0,8.0,16.0,41,31,10,11.0,9.0,2.0
105126,3,3,0,0,1,2,5,39,0.0,0.0,0.0,0.0,0.0,0.0,0.0,21,3,18,6.0,0.0,6.0
9409356,17,4,13,30,4,13,25,135,8.0,1.0,7.0,13.0,0.0,8.0,15.0,20,17,3,10.0,8.0,2.0
6278,38,5,33,135,0,38,345,2,29.0,3.0,26.0,110.0,0.0,29.0,141.0,58,38,20,36.0,25.0,11.0
9909389,6,2,4,5,2,4,40,2,1.0,1.0,0.0,0.0,0.0,1.0,31.0,44,6,38,20.0,1.0,19.0
9907362,67,8,59,261,1,66,576,2,40.0,5.0,35.0,141.0,0.0,40.0,403.0,91,67,24,38.0,20.0,18.0
102291,19,13,6,8,2,17,66,11,10.0,7.0,3.0,4.0,1.0,9.0,25.0,42,19,23,3.0,3.0,0.0
9509353,38,3,35,115,1,37,77,11,18.0,1.0,17.0,39.0,0.0,18.0,40.0,41,38,3,9.0,8.0,1.0
11270,26,10,16,25,4,22,195,16,11.0,5.0,6.0,9.0,0.0,11.0,103.0,72,26,46,30.0,5.0,25.0
9609377,32,6,26,63,9,23,45,135,9.0,2.0,7.0,10.0,0.0,9.0,22.0,41,32,9,8.0,7.0,1.0
110083,16,4,12,31,1,15,184,19,14.0,2.0,12.0,31.0,0.0,14.0,164.0,49,16,33,31.0,11.0,20.0
3142,25,10,15,32,4,21,196,17,7.0,3.0,4.0,6.0,0.0,7.0,112.0,97,25,72,29.0,2.0,27.0
201019,11,5,6,12,0,11,127,8,7.0,3.0,4.0,8.0,0.0,7.0,74.0,43,11,32,27.0,6.0,21.0
9811436,3,3,0,0,0,3,14,160,1.0,1.0,0.0,0.0,0.0,1.0,5.0,24,3,21,3.0,1.0,2.0
201139,31,3,28,175,0,31,506,28,29.0,2.0,27.0,171.0,0.0,29.0,376.0,73,31,42,47.0,28.0,19.0
111298,3,1,2,2,0,3,24,28,2.0,1.0,1.0,1.0,0.0,2.0,12.0,15,3,12,,,
3328,12,6,6,8,1,11,79,2,7.0,3.0,4.0,6.0,0.0,7.0,25.0,31,12,19,10.0,5.0,5.0
9510449,109,20,89,467,17,92,296,14,55.0,10.0,45.0,263.0,3.0,52.0,199.0,125,109,16,27.0,23.0,4.0
9212215,2,1,1,1,2,0,0,108,,,,,,,,2,2,0,,,
9604443,17,4,13,45,2,15,30,142,15.0,3.0,12.0,43.0,1.0,14.0,29.0,20,17,3,13.0,11.0,2.0
107156,20,12,8,13,3,17,135,2,8.0,6.0,2.0,2.0,0.0,8.0,28.0,56,20,36,14.0,5.0,9.0
10066,8,4,4,9,0,8,15,28,6.0,2.0,4.0,9.0,6.0,0.0,0.0,12,8,4,3.0,3.0,0.0
9912266,27,6,21,59,0,27,228,2,20.0,4.0,16.0,47.0,0.0,20.0,62.0,44,27,17,19.0,14.0,5.0
9909480,49,7,42,150,2,47,418,32,34.0,2.0,32.0,118.0,0.0,34.0,319.0,93,49,44,19.0,13.0,6.0
5185,12,3,9,19,1,11,70,10,9.0,3.0,6.0,15.0,0.0,9.0,46.0,23,12,11,17.0,9.0,8.0
9609480,36,12,24,53,13,23,52,10,9.0,4.0,5.0,11.0,1.0,8.0,8.0,49,36,13,8.0,8.0,0.0
9408319,15,6,9,18,7,8,23,69,2.0,1.0,1.0,1.0,2.0,0.0,0.0,32,15,17,2.0,0.0,2.0
9503369,2,2,0,0,0,2,3,120,1.0,1.0,0.0,0.0,1.0,0.0,0.0,4,2,2,1.0,0.0,1.0
9310291,30,6,24,72,30,0,0,12,7.0,3.0,4.0,7.0,7.0,0.0,0.0,30,30,0,2.0,2.0,0.0
9408282,19,7,12,32,19,0,0,164,6.0,3.0,3.0,4.0,6.0,0.0,0.0,19,19,0,2.0,2.0,0.0
9306278,6,4,2,2,4,2,3,234,1.0,1.0,0.0,0.0,0.0,1.0,1.0,9,6,3,1.0,1.0,0.0
9912321,2,1,1,1,0,2,7,141,1.0,1.0,0.0,0.0,0.0,1.0,3.0,19,2,17,10.0,1.0,9.0
9402208,14,3,11,26,14,0,0,30,11.0,2.0,9.0,19.0,11.0,0.0,0.0,14,14,0,6.0,6.0,0.0
9908435,14,4,10,14,1,13,50,3,,,,,,,,24,14,10,1.0,1.0,0.0
2210,3,2,1,1,1,2,6,152,0.0,0.0,0.0,0.0,0.0,0.0,0.0,18,3,15,6.0,0.0,6.0
12072,2,2,0,0,0,2,2,909,,,,,,,,3,2,1,,,
9711215,33,4,29,117,2,31,152,1,15.0,3.0,12.0,28.0,1.0,14.0,33.0,57,33,24,13.0,9.0,4.0
2104,1,1,0,0,1,0,0,419,0.0,0.0,0.0,0.0,0.0,0.0,0.0,4,1,3,1.0,1.0,0.0
9311277,9,5,4,8,1,8,23,75,6.0,3.0,3.0,5.0,0.0,6.0,16.0,16,9,7,6.0,4.0,2.0
9212250,28,11,17,34,28,0,0,196,14.0,2.0,12.0,23.0,14.0,0.0,0.0,28,28,0,7.0,7.0,0.0
7315,29,1,28,132,0,29,196,9,24.0,1.0,23.0,113.0,0.0,24.0,165.0,43,29,14,18.0,15.0,3.0
9605327,20,1,19,87,1,19,107,11,18.0,1.0,17.0,80.0,0.0,18.0,104.0,28,20,8,16.0,12.0,4.0
9611218,89,9,80,405,0,89,480,17,71.0,6.0,65.0,353.0,0.0,71.0,411.0,102,89,13,42.0,32.0,10.0
9610364,13,5,8,20,0,13,104,17,13.0,5.0,8.0,20.0,0.0,13.0,100.0,32,13,19,23.0,9.0,14.0
9409211,16,5,11,35,16,0,0,102,7.0,1.0,6.0,17.0,7.0,0.0,0.0,16,16,0,7.0,7.0,0.0
9509262,2,2,0,0,0,2,3,168,0.0,0.0,0.0,0.0,0.0,0.0,0.0,7,2,5,2.0,1.0,1.0
9403237,20,3,17,59,9,11,23,56,11.0,1.0,10.0,28.0,11.0,0.0,0.0,24,20,4,9.0,9.0,0.0
9601262,18,7,11,21,2,16,81,5,4.0,3.0,1.0,1.0,0.0,4.0,21.0,34,18,16,5.0,4.0,1.0
9410271,5,3,2,2,2,3,3,108,3.0,2.0,1.0,1.0,0.0,3.0,3.0,6,5,1,1.0,1.0,0.0
9406373,18,5,13,39,15,3,4,8,9.0,1.0,8.0,24.0,9.0,0.0,0.0,20,18,2,10.0,10.0,0.0
9512387,13,8,5,7,12,1,1,238,5.0,3.0,2.0,2.0,4.0,1.0,1.0,14,13,1,4.0,3.0,1.0
106314,8,6,2,2,8,0,0,93,2.0,1.0,1.0,1.0,2.0,0.0,0.0,8,8,0,3.0,3.0,0.0
9903337,48,21,27,75,9,39,151,44,12.0,6.0,6.0,14.0,0.0,12.0,73.0,69,48,21,15.0,7.0,8.0
9811251,18,3,15,37,2,16,89,7,7.0,2.0,5.0,10.0,0.0,7.0,52.0,33,18,15,13.0,10.0,3.0
9210218,38,9,29,108,38,0,0,10,18.0,4.0,14.0,43.0,18.0,0.0,0.0,38,38,0,12.0,12.0,0.0
9511271,3,2,1,1,2,1,2,88,1.0,1.0,0.0,0.0,0.0,1.0,1.0,5,3,2,1.0,1.0,0.0
9709431,3,3,0,0,1,2,9,5,1.0,1.0,0.0,0.0,0.0,1.0,7.0,21,3,18,4.0,1.0,3.0
9804436,38,5,33,104,0,38,161,54,27.0,3.0,24.0,75.0,1.0,26.0,101.0,50,38,12,19.0,13.0,6.0
9405303,13,7,6,10,12,1,1,101,2.0,2.0,0.0,0.0,2.0,0.0,0.0,15,13,2,4.0,4.0,0.0
9610303,2,2,0,0,1,1,3,101,2.0,2.0,0.0,0.0,1.0,1.0,2.0,6,2,4,1.0,0.0,1.0
109122,7,2,5,7,1,6,69,24,6.0,1.0,5.0,7.0,0.0,6.0,66.0,35,7,28,23.0,5.0,18.0
9904479,3,2,1,1,0,3,5,24,0.0,0.0,0.0,0.0,0.0,0.0,0.0,20,3,17,5.0,0.0,5.0
9406253,1,1,0,0,0,1,3,69,0.0,0.0,0.0,0.0,0.0,0.0,0.0,8,1,7,2.0,0.0,2.0
9407274,20,14,6,12,12,8,10,279,6.0,5.0,1.0,1.0,6.0,0.0,0.0,26,20,6,3.0,2.0,1.0
9304259,8,5,3,7,8,0,0,776,1.0,1.0,0.0,0.0,1.0,0.0,0.0,8,8,0,3.0,3.0,0.0
9807298,19,5,14,28,0,19,63,9,5.0,2.0,3.0,5.0,0.0,5.0,19.0,33,19,14,9.0,3.0,6.0
9710508,13,4,9,16,1,12,68,14,11.0,3.0,8.0,14.0,0.0,11.0,57.0,31,13,18,7.0,4.0,3.0
9409212,49,12,37,85,6,43,122,14,17.0,6.0,11.0,19.0,0.0,17.0,55.0,56,49,7,16.0,11.0,5.0
9409455,14,4,10,18,5,9,16,14,4.0,1.0,3.0,6.0,4.0,0.0,0.0,18,14,4,4.0,4.0,0.0
9310204,4,2,2,3,4,0,0,14,1.0,1.0,0.0,0.0,1.0,0.0,0.0,4,4,0,1.0,1.0,0.0
9806513,21,5,16,38,3,18,54,68,8.0,1.0,7.0,17.0,1.0,7.0,19.0,29,21,8,7.0,3.0,4.0
9908500,1,1,0,0,0,1,1,14,0.0,0.0,0.0,0.0,0.0,0.0,0.0,24,1,23,4.0,0.0,4.0
9502285,18,3,15,66,2,16,34,13,17.0,2.0,15.0,64.0,3.0,14.0,29.0,27,18,9,13.0,10.0,3.0
9407261,19,4,15,30,11,8,10,94,6.0,1.0,5.0,10.0,0.0,6.0,6.0,22,19,3,4.0,4.0,0.0
102230,11,8,3,5,1,10,46,45,6.0,4.0,2.0,2.0,0.0,6.0,33.0,20,11,9,13.0,5.0,8.0
11252,24,9,15,63,0,24,372,11,20.0,7.0,13.0,59.0,0.0,20.0,327.0,62,24,38,34.0,14.0,20.0
9504247,17,10,7,12,1,16,25,16,11.0,8.0,3.0,6.0,0.0,11.0,19.0,19,17,2,3.0,3.0,0.0
9604437,25,10,15,36,5,20,40,258,10.0,4.0,6.0,14.0,2.0,8.0,13.0,30,25,5,10.0,8.0,2.0
9409373,2,1,1,1,0,2,2,127,0.0,0.0,0.0,0.0,0.0,0.0,0.0,4,2,2,1.0,0.0,1.0
9506333,18,8,10,21,11,7,8,150,6.0,4.0,2.0,2.0,0.0,6.0,6.0,20,18,2,4.0,4.0,0.0
9701312,3,3,0,0,1,2,2,106,0.0,0.0,0.0,0.0,0.0,0.0,0.0,5,3,2,1.0,0.0,1.0
9707514,5,2,3,5,0,5,18,66,3.0,2.0,1.0,1.0,0.0,3.0,8.0,14,5,9,7.0,2.0,5.0
9508204,51,12,39,168,9,42,91,13,33.0,5.0,28.0,114.0,3.0,30.0,61.0,56,51,5,20.0,17.0,3.0
9410212,2,1,1,1,2,0,0,208,2.0,1.0,1.0,1.0,2.0,0.0,0.0,5,2,3,2.0,2.0,0.0
9905477,13,2,11,21,13,0,0,97,10.0,1.0,9.0,18.0,10.0,0.0,0.0,13,13,0,7.0,7.0,0.0
9711481,15,3,12,33,0,15,76,8,5.0,1.0,4.0,6.0,0.0,5.0,16.0,27,15,12,17.0,9.0,8.0
9307268,18,5,13,33,2,16,29,15,5.0,1.0,4.0,4.0,5.0,0.0,0.0,23,18,5,3.0,3.0,0.0
9412270,3,2,1,1,1,2,3,15,0.0,0.0,0.0,0.0,0.0,0.0,0.0,5,3,2,,,
9706482,27,6,21,63,0,27,180,12,9.0,2.0,7.0,16.0,0.0,9.0,80.0,45,27,18,18.0,8.0,10.0
9702427,1,1,0,0,1,0,0,248,0.0,0.0,0.0,0.0,0.0,0.0,0.0,5,1,4,3.0,0.0,3.0
9212298,16,8,8,13,16,0,0,302,6.0,6.0,0.0,0.0,6.0,0.0,0.0,16,16,0,4.0,4.0,0.0
103328,8,5,3,4,0,8,28,122,6.0,4.0,2.0,3.0,0.0,6.0,23.0,14,8,6,12.0,6.0,6.0
5007,39,9,30,118,2,37,266,0,27.0,5.0,22.0,83.0,0.0,27.0,212.0,57,39,18,28.0,17.0,11.0
9066,12,3,9,20,0,12,120,12,3.0,1.0,2.0,3.0,0.0,3.0,74.0,68,12,56,31.0,3.0,28.0
9905458,5,3,2,3,0,5,7,0,0.0,0.0,0.0,0.0,0.0,0.0,0.0,11,5,6,1.0,1.0,0.0
9501251,40,9,31,105,20,20,30,100,22.0,1.0,21.0,81.0,5.0,17.0,27.0,42,40,2,18.0,16.0,2.0
9812491,6,4,2,2,1,5,25,52,4.0,3.0,1.0,1.0,0.0,4.0,14.0,30,6,24,6.0,0.0,6.0
9805474,4,1,3,6,0,4,11,32,0.0,0.0,0.0,0.0,0.0,0.0,0.0,10,4,6,1.0,0.0,1.0
9709474,16,2,14,32,9,7,12,318,4.0,1.0,3.0,4.0,1.0,3.0,6.0,23,16,7,6.0,4.0,2.0
9903540,20,4,16,52,0,20,201,1,16.0,3.0,13.0,46.0,0.0,16.0,179.0,48,20,28,22.0,12.0,10.0
9801253,8,4,4,4,1,7,7,146,5.0,3.0,2.0,2.0,0.0,5.0,5.0,9,8,1,6.0,5.0,1.0
7001,12,7,5,9,2,10,11,376,4.0,2.0,2.0,3.0,1.0,3.0,3.0,18,12,6,6.0,5.0,1.0
9404349,15,2,13,26,6,9,9,10,2.0,2.0,0.0,0.0,2.0,0.0,0.0,18,15,3,7.0,6.0,1.0
9510231,5,2,3,6,4,1,2,52,3.0,1.0,2.0,3.0,3.0,0.0,0.0,7,5,2,2.0,1.0,1.0
9411386,9,4,5,8,9,0,0,151,2.0,1.0,1.0,1.0,2.0,0.0,0.0,9,9,0,1.0,1.0,0.0
9910345,4,4,0,0,1,3,8,25,1.0,1.0,0.0,0.0,0.0,1.0,4.0,10,4,6,7.0,1.0,6.0
9903237,3,3,0,0,1,2,3,92,1.0,1.0,0.0,0.0,0.0,1.0,2.0,11,3,8,3.0,1.0,2.0
9307203,18,5,13,24,12,6,6,123,8.0,2.0,6.0,11.0,8.0,0.0,0.0,21,18,3,5.0,5.0,0.0
9501207,3,3,0,0,1,2,2,123,1.0,1.0,0.0,0.0,1.0,0.0,0.0,6,3,3,1.0,1.0,0.0
9211206,6,3,3,3,6,0,0,103,3.0,2.0,1.0,1.0,3.0,0.0,0.0,6,6,0,2.0,2.0,0.0
9903534,14,9,5,6,2,12,54,21,6.0,3.0,3.0,3.0,0.0,6.0,21.0,30,14,16,9.0,3.0,6.0
9310338,20,8,12,17,15,5,5,171,11.0,7.0,4.0,5.0,7.0,4.0,4.0,21,20,1,8.0,7.0,1.0
9805316,22,6,16,41,4,18,31,14,13.0,3.0,10.0,27.0,1.0,12.0,19.0,31,22,9,12.0,10.0,2.0
2066,10,6,4,5,2,8,17,30,0.0,0.0,0.0,0.0,0.0,0.0,0.0,36,10,26,4.0,2.0,2.0
1212,12,1,11,22,0,12,101,30,8.0,1.0,7.0,13.0,1.0,7.0,49.0,38,12,26,16.0,5.0,11.0
9912520,9,1,8,23,5,4,7,30,6.0,1.0,5.0,10.0,6.0,0.0,0.0,12,9,3,2.0,2.0,0.0
5191,25,2,23,106,13,12,36,165,24.0,1.0,23.0,106.0,24.0,0.0,0.0,34,25,9,20.0,20.0,0.0
9309325,2,2,0,0,1,1,2,923,0.0,0.0,0.0,0.0,0.0,0.0,0.0,7,2,5,2.0,0.0,2.0
108111,4,4,0,0,1,3,11,13,0.0,0.0,0.0,0.0,0.0,0.0,0.0,95,4,91,23.0,0.0,23.0
9907206,10,4,6,10,0,10,53,32,4.0,2.0,2.0,2.0,0.0,4.0,6.0,20,10,10,4.0,3.0,1.0
103221,4,1,3,3,0,4,11,13,4.0,1.0,3.0,3.0,0.0,4.0,11.0,11,4,7,6.0,2.0,4.0
5274,26,11,15,36,18,8,13,239,13.0,4.0,9.0,24.0,13.0,0.0,0.0,29,26,3,9.0,9.0,0.0
9601254,6,2,4,6,2,4,4,22,5.0,2.0,3.0,4.0,1.0,4.0,4.0,10,6,4,3.0,0.0,3.0
9507201,2,1,1,1,0,2,3,112,2.0,1.0,1.0,1.0,0.0,2.0,3.0,14,2,12,4.0,2.0,2.0
9609216,9,3,6,9,9,0,0,145,5.0,1.0,4.0,6.0,5.0,0.0,0.0,9,9,0,5.0,5.0,0.0
207101,15,6,9,18,0,15,110,1,0.0,0.0,0.0,0.0,0.0,0.0,0.0,62,15,47,16.0,2.0,14.0
9610506,15,3,12,36,2,13,44,36,8.0,1.0,7.0,12.0,1.0,7.0,20.0,21,15,6,13.0,7.0,6.0
106199,3,3,0,0,1,2,6,12,0.0,0.0,0.0,0.0,0.0,0.0,0.0,22,3,19,2.0,1.0,1.0
9508342,3,2,1,1,1,2,10,36,0.0,0.0,0.0,0.0,0.0,0.0,0.0,14,3,11,9.0,0.0,9.0
9408310,14,8,6,11,6,8,15,26,6.0,2.0,4.0,4.0,0.0,6.0,12.0,23,14,9,2.0,2.0,0.0
9301202,3,3,0,0,3,0,0,546,2.0,2.0,0.0,0.0,2.0,0.0,0.0,3,3,0,2.0,2.0,0.0
108242,10,3,7,8,1,9,50,192,1.0,1.0,0.0,0.0,0.0,1.0,3.0,32,10,22,5.0,1.0,4.0
9706311,17,8,9,16,1,16,90,6,10.0,4.0,6.0,11.0,0.0,10.0,64.0,32,17,15,11.0,4.0,7.0
9911511,15,2,13,30,0,15,88,12,4.0,2.0,2.0,3.0,0.0,4.0,38.0,57,15,42,12.0,3.0,9.0
9608412,24,6,18,40,21,3,3,102,10.0,2.0,8.0,16.0,10.0,0.0,0.0,26,24,2,7.0,7.0,0.0
112057,4,1,3,4,0,4,17,21,2.0,1.0,1.0,1.0,0.0,2.0,2.0,16,4,12,8.0,4.0,4.0
9709351,3,2,1,1,1,2,15,141,2.0,1.0,1.0,1.0,0.0,2.0,9.0,11,3,8,8.0,2.0,6.0
9204212,28,8,20,45,28,0,0,253,12.0,6.0,6.0,15.0,12.0,0.0,0.0,28,28,0,7.0,7.0,0.0
9803310,17,7,10,20,1,16,54,69,4.0,2.0,2.0,3.0,0.0,4.0,9.0,26,17,9,9.0,5.0,4.0
9708348,37,10,27,63,1,36,96,1,24.0,4.0,20.0,48.0,0.0,24.0,44.0,44,37,7,23.0,19.0,4.0
9611406,5,2,3,5,0,5,42,6,,,,,,,,20,5,15,3.0,3.0,0.0
9804202,16,9,7,8,0,16,87,98,12.0,8.0,4.0,5.0,0.0,12.0,70.0,36,16,20,15.0,5.0,10.0
9509369,14,2,12,20,14,0,0,154,14.0,2.0,12.0,20.0,14.0,0.0,0.0,14,14,0,8.0,8.0,0.0
9711345,10,4,6,8,7,3,3,64,6.0,1.0,5.0,7.0,3.0,3.0,3.0,11,10,1,6.0,5.0,1.0
9712299,13,5,8,16,1,12,33,44,4.0,1.0,3.0,3.0,0.0,4.0,6.0,25,13,12,11.0,7.0,4.0
9804300,18,5,13,36,5,13,23,7,7.0,2.0,5.0,11.0,7.0,0.0,0.0,23,18,5,7.0,4.0,3.0
9405202,13,4,9,11,6,7,8,195,5.0,1.0,4.0,6.0,5.0,0.0,0.0,15,13,2,5.0,5.0,0.0
9403274,36,8,28,79,25,11,17,25,14.0,2.0,12.0,29.0,14.0,0.0,0.0,40,36,4,11.0,11.0,0.0
9707335,8,5,3,4,2,6,8,129,3.0,1.0,2.0,3.0,0.0,3.0,5.0,12,8,4,4.0,3.0,1.0
9911393,8,4,4,6,0,8,26,25,4.0,1.0,3.0,3.0,0.0,4.0,6.0,16,8,8,6.0,4.0,2.0
9503292,5,5,0,0,5,0,0,221,3.0,3.0,0.0,0.0,3.0,0.0,0.0,5,5,0,2.0,2.0,0.0
9801257,9,2,7,15,1,8,14,43,1.0,1.0,0.0,0.0,0.0,1.0,1.0,16,9,7,2.0,1.0,1.0
9811255,5,2,3,4,0,5,23,42,2.0,1.0,1.0,1.0,0.0,2.0,13.0,17,5,12,12.0,2.0,10.0
204343,10,5,5,6,1,9,47,22,7.0,3.0,4.0,5.0,0.0,7.0,33.0,38,10,28,11.0,4.0,7.0
9611305,9,8,1,1,7,2,4,430,2.0,2.0,0.0,0.0,1.0,1.0,2.0,11,9,2,3.0,1.0,2.0
9801254,7,6,1,1,0,7,17,5,1.0,1.0,0.0,0.0,0.0,1.0,3.0,28,7,21,1.0,1.0,0.0
8134,4,2,2,3,0,4,35,0,4.0,2.0,2.0,3.0,0.0,4.0,21.0,28,4,24,12.0,3.0,9.0
9502407,2,2,0,0,2,0,0,200,0.0,0.0,0.0,0.0,0.0,0.0,0.0,3,2,1,1.0,0.0,1.0
9803356,18,4,14,38,0,18,61,1,17.0,4.0,13.0,37.0,0.0,17.0,59.0,26,18,8,14.0,10.0,4.0
9702202,5,3,2,2,3,2,7,61,1.0,1.0,0.0,0.0,0.0,1.0,4.0,24,5,19,11.0,1.0,10.0
9603241,2,2,0,0,0,2,3,248,1.0,1.0,0.0,0.0,1.0,0.0,0.0,4,2,2,,,
9909364,6,4,2,2,1,5,27,2,5.0,3.0,2.0,2.0,0.0,5.0,27.0,15,6,9,1.0,0.0,1.0
207031,4,4,0,0,1,3,8,11,1.0,1.0,0.0,0.0,1.0,0.0,0.0,12,4,8,1.0,0.0,1.0
9610274,34,10,24,51,16,18,41,9,9.0,1.0,8.0,20.0,2.0,7.0,12.0,38,34,4,5.0,4.0,1.0
9710251,1,1,0,0,1,0,0,1279,,,,,,,,1,1,0,,,
9911480,6,2,4,6,3,3,6,226,5.0,1.0,4.0,6.0,5.0,0.0,0.0,29,6,23,5.0,5.0,0.0
9807498,1,1,0,0,0,1,3,25,1.0,1.0,0.0,0.0,0.0,1.0,2.0,6,1,5,4.0,1.0,3.0
101010,13,2,11,23,6,7,30,23,1.0,1.0,0.0,0.0,0.0,1.0,7.0,28,13,15,2.0,2.0,0.0
12268,2,1,1,1,0,2,6,122,2.0,1.0,1.0,1.0,0.0,2.0,6.0,8,2,6,6.0,2.0,4.0
110098,5,1,4,4,0,5,38,32,2.0,2.0,0.0,0.0,0.0,2.0,16.0,28,5,23,6.0,3.0,3.0
104278,5,2,3,3,0,5,131,23,3.0,1.0,2.0,2.0,0.0,3.0,115.0,63,5,58,31.0,1.0,30.0
9308284,31,11,20,57,31,0,0,54,15.0,3.0,12.0,25.0,15.0,0.0,0.0,31,31,0,8.0,8.0,0.0
9403263,5,4,1,1,4,1,1,83,0.0,0.0,0.0,0.0,0.0,0.0,0.0,7,5,2,1.0,1.0,0.0
9810552,8,2,6,10,1,7,29,48,4.0,1.0,3.0,3.0,1.0,3.0,5.0,22,8,14,5.0,3.0,2.0
9307298,21,2,19,68,19,2,2,33,18.0,3.0,15.0,51.0,18.0,0.0,0.0,22,21,1,11.0,11.0,0.0
9703206,2,2,0,0,0,2,9,26,0.0,0.0,0.0,0.0,0.0,0.0,0.0,10,2,8,3.0,0.0,3.0
9806487,5,2,3,3,2,3,5,158,4.0,1.0,3.0,3.0,4.0,0.0,0.0,13,5,8,3.0,3.0,0.0
9405377,5,1,4,5,5,0,0,2076,1.0,1.0,0.0,0.0,1.0,0.0,0.0,6,5,1,2.0,2.0,0.0
9908436,2,2,0,0,0,2,14,3,0.0,0.0,0.0,0.0,0.0,0.0,0.0,19,2,17,3.0,1.0,2.0
9912506,10,2,8,13,10,0,0,70,8.0,1.0,7.0,12.0,8.0,0.0,0.0,10,10,0,1.0,1.0,0.0
204314,124,21,103,509,9,115,419,0,31.0,4.0,27.0,134.0,0.0,31.0,149.0,165,124,41,32.0,20.0,12.0
9902220,26,3,23,80,1,25,172,15,25.0,2.0,23.0,80.0,0.0,25.0,168.0,46,26,20,12.0,11.0,1.0
9904416,10,4,6,12,0,10,31,17,7.0,2.0,5.0,11.0,0.0,7.0,21.0,18,10,8,11.0,7.0,4.0
103087,26,6,20,54,2,24,150,7,15.0,5.0,10.0,23.0,0.0,15.0,104.0,46,26,20,7.0,7.0,0.0
9502381,7,3,4,7,7,0,0,238,1.0,1.0,0.0,0.0,1.0,0.0,0.0,8,7,1,1.0,1.0,0.0
9610407,16,3,13,33,2,14,35,27,11.0,1.0,10.0,30.0,0.0,11.0,27.0,21,16,5,4.0,4.0,0.0
9611359,35,5,30,99,29,6,6,27,28.0,2.0,26.0,89.0,28.0,0.0,0.0,36,35,1,11.0,11.0,0.0
9502246,3,2,1,1,0,3,6,10,2.0,2.0,0.0,0.0,0.0,2.0,3.0,6,3,3,2.0,1.0,1.0
101151,15,3,12,53,0,15,132,46,13.0,2.0,11.0,44.0,0.0,13.0,102.0,45,15,30,24.0,13.0,11.0
9910382,3,1,2,2,0,3,6,54,0.0,0.0,0.0,0.0,0.0,0.0,0.0,21,3,18,12.0,0.0,12.0
204137,3,2,1,1,1,2,19,46,1.0,1.0,0.0,0.0,0.0,1.0,8.0,24,3,21,13.0,1.0,12.0
201225,26,3,23,92,0,26,53,107,22.0,3.0,19.0,70.0,0.0,22.0,41.0,36,26,10,14.0,12.0,2.0
104316,0,0,0,0,0,0,0,3,0.0,0.0,0.0,0.0,0.0,0.0,0.0,29,0,29,1.0,0.0,1.0
105113,10,3,7,13,0,10,63,37,6.0,2.0,4.0,9.0,0.0,6.0,22.0,22,10,12,8.0,5.0,3.0
9411378,5,2,3,4,2,3,13,10,1.0,1.0,0.0,0.0,0.0,1.0,5.0,55,5,50,8.0,0.0,8.0
9912403,11,1,10,37,1,10,28,47,11.0,1.0,10.0,37.0,1.0,10.0,26.0,32,11,21,15.0,11.0,4.0
9609245,13,3,10,22,1,12,35,47,11.0,2.0,9.0,19.0,2.0,9.0,25.0,24,13,11,5.0,5.0,0.0
111290,5,3,2,3,0,5,59,0,0.0,0.0,0.0,0.0,0.0,0.0,0.0,34,5,29,10.0,2.0,8.0
203051,9,2,7,13,0,9,76,107,7.0,1.0,6.0,12.0,0.0,7.0,40.0,33,9,24,14.0,7.0,7.0
9512266,2,2,0,0,0,2,5,618,0.0,0.0,0.0,0.0,0.0,0.0,0.0,9,2,7,1.0,0.0,1.0
9606214,9,6,3,4,1,8,19,228,6.0,4.0,2.0,3.0,1.0,5.0,13.0,17,9,8,5.0,3.0,2.0
9902233,21,4,17,51,0,21,69,65,8.0,3.0,5.0,12.0,1.0,7.0,26.0,38,21,17,16.0,6.0,10.0
108089,4,4,0,0,2,2,2,87,0.0,0.0,0.0,0.0,0.0,0.0,0.0,13,4,9,1.0,0.0,1.0
9707404,3,3,0,0,2,1,1,13,1.0,1.0,0.0,0.0,0.0,1.0,1.0,13,3,10,2.0,0.0,2.0
9605388,4,3,1,1,2,2,2,624,1.0,1.0,0.0,0.0,1.0,0.0,0.0,5,4,1,2.0,2.0,0.0
9811514,5,2,3,4,3,2,3,272,4.0,3.0,1.0,1.0,4.0,0.0,0.0,9,5,4,3.0,3.0,0.0
101042,22,3,19,70,0,22,279,11,21.0,3.0,18.0,68.0,0.0,21.0,217.0,73,22,51,33.0,19.0,14.0
9903265,12,5,7,7,1,11,33,57,2.0,2.0,0.0,0.0,0.0,2.0,2.0,25,12,13,2.0,2.0,0.0
9805371,4,2,2,3,0,4,6,13,4.0,2.0,2.0,3.0,0.0,4.0,6.0,9,4,5,3.0,1.0,2.0
9902456,6,1,5,10,0,6,6,142,6.0,1.0,5.0,10.0,0.0,6.0,6.0,7,6,1,7.0,6.0,1.0
8221,17,8,9,18,5,12,35,59,5.0,2.0,3.0,7.0,1.0,4.0,17.0,29,17,12,10.0,3.0,7.0
9609290,6,3,3,3,4,2,3,250,2.0,2.0,0.0,0.0,0.0,2.0,3.0,10,6,4,3.0,2.0,1.0
9811440,12,9,3,3,3,9,40,12,1.0,1.0,0.0,0.0,0.0,1.0,7.0,40,12,28,10.0,2.0,8.0
101192,14,3,11,18,1,13,82,14,5.0,2.0,3.0,3.0,0.0,5.0,46.0,49,14,35,10.0,5.0,5.0
9612355,5,4,1,2,1,4,18,62,4.0,3.0,1.0,2.0,0.0,4.0,17.0,14,5,9,10.0,3.0,7.0
9606222,28,18,10,11,28,0,0,13,5.0,5.0,0.0,0.0,5.0,0.0,0.0,29,28,1,3.0,3.0,0.0
209187,32,18,14,17,2,30,128,23,9.0,4.0,5.0,6.0,0.0,9.0,61.0,54,32,22,21.0,4.0,17.0
9501209,1,1,0,0,0,1,2,63,0.0,0.0,0.0,0.0,0.0,0.0,0.0,7,1,6,1.0,0.0,1.0
109008,5,3,2,2,0,5,9,257,4.0,3.0,1.0,1.0,0.0,4.0,4.0,13,5,8,5.0,4.0,1.0
9812417,14,4,10,26,3,11,20,24,4.0,2.0,2.0,5.0,4.0,0.0,0.0,20,14,6,4.0,2.0,2.0
9701316,5,4,1,1,1,4,20,6,1.0,1.0,0.0,0.0,0.0,1.0,9.0,37,5,32,8.0,1.0,7.0
9309239,3,2,1,1,1,2,2,41,0.0,0.0,0.0,0.0,0.0,0.0,0.0,4,3,1,,,
9030,5,2,3,4,2,3,3,128,4.0,2.0,2.0,2.0,4.0,0.0,0.0,10,5,5,5.0,5.0,0.0
108221,12,2,10,24,0,12,151,109,12.0,2.0,10.0,24.0,0.0,12.0,150.0,35,12,23,26.0,12.0,14.0
9909466,1,1,0,0,0,1,1,61,0.0,0.0,0.0,0.0,0.0,0.0,0.0,15,1,14,3.0,0.0,3.0
9504257,3,2,1,1,2,1,1,500,1.0,1.0,0.0,0.0,1.0,0.0,0.0,4,3,1,1.0,1.0,0.0
9806382,18,3,15,61,0,18,159,12,15.0,3.0,12.0,54.0,0.0,15.0,126.0,37,18,19,28.0,11.0,17.0
9908300,9,6,3,7,0,9,46,50,3.0,3.0,0.0,0.0,0.0,3.0,16.0,25,9,16,7.0,4.0,3.0
201281,8,3,5,6,3,5,19,39,3.0,1.0,2.0,2.0,0.0,3.0,11.0,17,8,9,6.0,3.0,3.0
9811499,2,2,0,0,0,2,5,12,0.0,0.0,0.0,0.0,0.0,0.0,0.0,8,2,6,,,
112004,8,5,3,3,0,8,42,25,2.0,1.0,1.0,1.0,0.0,2.0,11.0,42,8,34,13.0,2.0,11.0
9707227,9,2,7,12,0,9,188,36,8.0,1.0,7.0,10.0,0.0,8.0,182.0,42,9,33,36.0,7.0,29.0
9909388,21,6,15,41,2,19,73,11,13.0,4.0,9.0,22.0,0.0,13.0,57.0,27,21,6,4.0,4.0,0.0
9512242,4,3,1,1,1,3,10,29,1.0,1.0,0.0,0.0,0.0,1.0,3.0,18,4,14,6.0,0.0,6.0
9902350,9,3,6,11,2,7,31,92,6.0,2.0,4.0,6.0,1.0,5.0,14.0,18,9,9,6.0,5.0,1.0
9807451,2,2,0,0,1,1,1,127,1.0,1.0,0.0,0.0,0.0,1.0,1.0,9,2,7,1.0,0.0,1.0
9506340,5,5,0,0,3,2,8,1,1.0,1.0,0.0,0.0,0.0,1.0,3.0,12,5,7,3.0,1.0,2.0
9908469,2,2,0,0,0,2,26,2,2.0,2.0,0.0,0.0,0.0,2.0,26.0,25,2,23,1.0,0.0,1.0
9811405,10,3,7,14,1,9,30,49,6.0,1.0,5.0,10.0,0.0,6.0,17.0,20,10,10,6.0,3.0,3.0
9911456,9,3,6,14,0,9,67,8,6.0,1.0,5.0,9.0,0.0,6.0,43.0,47,9,38,18.0,5.0,13.0
9902318,16,3,13,27,1,15,55,9,11.0,2.0,9.0,21.0,0.0,11.0,48.0,24,16,8,5.0,5.0,0.0
12240,5,2,3,3,0,5,25,85,2.0,1.0,1.0,1.0,0.0,2.0,10.0,19,5,14,6.0,2.0,4.0
105327,8,7,1,1,2,6,24,1,3.0,3.0,0.0,0.0,0.0,3.0,10.0,43,8,35,8.0,2.0,6.0
9602400,5,3,2,2,5,0,0,184,2.0,1.0,1.0,1.0,2.0,0.0,0.0,6,5,1,3.0,3.0,0.0
9705333,21,4,17,75,3,18,63,30,12.0,1.0,11.0,36.0,6.0,6.0,6.0,42,21,21,14.0,12.0,2.0
9804270,2,1,1,1,2,0,0,178,1.0,1.0,0.0,0.0,1.0,0.0,0.0,2,2,0,2.0,2.0,0.0
9405366,7,3,4,7,0,7,41,53,6.0,3.0,3.0,6.0,0.0,6.0,34.0,16,7,9,2.0,2.0,0.0
9412298,1,1,0,0,1,0,0,95,1.0,1.0,0.0,0.0,1.0,0.0,0.0,1,1,0,1.0,1.0,0.0
9804335,12,4,8,17,4,8,17,85,6.0,1.0,5.0,14.0,1.0,5.0,5.0,20,12,8,7.0,6.0,1.0
9907318,4,3,1,2,1,3,12,10,3.0,2.0,1.0,2.0,0.0,3.0,12.0,23,4,19,2.0,1.0,1.0
9711434,6,3,3,7,0,6,22,150,1.0,1.0,0.0,0.0,0.0,1.0,4.0,16,6,10,9.0,1.0,8.0
102209,14,4,10,17,3,11,54,9,8.0,2.0,6.0,11.0,0.0,8.0,40.0,25,14,11,12.0,7.0,5.0
107022,7,3,4,4,0,7,42,119,2.0,2.0,0.0,0.0,0.0,2.0,11.0,24,7,17,12.0,2.0,10.0
9307373,5,4,1,2,2,3,3,35,1.0,1.0,0.0,0.0,1.0,0.0,0.0,7,5,2,1.0,1.0,0.0
9907574,1,1,0,0,0,1,3,141,1.0,1.0,0.0,0.0,0.0,1.0,2.0,13,1,12,7.0,1.0,6.0
9702386,3,2,1,1,1,2,4,141,1.0,1.0,0.0,0.0,1.0,0.0,0.0,6,3,3,1.0,1.0,0.0
9808306,7,3,4,7,1,6,10,96,4.0,1.0,3.0,4.0,0.0,4.0,4.0,24,7,17,4.0,2.0,2.0
9612453,26,5,21,48,0,26,150,40,22.0,4.0,18.0,41.0,0.0,22.0,132.0,39,26,13,25.0,16.0,9.0
9710337,25,5,20,78,7,18,18,18,17.0,3.0,14.0,59.0,5.0,12.0,12.0,26,25,1,5.0,5.0,0.0
9912471,3,3,0,0,0,3,25,21,1.0,1.0,0.0,0.0,0.0,1.0,9.0,24,3,21,6.0,1.0,5.0
112276,7,4,3,5,0,7,37,14,7.0,4.0,3.0,5.0,0.0,7.0,29.0,32,7,25,5.0,1.0,4.0
110334,4,2,2,2,2,2,3,150,0.0,0.0,0.0,0.0,0.0,0.0,0.0,11,4,7,1.0,0.0,1.0
9902266,6,3,3,5,2,4,13,14,2.0,2.0,0.0,0.0,1.0,1.0,2.0,15,6,9,3.0,1.0,2.0
9812355,11,5,6,9,1,10,26,14,6.0,2.0,4.0,7.0,0.0,6.0,13.0,24,11,13,2.0,1.0,1.0
9342,6,1,5,6,1,5,14,143,2.0,1.0,1.0,1.0,0.0,2.0,7.0,15,6,9,3.0,3.0,0.0
9709505,7,5,2,2,7,0,0,92,1.0,1.0,0.0,0.0,1.0,0.0,0.0,7,7,0,1.0,1.0,0.0
9805387,2,2,0,0,1,1,2,1668,,,,,,,,6,2,4,,,
9902448,5,1,4,8,0,5,7,56,4.0,1.0,3.0,6.0,0.0,4.0,6.0,7,5,2,3.0,2.0,1.0
9612299,1,1,0,0,1,0,0,61,,,,,,,,6,1,5,,,
9506204,21,5,16,46,8,13,14,13,14.0,3.0,11.0,28.0,4.0,10.0,11.0,23,21,2,11.0,10.0,1.0
211018,6,2,4,4,0,6,61,193,4.0,1.0,3.0,3.0,0.0,4.0,29.0,30,6,24,14.0,3.0,11.0
9209253,6,3,3,4,6,0,0,246,3.0,1.0,2.0,3.0,3.0,0.0,0.0,6,6,0,3.0,3.0,0.0
9710346,4,3,1,1,3,1,1,1957,0.0,0.0,0.0,0.0,0.0,0.0,0.0,5,4,1,1.0,0.0,1.0
109108,6,4,2,2,2,4,4,398,3.0,2.0,1.0,1.0,3.0,0.0,0.0,8,6,2,3.0,3.0,0.0
110031,16,7,9,21,4,12,16,15,10.0,4.0,6.0,12.0,3.0,7.0,10.0,19,16,3,4.0,4.0,0.0
9403277,7,5,2,3,2,5,6,96,4.0,2.0,2.0,3.0,1.0,3.0,3.0,12,7,5,6.0,4.0,2.0
9404264,2,2,0,0,2,0,0,284,1.0,1.0,0.0,0.0,1.0,0.0,0.0,2,2,0,1.0,1.0,0.0
212025,1,1,0,0,0,1,23,27,1.0,1.0,0.0,0.0,0.0,1.0,20.0,96,1,95,18.0,1.0,17.0
9911316,14,5,9,33,0,14,138,8,13.0,4.0,9.0,33.0,0.0,13.0,130.0,33,14,19,27.0,13.0,14.0
9712266,7,1,6,15,0,7,21,142,7.0,1.0,6.0,15.0,0.0,7.0,19.0,13,7,6,10.0,7.0,3.0
9706478,9,6,3,5,0,9,37,5,7.0,4.0,3.0,4.0,0.0,7.0,26.0,16,9,7,11.0,6.0,5.0
9806335,10,4,6,11,2,8,8,131,7.0,2.0,5.0,9.0,2.0,5.0,5.0,11,10,1,5.0,5.0,0.0
10282,3,2,1,1,0,3,11,51,1.0,1.0,0.0,0.0,0.0,1.0,4.0,15,3,12,6.0,2.0,4.0
9908497,12,3,9,20,4,8,18,16,8.0,2.0,6.0,14.0,2.0,6.0,8.0,18,12,6,8.0,5.0,3.0
9309282,2,2,0,0,2,0,0,79,1.0,1.0,0.0,0.0,1.0,0.0,0.0,2,2,0,,,
9905493,6,5,1,1,4,2,2,39,1.0,1.0,0.0,0.0,0.0,1.0,1.0,8,6,2,1.0,1.0,0.0
9802407,13,5,8,17,1,12,105,12,8.0,2.0,6.0,14.0,0.0,8.0,94.0,39,13,26,27.0,8.0,19.0
9601248,11,8,3,4,0,11,29,53,7.0,6.0,1.0,1.0,0.0,7.0,13.0,17,11,6,7.0,5.0,2.0
202122,27,14,13,18,1,26,211,50,4.0,3.0,1.0,1.0,0.0,4.0,35.0,281,27,254,36.0,0.0,36.0
110072,11,3,8,22,0,11,95,73,8.0,2.0,6.0,16.0,0.0,8.0,60.0,33,11,22,12.0,3.0,9.0
104100,13,4,9,22,1,12,68,21,9.0,4.0,5.0,10.0,0.0,9.0,45.0,39,13,26,15.0,3.0,12.0
9312,8,6,2,3,6,2,3,44,1.0,1.0,0.0,0.0,1.0,0.0,0.0,14,8,6,3.0,2.0,1.0
9712462,5,3,2,2,3,2,2,159,2.0,2.0,0.0,0.0,1.0,1.0,1.0,11,5,6,2.0,2.0,0.0
9512291,2,1,1,1,2,0,0,401,0.0,0.0,0.0,0.0,0.0,0.0,0.0,8,2,6,2.0,0.0,2.0
104103,19,3,16,47,0,19,90,37,8.0,1.0,7.0,16.0,0.0,8.0,32.0,38,19,19,8.0,4.0,4.0
102125,8,4,4,7,0,8,67,50,7.0,4.0,3.0,6.0,0.0,7.0,65.0,29,8,21,24.0,3.0,21.0
9809503,13,4,9,19,0,13,83,82,11.0,3.0,8.0,17.0,0.0,11.0,71.0,29,13,16,21.0,8.0,13.0
7053,15,8,7,9,9,6,6,30,2.0,2.0,0.0,0.0,2.0,0.0,0.0,20,15,5,5.0,5.0,0.0
8306,8,4,4,9,0,8,42,147,4.0,2.0,2.0,3.0,0.0,4.0,13.0,26,8,18,6.0,3.0,3.0
9809207,8,2,6,13,1,7,25,255,6.0,1.0,5.0,11.0,0.0,6.0,14.0,21,8,13,8.0,6.0,2.0
9612374,15,7,8,20,1,14,28,13,7.0,3.0,4.0,9.0,0.0,7.0,14.0,20,15,5,3.0,3.0,0.0
106160,0,0,0,0,0,0,0,78,0.0,0.0,0.0,0.0,0.0,0.0,0.0,6,0,6,3.0,0.0,3.0
9904351,6,3,3,4,0,6,9,18,3.0,2.0,1.0,1.0,0.0,3.0,6.0,9,6,3,4.0,3.0,1.0
111249,4,2,2,2,1,3,14,7,1.0,1.0,0.0,0.0,1.0,0.0,0.0,19,4,15,5.0,0.0,5.0
9906515,3,2,1,1,0,3,7,183,2.0,1.0,1.0,1.0,0.0,2.0,6.0,12,3,9,5.0,2.0,3.0
210362,0,0,0,0,0,0,0,92,0.0,0.0,0.0,0.0,0.0,0.0,0.0,26,0,26,3.0,0.0,3.0
9403273,9,6,3,3,0,9,13,40,9.0,6.0,3.0,3.0,0.0,9.0,13.0,11,9,2,2.0,2.0,0.0
10050,1,1,0,0,1,0,0,351,0.0,0.0,0.0,0.0,0.0,0.0,0.0,4,1,3,1.0,0.0,1.0
9611246,2,2,0,0,1,1,8,14,0.0,0.0,0.0,0.0,0.0,0.0,0.0,11,2,9,1.0,0.0,1.0
9306216,6,4,2,3,6,0,0,142,4.0,3.0,1.0,2.0,4.0,0.0,0.0,6,6,0,3.0,3.0,0.0
9704321,2,2,0,0,1,1,3,43,0.0,0.0,0.0,0.0,0.0,0.0,0.0,23,2,21,1.0,1.0,0.0
9904376,10,8,2,2,0,10,19,9,8.0,6.0,2.0,2.0,8.0,0.0,0.0,19,10,9,7.0,7.0,0.0
9706419,13,3,10,22,6,7,12,72,8.0,3.0,5.0,9.0,3.0,5.0,9.0,20,13,7,8.0,6.0,2.0
103170,13,6,7,13,5,8,26,0,5.0,2.0,3.0,4.0,0.0,5.0,16.0,23,13,10,11.0,7.0,4.0
9309331,4,4,0,0,2,2,3,48,1.0,1.0,0.0,0.0,1.0,0.0,0.0,6,4,2,1.0,0.0,1.0
204171,8,3,5,10,0,8,68,0,7.0,2.0,5.0,10.0,0.0,7.0,66.0,26,8,18,22.0,4.0,18.0
8256,2,1,1,1,0,2,3,1623,,,,,,,,7,2,5,,,
9412284,3,2,1,1,3,0,0,208,0.0,0.0,0.0,0.0,0.0,0.0,0.0,7,3,4,1.0,0.0,1.0
3114,20,4,16,49,0,20,73,65,19.0,3.0,16.0,49.0,0.0,19.0,65.0,35,20,15,21.0,13.0,8.0
9302253,3,3,0,0,3,0,0,114,1.0,1.0,0.0,0.0,1.0,0.0,0.0,3,3,0,1.0,1.0,0.0
1008,5,5,0,0,1,4,5,51,1.0,1.0,0.0,0.0,0.0,1.0,1.0,12,5,7,2.0,1.0,1.0
204070,5,3,2,2,0,5,10,63,0.0,0.0,0.0,0.0,0.0,0.0,0.0,22,5,17,3.0,0.0,3.0
107054,1,1,0,0,0,1,2,3,0.0,0.0,0.0,0.0,0.0,0.0,0.0,39,1,38,8.0,0.0,8.0
202147,5,4,1,1,0,5,21,3,1.0,1.0,0.0,0.0,0.0,1.0,1.0,24,5,19,8.0,1.0,7.0
107053,11,7,4,6,1,10,47,81,3.0,3.0,0.0,0.0,0.0,3.0,20.0,35,11,24,8.0,2.0,6.0
9267,6,6,0,0,3,3,3,59,0.0,0.0,0.0,0.0,0.0,0.0,0.0,16,6,10,2.0,0.0,2.0
9704346,9,5,4,7,5,4,8,142,4.0,1.0,3.0,5.0,0.0,4.0,8.0,12,9,3,6.0,4.0,2.0
107311,3,3,0,0,0,3,5,129,1.0,1.0,0.0,0.0,0.0,1.0,2.0,8,3,5,1.0,1.0,0.0
201125,1,1,0,0,0,1,8,2,0.0,0.0,0.0,0.0,0.0,0.0,0.0,44,1,43,18.0,0.0,18.0
207327,10,6,4,5,1,9,64,1,7.0,3.0,4.0,5.0,0.0,7.0,26.0,47,10,37,4.0,0.0,4.0
208019,5,2,3,3,1,4,49,24,1.0,1.0,0.0,0.0,0.0,1.0,15.0,44,5,39,7.0,3.0,4.0
110254,3,2,1,1,1,2,3,59,2.0,1.0,1.0,1.0,0.0,2.0,3.0,11,3,8,2.0,2.0,0.0
103014,7,2,5,7,0,7,21,25,6.0,1.0,5.0,7.0,0.0,6.0,16.0,13,7,6,7.0,6.0,1.0
9304210,3,2,1,2,3,0,0,293,3.0,2.0,1.0,2.0,3.0,0.0,0.0,3,3,0,3.0,3.0,0.0
9706336,3,1,2,2,3,0,0,163,3.0,1.0,2.0,2.0,3.0,0.0,0.0,4,3,1,4.0,3.0,1.0
108067,4,2,2,3,0,4,12,76,2.0,1.0,1.0,1.0,0.0,2.0,2.0,8,4,4,5.0,3.0,2.0
9704371,8,5,3,3,3,5,14,15,4.0,2.0,2.0,2.0,0.0,4.0,4.0,22,8,14,5.0,4.0,1.0
103184,5,2,3,3,0,5,19,9,5.0,2.0,3.0,3.0,0.0,5.0,19.0,10,5,5,8.0,4.0,4.0
9408343,8,3,5,10,5,3,6,124,2.0,1.0,1.0,1.0,2.0,0.0,0.0,12,8,4,3.0,2.0,1.0
103091,2,2,0,0,1,1,10,44,0.0,0.0,0.0,0.0,0.0,0.0,0.0,13,2,11,11.0,1.0,10.0
209002,12,1,11,32,0,12,115,1,11.0,1.0,10.0,30.0,0.0,11.0,86.0,30,12,18,18.0,10.0,8.0
2160,2,2,0,0,1,1,5,22,1.0,1.0,0.0,0.0,1.0,0.0,0.0,7,2,5,1.0,1.0,0.0
9903322,10,4,6,14,1,9,84,24,7.0,3.0,4.0,10.0,0.0,7.0,40.0,24,10,14,5.0,1.0,4.0
9806295,1,1,0,0,0,1,2,57,0.0,0.0,0.0,0.0,0.0,0.0,0.0,7,1,6,4.0,0.0,4.0
9907359,3,2,1,1,0,3,5,12,0.0,0.0,0.0,0.0,0.0,0.0,0.0,5,3,2,,,
9710402,9,4,5,15,2,7,7,174,7.0,2.0,5.0,15.0,7.0,0.0,0.0,17,9,8,7.0,7.0,0.0
9706543,8,5,3,5,3,5,10,59,3.0,2.0,1.0,2.0,3.0,0.0,0.0,13,8,5,1.0,1.0,0.0
112086,4,4,0,0,3,1,1,495,0.0,0.0,0.0,0.0,0.0,0.0,0.0,9,4,5,4.0,0.0,4.0
9810223,12,1,11,52,0,12,29,16,12.0,1.0,11.0,52.0,0.0,12.0,12.0,18,12,6,13.0,12.0,1.0
9608333,0,0,0,0,0,0,0,156,0.0,0.0,0.0,0.0,0.0,0.0,0.0,3,0,3,3.0,0.0,3.0
101039,1,1,0,0,0,1,9,2,1.0,1.0,0.0,0.0,0.0,1.0,6.0,17,1,16,10.0,1.0,9.0
110049,9,5,4,5,0,9,133,12,3.0,2.0,1.0,1.0,0.0,3.0,58.0,61,9,52,18.0,4.0,14.0
211292,1,1,0,0,0,1,4,268,1.0,1.0,0.0,0.0,0.0,1.0,4.0,6,1,5,5.0,1.0,4.0
301117,0,0,0,0,0,0,0,21,0.0,0.0,0.0,0.0,0.0,0.0,0.0,7,0,7,2.0,0.0,2.0
201085,0,0,0,0,0,0,0,115,0.0,0.0,0.0,0.0,0.0,0.0,0.0,2,0,2,1.0,0.0,1.0
111106,8,6,2,2,0,8,52,12,0.0,0.0,0.0,0.0,0.0,0.0,0.0,57,8,49,17.0,3.0,14.0
109217,18,6,12,32,2,16,140,55,7.0,3.0,4.0,9.0,0.0,7.0,65.0,74,18,56,22.0,6.0,16.0
101334,6,4,2,3,1,5,59,3,4.0,2.0,2.0,3.0,0.0,4.0,39.0,47,6,41,10.0,2.0,8.0
202016,5,4,1,1,0,5,37,4,3.0,3.0,0.0,0.0,0.0,3.0,20.0,26,5,21,2.0,0.0,2.0
203276,1,1,0,0,0,1,3,9,0.0,0.0,0.0,0.0,0.0,0.0,0.0,13,1,12,2.0,0.0,2.0
12108,12,6,6,9,1,11,68,9,3.0,1.0,2.0,2.0,0.0,3.0,28.0,47,12,35,10.0,1.0,9.0
9901276,3,2,1,1,0,3,64,17,3.0,2.0,1.0,1.0,0.0,3.0,63.0,32,3,29,29.0,3.0,26.0
9802444,1,1,0,0,0,1,1,212,1.0,1.0,0.0,0.0,1.0,0.0,0.0,9,1,8,3.0,1.0,2.0
210258,2,1,1,1,0,2,17,4,2.0,1.0,1.0,1.0,0.0,2.0,9.0,29,2,27,5.0,1.0,4.0
9906247,6,2,4,7,3,3,4,65,5.0,1.0,4.0,7.0,3.0,2.0,2.0,12,6,6,2.0,0.0,2.0
9907307,8,1,7,17,0,8,72,34,7.0,1.0,6.0,15.0,0.0,7.0,65.0,24,8,16,6.0,3.0,3.0
5172,12,3,9,21,0,12,49,68,11.0,2.0,9.0,21.0,0.0,11.0,48.0,18,12,6,15.0,10.0,5.0
9707491,5,2,3,4,0,5,6,68,4.0,2.0,2.0,3.0,0.0,4.0,5.0,8,5,3,6.0,4.0,2.0
9803379,1,1,0,0,1,0,0,118,,,,,,,,1,1,0,,,
107279,5,2,3,3,0,5,51,23,3.0,2.0,1.0,1.0,0.0,3.0,31.0,36,5,31,2.0,2.0,0.0
9806439,6,6,0,0,3,3,10,27,0.0,0.0,0.0,0.0,0.0,0.0,0.0,15,6,9,3.0,1.0,2.0
9405279,2,1,1,1,1,1,2,40,,,,,,,,6,2,4,1.0,0.0,1.0
112083,3,1,2,2,3,0,0,28,0.0,0.0,0.0,0.0,0.0,0.0,0.0,4,3,1,1.0,0.0,1.0
3079,2,2,0,0,0,2,5,51,1.0,1.0,0.0,0.0,0.0,1.0,3.0,9,2,7,3.0,1.0,2.0
9804466,1,1,0,0,0,1,3,167,0.0,0.0,0.0,0.0,0.0,0.0,0.0,10,1,9,6.0,0.0,6.0
6299,5,3,2,2,0,5,18,13,3.0,1.0,2.0,2.0,0.0,3.0,15.0,20,5,15,11.0,2.0,9.0
104185,2,1,1,1,0,2,2,28,0.0,0.0,0.0,0.0,0.0,0.0,0.0,7,2,5,4.0,1.0,3.0
11089,9,2,7,11,0,9,69,7,6.0,2.0,4.0,5.0,0.0,6.0,26.0,32,9,23,10.0,6.0,4.0
9806234,7,3,4,8,7,0,0,505,4.0,1.0,3.0,5.0,4.0,0.0,0.0,11,7,4,4.0,4.0,0.0
9502353,2,2,0,0,0,2,5,56,1.0,1.0,0.0,0.0,0.0,1.0,4.0,12,2,10,2.0,1.0,1.0
9908474,2,2,0,0,0,2,15,34,0.0,0.0,0.0,0.0,0.0,0.0,0.0,22,2,20,7.0,0.0,7.0
9905408,2,2,0,0,2,0,0,142,1.0,1.0,0.0,0.0,1.0,0.0,0.0,4,2,2,1.0,1.0,0.0
1157,4,2,2,2,0,4,80,16,4.0,2.0,2.0,2.0,0.0,4.0,57.0,37,4,33,25.0,4.0,21.0
9606264,16,4,12,23,10,6,6,117,13.0,3.0,10.0,21.0,13.0,0.0,0.0,26,16,10,11.0,10.0,1.0
209377,1,1,0,0,1,0,0,4,0.0,0.0,0.0,0.0,0.0,0.0,0.0,40,1,39,8.0,0.0,8.0
9403286,6,2,4,6,6,0,0,147,4.0,1.0,3.0,3.0,4.0,0.0,0.0,6,6,0,2.0,2.0,0.0
103348,2,1,1,1,0,2,2,695,2.0,1.0,1.0,1.0,2.0,0.0,0.0,6,2,4,3.0,2.0,1.0
9311226,1,1,0,0,1,0,0,304,1.0,1.0,0.0,0.0,1.0,0.0,0.0,3,1,2,1.0,0.0,1.0
109013,5,3,2,2,0,5,32,20,2.0,2.0,0.0,0.0,0.0,2.0,18.0,21,5,16,3.0,3.0,0.0
9509263,11,2,9,22,6,5,5,123,8.0,1.0,7.0,15.0,5.0,3.0,3.0,13,11,2,8.0,7.0,1.0
9504267,2,2,0,0,2,0,0,1,,,,,,,,4,2,2,,,
203001,3,1,2,2,0,3,3,37,1.0,1.0,0.0,0.0,1.0,0.0,0.0,4,3,1,4.0,3.0,1.0
9407379,3,3,0,0,1,2,3,619,2.0,2.0,0.0,0.0,0.0,2.0,2.0,7,3,4,3.0,2.0,1.0
111092,6,4,2,2,1,5,68,11,3.0,2.0,1.0,1.0,0.0,3.0,37.0,92,6,86,13.0,1.0,12.0
9608481,7,1,6,8,1,6,8,44,5.0,1.0,4.0,4.0,1.0,4.0,4.0,9,7,2,2.0,2.0,0.0
9229,2,2,0,0,1,1,1,9,0.0,0.0,0.0,0.0,0.0,0.0,0.0,38,2,36,12.0,0.0,12.0
9411251,2,2,0,0,2,0,0,149,2.0,2.0,0.0,0.0,2.0,0.0,0.0,2,2,0,1.0,1.0,0.0
9812503,4,3,1,2,3,1,1,240,3.0,2.0,1.0,2.0,3.0,0.0,0.0,7,4,3,3.0,3.0,0.0
9808300,1,1,0,0,1,0,0,47,0.0,0.0,0.0,0.0,0.0,0.0,0.0,7,1,6,2.0,0.0,2.0
11154,4,3,1,1,3,1,1,356,2.0,2.0,0.0,0.0,1.0,1.0,1.0,8,4,4,4.0,1.0,3.0
107018,5,3,2,3,3,2,3,293,2.0,1.0,1.0,1.0,1.0,1.0,1.0,8,5,3,2.0,2.0,0.0
9712223,4,2,2,4,0,4,32,5,2.0,1.0,1.0,1.0,0.0,2.0,14.0,17,4,13,12.0,4.0,8.0
301062,1,1,0,0,0,1,10,4,1.0,1.0,0.0,0.0,0.0,1.0,10.0,15,1,14,3.0,0.0,3.0
207330,4,3,1,1,0,4,53,32,1.0,1.0,0.0,0.0,0.0,1.0,18.0,59,4,55,21.0,0.0,21.0
301101,2,1,1,1,0,2,26,4,0.0,0.0,0.0,0.0,0.0,0.0,0.0,96,2,94,16.0,0.0,16.0
110376,5,2,3,4,1,4,25,49,0.0,0.0,0.0,0.0,0.0,0.0,0.0,33,5,28,1.0,0.0,1.0
206122,11,5,6,9,0,11,105,55,5.0,2.0,3.0,6.0,0.0,5.0,60.0,54,11,43,29.0,4.0,25.0
1115,10,5,5,5,0,10,98,2,8.0,4.0,4.0,4.0,0.0,8.0,81.0,26,10,16,19.0,6.0,13.0
212378,0,0,0,0,0,0,0,64,0.0,0.0,0.0,0.0,0.0,0.0,0.0,15,0,15,3.0,0.0,3.0
9406211,7,6,1,1,4,3,6,13,2.0,2.0,0.0,0.0,2.0,0.0,0.0,12,7,5,2.0,2.0,0.0
11004,2,2,0,0,1,1,5,5,0.0,0.0,0.0,0.0,0.0,0.0,0.0,11,2,9,1.0,0.0,1.0
9707353,3,3,0,0,1,2,3,397,1.0,1.0,0.0,0.0,0.0,1.0,1.0,6,3,3,2.0,1.0,1.0
104155,4,1,3,4,0,4,27,45,4.0,1.0,3.0,4.0,0.0,4.0,18.0,12,4,8,9.0,4.0,5.0
9610228,8,4,4,10,6,2,2,160,5.0,2.0,3.0,8.0,3.0,2.0,2.0,9,8,1,5.0,5.0,0.0
204012,2,2,0,0,2,0,0,423,1.0,1.0,0.0,0.0,1.0,0.0,0.0,3,2,1,1.0,0.0,1.0
202191,13,5,8,12,1,12,210,37,11.0,4.0,7.0,10.0,0.0,11.0,179.0,49,13,36,33.0,10.0,23.0
8271,0,0,0,0,0,0,0,33,0.0,0.0,0.0,0.0,0.0,0.0,0.0,15,0,15,7.0,0.0,7.0
9612277,2,2,0,0,1,1,4,164,0.0,0.0,0.0,0.0,0.0,0.0,0.0,13,2,11,8.0,0.0,8.0
111412,1,1,0,0,1,0,0,1798,,,,,,,,4,1,3,1.0,0.0,1.0
11130,8,3,5,10,0,8,57,42,5.0,1.0,4.0,7.0,0.0,5.0,28.0,32,8,24,17.0,4.0,13.0
9606461,4,1,3,4,3,1,7,298,4.0,1.0,3.0,4.0,3.0,1.0,1.0,17,4,13,6.0,4.0,2.0
9803489,6,4,2,3,0,6,14,78,5.0,3.0,2.0,3.0,0.0,5.0,11.0,21,6,15,2.0,0.0,2.0
101097,2,2,0,0,0,2,6,58,1.0,1.0,0.0,0.0,0.0,1.0,4.0,16,2,14,4.0,1.0,3.0
9710420,2,1,1,1,1,1,1,160,2.0,1.0,1.0,1.0,2.0,0.0,0.0,3,2,1,2.0,2.0,0.0
9306284,3,3,0,0,0,3,3,341,2.0,2.0,0.0,0.0,0.0,2.0,2.0,4,3,1,4.0,3.0,1.0
108010,4,3,1,1,3,1,3,285,3.0,2.0,1.0,1.0,2.0,1.0,2.0,10,4,6,4.0,3.0,1.0
9811403,2,2,0,0,1,1,1,45,1.0,1.0,0.0,0.0,0.0,1.0,1.0,3,2,1,2.0,1.0,1.0
11069,1,1,0,0,0,1,13,27,1.0,1.0,0.0,0.0,0.0,1.0,12.0,23,1,22,9.0,0.0,9.0
9903395,3,1,2,3,0,3,19,5,2.0,1.0,1.0,1.0,0.0,2.0,3.0,20,3,17,7.0,3.0,4.0
208236,3,2,1,1,0,3,7,15,0.0,0.0,0.0,0.0,0.0,0.0,0.0,68,3,65,28.0,0.0,28.0
9502208,1,1,0,0,1,0,0,155,0.0,0.0,0.0,0.0,0.0,0.0,0.0,3,1,2,,,
111430,2,1,1,1,0,2,5,95,2.0,1.0,1.0,1.0,0.0,2.0,4.0,7,2,5,6.0,2.0,4.0
9212317,1,1,0,0,1,0,0,235,1.0,1.0,0.0,0.0,1.0,0.0,0.0,1,1,0,,,
9503468,6,5,1,1,6,0,0,231,1.0,1.0,0.0,0.0,1.0,0.0,0.0,7,6,1,1.0,0.0,1.0
202078,3,2,1,1,0,3,3,220,3.0,2.0,1.0,1.0,0.0,3.0,3.0,5,3,2,4.0,3.0,1.0
301165,2,2,0,0,0,2,13,1,0.0,0.0,0.0,0.0,0.0,0.0,0.0,27,2,25,3.0,0.0,3.0
9902361,10,1,9,23,1,9,46,130,9.0,1.0,8.0,18.0,1.0,8.0,27.0,22,10,12,10.0,9.0,1.0
9812351,6,6,0,0,3,3,3,497,1.0,1.0,0.0,0.0,1.0,0.0,0.0,12,6,6,1.0,1.0,0.0
9908459,3,3,0,0,1,2,2,185,0.0,0.0,0.0,0.0,0.0,0.0,0.0,8,3,5,2.0,1.0,1.0
9501387,26,1,25,110,26,0,0,137,19.0,1.0,18.0,99.0,19.0,0.0,0.0,26,26,0,18.0,18.0,0.0
9311304,3,2,1,1,1,2,5,183,3.0,2.0,1.0,1.0,3.0,0.0,0.0,7,3,4,2.0,2.0,0.0
9802237,3,2,1,1,3,0,0,387,3.0,2.0,1.0,1.0,3.0,0.0,0.0,3,3,0,3.0,3.0,0.0
105321,2,2,0,0,0,2,3,37,,,,,,,,7,2,5,,,
109130,8,4,4,6,0,8,36,24,2.0,1.0,1.0,1.0,1.0,1.0,4.0,18,8,10,9.0,4.0,5.0
9601266,1,1,0,0,1,0,0,310,1.0,1.0,0.0,0.0,1.0,0.0,0.0,5,1,4,2.0,0.0,2.0
205065,5,4,1,2,0,5,47,7,4.0,3.0,1.0,1.0,0.0,4.0,21.0,29,5,24,12.0,2.0,10.0
9410352,5,4,1,1,5,0,0,773,2.0,2.0,0.0,0.0,2.0,0.0,0.0,5,5,0,1.0,1.0,0.0
9708271,4,1,3,5,0,4,4,192,4.0,1.0,3.0,5.0,0.0,4.0,4.0,5,4,1,5.0,4.0,1.0
5279,0,0,0,0,0,0,0,16,0.0,0.0,0.0,0.0,0.0,0.0,0.0,48,0,48,13.0,0.0,13.0
9409272,5,3,2,2,0,5,7,196,2.0,1.0,1.0,1.0,0.0,2.0,4.0,13,5,8,3.0,2.0,1.0
9809449,10,3,7,17,4,6,6,139,7.0,2.0,5.0,9.0,5.0,2.0,2.0,13,10,3,8.0,6.0,2.0
106099,14,7,7,16,1,13,70,16,13.0,6.0,7.0,16.0,0.0,13.0,70.0,28,14,14,6.0,5.0,1.0
204027,15,6,9,17,0,15,83,46,8.0,3.0,5.0,12.0,0.0,8.0,33.0,43,15,28,9.0,4.0,5.0
9403279,2,2,0,0,2,0,0,257,1.0,1.0,0.0,0.0,1.0,0.0,0.0,3,2,1,,,
9611283,6,3,3,5,0,6,19,8,3.0,2.0,1.0,1.0,0.0,3.0,3.0,14,6,8,7.0,6.0,1.0
9608351,6,3,3,3,0,6,13,29,1.0,1.0,0.0,0.0,0.0,1.0,3.0,16,6,10,2.0,0.0,2.0
9902481,8,5,3,3,0,8,27,258,6.0,3.0,3.0,3.0,0.0,6.0,20.0,20,8,12,12.0,5.0,7.0
9710376,7,3,4,5,1,6,10,102,5.0,3.0,2.0,2.0,1.0,4.0,7.0,10,7,3,2.0,2.0,0.0
9909225,9,1,8,29,0,9,64,8,8.0,1.0,7.0,22.0,0.0,8.0,44.0,18,9,9,16.0,9.0,7.0
9406325,2,2,0,0,1,1,1,1090,0.0,0.0,0.0,0.0,0.0,0.0,0.0,5,2,3,,,
9410224,5,3,2,4,1,4,6,112,4.0,2.0,2.0,4.0,2.0,2.0,2.0,7,5,2,1.0,1.0,0.0
6341,10,3,7,13,1,9,58,11,6.0,2.0,4.0,8.0,0.0,6.0,22.0,28,10,18,13.0,6.0,7.0
9808336,3,2,1,1,2,1,2,103,2.0,1.0,1.0,1.0,1.0,1.0,2.0,7,3,4,4.0,2.0,2.0
110326,5,4,1,1,2,3,15,59,1.0,1.0,0.0,0.0,0.0,1.0,13.0,20,5,15,13.0,1.0,12.0
9802326,2,1,1,1,0,2,4,124,0.0,0.0,0.0,0.0,0.0,0.0,0.0,10,2,8,2.0,0.0,2.0
9910358,0,0,0,0,0,0,0,333,0.0,0.0,0.0,0.0,0.0,0.0,0.0,5,0,5,3.0,0.0,3.0
9912279,6,4,2,2,3,3,17,2,1.0,1.0,0.0,0.0,0.0,1.0,5.0,76,6,70,7.0,0.0,7.0
109026,3,1,2,3,3,0,0,34,0.0,0.0,0.0,0.0,0.0,0.0,0.0,22,3,19,10.0,0.0,10.0
8242,11,2,9,10,4,7,18,65,6.0,2.0,4.0,4.0,0.0,6.0,14.0,18,11,7,5.0,5.0,0.0
101309,1,1,0,0,0,1,7,22,0.0,0.0,0.0,0.0,0.0,0.0,0.0,23,1,22,14.0,0.0,14.0
206264,3,3,0,0,2,1,1,98,1.0,1.0,0.0,0.0,1.0,0.0,0.0,13,3,10,1.0,1.0,0.0
107286,2,2,0,0,0,2,10,12,0.0,0.0,0.0,0.0,0.0,0.0,0.0,18,2,16,2.0,0.0,2.0
202201,4,2,2,2,0,4,14,80,2.0,2.0,0.0,0.0,0.0,2.0,3.0,15,4,11,5.0,2.0,3.0
11122,3,3,0,0,1,2,3,39,0.0,0.0,0.0,0.0,0.0,0.0,0.0,52,3,49,14.0,0.0,14.0
206248,2,1,1,1,0,2,47,12,2.0,1.0,1.0,1.0,0.0,2.0,30.0,92,2,90,16.0,1.0,15.0
9903510,10,5,5,9,1,9,72,6,0.0,0.0,0.0,0.0,0.0,0.0,0.0,51,10,41,16.0,8.0,8.0
10306,8,3,5,5,1,7,29,122,4.0,1.0,3.0,3.0,0.0,4.0,22.0,20,8,12,10.0,3.0,7.0
9712314,2,2,0,0,0,2,5,163,2.0,2.0,0.0,0.0,0.0,2.0,4.0,7,2,5,5.0,2.0,3.0
9606270,0,0,0,0,0,0,0,295,0.0,0.0,0.0,0.0,0.0,0.0,0.0,7,0,7,5.0,0.0,5.0
9706351,2,2,0,0,0,2,9,14,0.0,0.0,0.0,0.0,0.0,0.0,0.0,35,2,33,3.0,0.0,3.0
9810296,9,3,6,7,8,1,1,213,3.0,1.0,2.0,2.0,2.0,1.0,1.0,11,9,2,2.0,2.0,0.0
9802371,2,2,0,0,0,2,13,182,2.0,2.0,0.0,0.0,0.0,2.0,13.0,12,2,10,10.0,2.0,8.0
9508261,1,1,0,0,1,0,0,1093,0.0,0.0,0.0,0.0,0.0,0.0,0.0,5,1,4,,,
206231,2,2,0,0,2,0,0,102,0.0,0.0,0.0,0.0,0.0,0.0,0.0,37,2,35,8.0,0.0,8.0
9805512,4,3,1,1,0,4,13,158,2.0,2.0,0.0,0.0,0.0,2.0,4.0,11,4,7,3.0,2.0,1.0
9809402,6,3,3,3,0,6,17,212,6.0,3.0,3.0,3.0,0.0,6.0,15.0,24,6,18,7.0,5.0,2.0
101024,4,1,3,4,0,4,12,31,2.0,2.0,0.0,0.0,0.0,2.0,5.0,17,4,13,7.0,0.0,7.0
9904484,4,2,2,2,4,0,0,58,2.0,2.0,0.0,0.0,2.0,0.0,0.0,4,4,0,1.0,1.0,0.0
9609206,1,1,0,0,0,1,5,62,1.0,1.0,0.0,0.0,0.0,1.0,5.0,13,1,12,8.0,1.0,7.0
9607316,0,0,0,0,0,0,0,331,0.0,0.0,0.0,0.0,0.0,0.0,0.0,5,0,5,4.0,0.0,4.0
8198,1,1,0,0,0,1,3,33,0.0,0.0,0.0,0.0,0.0,0.0,0.0,17,1,16,1.0,0.0,1.0
9612352,1,1,0,0,0,1,4,14,1.0,1.0,0.0,0.0,0.0,1.0,4.0,16,1,15,,,
9908398,3,3,0,0,0,3,11,123,2.0,2.0,0.0,0.0,0.0,2.0,6.0,15,3,12,5.0,0.0,5.0
211288,2,1,1,1,0,2,2,25,0.0,0.0,0.0,0.0,0.0,0.0,0.0,9,2,7,3.0,2.0,1.0
9512413,3,2,1,1,1,2,2,58,2.0,1.0,1.0,1.0,0.0,2.0,2.0,5,3,2,,,
209241,2,2,0,0,0,2,12,147,1.0,1.0,0.0,0.0,0.0,1.0,4.0,9,2,7,5.0,1.0,4.0
9908318,5,1,4,6,5,0,0,65,5.0,1.0,4.0,6.0,5.0,0.0,0.0,10,5,5,3.0,0.0,3.0
109150,2,2,0,0,0,2,7,0,0.0,0.0,0.0,0.0,0.0,0.0,0.0,36,2,34,3.0,0.0,3.0
4192,7,4,3,7,0,7,64,24,1.0,1.0,0.0,0.0,0.0,1.0,5.0,24,7,17,14.0,5.0,9.0
10280,5,5,0,0,1,4,13,112,4.0,4.0,0.0,0.0,0.0,4.0,12.0,9,5,4,7.0,4.0,3.0
203222,5,2,3,6,0,5,74,3,5.0,2.0,3.0,6.0,0.0,5.0,59.0,35,5,30,10.0,4.0,6.0
204090,1,1,0,0,0,1,1,77,1.0,1.0,0.0,0.0,0.0,1.0,1.0,5,1,4,2.0,1.0,1.0
9903531,5,4,1,1,0,5,55,9,5.0,4.0,1.0,1.0,0.0,5.0,55.0,33,5,28,22.0,3.0,19.0
9710466,1,1,0,0,0,1,2,290,1.0,1.0,0.0,0.0,0.0,1.0,2.0,3,1,2,2.0,1.0,1.0
9312282,2,2,0,0,0,2,3,265,2.0,2.0,0.0,0.0,0.0,2.0,2.0,4,2,2,1.0,1.0,0.0
6215,4,4,0,0,2,2,11,108,2.0,2.0,0.0,0.0,1.0,1.0,5.0,10,4,6,7.0,1.0,6.0
6021,3,3,0,0,0,3,13,33,2.0,2.0,0.0,0.0,0.0,2.0,4.0,15,3,12,2.0,0.0,2.0
10327,1,1,0,0,0,1,4,38,1.0,1.0,0.0,0.0,0.0,1.0,3.0,9,1,8,6.0,1.0,5.0
9808416,2,2,0,0,2,0,0,1,0.0,0.0,0.0,0.0,0.0,0.0,0.0,14,2,12,2.0,0.0,2.0
206075,0,0,0,0,0,0,0,40,0.0,0.0,0.0,0.0,0.0,0.0,0.0,17,0,17,3.0,0.0,3.0
207084,2,2,0,0,2,0,0,562,2.0,2.0,0.0,0.0,2.0,0.0,0.0,2,2,0,2.0,2.0,0.0
9709298,0,0,0,0,0,0,0,27,0.0,0.0,0.0,0.0,0.0,0.0,0.0,5,0,5,,,
9909566,0,0,0,0,0,0,0,1,,,,,,,,15,0,15,,,
104154,14,6,8,9,1,13,15,11,3.0,1.0,2.0,3.0,3.0,0.0,0.0,23,14,9,3.0,3.0,0.0
201256,10,8,2,2,0,10,43,77,3.0,3.0,0.0,0.0,0.0,3.0,15.0,31,10,21,10.0,4.0,6.0
3307,6,1,5,5,0,6,27,122,6.0,1.0,5.0,5.0,0.0,6.0,20.0,20,6,14,10.0,6.0,4.0
206259,13,5,8,10,0,13,71,27,11.0,4.0,7.0,9.0,0.0,11.0,48.0,29,13,16,15.0,9.0,6.0
9411325,2,2,0,0,0,2,8,35,,,,,,,,10,2,8,2.0,1.0,1.0
211026,0,0,0,0,0,0,0,31,0.0,0.0,0.0,0.0,0.0,0.0,0.0,12,0,12,1.0,0.0,1.0
101063,1,1,0,0,0,1,1,271,1.0,1.0,0.0,0.0,0.0,1.0,1.0,2,1,1,2.0,1.0,1.0
105091,2,2,0,0,2,0,0,283,0.0,0.0,0.0,0.0,0.0,0.0,0.0,4,2,2,1.0,0.0,1.0
111141,14,8,6,6,1,13,231,70,12.0,6.0,6.0,6.0,0.0,12.0,217.0,38,14,24,32.0,10.0,22.0
112332,1,1,0,0,1,0,0,129,0.0,0.0,0.0,0.0,0.0,0.0,0.0,5,1,4,,,
9807367,5,3,2,3,0,5,15,83,4.0,3.0,1.0,2.0,0.0,4.0,6.0,14,5,9,9.0,4.0,5.0
9901455,0,0,0,0,0,0,0,220,0.0,0.0,0.0,0.0,0.0,0.0,0.0,7,0,7,2.0,0.0,2.0
9904509,0,0,0,0,0,0,0,203,0.0,0.0,0.0,0.0,0.0,0.0,0.0,3,0,3,1.0,0.0,1.0
9901273,3,3,0,0,2,1,2,3,2.0,2.0,0.0,0.0,1.0,1.0,1.0,12,3,9,3.0,1.0,2.0
212108,2,2,0,0,1,1,1,178,1.0,1.0,0.0,0.0,1.0,0.0,0.0,4,2,2,,,
104183,3,2,1,2,0,3,7,161,3.0,2.0,1.0,2.0,0.0,3.0,7.0,10,3,7,5.0,3.0,2.0
9601308,15,7,8,19,4,11,14,244,11.0,5.0,6.0,14.0,2.0,9.0,10.0,22,15,7,9.0,8.0,1.0
9805339,5,1,4,8,0,5,14,206,5.0,1.0,4.0,8.0,0.0,5.0,12.0,10,5,5,8.0,5.0,3.0
6087,6,2,4,6,2,4,13,161,4.0,1.0,3.0,5.0,0.0,4.0,12.0,12,6,6,8.0,4.0,4.0
206249,6,6,0,0,3,3,8,18,0.0,0.0,0.0,0.0,0.0,0.0,0.0,17,6,11,1.0,0.0,1.0
207061,1,1,0,0,1,0,0,1,1.0,1.0,0.0,0.0,1.0,0.0,0.0,23,1,22,3.0,0.0,3.0
110064,5,1,4,5,1,4,22,82,4.0,1.0,3.0,4.0,0.0,4.0,20.0,27,5,22,20.0,3.0,17.0
9804345,7,2,5,14,0,7,7,76,7.0,2.0,5.0,14.0,0.0,7.0,7.0,8,7,1,8.0,7.0,1.0
111173,1,1,0,0,0,1,1,127,1.0,1.0,0.0,0.0,0.0,1.0,1.0,10,1,9,8.0,0.0,8.0
9406409,0,0,0,0,0,0,0,396,0.0,0.0,0.0,0.0,0.0,0.0,0.0,1,0,1,1.0,0.0,1.0
9712334,1,1,0,0,1,0,0,4,0.0,0.0,0.0,0.0,0.0,0.0,0.0,39,1,38,5.0,0.0,5.0
9508413,2,2,0,0,2,0,0,18,1.0,1.0,0.0,0.0,1.0,0.0,0.0,7,2,5,1.0,0.0,1.0
9230,1,1,0,0,0,1,4,294,0.0,0.0,0.0,0.0,0.0,0.0,0.0,5,1,4,2.0,1.0,1.0
110148,4,2,2,2,0,4,10,165,4.0,2.0,2.0,2.0,0.0,4.0,8.0,11,4,7,1.0,1.0,0.0
1247,1,1,0,0,0,1,9,2,1.0,1.0,0.0,0.0,0.0,1.0,7.0,21,1,20,,,
9608386,1,1,0,0,1,0,0,138,1.0,1.0,0.0,0.0,1.0,0.0,0.0,2,1,1,1.0,1.0,0.0
9511468,1,1,0,0,0,1,2,882,0.0,0.0,0.0,0.0,0.0,0.0,0.0,3,1,2,,,
212352,2,2,0,0,0,2,2,17,1.0,1.0,0.0,0.0,1.0,0.0,0.0,10,2,8,5.0,0.0,5.0
9512403,0,0,0,0,0,0,0,170,0.0,0.0,0.0,0.0,0.0,0.0,0.0,2,0,2,1.0,0.0,1.0
9906220,1,1,0,0,0,1,2,279,1.0,1.0,0.0,0.0,0.0,1.0,1.0,10,1,9,3.0,1.0,2.0
201216,6,3,3,6,0,6,28,37,1.0,1.0,0.0,0.0,0.0,1.0,11.0,48,6,42,20.0,1.0,19.0
205136,1,1,0,0,0,1,6,118,1.0,1.0,0.0,0.0,0.0,1.0,5.0,10,1,9,4.0,1.0,3.0
9602403,1,1,0,0,0,1,4,75,0.0,0.0,0.0,0.0,0.0,0.0,0.0,11,1,10,,,
108142,2,2,0,0,0,2,6,7,1.0,1.0,0.0,0.0,0.0,1.0,1.0,19,2,17,7.0,0.0,7.0
9710326,4,2,2,3,1,3,12,90,3.0,1.0,2.0,3.0,0.0,3.0,12.0,13,4,9,3.0,0.0,3.0
9807276,2,1,1,1,0,2,3,71,2.0,1.0,1.0,1.0,1.0,1.0,2.0,16,2,14,3.0,2.0,1.0
9712414,6,3,3,4,3,3,3,91,3.0,1.0,2.0,3.0,3.0,0.0,0.0,9,6,3,3.0,3.0,0.0
9904256,10,3,7,16,2,8,13,25,5.0,1.0,4.0,10.0,5.0,0.0,0.0,20,10,10,7.0,5.0,2.0
9705410,2,2,0,0,0,2,4,114,0.0,0.0,0.0,0.0,0.0,0.0,0.0,20,2,18,2.0,0.0,2.0
9811342,4,3,1,1,1,3,4,25,1.0,1.0,0.0,0.0,0.0,1.0,1.0,11,4,7,5.0,1.0,4.0
210053,1,1,0,0,0,1,4,2,0.0,0.0,0.0,0.0,0.0,0.0,0.0,37,1,36,19.0,0.0,19.0
211174,0,0,0,0,0,0,0,473,0.0,0.0,0.0,0.0,0.0,0.0,0.0,2,0,2,1.0,0.0,1.0
9712481,1,1,0,0,1,0,0,6,0.0,0.0,0.0,0.0,0.0,0.0,0.0,20,1,19,3.0,1.0,2.0
106216,2,1,1,1,0,2,9,166,2.0,1.0,1.0,1.0,0.0,2.0,4.0,9,2,7,5.0,2.0,3.0
112291,1,1,0,0,0,1,6,71,1.0,1.0,0.0,0.0,0.0,1.0,5.0,8,1,7,6.0,1.0,5.0
210013,0,0,0,0,0,0,0,104,0.0,0.0,0.0,0.0,0.0,0.0,0.0,5,0,5,1.0,0.0,1.0
9709254,4,3,1,1,1,3,3,338,3.0,2.0,1.0,1.0,3.0,0.0,0.0,12,4,8,2.0,2.0,0.0
9612434,1,1,0,0,0,1,1,35,0.0,0.0,0.0,0.0,0.0,0.0,0.0,5,1,4,,,
203082,2,1,1,1,0,2,4,17,1.0,1.0,0.0,0.0,1.0,0.0,0.0,7,2,5,1.0,0.0,1.0
9503429,1,1,0,0,1,0,0,262,1.0,1.0,0.0,0.0,1.0,0.0,0.0,1,1,0,1.0,1.0,0.0
102200,4,2,2,2,3,1,2,18,0.0,0.0,0.0,0.0,0.0,0.0,0.0,8,4,4,2.0,0.0,2.0
7358,3,1,2,2,3,0,0,447,3.0,1.0,2.0,2.0,3.0,0.0,0.0,3,3,0,3.0,3.0,0.0
302118,0,0,0,0,0,0,0,3,,,,,,,,13,0,13,2.0,0.0,2.0
9911215,2,1,1,1,0,2,27,29,2.0,1.0,1.0,1.0,0.0,2.0,23.0,28,2,26,15.0,2.0,13.0
208086,2,2,0,0,0,2,10,82,2.0,2.0,0.0,0.0,0.0,2.0,10.0,15,2,13,10.0,1.0,9.0
206145,1,1,0,0,0,1,2,64,0.0,0.0,0.0,0.0,0.0,0.0,0.0,14,1,13,5.0,0.0,5.0
9907442,0,0,0,0,0,0,0,110,0.0,0.0,0.0,0.0,0.0,0.0,0.0,8,0,8,2.0,0.0,2.0
109124,1,1,0,0,0,1,7,0,0.0,0.0,0.0,0.0,0.0,0.0,0.0,51,1,50,20.0,0.0,20.0
104009,4,2,2,3,0,4,20,1,3.0,1.0,2.0,3.0,1.0,2.0,3.0,16,4,12,3.0,3.0,0.0
112277,1,1,0,0,0,1,3,392,1.0,1.0,0.0,0.0,0.0,1.0,3.0,9,1,8,4.0,1.0,3.0
103099,7,4,3,6,0,7,49,20,5.0,2.0,3.0,6.0,0.0,5.0,41.0,21,7,14,5.0,4.0,1.0
9503272,1,1,0,0,0,1,3,6,0.0,0.0,0.0,0.0,0.0,0.0,0.0,14,1,13,,,
9809526,3,2,1,1,0,3,10,169,3.0,2.0,1.0,1.0,1.0,2.0,6.0,28,3,25,5.0,0.0,5.0
301119,0,0,0,0,0,0,0,2,0.0,0.0,0.0,0.0,0.0,0.0,0.0,13,0,13,6.0,0.0,6.0
9411348,0,0,0,0,0,0,0,96,0.0,0.0,0.0,0.0,0.0,0.0,0.0,2,0,2,,,
9607358,1,1,0,0,0,1,2,160,1.0,1.0,0.0,0.0,0.0,1.0,1.0,5,1,4,2.0,0.0,2.0
9409207,6,3,3,4,6,0,0,186,4.0,1.0,3.0,4.0,4.0,0.0,0.0,8,6,2,4.0,4.0,0.0
212136,0,0,0,0,0,0,0,4,0.0,0.0,0.0,0.0,0.0,0.0,0.0,101,0,101,8.0,0.0,8.0
209052,1,1,0,0,0,1,3,239,1.0,1.0,0.0,0.0,0.0,1.0,3.0,5,1,4,5.0,1.0,4.0
9407298,5,4,1,1,5,0,0,572,2.0,2.0,0.0,0.0,2.0,0.0,0.0,5,5,0,2.0,2.0,0.0
9805352,3,1,2,2,0,3,5,137,3.0,1.0,2.0,2.0,0.0,3.0,5.0,5,3,2,5.0,3.0,2.0
7166,4,3,1,1,4,0,0,187,0.0,0.0,0.0,0.0,0.0,0.0,0.0,9,4,5,3.0,3.0,0.0
5057,0,0,0,0,0,0,0,74,0.0,0.0,0.0,0.0,0.0,0.0,0.0,5,0,5,1.0,0.0,1.0
102214,0,0,0,0,0,0,0,88,0.0,0.0,0.0,0.0,0.0,0.0,0.0,4,0,4,,,
106038,3,1,2,2,1,2,3,311,3.0,1.0,2.0,2.0,1.0,2.0,3.0,6,3,3,5.0,3.0,2.0
9309308,1,1,0,0,1,0,0,327,1.0,1.0,0.0,0.0,1.0,0.0,0.0,1,1,0,1.0,1.0,0.0
9711397,2,2,0,0,1,1,1,44,1.0,1.0,0.0,0.0,1.0,0.0,0.0,6,2,4,1.0,1.0,0.0
105276,0,0,0,0,0,0,0,43,0.0,0.0,0.0,0.0,0.0,0.0,0.0,9,0,9,4.0,0.0,4.0
9406402,7,4,3,4,2,5,5,186,6.0,4.0,2.0,2.0,2.0,4.0,4.0,9,7,2,4.0,3.0,1.0
112341,1,1,0,0,0,1,7,136,1.0,1.0,0.0,0.0,0.0,1.0,7.0,16,1,15,8.0,1.0,7.0
205121,2,2,0,0,0,2,7,89,1.0,1.0,0.0,0.0,0.0,1.0,1.0,29,2,27,12.0,0.0,12.0
9802283,4,3,1,1,2,2,3,282,0.0,0.0,0.0,0.0,0.0,0.0,0.0,12,4,8,6.0,0.0,6.0
7309,6,5,1,1,0,6,12,72,2.0,2.0,0.0,0.0,1.0,1.0,2.0,18,6,12,7.0,2.0,5.0
11194,0,0,0,0,0,0,0,138,0.0,0.0,0.0,0.0,0.0,0.0,0.0,1,0,1,,,
9710486,1,1,0,0,1,0,0,105,1.0,1.0,0.0,0.0,1.0,0.0,0.0,1,1,0,1.0,1.0,0.0
101169,1,1,0,0,0,1,1,1891,1.0,1.0,0.0,0.0,1.0,0.0,0.0,8,1,7,1.0,1.0,0.0
9404316,1,1,0,0,1,0,0,242,,,,,,,,2,1,1,1.0,1.0,0.0
9508231,1,1,0,0,0,1,2,1205,,,,,,,,3,1,2,,,
8026,2,2,0,0,2,0,0,319,2.0,2.0,0.0,0.0,2.0,0.0,0.0,7,2,5,3.0,1.0,2.0
9903225,0,0,0,0,0,0,0,1162,0.0,0.0,0.0,0.0,0.0,0.0,0.0,5,0,5,1.0,0.0,1.0
109076,3,3,0,0,1,2,6,2,0.0,0.0,0.0,0.0,0.0,0.0,0.0,20,3,17,8.0,0.0,8.0
9806418,2,2,0,0,2,0,0,213,1.0,1.0,0.0,0.0,1.0,0.0,0.0,3,2,1,1.0,1.0,0.0
9165,2,2,0,0,1,1,1,185,1.0,1.0,0.0,0.0,0.0,1.0,1.0,4,2,2,1.0,1.0,0.0
206220,1,1,0,0,0,1,4,77,0.0,0.0,0.0,0.0,0.0,0.0,0.0,32,1,31,6.0,0.0,6.0
110143,2,2,0,0,0,2,4,767,1.0,1.0,0.0,0.0,0.0,1.0,1.0,6,2,4,4.0,2.0,2.0
9510263,2,2,0,0,0,2,3,27,2.0,2.0,0.0,0.0,2.0,0.0,0.0,7,2,5,2.0,1.0,1.0
9911271,1,1,0,0,0,1,7,79,0.0,0.0,0.0,0.0,0.0,0.0,0.0,31,1,30,6.0,1.0,5.0
202065,0,0,0,0,0,0,0,122,0.0,0.0,0.0,0.0,0.0,0.0,0.0,2,0,2,2.0,0.0,2.0
109043,5,1,4,9,0,5,41,187,5.0,1.0,4.0,9.0,0.0,5.0,21.0,19,5,14,10.0,5.0,5.0
9905538,0,0,0,0,0,0,0,185,0.0,0.0,0.0,0.0,0.0,0.0,0.0,2,0,2,2.0,0.0,2.0
9710307,1,1,0,0,0,1,7,6,1.0,1.0,0.0,0.0,0.0,1.0,7.0,17,1,16,6.0,0.0,6.0
302031,0,0,0,0,0,0,0,6,0.0,0.0,0.0,0.0,0.0,0.0,0.0,133,0,133,18.0,0.0,18.0
9701223,3,2,1,1,0,3,6,188,0.0,0.0,0.0,0.0,0.0,0.0,0.0,14,3,11,3.0,0.0,3.0
9910290,6,1,5,12,2,4,4,156,6.0,1.0,5.0,12.0,2.0,4.0,4.0,9,6,3,6.0,6.0,0.0
106194,2,2,0,0,0,2,16,79,2.0,2.0,0.0,0.0,0.0,2.0,14.0,14,2,12,11.0,2.0,9.0
205267,0,0,0,0,0,0,0,137,0.0,0.0,0.0,0.0,0.0,0.0,0.0,8,0,8,1.0,0.0,1.0
10219,1,1,0,0,1,0,0,334,0.0,0.0,0.0,0.0,0.0,0.0,0.0,6,1,5,2.0,1.0,1.0
106299,2,1,1,1,1,1,1,0,2.0,1.0,1.0,1.0,1.0,1.0,1.0,11,2,9,3.0,2.0,1.0
9904275,0,0,0,0,0,0,0,268,0.0,0.0,0.0,0.0,0.0,0.0,0.0,2,0,2,2.0,0.0,2.0
9912246,1,1,0,0,0,1,3,352,1.0,1.0,0.0,0.0,0.0,1.0,2.0,6,1,5,3.0,1.0,2.0
111041,0,0,0,0,0,0,0,70,0.0,0.0,0.0,0.0,0.0,0.0,0.0,22,0,22,21.0,0.0,21.0
202163,1,1,0,0,0,1,1,106,1.0,1.0,0.0,0.0,1.0,0.0,0.0,4,1,3,1.0,1.0,0.0
210334,1,1,0,0,0,1,3,31,0.0,0.0,0.0,0.0,0.0,0.0,0.0,11,1,10,1.0,1.0,0.0
9211274,1,1,0,0,1,0,0,359,1.0,1.0,0.0,0.0,1.0,0.0,0.0,1,1,0,1.0,1.0,0.0
9906488,2,2,0,0,0,2,10,101,1.0,1.0,0.0,0.0,0.0,1.0,5.0,16,2,14,9.0,1.0,8.0
9804440,1,1,0,0,1,0,0,81,1.0,1.0,0.0,0.0,1.0,0.0,0.0,5,1,4,1.0,0.0,1.0
9811344,0,0,0,0,0,0,0,242,0.0,0.0,0.0,0.0,0.0,0.0,0.0,5,0,5,1.0,0.0,1.0
9806254,0,0,0,0,0,0,0,31,0.0,0.0,0.0,0.0,0.0,0.0,0.0,4,0,4,,,
9312208,0,0,0,0,0,0,0,15,,,,,,,,9,0,9,,,
106196,1,1,0,0,0,1,1,143,0.0,0.0,0.0,0.0,0.0,0.0,0.0,13,1,12,3.0,0.0,3.0
9403357,0,0,0,0,0,0,0,1319,,,,,,,,1,0,1,1.0,0.0,1.0
9502241,1,1,0,0,1,0,0,611,1.0,1.0,0.0,0.0,1.0,0.0,0.0,3,1,2,1.0,0.0,1.0
110055,0,0,0,0,0,0,0,31,0.0,0.0,0.0,0.0,0.0,0.0,0.0,6,0,6,3.0,0.0,3.0
9707468,1,1,0,0,1,0,0,681,1.0,1.0,0.0,0.0,1.0,0.0,0.0,1,1,0,1.0,1.0,0.0
9909441,2,2,0,0,0,2,4,12,,,,,,,,6,2,4,1.0,0.0,1.0
205211,7,7,0,0,0,7,125,70,7.0,7.0,0.0,0.0,0.0,7.0,118.0,32,7,25,28.0,5.0,23.0
9607299,0,0,0,0,0,0,0,245,0.0,0.0,0.0,0.0,0.0,0.0,0.0,5,0,5,2.0,0.0,2.0
111433,1,1,0,0,0,1,1,254,0.0,0.0,0.0,0.0,0.0,0.0,0.0,9,1,8,4.0,0.0,4.0
9903297,0,0,0,0,0,0,0,20,0.0,0.0,0.0,0.0,0.0,0.0,0.0,9,0,9,3.0,0.0,3.0
9807516,2,2,0,0,2,0,0,312,0.0,0.0,0.0,0.0,0.0,0.0,0.0,8,2,6,1.0,0.0,1.0
206262,2,1,1,1,0,2,20,209,2.0,1.0,1.0,1.0,0.0,2.0,10.0,16,2,14,8.0,2.0,6.0
112147,0,0,0,0,0,0,0,285,0.0,0.0,0.0,0.0,0.0,0.0,0.0,4,0,4,2.0,0.0,2.0
206287,2,1,1,1,0,2,27,8,2.0,1.0,1.0,1.0,0.0,2.0,26.0,28,2,26,18.0,1.0,17.0
9803421,2,2,0,0,0,2,2,4,1.0,1.0,0.0,0.0,1.0,0.0,0.0,17,2,15,1.0,0.0,1.0
9607425,1,1,0,0,1,0,0,352,1.0,1.0,0.0,0.0,1.0,0.0,0.0,1,1,0,,,
9708288,2,1,1,1,0,2,10,95,2.0,1.0,1.0,1.0,0.0,2.0,10.0,18,2,16,7.0,2.0,5.0
9710278,2,1,1,1,0,2,2,180,2.0,1.0,1.0,1.0,0.0,2.0,2.0,3,2,1,2.0,2.0,0.0
302104,2,2,0,0,0,2,20,19,1.0,1.0,0.0,0.0,0.0,1.0,6.0,35,2,33,10.0,1.0,9.0
9709426,0,0,0,0,0,0,0,155,0.0,0.0,0.0,0.0,0.0,0.0,0.0,6,0,6,2.0,0.0,2.0
9802437,0,0,0,0,0,0,0,287,0.0,0.0,0.0,0.0,0.0,0.0,0.0,2,0,2,2.0,0.0,2.0
212143,1,1,0,0,0,1,6,2,1.0,1.0,0.0,0.0,0.0,1.0,3.0,65,1,64,15.0,0.0,15.0
9405370,0,0,0,0,0,0,0,690,0.0,0.0,0.0,0.0,0.0,0.0,0.0,1,0,1,1.0,0.0,1.0
106236,0,0,0,0,0,0,0,20,0.0,0.0,0.0,0.0,0.0,0.0,0.0,17,0,17,,,
9903437,1,1,0,0,0,1,1,83,,,,,,,,3,1,2,,,
9908418,0,0,0,0,0,0,0,116,0.0,0.0,0.0,0.0,0.0,0.0,0.0,2,0,2,1.0,0.0,1.0
5287,1,1,0,0,0,1,3,101,1.0,1.0,0.0,0.0,0.0,1.0,3.0,10,1,9,4.0,1.0,3.0
212139,0,0,0,0,0,0,0,145,0.0,0.0,0.0,0.0,0.0,0.0,0.0,13,0,13,8.0,0.0,8.0
206219,0,0,0,0,0,0,0,13,0.0,0.0,0.0,0.0,0.0,0.0,0.0,13,0,13,1.0,0.0,1.0
9905284,0,0,0,0,0,0,0,291,0.0,0.0,0.0,0.0,0.0,0.0,0.0,9,0,9,1.0,0.0,1.0
2206,3,3,0,0,1,2,2,190,2.0,2.0,0.0,0.0,0.0,2.0,2.0,5,3,2,3.0,2.0,1.0
9902379,5,5,0,0,1,4,8,108,4.0,4.0,0.0,0.0,0.0,4.0,8.0,8,5,3,5.0,4.0,1.0
9710498,0,0,0,0,0,0,0,27,0.0,0.0,0.0,0.0,0.0,0.0,0.0,10,0,10,2.0,0.0,2.0
9812241,0,0,0,0,0,0,0,352,0.0,0.0,0.0,0.0,0.0,0.0,0.0,5,0,5,1.0,0.0,1.0
9808279,0,0,0,0,0,0,0,296,0.0,0.0,0.0,0.0,0.0,0.0,0.0,4,0,4,1.0,0.0,1.0
111329,1,1,0,0,0,1,2,13,0.0,0.0,0.0,0.0,0.0,0.0,0.0,12,1,11,9.0,0.0,9.0
9707530,0,0,0,0,0,0,0,404,0.0,0.0,0.0,0.0,0.0,0.0,0.0,2,0,2,1.0,0.0,1.0
207239,1,1,0,0,0,1,1,16,0.0,0.0,0.0,0.0,0.0,0.0,0.0,7,1,6,6.0,0.0,6.0
9903392,0,0,0,0,0,0,0,51,0.0,0.0,0.0,0.0,0.0,0.0,0.0,7,0,7,2.0,0.0,2.0
111184,1,1,0,0,0,1,2,169,0.0,0.0,0.0,0.0,0.0,0.0,0.0,23,1,22,2.0,1.0,1.0
9910431,1,1,0,0,0,1,4,95,1.0,1.0,0.0,0.0,0.0,1.0,4.0,8,1,7,8.0,1.0,7.0
104138,0,0,0,0,0,0,0,153,0.0,0.0,0.0,0.0,0.0,0.0,0.0,3,0,3,2.0,0.0,2.0
212056,0,0,0,0,0,0,0,59,0.0,0.0,0.0,0.0,0.0,0.0,0.0,7,0,7,2.0,0.0,2.0
109105,1,1,0,0,1,0,0,165,0.0,0.0,0.0,0.0,0.0,0.0,0.0,3,1,2,,,
207265,0,0,0,0,0,0,0,306,0.0,0.0,0.0,0.0,0.0,0.0,0.0,11,0,11,4.0,0.0,4.0
211297,0,0,0,0,0,0,0,642,0.0,0.0,0.0,0.0,0.0,0.0,0.0,4,0,4,1.0,0.0,1.0
9511229,0,0,0,0,0,0,0,194,0.0,0.0,0.0,0.0,0.0,0.0,0.0,7,0,7,5.0,0.0,5.0
9312327,0,0,0,0,0,0,0,1487,,,,,,,,1,0,1,,,
102205,1,1,0,0,0,1,4,3,0.0,0.0,0.0,0.0,0.0,0.0,0.0,40,1,39,12.0,0.0,12.0
301268,0,0,0,0,0,0,0,121,0.0,0.0,0.0,0.0,0.0,0.0,0.0,11,0,11,4.0,0.0,4.0
7117,0,0,0,0,0,0,0,73,,,,,,,,3,0,3,,,
103282,1,1,0,0,1,0,0,639,1.0,1.0,0.0,0.0,1.0,0.0,0.0,3,1,2,1.0,1.0,0.0
208013,0,0,0,0,0,0,0,169,0.0,0.0,0.0,0.0,0.0,0.0,0.0,10,0,10,2.0,0.0,2.0
1223,1,1,0,0,0,1,2,191,1.0,1.0,0.0,0.0,0.0,1.0,2.0,3,1,2,3.0,1.0,2.0
9307264,1,1,0,0,1,0,0,567,1.0,1.0,0.0,0.0,1.0,0.0,0.0,1,1,0,1.0,1.0,0.0
107195,0,0,0,0,0,0,0,8,0.0,0.0,0.0,0.0,0.0,0.0,0.0,21,0,21,6.0,0.0,6.0
9009,2,2,0,0,1,1,3,131,1.0,1.0,0.0,0.0,0.0,1.0,3.0,15,2,13,4.0,1.0,3.0
9807554,2,2,0,0,0,2,2,467,2.0,2.0,0.0,0.0,0.0,2.0,2.0,3,2,1,3.0,2.0,1.0
9411327,0,0,0,0,0,0,0,795,0.0,0.0,0.0,0.0,0.0,0.0,0.0,2,0,2,1.0,0.0,1.0
9810317,0,0,0,0,0,0,0,305,0.0,0.0,0.0,0.0,0.0,0.0,0.0,5,0,5,4.0,0.0,4.0
9807473,0,0,0,0,0,0,0,416,0.0,0.0,0.0,0.0,0.0,0.0,0.0,4,0,4,,,
211274,0,0,0,0,0,0,0,107,0.0,0.0,0.0,0.0,0.0,0.0,0.0,35,0,35,8.0,0.0,8.0
3295,1,1,0,0,0,1,1,233,1.0,1.0,0.0,0.0,0.0,1.0,1.0,5,1,4,2.0,1.0,1.0
9308377,0,0,0,0,0,0,0,75,0.0,0.0,0.0,0.0,0.0,0.0,0.0,8,0,8,4.0,0.0,4.0
9512359,0,0,0,0,0,0,0,859,,,,,,,,2,0,2,,,
3216,1,1,0,0,0,1,1,148,,,,,,,,2,1,1,,,
9508224,0,0,0,0,0,0,0,150,0.0,0.0,0.0,0.0,0.0,0.0,0.0,1,0,1,1.0,0.0,1.0
209205,1,1,0,0,0,1,6,165,1.0,1.0,0.0,0.0,0.0,1.0,5.0,9,1,8,7.0,1.0,6.0
9903290,0,0,0,0,0,0,0,272,0.0,0.0,0.0,0.0,0.0,0.0,0.0,1,0,1,1.0,0.0,1.0
101015,2,2,0,0,0,2,3,128,2.0,2.0,0.0,0.0,2.0,0.0,0.0,8,2,6,2.0,2.0,0.0
111074,0,0,0,0,0,0,0,20,0.0,0.0,0.0,0.0,0.0,0.0,0.0,14,0,14,1.0,0.0,1.0
9708466,1,1,0,0,0,1,3,31,1.0,1.0,0.0,0.0,0.0,1.0,3.0,8,1,7,1.0,0.0,1.0
302191,2,2,0,0,0,2,8,12,0.0,0.0,0.0,0.0,0.0,0.0,0.0,42,2,40,4.0,2.0,2.0
9805415,0,0,0,0,0,0,0,390,0.0,0.0,0.0,0.0,0.0,0.0,0.0,2,0,2,2.0,0.0,2.0
106074,0,0,0,0,0,0,0,144,0.0,0.0,0.0,0.0,0.0,0.0,0.0,3,0,3,1.0,0.0,1.0
202272,0,0,0,0,0,0,0,86,0.0,0.0,0.0,0.0,0.0,0.0,0.0,7,0,7,1.0,0.0,1.0
210072,0,0,0,0,0,0,0,132,0.0,0.0,0.0,0.0,0.0,0.0,0.0,3,0,3,3.0,0.0,3.0
212137,0,0,0,0,0,0,0,361,0.0,0.0,0.0,0.0,0.0,0.0,0.0,1,0,1,1.0,0.0,1.0
9412383,1,1,0,0,0,1,2,342,1.0,1.0,0.0,0.0,0.0,1.0,2.0,11,1,10,3.0,1.0,2.0
9908476,0,0,0,0,0,0,0,3,,,,,,,,14,0,14,,,
9909460,0,0,0,0,0,0,0,428,0.0,0.0,0.0,0.0,0.0,0.0,0.0,4,0,4,3.0,0.0,3.0
9609346,1,1,0,0,0,1,8,15,1.0,1.0,0.0,0.0,0.0,1.0,8.0,11,1,10,,,
212042,0,0,0,0,0,0,0,89,0.0,0.0,0.0,0.0,0.0,0.0,0.0,8,0,8,7.0,0.0,7.0
202141,1,1,0,0,0,1,2,214,0.0,0.0,0.0,0.0,0.0,0.0,0.0,12,1,11,3.0,0.0,3.0
5237,1,1,0,0,1,0,0,700,1.0,1.0,0.0,0.0,1.0,0.0,0.0,1,1,0,1.0,1.0,0.0
9802430,0,0,0,0,0,0,0,286,0.0,0.0,0.0,0.0,0.0,0.0,0.0,2,0,2,,,
9809457,1,1,0,0,1,0,0,702,1.0,1.0,0.0,0.0,1.0,0.0,0.0,1,1,0,1.0,1.0,0.0
203066,0,0,0,0,0,0,0,1094,,,,,,,,3,0,3,,,
202116,2,1,1,1,2,0,0,103,1.0,1.0,0.0,0.0,1.0,0.0,0.0,5,2,3,2.0,1.0,1.0
9408240,0,0,0,0,0,0,0,49,0.0,0.0,0.0,0.0,0.0,0.0,0.0,4,0,4,,,
203084,1,1,0,0,1,0,0,16,1.0,1.0,0.0,0.0,1.0,0.0,0.0,20,1,19,3.0,0.0,3.0
8249,0,0,0,0,0,0,0,43,0.0,0.0,0.0,0.0,0.0,0.0,0.0,19,0,19,13.0,0.0,13.0
9906382,1,1,0,0,0,1,3,8,1.0,1.0,0.0,0.0,0.0,1.0,1.0,7,1,6,1.0,1.0,0.0
211078,1,1,0,0,0,1,2,1561,,,,,,,,3,1,2,2.0,1.0,1.0
302255,0,0,0,0,0,0,0,38,0.0,0.0,0.0,0.0,0.0,0.0,0.0,20,0,20,3.0,0.0,3.0
111085,1,1,0,0,0,1,11,60,1.0,1.0,0.0,0.0,0.0,1.0,11.0,35,1,34,22.0,1.0,21.0
9911229,1,1,0,0,0,1,5,2,0.0,0.0,0.0,0.0,0.0,0.0,0.0,50,1,49,7.0,0.0,7.0
10095,1,1,0,0,0,1,1,125,1.0,1.0,0.0,0.0,0.0,1.0,1.0,2,1,1,2.0,1.0,1.0
9902398,0,0,0,0,0,0,0,131,0.0,0.0,0.0,0.0,0.0,0.0,0.0,7,0,7,2.0,0.0,2.0
207169,1,1,0,0,0,1,6,16,1.0,1.0,0.0,0.0,0.0,1.0,6.0,14,1,13,3.0,0.0,3.0
112079,0,0,0,0,0,0,0,72,0.0,0.0,0.0,0.0,0.0,0.0,0.0,3,0,3,1.0,0.0,1.0
9507252,1,1,0,0,0,1,3,62,1.0,1.0,0.0,0.0,0.0,1.0,3.0,7,1,6,2.0,1.0,1.0
9407215,0,0,0,0,0,0,0,99,0.0,0.0,0.0,0.0,0.0,0.0,0.0,4,0,4,,,
9512408,0,0,0,0,0,0,0,30,0.0,0.0,0.0,0.0,0.0,0.0,0.0,14,0,14,3.0,0.0,3.0
111380,0,0,0,0,0,0,0,218,0.0,0.0,0.0,0.0,0.0,0.0,0.0,11,0,11,9.0,0.0,9.0
9511451,0,0,0,0,0,0,0,164,0.0,0.0,0.0,0.0,0.0,0.0,0.0,6,0,6,2.0,0.0,2.0
211368,0,0,0,0,0,0,0,55,0.0,0.0,0.0,0.0,0.0,0.0,0.0,37,0,37,19.0,0.0,19.0
9405353,0,0,0,0,0,0,0,6,,,,,,,,5,0,5,,,
9904273,2,2,0,0,0,2,4,48,2.0,2.0,0.0,0.0,0.0,2.0,4.0,7,2,5,,,
201167,0,0,0,0,0,0,0,26,0.0,0.0,0.0,0.0,0.0,0.0,0.0,38,0,38,9.0,0.0,9.0
9607468,0,0,0,0,0,0,0,199,0.0,0.0,0.0,0.0,0.0,0.0,0.0,7,0,7,3.0,0.0,3.0
204030,0,0,0,0,0,0,0,37,0.0,0.0,0.0,0.0,0.0,0.0,0.0,33,0,33,12.0,0.0,12.0
212358,0,0,0,0,0,0,0,49,0.0,0.0,0.0,0.0,0.0,0.0,0.0,10,0,10,3.0,0.0,3.0
9408232,0,0,0,0,0,0,0,1513,,,,,,,,1,0,1,,,
9510336,0,0,0,0,0,0,0,1828,,,,,,,,1,0,1,,,
9808482,0,0,0,0,0,0,0,108,0.0,0.0,0.0,0.0,0.0,0.0,0.0,7,0,7,6.0,0.0,6.0
9511302,0,0,0,0,0,0,0,1837,,,,,,,,1,0,1,,,
208020,0,0,0,0,0,0,0,16,0.0,0.0,0.0,0.0,0.0,0.0,0.0,17,0,17,7.0,0.0,7.0
9802264,1,1,0,0,1,0,0,19,0.0,0.0,0.0,0.0,0.0,0.0,0.0,41,1,40,15.0,0.0,15.0
9803461,1,1,0,0,0,1,3,87,1.0,1.0,0.0,0.0,0.0,1.0,3.0,11,1,10,9.0,0.0,9.0
9803442,3,3,0,0,0,3,9,110,3.0,3.0,0.0,0.0,0.0,3.0,9.0,10,3,7,6.0,2.0,4.0
111216,1,1,0,0,1,0,0,651,1.0,1.0,0.0,0.0,1.0,0.0,0.0,2,1,1,1.0,1.0,0.0
207144,0,0,0,0,0,0,0,221,0.0,0.0,0.0,0.0,0.0,0.0,0.0,20,0,20,4.0,0.0,4.0
204116,0,0,0,0,0,0,0,286,0.0,0.0,0.0,0.0,0.0,0.0,0.0,4,0,4,1.0,0.0,1.0
212276,0,0,0,0,0,0,0,52,0.0,0.0,0.0,0.0,0.0,0.0,0.0,6,0,6,1.0,0.0,1.0
3094,0,0,0,0,0,0,0,316,0.0,0.0,0.0,0.0,0.0,0.0,0.0,3,0,3,3.0,0.0,3.0
9812439,0,0,0,0,0,0,0,313,0.0,0.0,0.0,0.0,0.0,0.0,0.0,1,0,1,1.0,0.0,1.0
9712435,0,0,0,0,0,0,0,102,0.0,0.0,0.0,0.0,0.0,0.0,0.0,10,0,10,6.0,0.0,6.0
212133,1,1,0,0,0,1,4,2,0.0,0.0,0.0,0.0,0.0,0.0,0.0,39,1,38,1.0,0.0,1.0
211056,0,0,0,0,0,0,0,2,0.0,0.0,0.0,0.0,0.0,0.0,0.0,18,0,18,14.0,0.0,14.0
107026,1,1,0,0,0,1,12,17,1.0,1.0,0.0,0.0,0.0,1.0,7.0,16,1,15,11.0,1.0,10.0
9809353,0,0,0,0,0,0,0,69,0.0,0.0,0.0,0.0,0.0,0.0,0.0,6,0,6,1.0,0.0,1.0
208207,0,0,0,0,0,0,0,27,,,,,,,,5,0,5,,,
11057,3,2,1,1,1,2,6,347,3.0,2.0,1.0,1.0,1.0,2.0,6.0,9,3,6,5.0,3.0,2.0
112239,0,0,0,0,0,0,0,139,0.0,0.0,0.0,0.0,0.0,0.0,0.0,10,0,10,5.0,0.0,5.0
1010,0,0,0,0,0,0,0,985,,,,,,,,7,0,7,1.0,0.0,1.0
206165,0,0,0,0,0,0,0,13,0.0,0.0,0.0,0.0,0.0,0.0,0.0,24,0,24,10.0,0.0,10.0
9506460,0,0,0,0,0,0,0,318,0.0,0.0,0.0,0.0,0.0,0.0,0.0,5,0,5,1.0,0.0,1.0
108022,0,0,0,0,0,0,0,18,,,,,,,,8,0,8,2.0,0.0,2.0
9123,0,0,0,0,0,0,0,357,0.0,0.0,0.0,0.0,0.0,0.0,0.0,3,0,3,3.0,0.0,3.0
9704271,0,0,0,0,0,0,0,98,,,,,,,,1,0,1,,,
107090,0,0,0,0,0,0,0,19,0.0,0.0,0.0,0.0,0.0,0.0,0.0,24,0,24,22.0,0.0,22.0
207152,0,0,0,0,0,0,0,1468,0.0,0.0,0.0,0.0,0.0,0.0,0.0,3,0,3,1.0,0.0,1.0
301027,0,0,0,0,0,0,0,55,,,,,,,,10,0,10,,,
9803204,1,1,0,0,1,0,0,601,1.0,1.0,0.0,0.0,1.0,0.0,0.0,1,1,0,1.0,1.0,0.0
6131,0,0,0,0,0,0,0,1133,,,,,,,,2,0,2,,,
11261,0,0,0,0,0,0,0,42,0.0,0.0,0.0,0.0,0.0,0.0,0.0,11,0,11,10.0,0.0,10.0
11232,0,0,0,0,0,0,0,57,0.0,0.0,0.0,0.0,0.0,0.0,0.0,16,0,16,12.0,0.0,12.0
9410366,0,0,0,0,0,0,0,1868,,,,,,,,1,0,1,,,
9312290,0,0,0,0,0,0,0,297,0.0,0.0,0.0,0.0,0.0,0.0,0.0,3,0,3,,,
9903491,0,0,0,0,0,0,0,925,0.0,0.0,0.0,0.0,0.0,0.0,0.0,2,0,2,,,
9809359,0,0,0,0,0,0,0,4,0.0,0.0,0.0,0.0,0.0,0.0,0.0,17,0,17,2.0,0.0,2.0
109129,0,0,0,0,0,0,0,106,0.0,0.0,0.0,0.0,0.0,0.0,0.0,9,0,9,3.0,0.0,3.0
106039,1,1,0,0,0,1,1,74,1.0,1.0,0.0,0.0,1.0,0.0,0.0,14,1,13,1.0,0.0,1.0
9710365,0,0,0,0,0,0,0,78,0.0,0.0,0.0,0.0,0.0,0.0,0.0,4,0,4,,,
302020,0,0,0,0,0,0,0,46,0.0,0.0,0.0,0.0,0.0,0.0,0.0,8,0,8,2.0,0.0,2.0
9804245,0,0,0,0,0,0,0,107,0.0,0.0,0.0,0.0,0.0,0.0,0.0,3,0,3,2.0,0.0,2.0
9402300,0,0,0,0,0,0,0,265,0.0,0.0,0.0,0.0,0.0,0.0,0.0,4,0,4,1.0,0.0,1.0
109229,0,0,0,0,0,0,0,175,0.0,0.0,0.0,0.0,0.0,0.0,0.0,6,0,6,2.0,0.0,2.0
302169,0,0,0,0,0,0,0,9,0.0,0.0,0.0,0.0,0.0,0.0,0.0,20,0,20,9.0,0.0,9.0
9911495,0,0,0,0,0,0,0,39,0.0,0.0,0.0,0.0,0.0,0.0,0.0,9,0,9,1.0,0.0,1.0
107155,0,0,0,0,0,0,0,2,0.0,0.0,0.0,0.0,0.0,0.0,0.0,13,0,13,6.0,0.0,6.0
110010,0,0,0,0,0,0,0,905,,,,,,,,5,0,5,,,
7260,0,0,0,0,0,0,0,83,0.0,0.0,0.0,0.0,0.0,0.0,0.0,6,0,6,,,
9354,0,0,0,0,0,0,0,30,0.0,0.0,0.0,0.0,0.0,0.0,0.0,18,0,18,7.0,0.0,7.0
9410402,0,0,0,0,0,0,0,1799,0.0,0.0,0.0,0.0,0.0,0.0,0.0,1,0,1,,,
9707277,0,0,0,0,0,0,0,44,,,,,,,,2,0,2,,,
9608268,0,0,0,0,0,0,0,728,0.0,0.0,0.0,0.0,0.0,0.0,0.0,2,0,2,1.0,0.0,1.0
205275,0,0,0,0,0,0,0,80,0.0,0.0,0.0,0.0,0.0,0.0,0.0,5,0,5,,,
10064,0,0,0,0,0,0,0,262,0.0,0.0,0.0,0.0,0.0,0.0,0.0,1,0,1,1.0,0.0,1.0
211392,0,0,0,0,0,0,0,64,0.0,0.0,0.0,0.0,0.0,0.0,0.0,6,0,6,4.0,0.0,4.0
9912442,0,0,0,0,0,0,0,13,0.0,0.0,0.0,0.0,0.0,0.0,0.0,14,0,14,5.0,0.0,5.0
9612474,1,1,0,0,0,1,1,356,1.0,1.0,0.0,0.0,0.0,1.0,1.0,3,1,2,1.0,1.0,0.0
9806414,0,0,0,0,0,0,0,51,0.0,0.0,0.0,0.0,0.0,0.0,0.0,6,0,6,1.0,0.0,1.0
206160,0,0,0,0,0,0,0,241,0.0,0.0,0.0,0.0,0.0,0.0,0.0,6,0,6,1.0,0.0,1.0
212275,1,1,0,0,0,1,1,167,1.0,1.0,0.0,0.0,0.0,1.0,1.0,9,1,8,4.0,1.0,3.0
9608397,0,0,0,0,0,0,0,54,0.0,0.0,0.0,0.0,0.0,0.0,0.0,20,0,20,3.0,0.0,3.0
212172,0,0,0,0,0,0,0,55,0.0,0.0,0.0,0.0,0.0,0.0,0.0,23,0,23,8.0,0.0,8.0
9906388,0,0,0,0,0,0,0,21,0.0,0.0,0.0,0.0,0.0,0.0,0.0,10,0,10,,,
104273,1,1,0,0,0,1,3,2,0.0,0.0,0.0,0.0,0.0,0.0,0.0,18,1,17,1.0,0.0,1.0
204105,0,0,0,0,0,0,0,181,0.0,0.0,0.0,0.0,0.0,0.0,0.0,10,0,10,6.0,0.0,6.0
7239,0,0,0,0,0,0,0,935,0.0,0.0,0.0,0.0,0.0,0.0,0.0,5,0,5,1.0,0.0,1.0
302132,0,0,0,0,0,0,0,49,0.0,0.0,0.0,0.0,0.0,0.0,0.0,54,0,54,17.0,0.0,17.0
9711471,0,0,0,0,0,0,0,42,0.0,0.0,0.0,0.0,0.0,0.0,0.0,25,0,25,10.0,0.0,10.0
201239,0,0,0,0,0,0,0,314,0.0,0.0,0.0,0.0,0.0,0.0,0.0,3,0,3,2.0,0.0,2.0
203191,0,0,0,0,0,0,0,343,0.0,0.0,0.0,0.0,0.0,0.0,0.0,7,0,7,2.0,0.0,2.0
206227,0,0,0,0,0,0,0,1,0.0,0.0,0.0,0.0,0.0,0.0,0.0,26,0,26,1.0,0.0,1.0
210217,0,0,0,0,0,0,0,17,0.0,0.0,0.0,0.0,0.0,0.0,0.0,16,0,16,6.0,0.0,6.0
212152,0,0,0,0,0,0,0,41,0.0,0.0,0.0,0.0,0.0,0.0,0.0,9,0,9,2.0,0.0,2.0
212332,0,0,0,0,0,0,0,402,0.0,0.0,0.0,0.0,0.0,0.0,0.0,5,0,5,4.0,0.0,4.0
210383,1,1,0,0,0,1,1,412,1.0,1.0,0.0,0.0,0.0,1.0,1.0,3,1,2,2.0,1.0,1.0
111268,0,0,0,0,0,0,0,131,,,,,,,,7,0,7,1.0,0.0,1.0
9709287,0,0,0,0,0,0,0,15,0.0,0.0,0.0,0.0,0.0,0.0,0.0,6,0,6,5.0,0.0,5.0
9909328,0,0,0,0,0,0,0,249,0.0,0.0,0.0,0.0,0.0,0.0,0.0,3,0,3,1.0,0.0,1.0
205171,0,0,0,0,0,0,0,112,0.0,0.0,0.0,0.0,0.0,0.0,0.0,3,0,3,,,
101164,0,0,0,0,0,0,0,92,0.0,0.0,0.0,0.0,0.0,0.0,0.0,6,0,6,3.0,0.0,3.0
9904359,0,0,0,0,0,0,0,227,,,,,,,,1,0,1,,,
301155,0,0,0,0,0,0,0,127,0.0,0.0,0.0,0.0,0.0,0.0,0.0,18,0,18,7.0,0.0,7.0
9910529,0,0,0,0,0,0,0,233,0.0,0.0,0.0,0.0,0.0,0.0,0.0,6,0,6,3.0,0.0,3.0
7331,0,0,0,0,0,0,0,380,0.0,0.0,0.0,0.0,0.0,0.0,0.0,2,0,2,2.0,0.0,2.0
212220,0,0,0,0,0,0,0,7,0.0,0.0,0.0,0.0,0.0,0.0,0.0,41,0,41,14.0,0.0,14.0
301173,0,0,0,0,0,0,0,132,0.0,0.0,0.0,0.0,0.0,0.0,0.0,2,0,2,2.0,0.0,2.0
301086,0,0,0,0,0,0,0,21,0.0,0.0,0.0,0.0,0.0,0.0,0.0,10,0,10,,,
211031,0,0,0,0,0,0,0,38,0.0,0.0,0.0,0.0,0.0,0.0,0.0,7,0,7,3.0,0.0,3.0
111423,0,0,0,0,0,0,0,177,0.0,0.0,0.0,0.0,0.0,0.0,0.0,4,0,4,,,
9508355,0,0,0,0,0,0,0,164,0.0,0.0,0.0,0.0,0.0,0.0,0.0,8,0,8,6.0,0.0,6.0
110204,0,0,0,0,0,0,0,38,0.0,0.0,0.0,0.0,0.0,0.0,0.0,7,0,7,,,
9706312,0,0,0,0,0,0,0,188,,,,,,,,4,0,4,,,
111350,0,0,0,0,0,0,0,752,0.0,0.0,0.0,0.0,0.0,0.0,0.0,6,0,6,2.0,0.0,2.0
9706321,0,0,0,0,0,0,0,179,0.0,0.0,0.0,0.0,0.0,0.0,0.0,6,0,6,1.0,0.0,1.0
211254,0,0,0,0,0,0,0,395,0.0,0.0,0.0,0.0,0.0,0.0,0.0,4,0,4,2.0,0.0,2.0
210191,0,0,0,0,0,0,0,89,0.0,0.0,0.0,0.0,0.0,0.0,0.0,10,0,10,1.0,0.0,1.0
301174,0,0,0,0,0,0,0,193,0.0,0.0,0.0,0.0,0.0,0.0,0.0,5,0,5,,,
9912233,0,0,0,0,0,0,0,47,0.0,0.0,0.0,0.0,0.0,0.0,0.0,26,0,26,2.0,0.0,2.0
106284,0,0,0,0,0,0,0,39,0.0,0.0,0.0,0.0,0.0,0.0,0.0,5,0,5,1.0,0.0,1.0
208150,0,0,0,0,0,0,0,59,0.0,0.0,0.0,0.0,0.0,0.0,0.0,9,0,9,4.0,0.0,4.0
211291,1,1,0,0,1,0,0,1543,,,,,,,,1,1,0,,,
9608260,0,0,0,0,0,0,0,428,0.0,0.0,0.0,0.0,0.0,0.0,0.0,5,0,5,,,
301084,0,0,0,0,0,0,0,11,0.0,0.0,0.0,0.0,0.0,0.0,0.0,82,0,82,25.0,0.0,25.0
112208,0,0,0,0,0,0,0,28,0.0,0.0,0.0,0.0,0.0,0.0,0.0,11,0,11,6.0,0.0,6.0
9702231,0,0,0,0,0,0,0,0,0.0,0.0,0.0,0.0,0.0,0.0,0.0,40,0,40,7.0,0.0,7.0
9912461,0,0,0,0,0,0,0,108,0.0,0.0,0.0,0.0,0.0,0.0,0.0,4,0,4,2.0,0.0,2.0
9301206,3,3,0,0,3,0,0,74,,,,,,,,3,3,0,1.0,1.0,0.0
9403384,118,23,95,789,64,54,98,1,35.0,2.0,33.0,243.0,35.0,0.0,0.0,123,118,5,17.0,17.0,0.0
7038,27,6,21,65,0,27,122,1,16.0,3.0,13.0,37.0,0.0,16.0,66.0,36,27,9,17.0,15.0,2.0
9607366,43,5,38,208,21,22,33,1,19.0,1.0,18.0,100.0,14.0,5.0,5.0,63,43,20,13.0,11.0,2.0
9709328,8,5,3,4,8,0,0,320,2.0,1.0,1.0,1.0,2.0,0.0,0.0,8,8,0,3.0,3.0,0.0
9401254,104,13,91,516,29,75,94,7,42.0,3.0,39.0,228.0,3.0,39.0,39.0,107,104,3,13.0,13.0,0.0
9502363,57,10,47,286,11,46,122,34,29.0,2.0,27.0,182.0,6.0,23.0,55.0,72,57,15,12.0,6.0,6.0
9610449,83,10,73,224,15,68,354,3,32.0,5.0,27.0,81.0,2.0,30.0,150.0,105,83,22,25.0,18.0,7.0
9908202,33,6,27,78,1,32,124,1,13.0,4.0,9.0,14.0,1.0,12.0,31.0,51,33,18,7.0,5.0,2.0
6136,32,16,16,29,5,27,183,7,4.0,3.0,1.0,1.0,0.0,4.0,17.0,76,32,44,5.0,0.0,5.0
9705356,60,9,51,263,11,49,222,1,31.0,7.0,24.0,161.0,1.0,30.0,139.0,82,60,22,17.0,8.0,9.0
9510383,3,2,1,1,1,2,5,34,0.0,0.0,0.0,0.0,0.0,0.0,0.0,6,3,3,1.0,0.0,1.0
9405214,71,30,41,81,54,17,20,35,11.0,2.0,9.0,21.0,11.0,0.0,0.0,77,71,6,9.0,9.0,0.0
9503280,127,43,84,201,127,0,0,141,13.0,6.0,7.0,10.0,13.0,0.0,0.0,128,127,1,8.0,8.0,0.0
9503359,5,2,3,3,0,5,14,35,5.0,2.0,3.0,3.0,0.0,5.0,11.0,11,5,6,7.0,4.0,3.0
9611272,66,10,56,333,4,62,205,19,26.0,2.0,24.0,127.0,3.0,23.0,23.0,89,66,23,20.0,18.0,2.0
9909411,41,11,30,84,2,39,197,2,16.0,5.0,11.0,16.0,0.0,16.0,101.0,55,41,14,14.0,13.0,1.0
9401236,74,31,43,106,60,14,14,26,13.0,7.0,6.0,10.0,5.0,8.0,8.0,75,74,1,8.0,7.0,1.0
9605345,35,10,25,109,6,29,69,33,18.0,2.0,16.0,72.0,0.0,18.0,29.0,47,35,12,16.0,14.0,2.0
9704305,23,3,20,50,0,23,85,48,13.0,3.0,10.0,25.0,0.0,13.0,52.0,33,23,10,16.0,10.0,6.0
9804331,5,3,2,2,2,3,3,33,1.0,1.0,0.0,0.0,0.0,1.0,1.0,9,5,4,1.0,0.0,1.0
9902452,21,5,16,57,2,19,132,102,15.0,3.0,12.0,44.0,1.0,14.0,93.0,43,21,22,24.0,12.0,12.0
108041,25,10,15,23,1,24,131,26,2.0,2.0,0.0,0.0,0.0,2.0,27.0,57,25,32,11.0,2.0,9.0
6262,8,4,4,9,0,8,12,168,6.0,2.0,4.0,8.0,3.0,3.0,3.0,14,8,6,4.0,3.0,1.0
9209244,12,5,7,11,12,0,0,26,4.0,3.0,1.0,1.0,4.0,0.0,0.0,13,12,1,2.0,2.0,0.0
9602390,32,3,29,73,16,16,25,26,9.0,1.0,8.0,16.0,5.0,4.0,4.0,36,32,4,10.0,9.0,1.0
9809472,14,5,9,14,1,13,51,26,12.0,4.0,8.0,12.0,0.0,12.0,50.0,26,14,12,15.0,11.0,4.0
9605326,50,17,33,81,22,28,62,33,12.0,6.0,6.0,15.0,2.0,10.0,24.0,56,50,6,14.0,11.0,3.0
201292,3,3,0,0,2,1,1,460,1.0,1.0,0.0,0.0,1.0,0.0,0.0,8,3,5,2.0,1.0,1.0
9510370,39,10,29,79,13,26,39,73,13.0,3.0,10.0,34.0,1.0,12.0,16.0,46,39,7,4.0,4.0,0.0
9703402,29,5,24,87,1,28,70,86,17.0,2.0,15.0,48.0,1.0,16.0,43.0,39,29,10,13.0,10.0,3.0
104016,13,9,4,6,7,6,15,4,2.0,2.0,0.0,0.0,1.0,1.0,3.0,23,13,10,1.0,0.0,1.0
101342,31,13,18,51,3,28,106,26,2.0,2.0,0.0,0.0,0.0,2.0,8.0,63,31,32,10.0,5.0,5.0
112177,48,12,36,114,0,48,432,4,32.0,5.0,27.0,92.0,0.0,32.0,338.0,75,48,27,38.0,19.0,19.0
9912236,81,4,77,415,12,69,536,4,45.0,3.0,42.0,245.0,1.0,44.0,366.0,106,81,25,43.0,30.0,13.0
9905337,53,5,48,238,10,43,235,38,38.0,2.0,36.0,201.0,2.0,36.0,192.0,72,53,19,40.0,27.0,13.0
9409320,15,4,11,25,12,3,6,87,7.0,1.0,6.0,9.0,7.0,0.0,0.0,18,15,3,6.0,6.0,0.0
9301276,63,9,54,272,63,0,0,89,38.0,2.0,36.0,190.0,38.0,0.0,0.0,63,63,0,27.0,27.0,0.0
9606230,99,13,86,425,20,79,205,25,34.0,5.0,29.0,120.0,1.0,33.0,90.0,118,99,19,26.0,21.0,5.0
9412286,20,6,14,32,19,1,3,105,6.0,3.0,3.0,5.0,5.0,1.0,2.0,23,20,3,7.0,7.0,0.0
9610383,3,2,1,1,0,3,5,223,2.0,1.0,1.0,1.0,1.0,1.0,1.0,17,3,14,2.0,0.0,2.0
9311281,81,15,66,312,17,64,124,5,38.0,4.0,34.0,184.0,6.0,32.0,32.0,88,81,7,23.0,22.0,1.0
9305262,69,16,53,201,69,0,0,60,23.0,4.0,19.0,69.0,23.0,0.0,0.0,69,69,0,12.0,12.0,0.0
9508322,8,3,5,8,0,8,40,3,4.0,3.0,1.0,1.0,0.0,4.0,16.0,19,8,11,2.0,2.0,0.0
9602349,20,9,11,24,2,18,76,87,9.0,3.0,6.0,15.0,0.0,9.0,43.0,42,20,22,15.0,8.0,7.0
9612444,32,1,31,186,0,32,85,0,25.0,1.0,24.0,145.0,0.0,25.0,49.0,50,32,18,24.0,22.0,2.0
9808293,167,7,160,1249,12,155,342,3,91.0,4.0,87.0,809.0,5.0,86.0,204.0,174,167,7,47.0,44.0,3.0
9203201,82,20,62,390,82,0,0,15,41.0,7.0,34.0,297.0,41.0,0.0,0.0,82,82,0,28.0,28.0,0.0
9311204,90,25,65,395,79,11,13,0,37.0,2.0,35.0,252.0,37.0,0.0,0.0,94,90,4,24.0,24.0,0.0
9809205,11,5,6,8,3,8,17,0,0.0,0.0,0.0,0.0,0.0,0.0,0.0,18,11,7,1.0,1.0,0.0
9807234,21,5,16,36,2,19,63,3,5.0,1.0,4.0,4.0,0.0,5.0,21.0,34,21,13,2.0,2.0,0.0
9903460,34,5,29,109,4,30,226,3,22.0,2.0,20.0,71.0,0.0,22.0,167.0,60,34,26,27.0,13.0,14.0
9912238,41,9,32,110,0,41,168,12,14.0,3.0,11.0,45.0,0.0,14.0,14.0,55,41,14,16.0,13.0,3.0
9703464,99,7,92,609,37,62,269,70,71.0,3.0,68.0,543.0,12.0,59.0,257.0,105,99,6,48.0,43.0,5.0
9901208,41,18,23,48,9,32,219,3,14.0,5.0,9.0,20.0,1.0,13.0,91.0,141,41,100,23.0,3.0,20.0
9612232,46,7,39,163,8,38,143,3,6.0,2.0,4.0,5.0,0.0,6.0,30.0,62,46,16,15.0,13.0,2.0
9812222,10,2,8,13,10,0,0,0,1.0,1.0,0.0,0.0,1.0,0.0,0.0,10,10,0,1.0,1.0,0.0
9403311,32,3,29,115,31,1,2,3,10.0,1.0,9.0,18.0,10.0,0.0,0.0,36,32,4,4.0,4.0,0.0
9905320,23,5,18,61,0,23,326,0,16.0,2.0,14.0,55.0,0.0,16.0,304.0,60,23,37,41.0,14.0,27.0
9503436,6,3,3,5,5,1,1,1443,3.0,1.0,2.0,3.0,3.0,0.0,0.0,8,6,2,3.0,3.0,0.0
9807442,26,5,21,65,4,22,94,82,19.0,5.0,14.0,50.0,0.0,19.0,85.0,37,26,11,22.0,12.0,10.0
9810491,35,3,32,167,5,30,247,3,30.0,2.0,28.0,153.0,2.0,28.0,212.0,58,35,23,30.0,17.0,13.0
9908369,18,8,10,14,1,17,121,2,9.0,3.0,6.0,10.0,0.0,9.0,91.0,39,18,21,23.0,7.0,16.0
9711476,12,4,8,18,6,6,17,81,2.0,2.0,0.0,0.0,1.0,1.0,2.0,31,12,19,3.0,1.0,2.0
9412352,23,11,12,26,13,10,16,172,11.0,2.0,9.0,23.0,8.0,3.0,3.0,26,23,3,7.0,7.0,0.0
9710418,15,5,10,27,2,13,40,256,5.0,1.0,4.0,10.0,0.0,5.0,18.0,25,15,10,11.0,6.0,5.0
9711360,35,9,26,67,4,31,152,21,20.0,5.0,15.0,44.0,0.0,20.0,100.0,54,35,19,9.0,9.0,0.0
9602381,85,10,75,527,6,79,207,12,50.0,3.0,47.0,394.0,3.0,47.0,78.0,103,85,18,19.0,19.0,0.0
9603217,34,10,24,63,10,24,62,22,3.0,3.0,0.0,0.0,1.0,2.0,3.0,48,34,14,6.0,5.0,1.0
9311340,191,35,156,633,107,84,148,10,17.0,4.0,13.0,28.0,1.0,16.0,31.0,204,191,13,9.0,9.0,0.0
9604343,22,8,14,19,1,21,75,12,8.0,4.0,4.0,4.0,1.0,7.0,31.0,36,22,14,6.0,3.0,3.0
9805386,22,10,12,23,9,13,37,0,8.0,5.0,3.0,4.0,1.0,7.0,13.0,32,22,10,9.0,3.0,6.0
9602399,6,5,1,2,3,3,3,10,1.0,1.0,0.0,0.0,1.0,0.0,0.0,8,6,2,,,
9507219,7,6,1,1,2,5,9,81,3.0,3.0,0.0,0.0,3.0,0.0,0.0,14,7,7,4.0,1.0,3.0
9209236,27,7,20,73,27,0,0,28,13.0,2.0,11.0,36.0,13.0,0.0,0.0,27,27,0,6.0,6.0,0.0
9701283,36,4,32,117,4,32,95,12,20.0,2.0,18.0,59.0,1.0,19.0,62.0,46,36,10,22.0,14.0,8.0
9502201,21,7,14,27,16,5,10,10,7.0,2.0,5.0,10.0,7.0,0.0,0.0,27,21,6,3.0,3.0,0.0
109259,1,1,0,0,0,1,3,1,0.0,0.0,0.0,0.0,0.0,0.0,0.0,21,1,20,2.0,0.0,2.0
9903447,20,6,14,51,0,20,206,1,17.0,4.0,13.0,45.0,0.0,17.0,192.0,43,20,23,30.0,15.0,15.0
9709369,23,4,19,50,1,22,52,48,7.0,2.0,5.0,9.0,1.0,6.0,20.0,32,23,9,11.0,8.0,3.0
9805260,10,4,6,10,1,9,29,1,3.0,1.0,2.0,2.0,0.0,3.0,3.0,18,10,8,4.0,3.0,1.0
10003,113,14,99,560,4,109,311,18,31.0,2.0,29.0,116.0,25.0,6.0,6.0,128,113,15,21.0,21.0,0.0
2234,56,8,48,264,2,54,647,34,42.0,3.0,39.0,236.0,0.0,42.0,587.0,95,56,39,56.0,31.0,25.0
9912254,30,2,28,147,1,29,151,34,26.0,2.0,24.0,141.0,0.0,26.0,129.0,43,30,13,26.0,19.0,7.0
9909292,39,3,36,140,9,30,71,13,23.0,1.0,22.0,83.0,3.0,20.0,35.0,53,39,14,18.0,17.0,1.0
9608224,85,6,79,511,2,83,636,5,54.0,4.0,50.0,379.0,0.0,54.0,443.0,115,85,30,52.0,37.0,15.0
9703390,10,2,8,20,0,10,114,5,9.0,2.0,7.0,19.0,0.0,9.0,111.0,42,10,32,25.0,8.0,17.0
9712499,35,5,30,101,5,30,268,5,14.0,2.0,12.0,39.0,0.0,14.0,208.0,78,35,43,31.0,9.0,22.0
101023,14,5,9,13,3,11,32,29,3.0,2.0,1.0,1.0,0.0,3.0,4.0,29,14,15,5.0,4.0,1.0
9511242,3,1,2,2,0,3,3,93,,,,,,,,4,3,1,,,
9910505,8,5,3,5,0,8,10,1,2.0,2.0,0.0,0.0,2.0,0.0,0.0,10,8,2,2.0,2.0,0.0
2161,37,6,31,89,1,36,343,6,14.0,7.0,7.0,20.0,0.0,14.0,192.0,76,37,39,21.0,10.0,11.0
9212266,22,7,15,33,17,5,5,6,6.0,4.0,2.0,2.0,6.0,0.0,0.0,23,22,1,3.0,3.0,0.0
9510313,18,2,16,56,3,15,29,1,15.0,2.0,13.0,52.0,2.0,13.0,20.0,25,18,7,13.0,11.0,2.0
9808385,61,13,48,175,10,51,143,1,21.0,4.0,17.0,43.0,1.0,20.0,29.0,73,61,12,19.0,16.0,3.0
9506398,51,7,44,127,8,43,115,6,13.0,2.0,11.0,24.0,0.0,13.0,33.0,64,51,13,11.0,8.0,3.0
9906290,2,2,0,0,0,2,11,1,0.0,0.0,0.0,0.0,0.0,0.0,0.0,16,2,14,8.0,0.0,8.0
9804252,63,11,52,265,7,56,311,7,35.0,3.0,32.0,172.0,1.0,34.0,209.0,78,63,15,36.0,27.0,9.0
9710348,11,4,7,18,10,1,1,313,9.0,3.0,6.0,15.0,9.0,0.0,0.0,12,11,1,8.0,8.0,0.0
9802354,1,1,0,0,1,0,0,54,0.0,0.0,0.0,0.0,0.0,0.0,0.0,12,1,11,7.0,0.0,7.0
9912438,4,4,0,0,1,3,4,349,3.0,3.0,0.0,0.0,0.0,3.0,4.0,6,4,2,5.0,3.0,2.0
9501380,1,1,0,0,1,0,0,1167,,,,,,,,2,1,1,,,
9910501,25,8,17,39,1,24,163,7,17.0,6.0,11.0,25.0,0.0,17.0,94.0,51,25,26,17.0,10.0,7.0
9308264,35,11,24,58,35,0,0,7,2.0,2.0,0.0,0.0,2.0,0.0,0.0,35,35,0,3.0,3.0,0.0
9607284,14,5,9,20,4,10,10,7,2.0,2.0,0.0,0.0,2.0,0.0,0.0,15,14,1,4.0,4.0,0.0
9804223,10,3,7,22,10,0,0,142,7.0,1.0,6.0,16.0,7.0,0.0,0.0,10,10,0,7.0,7.0,0.0
9606447,4,4,0,0,0,4,20,12,3.0,3.0,0.0,0.0,0.0,3.0,14.0,37,4,33,7.0,2.0,5.0
9512288,49,8,41,119,2,47,225,61,24.0,2.0,22.0,52.0,0.0,24.0,123.0,67,49,18,24.0,16.0,8.0
9505241,12,3,9,16,1,11,42,69,5.0,1.0,4.0,8.0,0.0,5.0,26.0,39,12,27,6.0,1.0,5.0
9711212,20,11,9,14,1,19,52,98,14.0,5.0,9.0,14.0,0.0,14.0,47.0,27,20,7,10.0,6.0,4.0
9712476,18,5,13,31,4,14,58,40,14.0,3.0,11.0,28.0,2.0,12.0,38.0,32,18,14,7.0,7.0,0.0
9803267,3,3,0,0,3,0,0,151,3.0,3.0,0.0,0.0,3.0,0.0,0.0,3,3,0,,,
9612413,20,7,13,40,2,18,38,19,13.0,3.0,10.0,31.0,1.0,12.0,20.0,28,20,8,13.0,11.0,2.0
9612377,13,4,9,23,1,12,67,62,8.0,2.0,6.0,16.0,0.0,8.0,44.0,37,13,24,10.0,0.0,10.0
4267,16,1,15,46,0,16,80,24,6.0,1.0,5.0,11.0,0.0,6.0,10.0,31,16,15,9.0,6.0,3.0
9904478,21,6,15,35,5,16,25,218,11.0,2.0,9.0,22.0,5.0,6.0,6.0,26,21,5,12.0,11.0,1.0
9403276,56,11,45,178,30,26,27,47,18.0,2.0,16.0,53.0,8.0,10.0,10.0,59,56,3,15.0,15.0,0.0
9405355,58,15,43,136,22,36,65,57,28.0,7.0,21.0,75.0,6.0,22.0,40.0,62,58,4,16.0,14.0,2.0
9602320,48,11,37,96,24,24,50,16,10.0,2.0,8.0,22.0,2.0,8.0,11.0,56,48,8,12.0,8.0,4.0
9507422,25,10,15,45,19,6,7,30,11.0,3.0,8.0,33.0,8.0,3.0,4.0,29,25,4,9.0,9.0,0.0
9806531,11,2,9,18,11,0,0,80,6.0,1.0,5.0,9.0,6.0,0.0,0.0,13,11,2,3.0,3.0,0.0
9604347,13,8,5,7,7,6,6,98,4.0,1.0,3.0,5.0,4.0,0.0,0.0,15,13,2,4.0,4.0,0.0
9904491,16,7,9,21,0,16,89,4,7.0,2.0,5.0,9.0,0.0,7.0,26.0,47,16,31,11.0,6.0,5.0
9507277,11,4,7,9,11,0,0,30,7.0,1.0,6.0,8.0,7.0,0.0,0.0,11,11,0,5.0,5.0,0.0
9303203,5,5,0,0,2,3,3,93,2.0,2.0,0.0,0.0,2.0,0.0,0.0,6,5,1,2.0,2.0,0.0
9702339,24,7,17,70,3,21,52,59,19.0,4.0,15.0,67.0,1.0,18.0,48.0,29,24,5,21.0,16.0,5.0
9703291,34,5,29,78,1,33,106,6,16.0,3.0,13.0,34.0,0.0,16.0,57.0,43,34,9,10.0,8.0,2.0
9405270,19,3,16,40,5,14,25,6,5.0,3.0,2.0,3.0,5.0,0.0,0.0,21,19,2,3.0,3.0,0.0
9405246,35,5,30,107,18,17,53,6,11.0,2.0,9.0,22.0,1.0,10.0,32.0,46,35,11,4.0,4.0,0.0
9507342,20,4,16,42,12,8,13,85,12.0,2.0,10.0,27.0,9.0,3.0,3.0,25,20,5,10.0,10.0,0.0
9511409,17,9,8,22,3,14,292,6,10.0,3.0,7.0,17.0,0.0,10.0,213.0,117,17,100,41.0,8.0,33.0
7071,2,1,1,1,1,1,3,96,1.0,1.0,0.0,0.0,0.0,1.0,3.0,11,2,9,7.0,0.0,7.0
9410240,75,14,61,232,22,53,98,8,8.0,1.0,7.0,14.0,8.0,0.0,0.0,86,75,11,8.0,7.0,1.0
9702435,19,14,5,6,2,17,27,14,0.0,0.0,0.0,0.0,0.0,0.0,0.0,28,19,9,3.0,3.0,0.0
105242,11,6,5,5,3,8,42,38,3.0,2.0,1.0,1.0,0.0,3.0,19.0,30,11,19,5.0,4.0,1.0
9708412,16,3,13,33,7,9,12,22,9.0,1.0,8.0,17.0,2.0,7.0,7.0,18,16,2,8.0,7.0,1.0
9802440,113,13,100,828,4,109,479,11,86.0,7.0,79.0,741.0,3.0,83.0,419.0,124,113,11,62.0,55.0,7.0
9904305,9,2,7,13,8,1,4,38,0.0,0.0,0.0,0.0,0.0,0.0,0.0,16,9,7,5.0,0.0,5.0
9907439,3,3,0,0,1,2,5,22,2.0,2.0,0.0,0.0,0.0,2.0,5.0,7,3,4,3.0,1.0,2.0
9610259,45,4,41,226,1,44,105,22,30.0,1.0,29.0,169.0,1.0,29.0,69.0,54,45,9,23.0,20.0,3.0
9912306,17,4,13,33,1,16,115,22,15.0,4.0,11.0,26.0,1.0,14.0,107.0,32,17,15,22.0,11.0,11.0
9601214,4,4,0,0,1,3,3,88,0.0,0.0,0.0,0.0,0.0,0.0,0.0,6,4,2,1.0,0.0,1.0
9705474,34,10,24,63,7,27,132,90,20.0,7.0,13.0,37.0,3.0,17.0,75.0,56,34,22,17.0,8.0,9.0
7043,0,0,0,0,0,0,0,21,0.0,0.0,0.0,0.0,0.0,0.0,0.0,17,0,17,15.0,0.0,15.0
9701360,19,4,15,24,0,19,110,40,11.0,2.0,9.0,13.0,0.0,11.0,69.0,38,19,19,16.0,7.0,9.0
5114,27,15,12,32,0,27,276,19,3.0,1.0,2.0,3.0,0.0,3.0,53.0,222,27,195,21.0,0.0,21.0
9603326,95,17,78,343,6,89,281,43,34.0,2.0,32.0,196.0,3.0,31.0,112.0,108,95,13,28.0,22.0,6.0
9806482,79,9,70,292,2,77,357,16,49.0,6.0,43.0,179.0,0.0,49.0,264.0,92,79,13,39.0,28.0,11.0
9905391,21,7,14,35,2,19,75,43,7.0,3.0,4.0,6.0,2.0,5.0,10.0,31,21,10,9.0,4.0,5.0
9409410,43,33,10,14,39,4,8,39,6.0,6.0,0.0,0.0,6.0,0.0,0.0,47,43,4,4.0,4.0,0.0
9507363,79,8,71,362,13,66,115,43,30.0,2.0,28.0,181.0,0.0,30.0,58.0,84,79,5,22.0,19.0,3.0
9810220,12,3,9,12,2,10,40,101,6.0,2.0,4.0,4.0,1.0,5.0,19.0,28,12,16,4.0,2.0,2.0
106110,10,5,5,5,0,10,66,20,3.0,2.0,1.0,1.0,0.0,3.0,18.0,41,10,31,13.0,3.0,10.0
3185,9,4,5,8,1,8,115,20,8.0,3.0,5.0,8.0,0.0,8.0,114.0,34,9,25,30.0,7.0,23.0
9209262,51,23,28,97,34,17,20,29,16.0,8.0,8.0,33.0,8.0,8.0,8.0,53,51,2,10.0,10.0,0.0
9406295,54,12,42,165,14,40,106,29,21.0,7.0,14.0,47.0,3.0,18.0,43.0,64,54,10,16.0,12.0,4.0
12274,15,4,11,39,0,15,71,20,15.0,4.0,11.0,39.0,0.0,15.0,71.0,25,15,10,12.0,9.0,3.0
9812515,7,2,5,11,0,7,25,20,0.0,0.0,0.0,0.0,0.0,0.0,0.0,16,7,9,2.0,0.0,2.0
9905356,11,7,4,6,11,0,0,153,2.0,2.0,0.0,0.0,2.0,0.0,0.0,11,11,0,2.0,2.0,0.0
9510232,64,16,48,169,53,11,13,54,13.0,2.0,11.0,33.0,11.0,2.0,2.0,72,64,8,8.0,8.0,0.0
210133,6,2,4,6,0,6,52,37,4.0,2.0,2.0,2.0,0.0,4.0,24.0,35,6,29,10.0,1.0,9.0
9709320,23,9,14,27,6,17,58,15,6.0,3.0,3.0,4.0,0.0,6.0,6.0,57,23,34,8.0,7.0,1.0
9510294,17,6,11,19,3,14,32,29,2.0,1.0,1.0,1.0,0.0,2.0,4.0,26,17,9,3.0,0.0,3.0
9801353,27,2,25,71,0,27,86,18,13.0,1.0,12.0,34.0,0.0,13.0,37.0,34,27,7,15.0,11.0,4.0
9310211,42,11,31,121,42,0,0,5,6.0,1.0,5.0,11.0,6.0,0.0,0.0,43,42,1,4.0,4.0,0.0
9803391,51,7,44,193,19,32,63,32,25.0,1.0,24.0,101.0,2.0,23.0,44.0,59,51,8,7.0,7.0,0.0
9507441,10,2,8,14,6,4,5,376,5.0,0.0,5.0,10.0,5.0,0.0,0.0,14,10,4,5.0,5.0,0.0
6128,16,4,12,23,0,16,112,73,16.0,4.0,12.0,23.0,0.0,16.0,104.0,27,16,11,19.0,9.0,10.0
9405389,73,9,64,325,56,17,21,42,36.0,3.0,33.0,163.0,25.0,11.0,14.0,75,73,2,22.0,22.0,0.0
9707201,19,6,13,43,1,18,96,42,11.0,5.0,6.0,21.0,3.0,8.0,13.0,42,19,23,12.0,9.0,3.0
9506380,280,48,232,1360,87,193,645,18,82.0,3.0,79.0,571.0,8.0,74.0,208.0,338,280,58,35.0,33.0,2.0
9511298,9,5,4,5,3,6,13,35,2.0,2.0,0.0,0.0,1.0,1.0,1.0,17,9,8,3.0,0.0,3.0
9306204,37,14,23,87,37,0,0,5,16.0,3.0,13.0,37.0,16.0,0.0,0.0,37,37,0,13.0,13.0,0.0
9403378,25,1,24,110,2,23,23,71,23.0,1.0,22.0,100.0,1.0,22.0,22.0,26,25,1,18.0,17.0,1.0
9508221,25,13,12,35,1,24,92,44,7.0,4.0,3.0,6.0,0.0,7.0,29.0,74,25,49,7.0,2.0,5.0
9506455,15,2,13,27,0,15,40,4,2.0,1.0,1.0,1.0,0.0,2.0,10.0,27,15,12,6.0,3.0,3.0
9901351,12,8,4,5,2,10,22,61,2.0,2.0,0.0,0.0,0.0,2.0,12.0,27,12,15,10.0,2.0,8.0
9902219,3,3,0,0,3,0,0,50,1.0,1.0,0.0,0.0,1.0,0.0,0.0,7,3,4,2.0,2.0,0.0
9605446,112,2,110,995,3,109,322,11,94.0,1.0,93.0,950.0,1.0,93.0,279.0,116,112,4,59.0,56.0,3.0
9904369,7,4,3,4,6,1,1,91,0.0,0.0,0.0,0.0,0.0,0.0,0.0,15,7,8,4.0,0.0,4.0
9805346,29,1,28,91,3,26,86,28,19.0,1.0,18.0,50.0,0.0,19.0,53.0,35,29,6,18.0,14.0,4.0
9409387,1,1,0,0,1,0,0,6,0.0,0.0,0.0,0.0,0.0,0.0,0.0,23,1,22,17.0,0.0,17.0
9207216,26,10,16,45,26,0,0,41,11.0,5.0,6.0,8.0,11.0,0.0,0.0,26,26,0,9.0,9.0,0.0
9807213,5,4,1,1,2,3,4,63,4.0,4.0,0.0,0.0,3.0,1.0,1.0,7,5,2,3.0,3.0,0.0
9410345,71,15,56,253,35,36,55,117,36.0,4.0,32.0,166.0,36.0,0.0,0.0,76,71,5,25.0,25.0,0.0
9506400,0,0,0,0,0,0,0,583,0.0,0.0,0.0,0.0,0.0,0.0,0.0,1,0,1,1.0,0.0,1.0
9408287,19,3,16,65,1,18,26,49,15.0,2.0,13.0,57.0,15.0,0.0,0.0,22,19,3,7.0,7.0,0.0
9702375,33,15,18,30,3,30,147,6,8.0,5.0,3.0,4.0,0.0,8.0,75.0,128,33,95,42.0,1.0,41.0
205162,2,2,0,0,1,1,1,13,1.0,1.0,0.0,0.0,1.0,0.0,0.0,8,2,6,1.0,1.0,0.0
9712384,7,5,2,3,2,5,19,157,5.0,3.0,2.0,3.0,0.0,5.0,14.0,16,7,9,5.0,3.0,2.0
9408270,4,3,1,1,0,4,7,74,2.0,2.0,0.0,0.0,1.0,1.0,1.0,8,4,4,1.0,0.0,1.0
9511259,3,3,0,0,0,3,10,10,0.0,0.0,0.0,0.0,0.0,0.0,0.0,13,3,10,3.0,1.0,2.0
9507379,40,5,35,201,7,33,47,55,28.0,2.0,26.0,160.0,6.0,22.0,22.0,49,40,9,23.0,22.0,1.0
9712359,27,7,20,41,7,20,131,87,16.0,2.0,14.0,29.0,0.0,16.0,90.0,44,27,17,23.0,14.0,9.0
9041,51,16,35,83,21,30,87,0,15.0,2.0,13.0,33.0,1.0,14.0,41.0,60,51,9,12.0,6.0,6.0
9704219,9,6,3,4,0,9,20,55,4.0,4.0,0.0,0.0,1.0,3.0,3.0,15,9,6,1.0,1.0,0.0
9174,37,13,24,65,3,34,92,3,10.0,3.0,7.0,18.0,3.0,7.0,7.0,47,37,10,8.0,4.0,4.0
9911204,3,3,0,0,0,3,12,161,1.0,1.0,0.0,0.0,0.0,1.0,4.0,21,3,18,6.0,1.0,5.0
9509398,41,11,30,64,15,26,80,124,4.0,1.0,3.0,6.0,0.0,4.0,30.0,81,41,40,12.0,4.0,8.0
1229,21,3,18,69,0,21,134,23,18.0,2.0,16.0,60.0,0.0,18.0,70.0,44,21,23,19.0,14.0,5.0
9208251,80,10,70,472,80,0,0,18,55.0,3.0,52.0,407.0,55.0,0.0,0.0,80,80,0,31.0,31.0,0.0
110252,7,5,2,2,0,7,45,27,5.0,3.0,2.0,2.0,0.0,5.0,36.0,27,7,20,13.0,5.0,8.0
9904282,42,6,36,123,7,35,134,5,9.0,1.0,8.0,16.0,0.0,9.0,57.0,65,42,23,14.0,6.0,8.0
9902237,36,6,30,119,1,35,156,18,24.0,2.0,22.0,92.0,0.0,24.0,100.0,63,36,27,15.0,14.0,1.0
9808456,32,3,29,144,4,28,106,18,22.0,1.0,21.0,121.0,2.0,20.0,68.0,56,32,24,26.0,22.0,4.0
9911345,11,8,3,4,3,8,9,92,3.0,3.0,0.0,0.0,0.0,3.0,4.0,13,11,2,2.0,2.0,0.0
102163,24,6,18,54,4,20,106,7,7.0,2.0,5.0,16.0,0.0,7.0,48.0,47,24,23,17.0,6.0,11.0
9903402,68,6,62,374,1,67,341,32,49.0,2.0,47.0,306.0,1.0,48.0,247.0,86,68,18,38.0,31.0,7.0
9712364,3,2,1,1,2,1,13,6,0.0,0.0,0.0,0.0,0.0,0.0,0.0,32,3,29,7.0,0.0,7.0
105269,30,4,26,79,3,27,258,0,9.0,3.0,6.0,14.0,0.0,9.0,149.0,80,30,50,41.0,5.0,36.0
11307,26,6,20,62,2,24,81,0,14.0,1.0,13.0,39.0,0.0,14.0,41.0,44,26,18,6.0,2.0,4.0
9302249,41,10,31,93,41,0,0,97,17.0,6.0,11.0,16.0,17.0,0.0,0.0,41,41,0,7.0,7.0,0.0
9608398,11,4,7,8,5,6,16,41,6.0,3.0,3.0,4.0,0.0,6.0,10.0,15,11,4,9.0,6.0,3.0
2008,11,3,8,17,1,10,10,11,7.0,2.0,5.0,11.0,7.0,0.0,0.0,14,11,3,7.0,6.0,1.0
7215,10,8,2,2,3,7,10,64,6.0,4.0,2.0,2.0,3.0,3.0,3.0,14,10,4,5.0,4.0,1.0
9410266,30,9,21,53,1,29,78,35,12.0,4.0,8.0,16.0,0.0,12.0,32.0,43,30,13,9.0,6.0,3.0
9710416,16,3,13,32,6,10,29,163,11.0,2.0,9.0,23.0,6.0,5.0,15.0,22,16,6,9.0,4.0,5.0
9906402,10,5,5,7,0,10,35,43,5.0,2.0,3.0,4.0,0.0,5.0,5.0,17,10,7,6.0,5.0,1.0
9508337,29,9,20,72,10,19,34,44,11.0,3.0,8.0,27.0,3.0,8.0,12.0,37,29,8,13.0,11.0,2.0
9508334,10,1,9,10,2,8,14,94,2.0,1.0,1.0,1.0,1.0,1.0,4.0,16,10,6,4.0,3.0,1.0
9806290,12,8,4,7,2,10,110,5,5.0,3.0,2.0,5.0,0.0,5.0,75.0,44,12,32,24.0,5.0,19.0
9508274,22,12,10,21,9,13,23,8,3.0,2.0,1.0,1.0,3.0,0.0,0.0,24,22,2,4.0,3.0,1.0
4268,8,6,2,3,4,4,6,113,2.0,1.0,1.0,1.0,2.0,0.0,0.0,13,8,5,1.0,1.0,0.0
9505419,34,7,27,95,5,29,72,39,21.0,4.0,17.0,54.0,6.0,15.0,23.0,41,34,7,18.0,16.0,2.0
8049,51,5,46,187,2,49,236,2,32.0,4.0,28.0,132.0,0.0,32.0,112.0,63,51,12,38.0,32.0,6.0
9910365,48,18,30,55,10,38,209,0,20.0,5.0,15.0,32.0,0.0,20.0,98.0,132,48,84,3.0,2.0,1.0
9908462,7,4,3,5,0,7,31,2,6.0,4.0,2.0,4.0,0.0,6.0,27.0,15,7,8,1.0,0.0,1.0
107068,8,4,4,6,1,7,20,258,5.0,2.0,3.0,5.0,0.0,5.0,16.0,17,8,9,11.0,4.0,7.0
9509373,37,23,14,24,28,9,12,44,8.0,5.0,3.0,4.0,8.0,0.0,0.0,42,37,5,4.0,4.0,0.0
11368,12,6,6,7,2,10,33,16,1.0,1.0,0.0,0.0,0.0,1.0,6.0,30,12,18,7.0,1.0,6.0
5232,36,1,35,251,0,36,169,19,29.0,1.0,28.0,229.0,0.0,29.0,149.0,43,36,7,34.0,28.0,6.0
110315,8,6,2,2,1,7,35,19,4.0,2.0,2.0,2.0,0.0,4.0,19.0,26,8,18,5.0,0.0,5.0
6304,12,6,6,9,1,11,36,19,3.0,2.0,1.0,2.0,1.0,2.0,2.0,24,12,12,4.0,3.0,1.0
201127,44,17,27,67,10,34,221,19,12.0,2.0,10.0,31.0,1.0,11.0,81.0,85,44,41,13.0,9.0,4.0
10031,5,3,2,3,0,5,34,19,4.0,2.0,2.0,3.0,0.0,4.0,33.0,15,5,10,1.0,1.0,0.0
201228,20,3,17,70,0,20,279,28,17.0,2.0,15.0,68.0,0.0,17.0,202.0,41,20,21,33.0,17.0,16.0
9912287,37,7,30,86,0,37,468,2,20.0,5.0,15.0,41.0,0.0,20.0,346.0,96,37,59,36.0,8.0,28.0
4086,12,5,7,13,0,12,71,2,8.0,3.0,5.0,9.0,1.0,7.0,22.0,20,12,8,10.0,6.0,4.0
9603397,32,9,23,67,19,13,28,105,16.0,4.0,12.0,27.0,10.0,6.0,12.0,41,32,9,11.0,11.0,0.0
9304261,10,5,5,13,10,0,0,108,6.0,3.0,3.0,9.0,6.0,0.0,0.0,10,10,0,2.0,2.0,0.0
9605423,15,3,12,50,0,15,27,142,14.0,3.0,11.0,49.0,0.0,14.0,23.0,18,15,3,15.0,13.0,2.0
110391,14,4,10,19,0,14,152,2,10.0,4.0,6.0,9.0,0.0,10.0,123.0,44,14,30,23.0,4.0,19.0
10103,9,5,4,4,0,9,67,2,1.0,1.0,0.0,0.0,0.0,1.0,14.0,40,9,31,3.0,3.0,0.0
9912464,19,12,7,14,0,19,85,2,10.0,7.0,3.0,4.0,2.0,8.0,27.0,34,19,15,10.0,4.0,6.0
9912271,19,11,8,17,0,19,100,10,4.0,4.0,0.0,0.0,0.0,4.0,31.0,43,19,24,10.0,3.0,7.0
8120,5,3,2,3,0,5,30,2,0.0,0.0,0.0,0.0,0.0,0.0,0.0,32,5,27,4.0,1.0,3.0
9707462,16,9,7,11,3,13,61,10,2.0,1.0,1.0,1.0,0.0,2.0,8.0,30,16,14,5.0,3.0,2.0
9611248,13,5,8,19,10,3,26,30,2.0,2.0,0.0,0.0,0.0,2.0,22.0,31,13,18,9.0,1.0,8.0
9601311,20,7,13,30,5,15,25,119,12.0,4.0,8.0,14.0,4.0,8.0,17.0,25,20,5,10.0,7.0,3.0
9403349,20,6,14,44,14,6,7,12,11.0,3.0,8.0,32.0,11.0,0.0,0.0,26,20,6,1.0,1.0,0.0
9410259,23,8,15,42,6,17,69,164,6.0,3.0,3.0,4.0,1.0,5.0,20.0,35,23,12,11.0,3.0,8.0
9811444,24,11,13,17,21,3,3,0,4.0,1.0,3.0,3.0,4.0,0.0,0.0,28,24,4,4.0,1.0,3.0
9912330,18,2,16,38,0,18,158,32,13.0,1.0,12.0,28.0,0.0,13.0,127.0,61,18,43,35.0,10.0,25.0
201207,0,0,0,0,0,0,0,3,0.0,0.0,0.0,0.0,0.0,0.0,0.0,17,0,17,1.0,0.0,1.0
9911395,54,7,47,242,0,54,390,3,45.0,8.0,37.0,173.0,0.0,45.0,315.0,82,54,28,16.0,13.0,3.0
2254,2,2,0,0,1,1,20,58,0.0,0.0,0.0,0.0,0.0,0.0,0.0,34,2,32,9.0,0.0,9.0
12154,8,2,6,11,1,7,26,301,3.0,1.0,2.0,2.0,0.0,3.0,8.0,22,8,14,6.0,3.0,3.0
9711280,17,3,14,37,0,17,66,7,12.0,4.0,8.0,20.0,1.0,11.0,32.0,28,17,11,2.0,0.0,2.0
3321,17,6,11,20,8,9,13,1,4.0,2.0,2.0,2.0,3.0,1.0,1.0,22,17,5,3.0,3.0,0.0
9505339,12,7,5,9,1,11,22,61,4.0,1.0,3.0,4.0,4.0,0.0,0.0,19,12,7,5.0,4.0,1.0
9301233,11,8,3,4,11,0,0,196,8.0,7.0,1.0,1.0,8.0,0.0,0.0,11,11,0,6.0,6.0,0.0
8214,17,3,14,50,0,17,135,9,16.0,3.0,13.0,48.0,0.0,16.0,134.0,32,17,15,14.0,10.0,4.0
9608261,6,3,3,8,0,6,8,11,2.0,2.0,0.0,0.0,0.0,2.0,2.0,9,6,3,3.0,2.0,1.0
9701208,13,9,4,5,0,13,148,17,11.0,9.0,2.0,3.0,0.0,11.0,137.0,46,13,33,32.0,7.0,25.0
9612408,14,6,8,16,0,14,111,17,13.0,5.0,8.0,16.0,0.0,13.0,109.0,36,14,22,27.0,9.0,18.0
9801206,9,3,6,14,1,8,18,48,4.0,2.0,2.0,3.0,0.0,4.0,9.0,14,9,5,1.0,1.0,0.0
9511301,13,8,5,8,13,0,0,211,8.0,6.0,2.0,4.0,8.0,0.0,0.0,13,13,0,5.0,5.0,0.0
9411324,13,5,8,18,10,3,4,162,7.0,2.0,5.0,9.0,5.0,2.0,3.0,18,13,5,7.0,7.0,0.0
9607294,6,6,0,0,0,6,26,5,3.0,3.0,0.0,0.0,0.0,3.0,17.0,18,6,12,1.0,1.0,0.0
9410274,12,9,3,3,12,0,0,287,3.0,3.0,0.0,0.0,3.0,0.0,0.0,12,12,0,4.0,4.0,0.0
9406399,7,2,5,8,4,3,3,8,4.0,1.0,3.0,5.0,4.0,0.0,0.0,8,7,1,1.0,1.0,0.0
9612322,16,3,13,32,0,16,46,182,14.0,3.0,11.0,29.0,0.0,14.0,42.0,23,16,7,18.0,13.0,5.0
202007,5,2,3,3,0,5,21,93,2.0,2.0,0.0,0.0,0.0,2.0,4.0,15,5,10,7.0,4.0,3.0
9905228,11,2,9,17,3,8,9,44,10.0,2.0,8.0,16.0,9.0,1.0,1.0,15,11,4,10.0,9.0,1.0
9902242,4,4,0,0,0,4,25,5,0.0,0.0,0.0,0.0,0.0,0.0,0.0,14,4,10,,,
6054,11,1,10,27,0,11,62,29,10.0,1.0,9.0,24.0,0.0,10.0,61.0,26,11,15,20.0,10.0,10.0
9303272,6,4,2,2,6,0,0,253,2.0,2.0,0.0,0.0,2.0,0.0,0.0,6,6,0,1.0,1.0,0.0
9709511,11,1,10,28,0,11,144,5,7.0,1.0,6.0,18.0,0.0,7.0,124.0,38,11,27,33.0,7.0,26.0
9809243,9,3,6,7,0,9,30,101,7.0,3.0,4.0,5.0,0.0,7.0,24.0,15,9,6,10.0,7.0,3.0
9509237,38,17,21,40,21,17,24,117,10.0,2.0,8.0,17.0,10.0,0.0,0.0,42,38,4,4.0,4.0,0.0
9701248,31,7,24,81,4,27,51,117,24.0,4.0,20.0,75.0,1.0,23.0,27.0,41,31,10,21.0,19.0,2.0
110032,19,7,12,28,0,19,189,23,9.0,2.0,7.0,14.0,0.0,9.0,104.0,54,19,35,22.0,10.0,12.0
3032,20,3,17,65,0,20,302,24,19.0,3.0,16.0,64.0,0.0,19.0,272.0,55,20,35,39.0,13.0,26.0
9407285,4,3,1,1,3,1,2,1769,,,,,,,,6,4,2,,,
9410309,13,4,9,27,13,0,0,22,4.0,1.0,3.0,4.0,4.0,0.0,0.0,13,13,0,3.0,3.0,0.0
9305346,7,5,2,2,7,0,0,121,1.0,1.0,0.0,0.0,1.0,0.0,0.0,7,7,0,1.0,1.0,0.0
9808291,8,3,5,7,1,7,30,9,6.0,2.0,4.0,5.0,6.0,0.0,0.0,16,8,8,3.0,3.0,0.0
9711440,45,7,38,166,0,45,232,14,31.0,5.0,26.0,111.0,0.0,31.0,170.0,61,45,16,25.0,16.0,9.0
9607217,22,11,11,18,13,9,12,105,6.0,1.0,5.0,7.0,3.0,3.0,4.0,25,22,3,4.0,2.0,2.0
9501414,4,4,0,0,2,2,10,14,1.0,1.0,0.0,0.0,1.0,0.0,0.0,9,4,5,,,
9310346,12,7,5,10,4,8,10,14,4.0,4.0,0.0,0.0,1.0,3.0,3.0,18,12,6,3.0,2.0,1.0
9807487,11,4,7,12,1,10,45,41,4.0,1.0,3.0,4.0,0.0,4.0,24.0,31,11,20,13.0,3.0,10.0
9912345,2,2,0,0,0,2,17,14,2.0,2.0,0.0,0.0,0.0,2.0,12.0,17,2,15,4.0,1.0,3.0
9402318,17,5,12,30,3,14,18,13,13.0,4.0,9.0,24.0,5.0,8.0,11.0,20,17,3,2.0,1.0,1.0
9511407,21,6,15,40,4,17,79,94,14.0,2.0,12.0,34.0,0.0,14.0,74.0,30,21,9,19.0,12.0,7.0
9911476,7,2,5,9,2,5,16,45,4.0,1.0,3.0,4.0,0.0,4.0,10.0,14,7,7,7.0,4.0,3.0
104060,2,1,1,1,0,2,4,11,1.0,1.0,0.0,0.0,0.0,1.0,1.0,5,2,3,1.0,0.0,1.0
9504336,36,13,23,79,4,32,58,16,31.0,14.0,17.0,62.0,3.0,28.0,51.0,41,36,5,18.0,17.0,1.0
9811395,5,1,4,6,1,4,10,162,4.0,1.0,3.0,5.0,2.0,2.0,6.0,12,5,7,6.0,4.0,2.0
9507211,7,1,6,15,0,7,34,16,6.0,1.0,5.0,12.0,0.0,6.0,30.0,14,7,7,7.0,5.0,2.0
9508203,1,1,0,0,0,1,3,286,0.0,0.0,0.0,0.0,0.0,0.0,0.0,6,1,5,2.0,0.0,2.0
9701320,3,3,0,0,2,1,1,192,1.0,1.0,0.0,0.0,1.0,0.0,0.0,5,3,2,1.0,1.0,0.0
9707524,4,1,3,4,4,0,0,66,3.0,1.0,2.0,3.0,3.0,0.0,0.0,5,4,1,,,
9509259,9,3,6,6,5,4,5,367,2.0,1.0,1.0,1.0,2.0,0.0,0.0,13,9,4,3.0,2.0,1.0
9411433,14,7,7,9,10,4,9,29,2.0,1.0,1.0,1.0,0.0,2.0,4.0,24,14,10,5.0,5.0,0.0
9907487,8,1,7,11,1,7,15,97,8.0,1.0,7.0,11.0,1.0,7.0,9.0,14,8,6,8.0,6.0,2.0
9712236,16,5,11,17,2,14,125,8,9.0,2.0,7.0,11.0,0.0,9.0,91.0,53,16,37,20.0,4.0,16.0
9308273,19,5,14,44,13,6,6,90,8.0,3.0,5.0,12.0,8.0,0.0,0.0,20,19,1,6.0,6.0,0.0
9501216,7,1,6,12,0,7,18,15,1.0,1.0,0.0,0.0,0.0,1.0,2.0,11,7,4,6.0,4.0,2.0
9606438,12,3,9,20,1,11,134,15,10.0,1.0,9.0,20.0,0.0,10.0,129.0,44,12,32,24.0,9.0,15.0
9702214,12,5,7,22,3,9,16,37,5.0,2.0,3.0,6.0,3.0,2.0,2.0,20,12,8,7.0,6.0,1.0
9707211,8,3,5,14,5,3,3,33,2.0,1.0,1.0,1.0,2.0,0.0,0.0,20,8,12,5.0,5.0,0.0
105023,1,1,0,0,1,0,0,78,0.0,0.0,0.0,0.0,0.0,0.0,0.0,6,1,5,1.0,0.0,1.0
9311309,10,5,5,9,10,0,0,78,5.0,1.0,4.0,8.0,5.0,0.0,0.0,10,10,0,5.0,5.0,0.0
11141,12,7,5,6,3,9,28,376,2.0,2.0,0.0,0.0,1.0,1.0,6.0,23,12,11,7.0,2.0,5.0
9912295,20,5,15,33,1,19,111,0,11.0,3.0,8.0,16.0,0.0,11.0,28.0,42,20,22,18.0,7.0,11.0
9501273,4,2,2,3,4,0,0,517,3.0,1.0,2.0,3.0,3.0,0.0,0.0,4,4,0,3.0,3.0,0.0
9901322,5,2,3,5,0,5,36,52,5.0,2.0,3.0,5.0,0.0,5.0,25.0,15,5,10,12.0,5.0,7.0
9711516,24,3,21,59,12,12,63,158,12.0,2.0,10.0,31.0,2.0,10.0,47.0,36,24,12,21.0,9.0,12.0
9801440,3,3,0,0,2,1,9,18,1.0,1.0,0.0,0.0,0.0,1.0,6.0,46,3,43,10.0,0.0,10.0
9709500,7,6,1,1,4,3,4,1,1.0,1.0,0.0,0.0,1.0,0.0,0.0,18,7,11,2.0,2.0,0.0
9905494,3,2,1,1,0,3,5,146,1.0,1.0,0.0,0.0,0.0,1.0,2.0,5,3,2,3.0,1.0,2.0
12275,3,3,0,0,0,3,4,5,,,,,,,,19,3,16,2.0,0.0,2.0
9805286,0,0,0,0,0,0,0,213,0.0,0.0,0.0,0.0,0.0,0.0,0.0,4,0,4,2.0,0.0,2.0
9305251,39,12,27,63,39,0,0,155,20.0,6.0,14.0,40.0,20.0,0.0,0.0,39,39,0,12.0,12.0,0.0
9501404,15,8,7,19,1,14,45,134,6.0,1.0,5.0,11.0,0.0,6.0,24.0,28,15,13,11.0,6.0,5.0
9402212,2,2,0,0,1,1,1,304,0.0,0.0,0.0,0.0,0.0,0.0,0.0,5,2,3,2.0,0.0,2.0
9906298,26,14,12,19,10,16,50,92,5.0,2.0,3.0,3.0,1.0,4.0,14.0,37,26,11,6.0,2.0,4.0
9411342,95,30,65,136,53,42,67,103,13.0,9.0,4.0,6.0,9.0,4.0,5.0,115,95,20,7.0,5.0,2.0
9511295,10,4,6,10,7,3,3,123,4.0,2.0,2.0,3.0,2.0,2.0,2.0,11,10,1,4.0,4.0,0.0
9301287,8,4,4,4,8,0,0,409,2.0,1.0,1.0,1.0,2.0,0.0,0.0,9,8,1,2.0,2.0,0.0
9909372,13,9,4,5,1,12,65,21,1.0,1.0,0.0,0.0,0.0,1.0,8.0,45,13,32,11.0,0.0,11.0
9207241,9,4,5,10,9,0,0,171,6.0,2.0,4.0,7.0,6.0,0.0,0.0,9,9,0,6.0,6.0,0.0
9812520,15,1,14,42,0,15,68,14,13.0,1.0,12.0,34.0,1.0,12.0,33.0,27,15,12,15.0,11.0,4.0
5309,42,9,33,103,2,40,387,30,21.0,3.0,18.0,52.0,0.0,21.0,178.0,110,42,68,30.0,11.0,19.0
2249,10,2,8,17,0,10,62,30,7.0,1.0,6.0,8.0,0.0,7.0,35.0,29,10,19,12.0,4.0,8.0
9503246,2,2,0,0,0,2,2,71,1.0,1.0,0.0,0.0,1.0,0.0,0.0,3,2,1,2.0,2.0,0.0
9809220,8,4,4,6,6,2,5,86,0.0,0.0,0.0,0.0,0.0,0.0,0.0,21,8,13,2.0,0.0,2.0
9801411,29,6,23,57,0,29,136,32,12.0,1.0,11.0,26.0,1.0,11.0,21.0,52,29,23,7.0,5.0,2.0
109125,36,6,30,123,2,34,365,55,13.0,2.0,11.0,25.0,0.0,13.0,156.0,99,36,63,36.0,13.0,23.0
9910557,21,1,20,88,0,21,285,32,20.0,1.0,19.0,83.0,0.0,20.0,239.0,76,21,55,42.0,16.0,26.0
103263,13,10,3,4,0,13,67,13,4.0,4.0,0.0,0.0,0.0,4.0,15.0,42,13,29,12.0,1.0,11.0
9606253,10,5,5,6,4,6,19,25,1.0,1.0,0.0,0.0,1.0,0.0,0.0,25,10,15,3.0,0.0,3.0
9704262,35,12,23,59,9,26,62,22,12.0,3.0,9.0,29.0,0.0,12.0,27.0,42,35,7,15.0,12.0,3.0
9503360,6,3,3,4,0,6,19,15,2.0,1.0,1.0,1.0,0.0,2.0,14.0,29,6,23,6.0,0.0,6.0
9710391,1,1,0,0,0,1,2,181,1.0,1.0,0.0,0.0,0.0,1.0,2.0,4,1,3,4.0,1.0,3.0
207242,5,1,4,8,0,5,52,7,3.0,1.0,2.0,3.0,0.0,3.0,22.0,43,5,38,9.0,0.0,9.0
9709235,1,1,0,0,0,1,10,36,0.0,0.0,0.0,0.0,0.0,0.0,0.0,45,1,44,21.0,0.0,21.0
106302,2,2,0,0,1,1,1,204,1.0,1.0,0.0,0.0,1.0,0.0,0.0,7,2,5,1.0,1.0,0.0
9608368,12,5,7,22,0,12,59,36,6.0,3.0,3.0,6.0,0.0,6.0,32.0,21,12,9,8.0,4.0,4.0
9504269,4,4,0,0,2,2,10,34,0.0,0.0,0.0,0.0,0.0,0.0,0.0,48,4,44,6.0,0.0,6.0
210061,0,0,0,0,0,0,0,89,0.0,0.0,0.0,0.0,0.0,0.0,0.0,16,0,16,10.0,0.0,10.0
109084,31,18,13,29,8,23,129,24,5.0,3.0,2.0,3.0,0.0,5.0,18.0,58,31,27,7.0,4.0,3.0
9502377,4,1,3,4,2,2,5,6,1.0,1.0,0.0,0.0,1.0,0.0,0.0,9,4,5,1.0,0.0,1.0
8129,21,5,16,38,1,20,37,3,9.0,2.0,7.0,12.0,9.0,0.0,0.0,24,21,3,10.0,10.0,0.0
9905453,19,5,14,39,10,9,17,102,14.0,3.0,11.0,34.0,8.0,6.0,6.0,22,19,3,7.0,6.0,1.0
9911521,3,2,1,1,0,3,23,21,0.0,0.0,0.0,0.0,0.0,0.0,0.0,23,3,20,11.0,0.0,11.0
9308212,2,2,0,0,2,0,0,1035,,,,,,,,2,2,0,,,
9304217,11,4,7,17,1,10,10,253,6.0,2.0,4.0,8.0,0.0,6.0,6.0,12,11,1,7.0,6.0,1.0
9511431,8,1,7,18,0,8,20,37,6.0,1.0,5.0,12.0,0.0,6.0,14.0,14,8,6,10.0,7.0,3.0
9512280,16,4,12,26,13,3,3,1,3.0,1.0,2.0,3.0,3.0,0.0,0.0,20,16,4,3.0,3.0,0.0
9412343,11,2,9,20,5,6,13,83,6.0,1.0,5.0,14.0,2.0,4.0,9.0,14,11,3,4.0,4.0,0.0
9907201,3,2,1,2,0,3,16,26,1.0,1.0,0.0,0.0,0.0,1.0,12.0,17,3,14,12.0,1.0,11.0
9602225,14,5,9,23,14,0,0,154,11.0,3.0,8.0,17.0,11.0,0.0,0.0,14,14,0,6.0,6.0,0.0
9304238,3,2,1,1,3,0,0,172,2.0,1.0,1.0,1.0,2.0,0.0,0.0,3,3,0,1.0,1.0,0.0
9512343,8,1,7,9,6,2,2,140,5.0,1.0,4.0,4.0,5.0,0.0,0.0,11,8,3,4.0,4.0,0.0
9805461,18,3,15,55,0,18,105,29,16.0,1.0,15.0,54.0,0.0,16.0,86.0,32,18,14,23.0,16.0,7.0
9504238,22,3,19,28,9,13,30,100,10.0,1.0,9.0,14.0,0.0,10.0,21.0,31,22,9,12.0,9.0,3.0
9704222,42,8,34,117,7,35,112,25,20.0,2.0,18.0,58.0,0.0,20.0,83.0,50,42,8,24.0,16.0,8.0
110304,9,8,1,1,3,6,21,34,1.0,1.0,0.0,0.0,0.0,1.0,2.0,19,9,10,3.0,0.0,3.0
9912322,14,8,6,8,11,3,3,296,3.0,3.0,0.0,0.0,2.0,1.0,1.0,15,14,1,2.0,2.0,0.0
2118,0,0,0,0,0,0,0,119,0.0,0.0,0.0,0.0,0.0,0.0,0.0,16,0,16,15.0,0.0,15.0
9409296,20,4,16,54,15,5,9,44,8.0,3.0,5.0,14.0,6.0,2.0,2.0,23,20,3,9.0,9.0,0.0
9901302,9,3,6,11,0,9,22,42,2.0,1.0,1.0,1.0,0.0,2.0,4.0,17,9,8,4.0,1.0,3.0
208103,2,2,0,0,0,2,18,22,2.0,2.0,0.0,0.0,0.0,2.0,18.0,14,2,12,11.0,2.0,9.0
9611391,13,6,7,16,3,10,21,140,2.0,2.0,0.0,0.0,1.0,1.0,3.0,20,13,7,4.0,1.0,3.0
9802252,15,7,8,12,1,14,87,5,8.0,3.0,5.0,8.0,0.0,8.0,66.0,37,15,22,19.0,6.0,13.0
11136,10,5,5,8,5,5,8,0,2.0,2.0,0.0,0.0,2.0,0.0,0.0,18,10,8,1.0,1.0,0.0
9805338,14,7,7,12,3,11,52,9,7.0,3.0,4.0,5.0,7.0,0.0,0.0,26,14,12,5.0,5.0,0.0
9805451,10,3,7,12,0,10,32,1,9.0,3.0,6.0,10.0,0.0,9.0,30.0,19,10,9,10.0,3.0,7.0
9906332,5,2,3,4,0,5,17,61,1.0,1.0,0.0,0.0,0.0,1.0,2.0,24,5,19,4.0,2.0,2.0
9609441,14,2,12,42,4,10,18,21,9.0,1.0,8.0,31.0,9.0,0.0,0.0,42,14,28,8.0,8.0,0.0
9507245,12,7,5,11,12,0,0,160,4.0,3.0,1.0,1.0,4.0,0.0,0.0,12,12,0,2.0,2.0,0.0
4114,33,4,29,134,0,33,183,0,28.0,4.0,24.0,119.0,0.0,28.0,143.0,47,33,14,32.0,21.0,11.0
5270,8,4,4,6,0,8,41,63,6.0,3.0,3.0,4.0,0.0,6.0,30.0,29,8,21,10.0,3.0,7.0
9907222,6,4,2,2,1,5,31,0,1.0,1.0,0.0,0.0,0.0,1.0,9.0,114,6,108,8.0,0.0,8.0
9811230,1,1,0,0,1,0,0,227,1.0,1.0,0.0,0.0,1.0,0.0,0.0,2,1,1,1.0,1.0,0.0
9608480,54,9,45,178,23,31,72,25,16.0,3.0,13.0,51.0,3.0,13.0,38.0,67,54,13,16.0,13.0,3.0
9609393,9,5,4,6,2,7,23,23,1.0,1.0,0.0,0.0,0.0,1.0,6.0,22,9,13,4.0,2.0,2.0
102042,4,1,3,4,0,4,7,122,3.0,1.0,2.0,2.0,0.0,3.0,3.0,6,4,2,5.0,4.0,1.0
9712432,7,3,4,7,0,7,33,3,0.0,0.0,0.0,0.0,0.0,0.0,0.0,29,7,22,4.0,1.0,3.0
106237,3,2,1,1,0,3,4,55,2.0,1.0,1.0,1.0,2.0,0.0,0.0,12,3,9,2.0,1.0,1.0
9402292,2,1,1,1,2,0,0,253,2.0,1.0,1.0,1.0,2.0,0.0,0.0,6,2,4,3.0,2.0,1.0
9711229,40,10,30,116,10,30,68,83,22.0,4.0,18.0,70.0,3.0,19.0,37.0,47,40,7,18.0,15.0,3.0
9903343,2,2,0,0,0,2,14,48,2.0,2.0,0.0,0.0,0.0,2.0,5.0,12,2,10,5.0,2.0,3.0
9310286,35,9,26,96,22,13,15,33,24.0,6.0,18.0,56.0,14.0,10.0,10.0,39,35,4,12.0,12.0,0.0
9703285,20,5,15,56,18,2,5,36,18.0,4.0,14.0,55.0,18.0,0.0,0.0,30,20,10,6.0,1.0,5.0
9911479,19,7,12,20,0,19,73,12,6.0,3.0,3.0,5.0,1.0,5.0,12.0,37,19,18,8.0,4.0,4.0
9406357,18,7,11,31,18,0,0,4,11.0,2.0,9.0,29.0,11.0,0.0,0.0,25,18,7,5.0,5.0,0.0
9208214,6,4,2,3,6,0,0,248,3.0,1.0,2.0,3.0,3.0,0.0,0.0,6,6,0,3.0,3.0,0.0
106139,14,10,4,5,1,13,122,0,8.0,6.0,2.0,3.0,0.0,8.0,85.0,87,14,73,32.0,4.0,28.0
210251,6,6,0,0,0,6,67,32,3.0,3.0,0.0,0.0,0.0,3.0,56.0,95,6,89,46.0,1.0,45.0
9902325,5,1,4,8,0,5,12,15,,,,,,,,10,5,5,7.0,4.0,3.0
9905276,14,9,5,5,0,14,68,151,4.0,3.0,1.0,1.0,0.0,4.0,20.0,46,14,32,17.0,2.0,15.0
105302,31,3,28,91,0,31,157,7,15.0,1.0,14.0,35.0,2.0,13.0,29.0,49,31,18,19.0,14.0,5.0
9511334,4,1,3,6,0,4,18,60,4.0,1.0,3.0,6.0,0.0,4.0,18.0,15,4,11,9.0,4.0,5.0
9703303,16,5,11,33,0,16,38,27,12.0,2.0,10.0,31.0,0.0,12.0,30.0,21,16,5,4.0,3.0,1.0
9603428,18,6,12,44,13,5,5,27,12.0,3.0,9.0,32.0,12.0,0.0,0.0,21,18,3,10.0,10.0,0.0
210276,5,4,1,1,0,5,16,3,3.0,3.0,0.0,0.0,0.0,3.0,8.0,19,5,14,7.0,2.0,5.0
101307,25,4,21,72,0,25,73,46,17.0,2.0,15.0,51.0,0.0,17.0,39.0,38,25,13,19.0,15.0,4.0
6076,6,3,3,4,1,5,20,3,4.0,1.0,3.0,4.0,0.0,4.0,16.0,25,6,19,2.0,0.0,2.0
204286,86,2,84,460,2,84,182,0,30.0,2.0,28.0,160.0,0.0,30.0,93.0,102,86,16,31.0,22.0,9.0
201226,11,3,8,24,0,11,51,2,9.0,1.0,8.0,24.0,0.0,9.0,15.0,48,11,37,12.0,1.0,11.0
3189,7,5,2,2,0,7,38,0,3.0,3.0,0.0,0.0,0.0,3.0,15.0,32,7,25,8.0,1.0,7.0
106021,6,3,3,4,0,6,40,37,3.0,1.0,2.0,3.0,0.0,3.0,15.0,26,6,20,7.0,3.0,4.0
9511313,2,1,1,1,1,1,4,10,1.0,1.0,0.0,0.0,1.0,0.0,0.0,8,2,6,1.0,1.0,0.0
1092,5,4,1,1,4,1,1,47,1.0,1.0,0.0,0.0,1.0,0.0,0.0,6,5,1,2.0,2.0,0.0
203122,2,1,1,1,0,2,9,47,2.0,1.0,1.0,1.0,0.0,2.0,9.0,24,2,22,15.0,2.0,13.0
9503481,27,3,24,75,18,9,9,50,14.0,1.0,13.0,41.0,9.0,5.0,5.0,28,27,1,16.0,15.0,1.0
203113,7,4,3,4,0,7,44,3,1.0,1.0,0.0,0.0,0.0,1.0,4.0,28,7,21,7.0,2.0,5.0
9702295,3,2,1,1,2,1,2,10,2.0,1.0,1.0,1.0,2.0,0.0,0.0,14,3,11,2.0,2.0,0.0
9402213,6,2,4,9,1,5,5,228,5.0,2.0,3.0,6.0,1.0,4.0,4.0,7,6,1,7.0,6.0,1.0
9902336,13,8,5,7,13,0,0,84,6.0,4.0,2.0,2.0,6.0,0.0,0.0,13,13,0,5.0,5.0,0.0
9906331,15,6,9,13,0,15,40,2,5.0,3.0,2.0,2.0,0.0,5.0,6.0,23,15,8,7.0,5.0,2.0
9707509,25,10,15,30,8,17,58,100,11.0,4.0,7.0,12.0,1.0,10.0,30.0,44,25,19,14.0,8.0,6.0
9810316,6,5,1,1,5,1,1,25,0.0,0.0,0.0,0.0,0.0,0.0,0.0,43,6,37,2.0,0.0,2.0
9903352,2,1,1,1,0,2,3,272,1.0,1.0,0.0,0.0,0.0,1.0,2.0,5,2,3,3.0,1.0,2.0
102009,46,4,42,237,0,46,666,11,44.0,3.0,41.0,234.0,0.0,44.0,642.0,72,46,26,58.0,35.0,23.0
9903341,56,8,48,185,4,52,130,11,14.0,4.0,10.0,32.0,9.0,5.0,6.0,71,56,15,11.0,10.0,1.0
9808387,3,1,2,3,1,2,2,13,,,,,,,,4,3,1,,,
9906240,3,2,1,1,2,1,3,142,0.0,0.0,0.0,0.0,0.0,0.0,0.0,7,3,4,1.0,1.0,0.0
103287,6,1,5,7,2,4,7,59,6.0,1.0,5.0,7.0,2.0,4.0,4.0,11,6,5,7.0,5.0,2.0
9307328,4,4,0,0,2,2,4,250,2.0,2.0,0.0,0.0,0.0,2.0,4.0,7,4,3,3.0,1.0,2.0
9907279,7,3,4,7,0,7,49,32,7.0,3.0,4.0,7.0,0.0,7.0,48.0,22,7,15,2.0,1.0,1.0
9702296,11,4,7,24,2,9,23,39,7.0,2.0,5.0,16.0,0.0,7.0,12.0,14,11,3,2.0,1.0,1.0
9704310,1,1,0,0,0,1,3,62,1.0,1.0,0.0,0.0,0.0,1.0,3.0,12,1,11,6.0,1.0,5.0
9702416,6,4,2,4,1,5,12,26,1.0,1.0,0.0,0.0,0.0,1.0,2.0,14,6,8,3.0,1.0,2.0
9805273,9,3,6,11,4,5,9,168,1.0,1.0,0.0,0.0,0.0,1.0,2.0,14,9,5,4.0,3.0,1.0
9308235,3,3,0,0,2,1,1,318,2.0,2.0,0.0,0.0,2.0,0.0,0.0,4,3,1,2.0,2.0,0.0
202106,4,3,1,1,1,3,18,6,1.0,1.0,0.0,0.0,0.0,1.0,3.0,16,4,12,2.0,1.0,1.0
9909458,18,4,14,23,3,15,17,108,5.0,1.0,4.0,5.0,1.0,4.0,4.0,27,18,9,4.0,4.0,0.0
9706380,4,1,3,4,2,2,2,749,1.0,1.0,0.0,0.0,1.0,0.0,0.0,5,4,1,1.0,1.0,0.0
9209223,15,6,9,13,15,0,0,41,6.0,3.0,3.0,3.0,6.0,0.0,0.0,15,15,0,4.0,4.0,0.0
203114,3,3,0,0,0,3,63,18,1.0,1.0,0.0,0.0,0.0,1.0,27.0,71,3,68,27.0,1.0,26.0
112030,13,6,7,20,1,12,148,109,11.0,4.0,7.0,20.0,0.0,11.0,143.0,40,13,27,28.0,10.0,18.0
9503398,15,7,8,14,1,14,20,61,6.0,3.0,3.0,3.0,0.0,6.0,6.0,20,15,5,2.0,2.0,0.0
9609221,4,4,0,0,0,4,9,207,2.0,2.0,0.0,0.0,1.0,1.0,1.0,13,4,9,2.0,1.0,1.0
9811203,7,6,1,2,0,7,33,12,3.0,3.0,0.0,0.0,0.0,3.0,8.0,33,7,26,6.0,3.0,3.0
4019,3,2,1,1,0,3,3,28,2.0,2.0,0.0,0.0,0.0,2.0,2.0,4,3,1,3.0,2.0,1.0
12184,14,7,7,9,1,13,31,12,7.0,3.0,4.0,5.0,1.0,6.0,6.0,30,14,16,6.0,3.0,3.0
9811358,4,2,2,2,4,0,0,0,,,,,,,,4,4,0,1.0,1.0,0.0
201075,7,6,1,1,0,7,69,25,2.0,2.0,0.0,0.0,0.0,2.0,22.0,143,7,136,23.0,1.0,22.0
9707299,10,2,8,11,0,10,39,36,9.0,2.0,7.0,9.0,0.0,9.0,36.0,19,10,9,1.0,0.0,1.0
9603339,5,4,1,1,4,1,1,22,1.0,1.0,0.0,0.0,1.0,0.0,0.0,8,5,3,2.0,2.0,0.0
9701291,20,9,11,36,1,19,65,78,12.0,4.0,8.0,25.0,2.0,10.0,17.0,40,20,20,9.0,7.0,2.0
9903528,9,4,5,14,0,9,55,60,0.0,0.0,0.0,0.0,0.0,0.0,0.0,44,9,35,3.0,0.0,3.0
9511314,15,9,6,13,10,5,12,74,5.0,1.0,4.0,8.0,5.0,0.0,0.0,19,15,4,2.0,2.0,0.0
9204217,9,4,5,6,9,0,0,303,2.0,2.0,0.0,0.0,2.0,0.0,0.0,9,9,0,1.0,1.0,0.0
9502266,6,1,5,9,6,0,0,276,5.0,1.0,4.0,7.0,5.0,0.0,0.0,6,6,0,5.0,5.0,0.0
9902395,7,4,3,5,0,7,51,1,7.0,4.0,3.0,5.0,0.0,7.0,51.0,18,7,11,,,
9611438,24,4,20,95,11,13,18,8,21.0,2.0,19.0,91.0,9.0,12.0,17.0,26,24,2,20.0,18.0,2.0
9902451,63,8,55,283,0,63,453,9,49.0,5.0,44.0,246.0,0.0,49.0,369.0,94,63,31,37.0,20.0,17.0
9612210,5,2,3,6,1,4,9,598,3.0,2.0,1.0,1.0,0.0,3.0,3.0,9,5,4,5.0,4.0,1.0
201210,4,1,3,4,3,1,4,24,3.0,1.0,2.0,2.0,2.0,1.0,1.0,16,4,12,3.0,2.0,1.0
9901225,1,1,0,0,1,0,0,38,1.0,1.0,0.0,0.0,1.0,0.0,0.0,12,1,11,1.0,1.0,0.0
9909367,0,0,0,0,0,0,0,51,0.0,0.0,0.0,0.0,0.0,0.0,0.0,11,0,11,3.0,0.0,3.0
9910552,2,1,1,1,1,1,2,106,2.0,1.0,1.0,1.0,1.0,1.0,2.0,10,2,8,3.0,0.0,3.0
9604337,14,1,13,31,10,4,25,53,11.0,1.0,10.0,23.0,11.0,0.0,0.0,25,14,11,11.0,11.0,0.0
9503363,7,3,4,6,7,0,0,95,1.0,1.0,0.0,0.0,1.0,0.0,0.0,7,7,0,3.0,3.0,0.0
10013,2,2,0,0,0,2,3,186,2.0,2.0,0.0,0.0,0.0,2.0,2.0,9,2,7,1.0,0.0,1.0
5054,4,3,1,1,1,3,12,68,2.0,1.0,1.0,1.0,0.0,2.0,7.0,15,4,11,1.0,0.0,1.0
9506209,3,3,0,0,3,0,0,322,1.0,1.0,0.0,0.0,1.0,0.0,0.0,3,3,0,1.0,1.0,0.0
9812449,13,6,7,13,1,12,96,130,10.0,3.0,7.0,13.0,0.0,10.0,66.0,69,13,56,20.0,3.0,17.0
9810408,34,10,24,76,14,20,45,0,11.0,3.0,8.0,19.0,5.0,6.0,12.0,45,34,11,14.0,14.0,0.0
9504423,6,1,5,7,0,6,12,105,4.0,1.0,3.0,3.0,0.0,4.0,8.0,9,6,3,7.0,5.0,2.0
1037,3,2,1,1,1,2,6,58,1.0,1.0,0.0,0.0,0.0,1.0,3.0,13,3,10,2.0,1.0,1.0
9912441,0,0,0,0,0,0,0,66,0.0,0.0,0.0,0.0,0.0,0.0,0.0,5,0,5,1.0,0.0,1.0
9601316,15,3,12,36,9,6,12,167,9.0,2.0,7.0,18.0,4.0,5.0,10.0,21,15,6,11.0,8.0,3.0
9709302,9,9,0,0,2,7,12,13,4.0,4.0,0.0,0.0,0.0,4.0,8.0,13,9,4,1.0,1.0,0.0
9706232,11,3,8,18,0,11,43,18,6.0,3.0,3.0,8.0,1.0,5.0,15.0,25,11,14,13.0,6.0,7.0
3072,5,2,3,3,0,5,38,50,3.0,1.0,2.0,2.0,0.0,3.0,10.0,23,5,18,10.0,4.0,6.0
9312363,5,4,1,1,1,4,4,114,2.0,2.0,0.0,0.0,0.0,2.0,2.0,9,5,4,3.0,2.0,1.0
110335,1,1,0,0,0,1,4,14,0.0,0.0,0.0,0.0,0.0,0.0,0.0,7,1,6,2.0,0.0,2.0
9512393,13,4,9,17,2,11,30,14,6.0,1.0,5.0,11.0,0.0,6.0,20.0,24,13,11,3.0,2.0,1.0
1259,22,5,17,74,0,22,201,68,19.0,4.0,15.0,65.0,0.0,19.0,156.0,47,22,25,32.0,16.0,16.0
9709415,9,5,4,4,8,1,1,198,4.0,1.0,3.0,3.0,4.0,0.0,0.0,10,9,1,3.0,3.0,0.0
9712550,5,2,3,4,0,5,20,12,3.0,2.0,1.0,1.0,0.0,3.0,5.0,16,5,11,4.0,1.0,3.0
9808236,6,6,0,0,2,4,25,0,1.0,1.0,0.0,0.0,0.0,1.0,11.0,30,6,24,2.0,0.0,2.0
9907553,8,4,4,5,0,8,41,56,8.0,4.0,4.0,5.0,0.0,8.0,41.0,21,8,13,6.0,1.0,5.0
9803263,5,4,1,1,1,4,9,99,2.0,1.0,1.0,1.0,0.0,2.0,6.0,10,5,5,1.0,1.0,0.0
9702394,17,4,13,31,4,13,39,13,11.0,2.0,9.0,19.0,1.0,10.0,24.0,26,17,9,4.0,4.0,0.0
211069,8,4,4,7,0,8,52,193,5.0,3.0,2.0,3.0,0.0,5.0,29.0,21,8,13,13.0,5.0,8.0
9407283,11,4,7,9,9,2,2,246,7.0,2.0,5.0,7.0,6.0,1.0,1.0,12,11,1,4.0,4.0,0.0
9511383,3,2,1,1,0,3,5,274,0.0,0.0,0.0,0.0,0.0,0.0,0.0,13,3,10,4.0,0.0,4.0
9803372,7,4,3,3,1,6,10,187,6.0,3.0,3.0,3.0,2.0,4.0,5.0,14,7,7,4.0,2.0,2.0
201245,5,2,3,5,0,5,27,15,4.0,1.0,3.0,5.0,0.0,4.0,25.0,18,5,13,3.0,2.0,1.0
9312222,2,2,0,0,1,1,4,1609,1.0,1.0,0.0,0.0,1.0,0.0,0.0,10,2,8,1.0,1.0,0.0
9305212,6,3,3,8,6,0,0,284,5.0,2.0,3.0,8.0,5.0,0.0,0.0,7,6,1,5.0,5.0,0.0
9512379,14,4,10,26,2,12,26,68,7.0,1.0,6.0,17.0,2.0,5.0,5.0,21,14,7,3.0,2.0,1.0
210022,1,1,0,0,0,1,1,1722,0.0,0.0,0.0,0.0,0.0,0.0,0.0,3,1,2,1.0,0.0,1.0
9712463,12,5,7,21,3,9,45,142,8.0,2.0,6.0,20.0,0.0,8.0,44.0,21,12,9,17.0,8.0,9.0
9703392,7,6,1,1,6,1,1,162,1.0,1.0,0.0,0.0,1.0,0.0,0.0,8,7,1,1.0,1.0,0.0
9806403,27,8,19,46,2,25,45,131,19.0,5.0,14.0,32.0,0.0,19.0,31.0,34,27,7,9.0,9.0,0.0
12010,1,1,0,0,0,1,1,51,0.0,0.0,0.0,0.0,0.0,0.0,0.0,6,1,5,4.0,0.0,4.0
109282,2,2,0,0,1,1,1,135,0.0,0.0,0.0,0.0,0.0,0.0,0.0,26,2,24,7.0,0.0,7.0
2114,4,3,1,1,0,4,31,34,2.0,1.0,1.0,1.0,0.0,2.0,23.0,24,4,20,17.0,2.0,15.0
9905555,12,6,6,7,4,8,39,39,2.0,1.0,1.0,1.0,0.0,2.0,13.0,30,12,18,11.0,3.0,8.0
9806359,2,2,0,0,0,2,12,12,1.0,1.0,0.0,0.0,0.0,1.0,8.0,24,2,22,1.0,0.0,1.0
9705324,8,7,1,1,1,7,20,85,3.0,3.0,0.0,0.0,0.0,3.0,8.0,19,8,11,6.0,2.0,4.0
205246,10,4,6,7,0,10,99,21,4.0,2.0,2.0,2.0,0.0,4.0,16.0,62,10,52,9.0,3.0,6.0
110073,3,2,1,1,0,3,34,73,2.0,2.0,0.0,0.0,0.0,2.0,14.0,21,3,18,10.0,2.0,8.0
110096,19,5,14,31,0,19,51,219,15.0,4.0,11.0,25.0,0.0,15.0,28.0,27,19,8,13.0,11.0,2.0
110186,4,2,2,3,0,4,24,13,1.0,1.0,0.0,0.0,0.0,1.0,12.0,28,4,24,16.0,1.0,15.0
9803378,7,5,2,4,2,5,12,242,5.0,3.0,2.0,3.0,1.0,4.0,11.0,14,7,7,5.0,3.0,2.0
9701374,7,4,3,5,0,7,19,47,7.0,4.0,3.0,5.0,0.0,7.0,14.0,14,7,7,2.0,2.0,0.0
106060,8,5,3,4,1,7,43,81,7.0,4.0,3.0,4.0,0.0,7.0,42.0,20,8,12,12.0,5.0,7.0
102246,3,3,0,0,0,3,8,0,0.0,0.0,0.0,0.0,0.0,0.0,0.0,17,3,14,2.0,1.0,1.0
9809563,4,4,0,0,0,4,4,50,2.0,2.0,0.0,0.0,0.0,2.0,2.0,5,4,1,3.0,2.0,1.0
8117,8,4,4,6,0,8,66,95,7.0,4.0,3.0,5.0,0.0,7.0,51.0,31,8,23,10.0,1.0,9.0
9607385,5,3,2,3,2,3,4,130,0.0,0.0,0.0,0.0,0.0,0.0,0.0,10,5,5,2.0,1.0,1.0
9911418,8,2,6,6,1,7,27,3,4.0,1.0,3.0,3.0,2.0,2.0,5.0,18,8,10,8.0,4.0,4.0
9801418,6,4,2,3,0,6,15,100,1.0,1.0,0.0,0.0,0.0,1.0,3.0,15,6,9,5.0,1.0,4.0
9805331,3,2,1,1,0,3,5,78,2.0,1.0,1.0,1.0,0.0,2.0,2.0,6,3,3,3.0,2.0,1.0
6284,0,0,0,0,0,0,0,57,0.0,0.0,0.0,0.0,0.0,0.0,0.0,26,0,26,4.0,0.0,4.0
206242,6,6,0,0,1,5,20,7,3.0,3.0,0.0,0.0,0.0,3.0,11.0,20,6,14,7.0,3.0,4.0
9907573,3,3,0,0,2,1,2,138,2.0,2.0,0.0,0.0,2.0,0.0,0.0,5,3,2,2.0,2.0,0.0
12021,5,4,1,1,1,4,8,92,2.0,1.0,1.0,1.0,0.0,2.0,4.0,13,5,8,3.0,0.0,3.0
9404324,3,3,0,0,0,3,8,40,2.0,2.0,0.0,0.0,2.0,0.0,0.0,9,3,6,2.0,2.0,0.0
105063,12,3,9,14,1,11,64,201,11.0,3.0,8.0,13.0,0.0,11.0,57.0,25,12,13,20.0,11.0,9.0
9502288,1,1,0,0,1,0,0,140,1.0,1.0,0.0,0.0,1.0,0.0,0.0,4,1,3,1.0,0.0,1.0
9703456,4,1,3,6,0,4,4,23,0.0,0.0,0.0,0.0,0.0,0.0,0.0,6,4,2,,,
9904365,3,2,1,1,1,2,8,48,2.0,1.0,1.0,1.0,1.0,1.0,5.0,12,3,9,1.0,0.0,1.0
9907214,24,11,13,37,0,24,54,9,22.0,9.0,13.0,37.0,0.0,22.0,28.0,34,24,10,12.0,12.0,0.0
9709295,19,6,13,18,6,13,35,117,14.0,3.0,11.0,16.0,2.0,12.0,26.0,27,19,8,14.0,10.0,4.0
106270,1,1,0,0,0,1,1,82,0.0,0.0,0.0,0.0,0.0,0.0,0.0,10,1,9,5.0,0.0,5.0
2042,7,3,4,6,0,7,20,4,0.0,0.0,0.0,0.0,0.0,0.0,0.0,23,7,16,2.0,1.0,1.0
204352,22,6,16,49,4,18,133,0,12.0,2.0,10.0,32.0,0.0,12.0,84.0,46,22,24,13.0,8.0,5.0
10232,1,1,0,0,0,1,6,0,0.0,0.0,0.0,0.0,0.0,0.0,0.0,20,1,19,15.0,0.0,15.0
9505423,3,3,0,0,1,2,2,748,1.0,1.0,0.0,0.0,0.0,1.0,1.0,6,3,3,2.0,1.0,1.0
9411345,5,3,2,2,4,1,1,360,1.0,1.0,0.0,0.0,1.0,0.0,0.0,6,5,1,1.0,1.0,0.0
9404246,3,3,0,0,3,0,0,164,1.0,1.0,0.0,0.0,1.0,0.0,0.0,3,3,0,1.0,1.0,0.0
9603421,1,1,0,0,0,1,2,104,0.0,0.0,0.0,0.0,0.0,0.0,0.0,5,1,4,2.0,1.0,1.0
207347,2,1,1,1,0,2,15,3,0.0,0.0,0.0,0.0,0.0,0.0,0.0,61,2,59,12.0,0.0,12.0
110175,4,4,0,0,1,3,4,119,0.0,0.0,0.0,0.0,0.0,0.0,0.0,18,4,14,8.0,0.0,8.0
206078,12,5,7,15,1,11,63,3,2.0,2.0,0.0,0.0,0.0,2.0,4.0,24,12,12,11.0,4.0,7.0
107304,2,1,1,1,0,2,7,81,1.0,1.0,0.0,0.0,0.0,1.0,1.0,7,2,5,6.0,2.0,4.0
103173,6,5,1,1,1,5,8,59,1.0,1.0,0.0,0.0,0.0,1.0,1.0,14,6,8,2.0,1.0,1.0
9805252,2,2,0,0,1,1,3,15,1.0,1.0,0.0,0.0,1.0,0.0,0.0,12,2,10,1.0,1.0,0.0
3155,3,2,1,1,3,0,0,1853,0.0,0.0,0.0,0.0,0.0,0.0,0.0,9,3,6,1.0,0.0,1.0
105326,3,2,1,1,0,3,25,2,2.0,1.0,1.0,1.0,0.0,2.0,23.0,35,3,32,26.0,1.0,25.0
207356,18,3,15,68,0,18,76,1,13.0,1.0,12.0,53.0,6.0,7.0,7.0,45,18,27,16.0,13.0,3.0
208144,1,1,0,0,1,0,0,424,0.0,0.0,0.0,0.0,0.0,0.0,0.0,12,1,11,2.0,0.0,2.0
110033,6,3,3,4,1,5,22,65,5.0,2.0,3.0,4.0,0.0,5.0,17.0,19,6,13,11.0,5.0,6.0
9903328,17,4,13,25,1,16,101,25,9.0,2.0,7.0,14.0,0.0,9.0,59.0,52,17,35,23.0,3.0,20.0
9309314,3,1,2,2,3,0,0,293,3.0,1.0,2.0,2.0,3.0,0.0,0.0,3,3,0,3.0,3.0,0.0
9707373,7,4,3,6,2,5,6,163,5.0,2.0,3.0,6.0,0.0,5.0,6.0,11,7,4,7.0,5.0,2.0
9910208,1,1,0,0,1,0,0,259,1.0,1.0,0.0,0.0,1.0,0.0,0.0,1,1,0,,,
9606478,2,2,0,0,1,1,5,35,0.0,0.0,0.0,0.0,0.0,0.0,0.0,23,2,21,2.0,0.0,2.0
106319,20,5,15,39,0,20,196,9,13.0,2.0,11.0,33.0,0.0,13.0,166.0,47,20,27,28.0,8.0,20.0
9409297,1,1,0,0,0,1,2,54,,,,,,,,3,1,2,,,
107110,10,2,8,24,1,9,29,78,9.0,1.0,8.0,24.0,2.0,7.0,7.0,18,10,8,11.0,9.0,2.0
209014,14,4,10,23,0,14,153,1,11.0,3.0,8.0,21.0,0.0,11.0,113.0,48,14,34,24.0,9.0,15.0
9911428,1,1,0,0,0,1,5,22,1.0,1.0,0.0,0.0,1.0,0.0,0.0,6,1,5,1.0,1.0,0.0
1236,1,1,0,0,0,1,7,12,1.0,1.0,0.0,0.0,0.0,1.0,7.0,12,1,11,,,
9802230,12,7,5,7,1,11,48,115,10.0,5.0,5.0,7.0,1.0,9.0,35.0,28,12,16,10.0,6.0,4.0
9710276,4,2,2,2,0,4,10,12,3.0,1.0,2.0,2.0,0.0,3.0,4.0,21,4,17,3.0,0.0,3.0
9810516,10,2,8,25,2,8,25,174,9.0,2.0,7.0,24.0,2.0,7.0,11.0,20,10,10,11.0,9.0,2.0
9712514,7,5,2,3,2,5,12,59,3.0,2.0,1.0,2.0,1.0,2.0,4.0,23,7,16,6.0,2.0,4.0
204210,2,2,0,0,0,2,12,4,0.0,0.0,0.0,0.0,0.0,0.0,0.0,21,2,19,5.0,0.0,5.0
9704203,4,4,0,0,0,4,4,39,2.0,2.0,0.0,0.0,0.0,2.0,2.0,15,4,11,1.0,0.0,1.0
9502279,12,8,4,8,0,12,12,156,12.0,8.0,4.0,8.0,0.0,12.0,12.0,14,12,2,10.0,9.0,1.0
9308366,4,3,1,1,4,0,0,462,2.0,1.0,1.0,1.0,2.0,0.0,0.0,4,4,0,2.0,2.0,0.0
106004,3,2,1,1,0,3,39,12,2.0,2.0,0.0,0.0,0.0,2.0,34.0,43,3,40,23.0,1.0,22.0
9409323,10,3,7,14,9,1,1,268,5.0,1.0,4.0,9.0,5.0,0.0,0.0,11,10,1,5.0,5.0,0.0
105332,5,4,1,1,2,3,5,22,0.0,0.0,0.0,0.0,0.0,0.0,0.0,16,5,11,3.0,3.0,0.0
9911278,1,1,0,0,0,1,3,47,0.0,0.0,0.0,0.0,0.0,0.0,0.0,14,1,13,8.0,0.0,8.0
106354,7,2,5,7,0,7,47,1,1.0,1.0,0.0,0.0,0.0,1.0,2.0,27,7,20,10.0,5.0,5.0
111324,16,4,12,27,0,16,129,55,5.0,2.0,3.0,3.0,0.0,5.0,33.0,55,16,39,18.0,6.0,12.0
111203,9,2,7,16,1,8,79,0,5.0,1.0,4.0,10.0,0.0,5.0,55.0,30,9,21,17.0,5.0,12.0
203187,6,3,3,4,0,6,57,4,1.0,1.0,0.0,0.0,0.0,1.0,1.0,57,6,51,11.0,0.0,11.0
105197,10,3,7,13,4,6,7,351,5.0,2.0,3.0,4.0,5.0,0.0,0.0,13,10,3,7.0,6.0,1.0
101279,6,5,1,1,3,3,4,9,0.0,0.0,0.0,0.0,0.0,0.0,0.0,14,6,8,2.0,2.0,0.0
9909437,4,4,0,0,1,3,3,144,1.0,1.0,0.0,0.0,1.0,0.0,0.0,5,4,1,1.0,1.0,0.0
8003,2,1,1,1,1,1,3,289,1.0,1.0,0.0,0.0,0.0,1.0,3.0,11,2,9,4.0,1.0,3.0
211071,3,3,0,0,0,3,19,18,2.0,2.0,0.0,0.0,0.0,2.0,13.0,46,3,43,22.0,1.0,21.0
9906415,11,4,7,14,1,10,45,85,7.0,1.0,6.0,12.0,1.0,6.0,23.0,24,11,13,12.0,5.0,7.0
9910263,4,2,2,3,0,4,47,34,4.0,2.0,2.0,3.0,0.0,4.0,46.0,25,4,21,6.0,1.0,5.0
8295,18,6,12,40,0,18,173,68,16.0,6.0,10.0,36.0,0.0,16.0,132.0,51,18,33,36.0,13.0,23.0
9711226,6,5,1,1,1,5,16,14,3.0,2.0,1.0,1.0,0.0,3.0,3.0,17,6,11,4.0,2.0,2.0
9206213,3,1,2,3,3,0,0,108,3.0,1.0,2.0,3.0,3.0,0.0,0.0,3,3,0,3.0,3.0,0.0
108138,9,5,4,5,5,4,15,18,3.0,2.0,1.0,1.0,2.0,1.0,1.0,20,9,11,3.0,3.0,0.0
9806464,2,2,0,0,1,1,2,133,1.0,1.0,0.0,0.0,0.0,1.0,2.0,5,2,3,2.0,1.0,1.0
9407212,1,1,0,0,0,1,1,40,,,,,,,,2,1,1,,,
202013,8,3,5,6,0,8,42,28,4.0,3.0,1.0,1.0,0.0,4.0,10.0,26,8,18,9.0,4.0,5.0
104053,7,7,0,0,1,6,26,19,3.0,3.0,0.0,0.0,0.0,3.0,11.0,16,7,9,7.0,3.0,4.0
9805261,10,6,4,4,0,10,59,40,9.0,5.0,4.0,4.0,0.0,9.0,58.0,23,10,13,11.0,4.0,7.0
9159,5,3,2,3,0,5,19,13,2.0,1.0,1.0,1.0,0.0,2.0,7.0,15,5,10,2.0,2.0,0.0
108174,2,2,0,0,0,2,17,2,1.0,1.0,0.0,0.0,0.0,1.0,11.0,31,2,29,3.0,1.0,2.0
204092,15,5,10,28,0,15,321,32,14.0,4.0,10.0,28.0,0.0,14.0,285.0,86,15,71,53.0,8.0,45.0
9806526,22,3,19,71,0,22,172,43,20.0,3.0,17.0,68.0,0.0,20.0,166.0,47,22,25,34.0,12.0,22.0
9502404,4,3,1,1,4,0,0,122,3.0,2.0,1.0,1.0,3.0,0.0,0.0,4,4,0,1.0,1.0,0.0
9909224,5,4,1,1,0,5,27,34,3.0,3.0,0.0,0.0,0.0,3.0,21.0,16,5,11,1.0,1.0,0.0
9807445,0,0,0,0,0,0,0,12,0.0,0.0,0.0,0.0,0.0,0.0,0.0,12,0,12,9.0,0.0,9.0
9512270,8,2,6,14,8,0,0,339,1.0,1.0,0.0,0.0,1.0,0.0,0.0,8,8,0,3.0,3.0,0.0
9803361,2,2,0,0,0,2,3,117,1.0,1.0,0.0,0.0,0.0,1.0,1.0,14,2,12,,,
209302,5,4,1,1,1,4,23,19,2.0,1.0,1.0,1.0,0.0,2.0,13.0,19,5,14,8.0,0.0,8.0
9804356,10,9,1,1,6,4,4,272,4.0,4.0,0.0,0.0,4.0,0.0,0.0,13,10,3,3.0,2.0,1.0
9806329,4,2,2,2,1,3,4,131,3.0,2.0,1.0,1.0,1.0,2.0,2.0,9,4,5,2.0,2.0,0.0
9709392,4,4,0,0,0,4,56,5,3.0,3.0,0.0,0.0,0.0,3.0,45.0,49,4,45,28.0,2.0,26.0
1108,7,2,5,11,0,7,39,20,6.0,2.0,4.0,8.0,0.0,6.0,13.0,23,7,16,10.0,7.0,3.0
9608286,8,3,5,15,1,7,11,123,7.0,3.0,4.0,11.0,1.0,6.0,8.0,11,8,3,9.0,7.0,2.0
9702238,10,2,8,21,10,0,0,85,6.0,1.0,5.0,15.0,6.0,0.0,0.0,13,10,3,7.0,7.0,0.0
106014,2,2,0,0,0,2,6,122,1.0,1.0,0.0,0.0,0.0,1.0,2.0,7,2,5,1.0,0.0,1.0
9806466,3,3,0,0,2,1,2,0,0.0,0.0,0.0,0.0,0.0,0.0,0.0,32,3,29,11.0,0.0,11.0
203137,23,7,16,44,0,23,407,11,21.0,5.0,16.0,42.0,0.0,21.0,384.0,62,23,39,51.0,16.0,35.0
9505230,3,1,2,2,0,3,4,44,2.0,1.0,1.0,1.0,0.0,2.0,3.0,6,3,3,,,
11308,3,2,1,1,0,3,30,103,3.0,2.0,1.0,1.0,0.0,3.0,27.0,16,3,13,10.0,3.0,7.0
9802235,3,3,0,0,1,2,7,182,2.0,2.0,0.0,0.0,0.0,2.0,6.0,31,3,28,2.0,1.0,1.0
9405249,2,2,0,0,2,0,0,1148,1.0,1.0,0.0,0.0,1.0,0.0,0.0,3,2,1,1.0,1.0,0.0
9810548,7,7,0,0,1,6,8,43,2.0,2.0,0.0,0.0,2.0,0.0,0.0,13,7,6,2.0,2.0,0.0
7297,4,3,1,1,4,0,0,356,2.0,2.0,0.0,0.0,2.0,0.0,0.0,6,4,2,2.0,2.0,0.0
107295,9,2,7,10,1,8,38,9,5.0,2.0,3.0,3.0,0.0,5.0,25.0,35,9,26,15.0,3.0,12.0
9506353,2,1,1,1,0,2,10,62,0.0,0.0,0.0,0.0,0.0,0.0,0.0,22,2,20,5.0,0.0,5.0
301111,1,1,0,0,0,1,4,18,0.0,0.0,0.0,0.0,0.0,0.0,0.0,13,1,12,4.0,0.0,4.0
209124,6,2,4,8,0,6,25,4,2.0,1.0,1.0,1.0,0.0,2.0,8.0,20,6,14,6.0,2.0,4.0
106212,3,3,0,0,1,2,8,5,0.0,0.0,0.0,0.0,0.0,0.0,0.0,15,3,12,3.0,0.0,3.0
203003,12,8,4,5,0,12,80,7,4.0,3.0,1.0,1.0,0.0,4.0,38.0,39,12,27,6.0,3.0,3.0
9904422,10,3,7,12,3,7,21,55,8.0,2.0,6.0,10.0,1.0,7.0,21.0,18,10,8,10.0,5.0,5.0
9807402,3,2,1,1,0,3,5,44,3.0,2.0,1.0,1.0,0.0,3.0,3.0,12,3,9,2.0,0.0,2.0
103149,7,5,2,3,4,3,7,64,4.0,3.0,1.0,2.0,1.0,3.0,6.0,10,7,3,6.0,4.0,2.0
9903339,1,1,0,0,0,1,2,9,1.0,1.0,0.0,0.0,0.0,1.0,1.0,7,1,6,,,
6211,6,3,3,5,2,4,7,99,1.0,1.0,0.0,0.0,0.0,1.0,2.0,14,6,8,4.0,1.0,3.0
9801219,10,8,2,2,10,0,0,132,5.0,4.0,1.0,1.0,5.0,0.0,0.0,10,10,0,4.0,4.0,0.0
108093,3,1,2,3,0,3,8,45,3.0,1.0,2.0,3.0,3.0,0.0,0.0,11,3,8,1.0,0.0,1.0
111109,3,1,2,2,1,2,21,109,2.0,1.0,1.0,1.0,0.0,2.0,21.0,17,3,14,14.0,1.0,13.0
204205,22,15,7,9,1,21,79,31,7.0,6.0,1.0,1.0,0.0,7.0,30.0,61,22,39,8.0,2.0,6.0
12227,5,4,1,1,1,4,33,2,2.0,1.0,1.0,1.0,0.0,2.0,7.0,22,5,17,12.0,2.0,10.0
4184,8,3,5,10,1,7,48,33,6.0,2.0,4.0,8.0,0.0,6.0,26.0,22,8,14,11.0,5.0,6.0
9702246,1,1,0,0,0,1,2,40,0.0,0.0,0.0,0.0,0.0,0.0,0.0,5,1,4,1.0,0.0,1.0
9906349,2,1,1,1,2,0,0,1560,,,,,,,,3,2,1,1.0,1.0,0.0
106035,5,3,2,3,1,4,22,42,3.0,2.0,1.0,1.0,0.0,3.0,14.0,28,5,23,16.0,2.0,14.0
9608246,3,2,1,1,0,3,3,298,3.0,2.0,1.0,1.0,0.0,3.0,3.0,18,3,15,6.0,3.0,3.0
9505335,13,7,6,14,4,9,15,78,12.0,6.0,6.0,14.0,4.0,8.0,8.0,20,13,7,6.0,5.0,1.0
105006,4,4,0,0,0,4,11,58,4.0,4.0,0.0,0.0,0.0,4.0,9.0,10,4,6,2.0,1.0,1.0
9403238,2,2,0,0,2,0,0,105,2.0,2.0,0.0,0.0,2.0,0.0,0.0,2,2,0,1.0,1.0,0.0
9307377,6,4,2,2,6,0,0,426,3.0,3.0,0.0,0.0,3.0,0.0,0.0,6,6,0,4.0,4.0,0.0
109278,1,1,0,0,1,0,0,285,1.0,1.0,0.0,0.0,1.0,0.0,0.0,4,1,3,1.0,0.0,1.0
9403206,2,2,0,0,2,0,0,253,0.0,0.0,0.0,0.0,0.0,0.0,0.0,3,2,1,1.0,1.0,0.0
9301296,2,1,1,1,2,0,0,1533,,,,,,,,2,2,0,,,
9307305,1,1,0,0,1,0,0,256,1.0,1.0,0.0,0.0,1.0,0.0,0.0,1,1,0,,,
9708333,1,1,0,0,1,0,0,93,0.0,0.0,0.0,0.0,0.0,0.0,0.0,28,1,27,4.0,0.0,4.0
9805210,1,1,0,0,0,1,4,53,1.0,1.0,0.0,0.0,0.0,1.0,4.0,7,1,6,6.0,1.0,5.0
111466,2,1,1,1,0,2,12,95,2.0,1.0,1.0,1.0,0.0,2.0,5.0,28,2,26,6.0,2.0,4.0
9206202,2,2,0,0,2,0,0,211,1.0,1.0,0.0,0.0,1.0,0.0,0.0,2,2,0,,,
9611299,8,1,7,12,7,1,2,384,5.0,1.0,4.0,6.0,5.0,0.0,0.0,11,8,3,4.0,4.0,0.0
9612241,4,1,3,3,4,0,0,220,4.0,1.0,3.0,3.0,4.0,0.0,0.0,6,4,2,4.0,4.0,0.0
9702212,2,2,0,0,0,2,16,85,2.0,2.0,0.0,0.0,0.0,2.0,8.0,16,2,14,8.0,2.0,6.0
9905263,3,3,0,0,1,2,16,9,2.0,2.0,0.0,0.0,0.0,2.0,16.0,23,3,20,19.0,2.0,17.0
103146,0,0,0,0,0,0,0,253,0.0,0.0,0.0,0.0,0.0,0.0,0.0,1,0,1,1.0,0.0,1.0
9905255,9,3,6,13,8,1,1,185,8.0,2.0,6.0,12.0,8.0,0.0,0.0,10,9,1,6.0,6.0,0.0
9601376,19,5,14,41,1,18,28,137,12.0,1.0,11.0,38.0,0.0,12.0,22.0,21,19,2,13.0,11.0,2.0
212110,1,1,0,0,0,1,2,28,1.0,1.0,0.0,0.0,0.0,1.0,2.0,22,1,21,3.0,1.0,2.0
6057,5,3,2,3,0,5,29,125,4.0,3.0,1.0,1.0,0.0,4.0,20.0,14,5,9,10.0,3.0,7.0
9910235,7,4,3,5,3,4,8,2,2.0,1.0,1.0,1.0,1.0,1.0,1.0,11,7,4,5.0,5.0,0.0
106095,4,3,1,1,0,4,13,17,3.0,2.0,1.0,1.0,1.0,2.0,4.0,12,4,8,4.0,2.0,2.0
9908346,0,0,0,0,0,0,0,196,0.0,0.0,0.0,0.0,0.0,0.0,0.0,9,0,9,4.0,0.0,4.0
9505354,3,3,0,0,2,1,4,6,1.0,1.0,0.0,0.0,1.0,0.0,0.0,11,3,8,3.0,1.0,2.0
9811204,4,1,3,4,4,0,0,111,4.0,1.0,3.0,4.0,4.0,0.0,0.0,4,4,0,4.0,4.0,0.0
9810284,4,2,2,5,3,1,3,144,1.0,1.0,0.0,0.0,0.0,1.0,3.0,14,4,10,5.0,1.0,4.0
2057,3,2,1,1,0,3,33,16,2.0,2.0,0.0,0.0,0.0,2.0,14.0,27,3,24,4.0,2.0,2.0
210272,0,0,0,0,0,0,0,293,0.0,0.0,0.0,0.0,0.0,0.0,0.0,9,0,9,3.0,0.0,3.0
9909452,6,1,5,8,0,6,7,139,4.0,1.0,3.0,3.0,0.0,4.0,5.0,8,6,2,6.0,4.0,2.0
107152,17,5,12,25,0,17,51,16,13.0,4.0,9.0,20.0,0.0,13.0,34.0,25,17,8,7.0,6.0,1.0
207236,8,1,7,16,0,8,79,46,7.0,1.0,6.0,15.0,0.0,7.0,67.0,35,8,27,20.0,4.0,16.0
106244,2,1,1,1,0,2,4,11,0.0,0.0,0.0,0.0,0.0,0.0,0.0,21,2,19,2.0,0.0,2.0
9805278,4,2,2,4,0,4,16,8,0.0,0.0,0.0,0.0,0.0,0.0,0.0,27,4,23,5.0,3.0,2.0
9802227,6,5,1,2,0,6,13,29,1.0,1.0,0.0,0.0,0.0,1.0,2.0,19,6,13,9.0,3.0,6.0
9611396,2,1,1,1,1,1,2,115,1.0,1.0,0.0,0.0,0.0,1.0,2.0,10,2,8,3.0,0.0,3.0
9903381,5,3,2,2,1,4,7,102,0.0,0.0,0.0,0.0,0.0,0.0,0.0,13,5,8,5.0,1.0,4.0
9610469,0,0,0,0,0,0,0,41,0.0,0.0,0.0,0.0,0.0,0.0,0.0,14,0,14,9.0,0.0,9.0
9801295,11,4,7,9,2,9,29,113,3.0,1.0,2.0,2.0,0.0,3.0,8.0,22,11,11,7.0,5.0,2.0
201254,0,0,0,0,0,0,0,1289,,,,,,,,4,0,4,,,
10059,5,1,4,5,1,4,20,11,3.0,1.0,2.0,3.0,1.0,2.0,5.0,16,5,11,5.0,3.0,2.0
9806327,4,2,2,2,4,0,0,219,3.0,1.0,2.0,2.0,3.0,0.0,0.0,5,4,1,1.0,0.0,1.0
109012,4,1,3,4,0,4,13,89,3.0,1.0,2.0,3.0,0.0,3.0,7.0,14,4,10,8.0,4.0,4.0
9904324,5,3,2,2,1,4,7,455,2.0,1.0,1.0,1.0,0.0,2.0,2.0,13,5,8,4.0,3.0,1.0
9909242,6,4,2,3,0,6,15,102,3.0,1.0,2.0,3.0,0.0,3.0,7.0,21,6,15,3.0,1.0,2.0
9506214,1,1,0,0,1,0,0,255,,,,,,,,1,1,0,,,
110327,1,1,0,0,0,1,19,1,1.0,1.0,0.0,0.0,0.0,1.0,15.0,35,1,34,15.0,0.0,15.0
9311217,4,3,1,3,4,0,0,65,4.0,3.0,1.0,3.0,4.0,0.0,0.0,4,4,0,1.0,1.0,0.0
108162,2,2,0,0,0,2,4,125,1.0,1.0,0.0,0.0,0.0,1.0,2.0,4,2,2,1.0,1.0,0.0
9905394,8,4,4,5,4,4,7,98,1.0,1.0,0.0,0.0,0.0,1.0,3.0,25,8,17,8.0,0.0,8.0
108267,1,1,0,0,0,1,4,12,0.0,0.0,0.0,0.0,0.0,0.0,0.0,74,1,73,2.0,0.0,2.0
6133,2,1,1,1,0,2,4,80,1.0,1.0,0.0,0.0,0.0,1.0,1.0,4,2,2,2.0,1.0,1.0
9702220,4,1,3,4,0,4,6,44,3.0,1.0,2.0,3.0,3.0,0.0,0.0,6,4,2,3.0,3.0,0.0
108150,2,1,1,1,0,2,21,12,0.0,0.0,0.0,0.0,0.0,0.0,0.0,46,2,44,11.0,0.0,11.0
9704405,15,2,13,47,0,15,105,6,5.0,3.0,2.0,5.0,0.0,5.0,49.0,37,15,22,17.0,14.0,3.0
201310,1,1,0,0,0,1,11,122,0.0,0.0,0.0,0.0,0.0,0.0,0.0,26,1,25,10.0,1.0,9.0
9702364,13,6,7,10,2,11,26,163,5.0,1.0,4.0,7.0,2.0,3.0,3.0,28,13,15,8.0,5.0,3.0
9303221,4,3,1,2,4,0,0,295,4.0,3.0,1.0,2.0,4.0,0.0,0.0,6,4,2,3.0,3.0,0.0
9711260,4,2,2,3,0,4,21,14,1.0,1.0,0.0,0.0,0.0,1.0,6.0,16,4,12,6.0,1.0,5.0
9302205,0,0,0,0,0,0,0,223,0.0,0.0,0.0,0.0,0.0,0.0,0.0,6,0,6,1.0,0.0,1.0
9807459,2,2,0,0,1,1,1,126,0.0,0.0,0.0,0.0,0.0,0.0,0.0,4,2,2,1.0,0.0,1.0
9809203,7,5,2,2,2,5,13,33,5.0,3.0,2.0,2.0,2.0,3.0,9.0,12,7,5,3.0,3.0,0.0
9804311,3,3,0,0,3,0,0,235,2.0,2.0,0.0,0.0,2.0,0.0,0.0,4,3,1,2.0,1.0,1.0
9812451,1,1,0,0,0,1,5,5,0.0,0.0,0.0,0.0,0.0,0.0,0.0,9,1,8,3.0,1.0,2.0
211237,0,0,0,0,0,0,0,57,0.0,0.0,0.0,0.0,0.0,0.0,0.0,10,0,10,3.0,0.0,3.0
107330,5,3,2,2,0,5,12,31,2.0,1.0,1.0,1.0,0.0,2.0,6.0,23,5,18,6.0,2.0,4.0
9908338,5,3,2,3,5,0,0,58,4.0,2.0,2.0,3.0,4.0,0.0,0.0,5,5,0,3.0,3.0,0.0
9606234,3,3,0,0,0,3,16,40,3.0,3.0,0.0,0.0,0.0,3.0,15.0,14,3,11,3.0,1.0,2.0
9412292,1,1,0,0,1,0,0,331,1.0,1.0,0.0,0.0,1.0,0.0,0.0,1,1,0,,,
101354,7,4,3,5,1,6,22,4,3.0,1.0,2.0,3.0,0.0,3.0,11.0,15,7,8,2.0,1.0,1.0
208057,1,1,0,0,0,1,1,398,0.0,0.0,0.0,0.0,0.0,0.0,0.0,4,1,3,1.0,0.0,1.0
9902432,1,1,0,0,0,1,4,123,1.0,1.0,0.0,0.0,0.0,1.0,2.0,9,1,8,3.0,1.0,2.0
211455,0,0,0,0,0,0,0,86,0.0,0.0,0.0,0.0,0.0,0.0,0.0,5,0,5,1.0,0.0,1.0
108119,1,1,0,0,0,1,3,58,0.0,0.0,0.0,0.0,0.0,0.0,0.0,11,1,10,1.0,0.0,1.0
209336,1,1,0,0,0,1,6,147,1.0,1.0,0.0,0.0,0.0,1.0,3.0,7,1,6,4.0,1.0,3.0
105141,11,6,5,10,1,10,45,65,8.0,4.0,4.0,8.0,0.0,8.0,43.0,28,11,17,18.0,5.0,13.0
201258,6,4,2,2,0,6,11,119,4.0,2.0,2.0,2.0,1.0,3.0,6.0,9,6,3,6.0,4.0,2.0
8279,5,3,2,2,0,5,66,24,2.0,1.0,1.0,1.0,0.0,2.0,39.0,36,5,31,15.0,3.0,12.0
101049,10,6,4,5,1,9,38,112,8.0,4.0,4.0,4.0,0.0,8.0,33.0,33,10,23,14.0,7.0,7.0
104181,7,4,3,3,2,5,7,263,3.0,1.0,2.0,2.0,3.0,0.0,0.0,10,7,3,4.0,3.0,1.0
210389,1,1,0,0,1,0,0,46,0.0,0.0,0.0,0.0,0.0,0.0,0.0,7,1,6,2.0,0.0,2.0
10158,1,1,0,0,0,1,3,9,0.0,0.0,0.0,0.0,0.0,0.0,0.0,8,1,7,5.0,0.0,5.0
9909543,3,3,0,0,0,3,5,137,3.0,3.0,0.0,0.0,0.0,3.0,5.0,5,3,2,5.0,3.0,2.0
104307,6,2,4,5,2,4,19,13,4.0,2.0,2.0,3.0,0.0,4.0,13.0,26,6,20,6.0,1.0,5.0
8180,1,1,0,0,0,1,3,17,,,,,,,,6,1,5,,,
7058,3,3,0,0,0,3,14,33,2.0,2.0,0.0,0.0,0.0,2.0,6.0,17,3,14,9.0,0.0,9.0
9804460,10,7,3,4,0,10,26,38,7.0,5.0,2.0,3.0,0.0,7.0,16.0,16,10,6,5.0,3.0,2.0
9906263,4,3,1,1,2,2,2,174,0.0,0.0,0.0,0.0,0.0,0.0,0.0,6,4,2,1.0,0.0,1.0
106257,3,3,0,0,0,3,19,40,2.0,2.0,0.0,0.0,0.0,2.0,15.0,42,3,39,14.0,2.0,12.0
9812470,2,2,0,0,2,0,0,438,1.0,1.0,0.0,0.0,1.0,0.0,0.0,6,2,4,1.0,0.0,1.0
208242,0,0,0,0,0,0,0,894,,,,,,,,2,0,2,,,
9908267,3,3,0,0,1,2,11,98,2.0,2.0,0.0,0.0,0.0,2.0,10.0,15,3,12,10.0,2.0,8.0
210139,5,3,2,2,0,5,27,11,5.0,3.0,2.0,2.0,0.0,5.0,27.0,16,5,11,1.0,1.0,0.0
9251,6,1,5,9,0,6,23,77,5.0,1.0,4.0,7.0,0.0,5.0,16.0,15,6,9,9.0,5.0,4.0
9903401,0,0,0,0,0,0,0,148,0.0,0.0,0.0,0.0,0.0,0.0,0.0,5,0,5,4.0,0.0,4.0
209085,3,2,1,1,0,3,28,27,3.0,2.0,1.0,1.0,0.0,3.0,25.0,18,3,15,8.0,3.0,5.0
9310238,1,1,0,0,1,0,0,368,1.0,1.0,0.0,0.0,1.0,0.0,0.0,1,1,0,1.0,1.0,0.0
9907465,2,2,0,0,0,2,11,14,2.0,2.0,0.0,0.0,0.0,2.0,10.0,11,2,9,2.0,1.0,1.0
11009,3,2,1,1,2,1,1,271,2.0,1.0,1.0,1.0,1.0,1.0,1.0,6,3,3,3.0,2.0,1.0
9708493,1,1,0,0,1,0,0,22,1.0,1.0,0.0,0.0,1.0,0.0,0.0,6,1,5,1.0,0.0,1.0
8133,1,1,0,0,0,1,9,99,1.0,1.0,0.0,0.0,0.0,1.0,3.0,28,1,27,8.0,1.0,7.0
1269,6,5,1,1,2,4,18,23,3.0,3.0,0.0,0.0,0.0,3.0,8.0,19,6,13,8.0,1.0,7.0
9810430,2,2,0,0,1,1,1,83,0.0,0.0,0.0,0.0,0.0,0.0,0.0,4,2,2,1.0,0.0,1.0
301130,2,2,0,0,0,2,21,38,2.0,2.0,0.0,0.0,0.0,2.0,20.0,29,2,27,18.0,1.0,17.0
9711222,1,1,0,0,1,0,0,203,0.0,0.0,0.0,0.0,0.0,0.0,0.0,10,1,9,7.0,0.0,7.0
105124,2,1,1,1,0,2,10,3,0.0,0.0,0.0,0.0,0.0,0.0,0.0,51,2,49,12.0,0.0,12.0
2094,2,2,0,0,1,1,1,266,0.0,0.0,0.0,0.0,0.0,0.0,0.0,12,2,10,3.0,0.0,3.0
107115,2,1,1,1,0,2,3,161,2.0,1.0,1.0,1.0,0.0,2.0,3.0,4,2,2,4.0,2.0,2.0
108201,4,2,2,3,0,4,16,144,3.0,1.0,2.0,3.0,0.0,3.0,4.0,29,4,25,6.0,3.0,3.0
9501261,1,1,0,0,1,0,0,206,0.0,0.0,0.0,0.0,0.0,0.0,0.0,4,1,3,2.0,0.0,2.0
9903304,8,2,6,18,1,7,13,161,7.0,1.0,6.0,18.0,0.0,7.0,13.0,11,8,3,9.0,7.0,2.0
207125,12,5,7,21,2,10,37,2,9.0,3.0,6.0,20.0,1.0,8.0,29.0,20,12,8,12.0,8.0,4.0
9710472,2,2,0,0,0,2,3,352,1.0,1.0,0.0,0.0,0.0,1.0,2.0,9,2,7,3.0,1.0,2.0
12272,2,2,0,0,1,1,6,120,1.0,1.0,0.0,0.0,0.0,1.0,6.0,12,2,10,7.0,1.0,6.0
9804413,4,3,1,1,0,4,11,76,3.0,2.0,1.0,1.0,0.0,3.0,10.0,8,4,4,7.0,3.0,4.0
9712336,0,0,0,0,0,0,0,31,0.0,0.0,0.0,0.0,0.0,0.0,0.0,4,0,4,1.0,0.0,1.0
9309221,2,2,0,0,2,0,0,396,1.0,1.0,0.0,0.0,1.0,0.0,0.0,2,2,0,1.0,1.0,0.0
12050,3,1,2,3,0,3,13,31,3.0,1.0,2.0,3.0,0.0,3.0,9.0,14,3,11,6.0,3.0,3.0
9810378,1,1,0,0,1,0,0,51,0.0,0.0,0.0,0.0,0.0,0.0,0.0,6,1,5,2.0,0.0,2.0
1154,2,1,1,1,0,2,5,262,2.0,1.0,1.0,1.0,0.0,2.0,5.0,6,2,4,6.0,2.0,4.0
9408334,0,0,0,0,0,0,0,269,0.0,0.0,0.0,0.0,0.0,0.0,0.0,2,0,2,1.0,0.0,1.0
103053,5,4,1,1,0,5,57,2,5.0,4.0,1.0,1.0,0.0,5.0,55.0,40,5,35,29.0,3.0,26.0
9609354,1,1,0,0,0,1,2,281,0.0,0.0,0.0,0.0,0.0,0.0,0.0,4,1,3,1.0,0.0,1.0
9911444,0,0,0,0,0,0,0,44,0.0,0.0,0.0,0.0,0.0,0.0,0.0,5,0,5,,,
112199,6,3,3,3,0,6,78,17,4.0,2.0,2.0,2.0,0.0,4.0,52.0,35,6,29,17.0,1.0,16.0
102100,0,0,0,0,0,0,0,44,0.0,0.0,0.0,0.0,0.0,0.0,0.0,11,0,11,6.0,0.0,6.0
9607395,2,1,1,1,1,1,1,279,2.0,1.0,1.0,1.0,1.0,1.0,1.0,3,2,1,3.0,2.0,1.0
204358,4,3,1,1,0,4,23,37,3.0,2.0,1.0,1.0,0.0,3.0,21.0,15,4,11,1.0,1.0,0.0
9710448,1,1,0,0,1,0,0,118,,,,,,,,1,1,0,,,
108042,0,0,0,0,0,0,0,67,0.0,0.0,0.0,0.0,0.0,0.0,0.0,19,0,19,2.0,0.0,2.0
8272,1,1,0,0,0,1,6,7,,,,,,,,13,1,12,1.0,0.0,1.0
9904357,3,3,0,0,0,3,36,90,2.0,2.0,0.0,0.0,0.0,2.0,22.0,32,3,29,13.0,2.0,11.0
9810212,0,0,0,0,0,0,0,240,0.0,0.0,0.0,0.0,0.0,0.0,0.0,2,0,2,2.0,0.0,2.0
9909527,0,0,0,0,0,0,0,411,0.0,0.0,0.0,0.0,0.0,0.0,0.0,9,0,9,7.0,0.0,7.0
202066,2,2,0,0,0,2,19,70,1.0,1.0,0.0,0.0,0.0,1.0,17.0,24,2,22,23.0,1.0,22.0
9704444,2,1,1,1,0,2,15,158,2.0,1.0,1.0,1.0,0.0,2.0,7.0,11,2,9,,,
9910496,4,3,1,1,1,3,28,25,2.0,1.0,1.0,1.0,0.0,2.0,8.0,44,4,40,9.0,2.0,7.0
202196,3,1,2,3,0,3,19,5,3.0,1.0,2.0,3.0,0.0,3.0,6.0,16,3,13,6.0,3.0,3.0
106185,3,3,0,0,3,0,0,473,3.0,3.0,0.0,0.0,3.0,0.0,0.0,3,3,0,2.0,2.0,0.0
207133,3,3,0,0,0,3,40,28,2.0,2.0,0.0,0.0,0.0,2.0,18.0,26,3,23,13.0,3.0,10.0
5213,4,3,1,1,0,4,12,13,1.0,1.0,0.0,0.0,0.0,1.0,5.0,12,4,8,6.0,1.0,5.0
211194,1,1,0,0,1,0,0,672,1.0,1.0,0.0,0.0,1.0,0.0,0.0,2,1,1,1.0,1.0,0.0
9911310,2,1,1,1,0,2,20,102,2.0,1.0,1.0,1.0,0.0,2.0,17.0,17,2,15,11.0,2.0,9.0
9503420,8,5,3,4,8,0,0,311,6.0,3.0,3.0,4.0,6.0,0.0,0.0,9,8,1,4.0,4.0,0.0
9412313,0,0,0,0,0,0,0,189,0.0,0.0,0.0,0.0,0.0,0.0,0.0,2,0,2,1.0,0.0,1.0
8182,1,1,0,0,0,1,5,107,0.0,0.0,0.0,0.0,0.0,0.0,0.0,12,1,11,6.0,0.0,6.0
207097,0,0,0,0,0,0,0,644,0.0,0.0,0.0,0.0,0.0,0.0,0.0,1,0,1,1.0,0.0,1.0
9409420,0,0,0,0,0,0,0,60,,,,,,,,2,0,2,1.0,0.0,1.0
12290,2,2,0,0,0,2,2,447,2.0,2.0,0.0,0.0,0.0,2.0,2.0,3,2,1,3.0,2.0,1.0
4121,0,0,0,0,0,0,0,174,0.0,0.0,0.0,0.0,0.0,0.0,0.0,3,0,3,1.0,0.0,1.0
9911389,1,1,0,0,0,1,9,29,1.0,1.0,0.0,0.0,0.0,1.0,6.0,11,1,10,8.0,1.0,7.0
9508236,0,0,0,0,0,0,0,10,,,,,,,,7,0,7,1.0,0.0,1.0
206230,2,2,0,0,1,1,2,172,1.0,1.0,0.0,0.0,0.0,1.0,2.0,11,2,9,3.0,0.0,3.0
9209227,2,1,1,1,2,0,0,1374,2.0,1.0,1.0,1.0,2.0,0.0,0.0,2,2,0,2.0,2.0,0.0
9706515,2,2,0,0,0,2,2,249,2.0,2.0,0.0,0.0,0.0,2.0,2.0,3,2,1,3.0,2.0,1.0
9810339,1,1,0,0,0,1,5,49,1.0,1.0,0.0,0.0,0.0,1.0,4.0,9,1,8,1.0,0.0,1.0
207225,1,1,0,0,0,1,4,113,0.0,0.0,0.0,0.0,0.0,0.0,0.0,18,1,17,12.0,0.0,12.0
112144,2,1,1,1,0,2,26,20,2.0,1.0,1.0,1.0,0.0,2.0,26.0,19,2,17,7.0,2.0,5.0
105007,0,0,0,0,0,0,0,369,0.0,0.0,0.0,0.0,0.0,0.0,0.0,1,0,1,1.0,0.0,1.0
9902209,1,1,0,0,1,0,0,38,0.0,0.0,0.0,0.0,0.0,0.0,0.0,6,1,5,1.0,0.0,1.0
210414,2,2,0,0,0,2,15,2,1.0,1.0,0.0,0.0,0.0,1.0,6.0,33,2,31,11.0,1.0,10.0
9809502,0,0,0,0,0,0,0,111,0.0,0.0,0.0,0.0,0.0,0.0,0.0,6,0,6,2.0,0.0,2.0
9306286,0,0,0,0,0,0,0,60,0.0,0.0,0.0,0.0,0.0,0.0,0.0,3,0,3,1.0,0.0,1.0
1156,1,1,0,0,1,0,0,149,0.0,0.0,0.0,0.0,0.0,0.0,0.0,4,1,3,3.0,0.0,3.0
211461,1,1,0,0,0,1,4,4,0.0,0.0,0.0,0.0,0.0,0.0,0.0,12,1,11,1.0,0.0,1.0
208227,5,4,1,1,0,5,14,239,4.0,3.0,1.0,1.0,0.0,4.0,10.0,11,5,6,7.0,4.0,3.0
9607406,1,1,0,0,0,1,2,15,1.0,1.0,0.0,0.0,1.0,0.0,0.0,9,1,8,2.0,1.0,1.0
9911441,0,0,0,0,0,0,0,353,0.0,0.0,0.0,0.0,0.0,0.0,0.0,1,0,1,1.0,0.0,1.0
209373,2,2,0,0,0,2,4,0,0.0,0.0,0.0,0.0,0.0,0.0,0.0,25,2,23,1.0,1.0,0.0
9211288,1,1,0,0,1,0,0,1610,,,,,,,,1,1,0,,,
9604366,11,7,4,6,11,0,0,111,5.0,4.0,1.0,2.0,5.0,0.0,0.0,11,11,0,3.0,3.0,0.0
109142,3,2,1,1,0,3,6,311,3.0,2.0,1.0,1.0,0.0,3.0,6.0,6,3,3,6.0,3.0,3.0
9412296,0,0,0,0,0,0,0,619,0.0,0.0,0.0,0.0,0.0,0.0,0.0,4,0,4,4.0,0.0,4.0
9901238,2,2,0,0,0,2,18,17,2.0,2.0,0.0,0.0,0.0,2.0,16.0,22,2,20,2.0,1.0,1.0
210403,2,2,0,0,0,2,8,83,1.0,1.0,0.0,0.0,0.0,1.0,1.0,11,2,9,2.0,1.0,1.0
208225,1,1,0,0,0,1,5,165,1.0,1.0,0.0,0.0,0.0,1.0,5.0,7,1,6,1.0,0.0,1.0
9407355,1,1,0,0,1,0,0,136,1.0,1.0,0.0,0.0,1.0,0.0,0.0,1,1,0,,,
106211,5,3,2,2,1,4,24,31,4.0,2.0,2.0,2.0,0.0,4.0,15.0,20,5,15,6.0,3.0,3.0
9909571,3,1,2,2,0,3,6,282,2.0,1.0,1.0,1.0,0.0,2.0,2.0,11,3,8,2.0,2.0,0.0
7231,2,2,0,0,0,2,10,72,2.0,2.0,0.0,0.0,0.0,2.0,4.0,7,2,5,6.0,2.0,4.0
9412321,2,2,0,0,2,0,0,322,2.0,2.0,0.0,0.0,2.0,0.0,0.0,3,2,1,2.0,2.0,0.0
212078,2,2,0,0,0,2,13,8,1.0,1.0,0.0,0.0,0.0,1.0,3.0,35,2,33,2.0,0.0,2.0
104007,0,0,0,0,0,0,0,56,0.0,0.0,0.0,0.0,0.0,0.0,0.0,19,0,19,10.0,0.0,10.0
9905211,5,5,0,0,0,5,11,9,0.0,0.0,0.0,0.0,0.0,0.0,0.0,12,5,7,3.0,0.0,3.0
9704284,0,0,0,0,0,0,0,45,0.0,0.0,0.0,0.0,0.0,0.0,0.0,6,0,6,1.0,0.0,1.0
110389,0,0,0,0,0,0,0,566,0.0,0.0,0.0,0.0,0.0,0.0,0.0,3,0,3,2.0,0.0,2.0
109175,0,0,0,0,0,0,0,230,0.0,0.0,0.0,0.0,0.0,0.0,0.0,1,0,1,1.0,0.0,1.0
206131,5,2,3,6,0,5,19,219,5.0,2.0,3.0,6.0,0.0,5.0,19.0,10,5,5,9.0,5.0,4.0
9907227,1,1,0,0,0,1,3,13,0.0,0.0,0.0,0.0,0.0,0.0,0.0,22,1,21,7.0,0.0,7.0
110305,1,1,0,0,1,0,0,185,0.0,0.0,0.0,0.0,0.0,0.0,0.0,3,1,2,1.0,0.0,1.0
209029,2,2,0,0,0,2,11,16,1.0,1.0,0.0,0.0,0.0,1.0,5.0,31,2,29,10.0,0.0,10.0
201111,1,1,0,0,1,0,0,17,0.0,0.0,0.0,0.0,0.0,0.0,0.0,7,1,6,1.0,0.0,1.0
9808388,1,1,0,0,0,1,1,250,0.0,0.0,0.0,0.0,0.0,0.0,0.0,5,1,4,2.0,0.0,2.0
9812410,0,0,0,0,0,0,0,357,0.0,0.0,0.0,0.0,0.0,0.0,0.0,1,0,1,,,
12032,5,5,0,0,0,5,12,122,5.0,5.0,0.0,0.0,0.0,5.0,9.0,16,5,11,9.0,5.0,4.0
207370,1,1,0,0,0,1,19,187,1.0,1.0,0.0,0.0,0.0,1.0,14.0,31,1,30,15.0,1.0,14.0
301224,0,0,0,0,0,0,0,475,0.0,0.0,0.0,0.0,0.0,0.0,0.0,1,0,1,1.0,0.0,1.0
209139,0,0,0,0,0,0,0,51,0.0,0.0,0.0,0.0,0.0,0.0,0.0,10,0,10,8.0,0.0,8.0
206006,1,1,0,0,0,1,4,1,0.0,0.0,0.0,0.0,0.0,0.0,0.0,11,1,10,3.0,0.0,3.0
9708491,3,3,0,0,1,2,11,87,3.0,3.0,0.0,0.0,1.0,2.0,10.0,13,3,10,8.0,2.0,6.0
211284,1,1,0,0,0,1,5,2,1.0,1.0,0.0,0.0,1.0,0.0,0.0,17,1,16,5.0,1.0,4.0
105016,3,1,2,2,0,3,18,79,3.0,1.0,2.0,2.0,0.0,3.0,15.0,19,3,16,9.0,2.0,7.0
2187,1,1,0,0,0,1,3,137,1.0,1.0,0.0,0.0,0.0,1.0,3.0,22,1,21,16.0,0.0,16.0
8075,1,1,0,0,0,1,1,55,,,,,,,,6,1,5,1.0,1.0,0.0
110239,1,1,0,0,0,1,5,512,1.0,1.0,0.0,0.0,0.0,1.0,2.0,7,1,6,3.0,1.0,2.0
9808311,1,1,0,0,0,1,1,268,1.0,1.0,0.0,0.0,0.0,1.0,1.0,3,1,2,2.0,1.0,1.0
9502282,8,1,7,11,8,0,0,352,8.0,1.0,7.0,11.0,8.0,0.0,0.0,8,8,0,8.0,8.0,0.0
9311238,0,0,0,0,0,0,0,2093,,,,,,,,1,0,1,,,
9910548,0,0,0,0,0,0,0,331,0.0,0.0,0.0,0.0,0.0,0.0,0.0,1,0,1,1.0,0.0,1.0
9511425,0,0,0,0,0,0,0,236,0.0,0.0,0.0,0.0,0.0,0.0,0.0,10,0,10,1.0,0.0,1.0
9804218,3,3,0,0,3,0,0,110,0.0,0.0,0.0,0.0,0.0,0.0,0.0,4,3,1,1.0,1.0,0.0
207049,0,0,0,0,0,0,0,334,0.0,0.0,0.0,0.0,0.0,0.0,0.0,3,0,3,3.0,0.0,3.0
11090,0,0,0,0,0,0,0,148,0.0,0.0,0.0,0.0,0.0,0.0,0.0,3,0,3,1.0,0.0,1.0
1065,1,1,0,0,0,1,14,35,0.0,0.0,0.0,0.0,0.0,0.0,0.0,31,1,30,10.0,1.0,9.0
9905418,0,0,0,0,0,0,0,216,0.0,0.0,0.0,0.0,0.0,0.0,0.0,1,0,1,1.0,0.0,1.0
9612280,0,0,0,0,0,0,0,1626,0.0,0.0,0.0,0.0,0.0,0.0,0.0,2,0,2,1.0,0.0,1.0
109227,1,1,0,0,0,1,1,91,0.0,0.0,0.0,0.0,0.0,0.0,0.0,13,1,12,3.0,1.0,2.0
302059,0,0,0,0,0,0,0,31,0.0,0.0,0.0,0.0,0.0,0.0,0.0,21,0,21,2.0,0.0,2.0
9907260,1,1,0,0,0,1,3,299,1.0,1.0,0.0,0.0,0.0,1.0,3.0,17,1,16,8.0,1.0,7.0
103336,2,1,1,1,1,1,1,175,0.0,0.0,0.0,0.0,0.0,0.0,0.0,15,2,13,9.0,0.0,9.0
11166,0,0,0,0,0,0,0,360,,,,,,,,1,0,1,1.0,0.0,1.0
104215,0,0,0,0,0,0,0,250,0.0,0.0,0.0,0.0,0.0,0.0,0.0,8,0,8,1.0,0.0,1.0
8202,1,1,0,0,0,1,2,201,0.0,0.0,0.0,0.0,0.0,0.0,0.0,10,1,9,6.0,0.0,6.0
210306,0,0,0,0,0,0,0,129,0.0,0.0,0.0,0.0,0.0,0.0,0.0,12,0,12,2.0,0.0,2.0
9603334,0,0,0,0,0,0,0,48,0.0,0.0,0.0,0.0,0.0,0.0,0.0,4,0,4,2.0,0.0,2.0
9612341,1,1,0,0,0,1,2,96,1.0,1.0,0.0,0.0,0.0,1.0,2.0,4,1,3,4.0,1.0,3.0
8101,0,0,0,0,0,0,0,24,0.0,0.0,0.0,0.0,0.0,0.0,0.0,37,0,37,23.0,0.0,23.0
209369,1,1,0,0,0,1,8,209,1.0,1.0,0.0,0.0,0.0,1.0,6.0,15,1,14,7.0,1.0,6.0
9310295,1,1,0,0,1,0,0,1913,,,,,,,,1,1,0,,,
207362,1,1,0,0,0,1,5,39,0.0,0.0,0.0,0.0,0.0,0.0,0.0,17,1,16,6.0,0.0,6.0
9708417,1,1,0,0,0,1,2,94,0.0,0.0,0.0,0.0,0.0,0.0,0.0,19,1,18,10.0,0.0,10.0
6061,3,1,2,2,3,0,0,213,2.0,1.0,1.0,1.0,2.0,0.0,0.0,10,3,7,4.0,3.0,1.0
9905558,4,1,3,4,0,4,22,95,4.0,1.0,3.0,4.0,0.0,4.0,22.0,16,4,12,5.0,2.0,3.0
9807485,1,1,0,0,0,1,2,180,1.0,1.0,0.0,0.0,0.0,1.0,2.0,4,1,3,2.0,1.0,1.0
205155,1,1,0,0,0,1,4,77,0.0,0.0,0.0,0.0,0.0,0.0,0.0,12,1,11,1.0,0.0,1.0
111286,1,1,0,0,0,1,1,118,1.0,1.0,0.0,0.0,1.0,0.0,0.0,8,1,7,3.0,1.0,2.0
9904373,2,1,1,1,0,2,7,23,2.0,1.0,1.0,1.0,0.0,2.0,3.0,13,2,11,7.0,1.0,6.0
204315,2,2,0,0,1,1,7,81,1.0,1.0,0.0,0.0,0.0,1.0,7.0,31,2,29,5.0,0.0,5.0
9312286,1,1,0,0,1,0,0,690,1.0,1.0,0.0,0.0,1.0,0.0,0.0,1,1,0,1.0,1.0,0.0
206210,0,0,0,0,0,0,0,219,0.0,0.0,0.0,0.0,0.0,0.0,0.0,10,0,10,2.0,0.0,2.0
9801343,0,0,0,0,0,0,0,6,0.0,0.0,0.0,0.0,0.0,0.0,0.0,31,0,31,4.0,0.0,4.0
9809407,1,1,0,0,0,1,1,116,1.0,1.0,0.0,0.0,1.0,0.0,0.0,2,1,1,1.0,1.0,0.0
9706248,0,0,0,0,0,0,0,329,0.0,0.0,0.0,0.0,0.0,0.0,0.0,8,0,8,4.0,0.0,4.0
110057,1,1,0,0,0,1,4,145,1.0,1.0,0.0,0.0,0.0,1.0,4.0,9,1,8,7.0,1.0,6.0
205078,1,1,0,0,0,1,2,146,1.0,1.0,0.0,0.0,0.0,1.0,2.0,7,1,6,1.0,0.0,1.0
204176,0,0,0,0,0,0,0,963,0.0,0.0,0.0,0.0,0.0,0.0,0.0,4,0,4,2.0,0.0,2.0
12340,2,2,0,0,0,2,15,95,2.0,2.0,0.0,0.0,0.0,2.0,11.0,26,2,24,7.0,0.0,7.0
9804448,1,1,0,0,0,1,1,396,1.0,1.0,0.0,0.0,0.0,1.0,1.0,3,1,2,1.0,1.0,0.0
9710330,1,1,0,0,0,1,3,27,0.0,0.0,0.0,0.0,0.0,0.0,0.0,9,1,8,3.0,1.0,2.0
9805347,2,2,0,0,1,1,3,352,1.0,1.0,0.0,0.0,0.0,1.0,2.0,10,2,8,3.0,1.0,2.0
105307,0,0,0,0,0,0,0,1078,,,,,,,,5,0,5,,,
205341,3,3,0,0,1,2,3,34,0.0,0.0,0.0,0.0,0.0,0.0,0.0,23,3,20,2.0,0.0,2.0
9502392,1,1,0,0,1,0,0,404,1.0,1.0,0.0,0.0,1.0,0.0,0.0,1,1,0,1.0,1.0,0.0
210347,0,0,0,0,0,0,0,23,0.0,0.0,0.0,0.0,0.0,0.0,0.0,8,0,8,,,
110231,0,0,0,0,0,0,0,43,0.0,0.0,0.0,0.0,0.0,0.0,0.0,11,0,11,3.0,0.0,3.0
108066,1,1,0,0,0,1,2,169,1.0,1.0,0.0,0.0,0.0,1.0,2.0,8,1,7,1.0,1.0,0.0
9210209,0,0,0,0,0,0,0,1662,,,,,,,,1,0,1,,,
9410275,1,1,0,0,0,1,1,210,1.0,1.0,0.0,0.0,0.0,1.0,1.0,8,1,7,2.0,1.0,1.0
208274,0,0,0,0,0,0,0,131,0.0,0.0,0.0,0.0,0.0,0.0,0.0,7,0,7,3.0,0.0,3.0
302178,0,0,0,0,0,0,0,28,0.0,0.0,0.0,0.0,0.0,0.0,0.0,36,0,36,14.0,0.0,14.0
112331,2,2,0,0,0,2,5,306,1.0,1.0,0.0,0.0,0.0,1.0,3.0,20,2,18,4.0,1.0,3.0
109128,1,1,0,0,0,1,5,126,0.0,0.0,0.0,0.0,0.0,0.0,0.0,6,1,5,2.0,0.0,2.0
301199,0,0,0,0,0,0,0,122,0.0,0.0,0.0,0.0,0.0,0.0,0.0,15,0,15,10.0,0.0,10.0
9511472,0,0,0,0,0,0,0,281,0.0,0.0,0.0,0.0,0.0,0.0,0.0,10,0,10,3.0,0.0,3.0
9611464,0,0,0,0,0,0,0,113,,,,,,,,1,0,1,1.0,0.0,1.0
9167,1,1,0,0,0,1,5,121,1.0,1.0,0.0,0.0,0.0,1.0,3.0,9,1,8,4.0,0.0,4.0
202045,1,1,0,0,0,1,1,33,0.0,0.0,0.0,0.0,0.0,0.0,0.0,22,1,21,12.0,0.0,12.0
109131,0,0,0,0,0,0,0,23,,,,,,,,6,0,6,,,
8199,1,1,0,0,1,0,0,169,1.0,1.0,0.0,0.0,1.0,0.0,0.0,5,1,4,1.0,1.0,0.0
9311295,0,0,0,0,0,0,0,523,0.0,0.0,0.0,0.0,0.0,0.0,0.0,1,0,1,1.0,0.0,1.0
210124,1,1,0,0,1,0,0,258,0.0,0.0,0.0,0.0,0.0,0.0,0.0,12,1,11,1.0,0.0,1.0
11173,0,0,0,0,0,0,0,41,0.0,0.0,0.0,0.0,0.0,0.0,0.0,17,0,17,1.0,0.0,1.0
2270,1,1,0,0,0,1,3,167,0.0,0.0,0.0,0.0,0.0,0.0,0.0,11,1,10,5.0,0.0,5.0
209070,0,0,0,0,0,0,0,1646,,,,,,,,3,0,3,,,
12149,2,2,0,0,2,0,0,467,1.0,1.0,0.0,0.0,1.0,0.0,0.0,3,2,1,1.0,0.0,1.0
9610428,0,0,0,0,0,0,0,345,0.0,0.0,0.0,0.0,0.0,0.0,0.0,12,0,12,3.0,0.0,3.0
9911303,0,0,0,0,0,0,0,187,0.0,0.0,0.0,0.0,0.0,0.0,0.0,3,0,3,2.0,0.0,2.0
208047,0,0,0,0,0,0,0,562,0.0,0.0,0.0,0.0,0.0,0.0,0.0,2,0,2,1.0,0.0,1.0
9810373,2,2,0,0,2,0,0,233,1.0,1.0,0.0,0.0,1.0,0.0,0.0,2,2,0,1.0,1.0,0.0
9809469,0,0,0,0,0,0,0,999,,,,,,,,1,0,1,,,
301126,0,0,0,0,0,0,0,31,0.0,0.0,0.0,0.0,0.0,0.0,0.0,12,0,12,4.0,0.0,4.0
9704208,0,0,0,0,0,0,0,818,,,,,,,,3,0,3,,,
9905508,1,1,0,0,1,0,0,202,1.0,1.0,0.0,0.0,1.0,0.0,0.0,7,1,6,1.0,1.0,0.0
107326,0,0,0,0,0,0,0,163,0.0,0.0,0.0,0.0,0.0,0.0,0.0,8,0,8,6.0,0.0,6.0
9603246,1,1,0,0,0,1,1,94,1.0,1.0,0.0,0.0,0.0,1.0,1.0,3,1,2,,,
9810404,1,1,0,0,1,0,0,343,0.0,0.0,0.0,0.0,0.0,0.0,0.0,5,1,4,1.0,1.0,0.0
202278,0,0,0,0,0,0,0,243,0.0,0.0,0.0,0.0,0.0,0.0,0.0,9,0,9,1.0,0.0,1.0
9911462,1,1,0,0,1,0,0,143,1.0,1.0,0.0,0.0,1.0,0.0,0.0,7,1,6,1.0,1.0,0.0
302201,1,1,0,0,0,1,7,3,1.0,1.0,0.0,0.0,0.0,1.0,1.0,61,1,60,10.0,0.0,10.0
5150,0,0,0,0,0,0,0,246,0.0,0.0,0.0,0.0,0.0,0.0,0.0,4,0,4,2.0,0.0,2.0
9803332,0,0,0,0,0,0,0,116,0.0,0.0,0.0,0.0,0.0,0.0,0.0,4,0,4,,,
9912411,0,0,0,0,0,0,0,17,0.0,0.0,0.0,0.0,0.0,0.0,0.0,17,0,17,,,
8293,0,0,0,0,0,0,0,214,0.0,0.0,0.0,0.0,0.0,0.0,0.0,6,0,6,1.0,0.0,1.0
9310354,0,0,0,0,0,0,0,253,0.0,0.0,0.0,0.0,0.0,0.0,0.0,2,0,2,1.0,0.0,1.0
9206263,2,1,1,1,2,0,0,342,2.0,1.0,1.0,1.0,2.0,0.0,0.0,2,2,0,2.0,2.0,0.0
206274,0,0,0,0,0,0,0,268,0.0,0.0,0.0,0.0,0.0,0.0,0.0,3,0,3,3.0,0.0,3.0
9402272,0,0,0,0,0,0,0,155,0.0,0.0,0.0,0.0,0.0,0.0,0.0,2,0,2,1.0,0.0,1.0
110182,0,0,0,0,0,0,0,386,0.0,0.0,0.0,0.0,0.0,0.0,0.0,2,0,2,2.0,0.0,2.0
210317,0,0,0,0,0,0,0,34,0.0,0.0,0.0,0.0,0.0,0.0,0.0,26,0,26,13.0,0.0,13.0
202234,1,1,0,0,1,0,0,199,0.0,0.0,0.0,0.0,0.0,0.0,0.0,6,1,5,2.0,0.0,2.0
203095,0,0,0,0,0,0,0,168,0.0,0.0,0.0,0.0,0.0,0.0,0.0,14,0,14,4.0,0.0,4.0
9609433,1,1,0,0,0,1,1,490,1.0,1.0,0.0,0.0,0.0,1.0,1.0,3,1,2,2.0,1.0,1.0
301009,0,0,0,0,0,0,0,2,0.0,0.0,0.0,0.0,0.0,0.0,0.0,9,0,9,3.0,0.0,3.0
9906466,1,1,0,0,1,0,0,298,1.0,1.0,0.0,0.0,1.0,0.0,0.0,6,1,5,2.0,1.0,1.0
207199,1,1,0,0,0,1,2,103,0.0,0.0,0.0,0.0,0.0,0.0,0.0,4,1,3,2.0,0.0,2.0
9510242,1,1,0,0,1,0,0,803,1.0,1.0,0.0,0.0,1.0,0.0,0.0,1,1,0,1.0,1.0,0.0
9511296,0,0,0,0,0,0,0,124,0.0,0.0,0.0,0.0,0.0,0.0,0.0,10,0,10,2.0,0.0,2.0
9711247,0,0,0,0,0,0,0,271,0.0,0.0,0.0,0.0,0.0,0.0,0.0,1,0,1,1.0,0.0,1.0
106103,0,0,0,0,0,0,0,4,0.0,0.0,0.0,0.0,0.0,0.0,0.0,24,0,24,3.0,0.0,3.0
9902330,0,0,0,0,0,0,0,180,0.0,0.0,0.0,0.0,0.0,0.0,0.0,1,0,1,1.0,0.0,1.0
101058,0,0,0,0,0,0,0,244,0.0,0.0,0.0,0.0,0.0,0.0,0.0,14,0,14,4.0,0.0,4.0
9611407,0,0,0,0,0,0,0,1428,0.0,0.0,0.0,0.0,0.0,0.0,0.0,1,0,1,1.0,0.0,1.0
9907403,0,0,0,0,0,0,0,238,0.0,0.0,0.0,0.0,0.0,0.0,0.0,13,0,13,3.0,0.0,3.0
9803233,0,0,0,0,0,0,0,203,0.0,0.0,0.0,0.0,0.0,0.0,0.0,2,0,2,1.0,0.0,1.0
9712267,0,0,0,0,0,0,0,9,,,,,,,,5,0,5,,,
212200,0,0,0,0,0,0,0,187,0.0,0.0,0.0,0.0,0.0,0.0,0.0,3,0,3,2.0,0.0,2.0
107319,1,1,0,0,0,1,1,118,0.0,0.0,0.0,0.0,0.0,0.0,0.0,25,1,24,10.0,0.0,10.0
112357,0,0,0,0,0,0,0,104,0.0,0.0,0.0,0.0,0.0,0.0,0.0,12,0,12,8.0,0.0,8.0
212260,0,0,0,0,0,0,0,27,0.0,0.0,0.0,0.0,0.0,0.0,0.0,23,0,23,9.0,0.0,9.0
301104,0,0,0,0,0,0,0,23,0.0,0.0,0.0,0.0,0.0,0.0,0.0,31,0,31,18.0,0.0,18.0
111264,1,1,0,0,0,1,8,218,1.0,1.0,0.0,0.0,0.0,1.0,8.0,17,1,16,9.0,1.0,8.0
9605414,0,0,0,0,0,0,0,1152,,,,,,,,2,0,2,,,
106200,0,0,0,0,0,0,0,174,0.0,0.0,0.0,0.0,0.0,0.0,0.0,6,0,6,3.0,0.0,3.0
210168,0,0,0,0,0,0,0,30,0.0,0.0,0.0,0.0,0.0,0.0,0.0,16,0,16,9.0,0.0,9.0
9710383,0,0,0,0,0,0,0,1628,,,,,,,,1,0,1,,,
9411369,0,0,0,0,0,0,0,93,,,,,,,,1,0,1,,,
9803409,1,1,0,0,0,1,4,56,0.0,0.0,0.0,0.0,0.0,0.0,0.0,5,1,4,1.0,0.0,1.0
9709380,0,0,0,0,0,0,0,1687,,,,,,,,1,0,1,,,
9912495,0,0,0,0,0,0,0,12,0.0,0.0,0.0,0.0,0.0,0.0,0.0,25,0,25,3.0,0.0,3.0
211339,0,0,0,0,0,0,0,8,0.0,0.0,0.0,0.0,0.0,0.0,0.0,30,0,30,5.0,0.0,5.0
9510295,0,0,0,0,0,0,0,1087,,,,,,,,1,0,1,,,
9801256,0,0,0,0,0,0,0,331,0.0,0.0,0.0,0.0,0.0,0.0,0.0,1,0,1,1.0,0.0,1.0
1167,0,0,0,0,0,0,0,77,0.0,0.0,0.0,0.0,0.0,0.0,0.0,5,0,5,1.0,0.0,1.0
112048,1,1,0,0,0,1,5,1,1.0,1.0,0.0,0.0,0.0,1.0,5.0,26,1,25,11.0,0.0,11.0
9507214,1,1,0,0,0,1,7,19,0.0,0.0,0.0,0.0,0.0,0.0,0.0,11,1,10,9.0,1.0,8.0
9809236,0,0,0,0,0,0,0,238,0.0,0.0,0.0,0.0,0.0,0.0,0.0,7,0,7,2.0,0.0,2.0
9803474,0,0,0,0,0,0,0,141,0.0,0.0,0.0,0.0,0.0,0.0,0.0,3,0,3,2.0,0.0,2.0
110118,0,0,0,0,0,0,0,153,0.0,0.0,0.0,0.0,0.0,0.0,0.0,1,0,1,1.0,0.0,1.0
12281,0,0,0,0,0,0,0,16,0.0,0.0,0.0,0.0,0.0,0.0,0.0,16,0,16,7.0,0.0,7.0
212160,0,0,0,0,0,0,0,39,0.0,0.0,0.0,0.0,0.0,0.0,0.0,18,0,18,2.0,0.0,2.0
9501288,0,0,0,0,0,0,0,81,0.0,0.0,0.0,0.0,0.0,0.0,0.0,5,0,5,5.0,0.0,5.0
9911279,1,1,0,0,0,1,2,316,1.0,1.0,0.0,0.0,0.0,1.0,2.0,3,1,2,3.0,1.0,2.0
9807416,1,1,0,0,0,1,1,387,1.0,1.0,0.0,0.0,0.0,1.0,1.0,5,1,4,5.0,1.0,4.0
10109,0,0,0,0,0,0,0,210,0.0,0.0,0.0,0.0,0.0,0.0,0.0,5,0,5,2.0,0.0,2.0
301228,0,0,0,0,0,0,0,14,0.0,0.0,0.0,0.0,0.0,0.0,0.0,14,0,14,4.0,0.0,4.0
9811458,0,0,0,0,0,0,0,158,0.0,0.0,0.0,0.0,0.0,0.0,0.0,16,0,16,13.0,0.0,13.0
108133,2,2,0,0,1,1,1,13,0.0,0.0,0.0,0.0,0.0,0.0,0.0,35,2,33,4.0,0.0,4.0
9904391,2,2,0,0,0,2,4,180,2.0,2.0,0.0,0.0,0.0,2.0,4.0,12,2,10,7.0,1.0,6.0
203268,0,0,0,0,0,0,0,54,0.0,0.0,0.0,0.0,0.0,0.0,0.0,9,0,9,2.0,0.0,2.0
11371,0,0,0,0,0,0,0,90,0.0,0.0,0.0,0.0,0.0,0.0,0.0,5,0,5,3.0,0.0,3.0
103222,1,1,0,0,0,1,1,211,1.0,1.0,0.0,0.0,0.0,1.0,1.0,2,1,1,1.0,1.0,0.0
2256,0,0,0,0,0,0,0,21,0.0,0.0,0.0,0.0,0.0,0.0,0.0,8,0,8,,,
302112,0,0,0,0,0,0,0,108,0.0,0.0,0.0,0.0,0.0,0.0,0.0,27,0,27,14.0,0.0,14.0
9803436,0,0,0,0,0,0,0,311,0.0,0.0,0.0,0.0,0.0,0.0,0.0,4,0,4,,,
9705461,0,0,0,0,0,0,0,212,0.0,0.0,0.0,0.0,0.0,0.0,0.0,3,0,3,2.0,0.0,2.0
9607483,0,0,0,0,0,0,0,70,0.0,0.0,0.0,0.0,0.0,0.0,0.0,5,0,5,,,
9906364,0,0,0,0,0,0,0,333,0.0,0.0,0.0,0.0,0.0,0.0,0.0,4,0,4,1.0,0.0,1.0
207137,0,0,0,0,0,0,0,46,0.0,0.0,0.0,0.0,0.0,0.0,0.0,71,0,71,16.0,0.0,16.0
212032,0,0,0,0,0,0,0,80,0.0,0.0,0.0,0.0,0.0,0.0,0.0,19,0,19,1.0,0.0,1.0
9712375,2,1,1,1,2,0,0,365,1.0,1.0,0.0,0.0,1.0,0.0,0.0,3,2,1,1.0,0.0,1.0
9507399,0,0,0,0,0,0,0,49,0.0,0.0,0.0,0.0,0.0,0.0,0.0,6,0,6,5.0,0.0,5.0
212196,0,0,0,0,0,0,0,203,0.0,0.0,0.0,0.0,0.0,0.0,0.0,4,0,4,,,
9805330,0,0,0,0,0,0,0,216,0.0,0.0,0.0,0.0,0.0,0.0,0.0,4,0,4,,,
3244,1,1,0,0,0,1,13,57,1.0,1.0,0.0,0.0,0.0,1.0,11.0,15,1,14,11.0,1.0,10.0
9606328,0,0,0,0,0,0,0,199,0.0,0.0,0.0,0.0,0.0,0.0,0.0,2,0,2,1.0,0.0,1.0
205258,0,0,0,0,0,0,0,70,0.0,0.0,0.0,0.0,0.0,0.0,0.0,2,0,2,1.0,0.0,1.0
104212,0,0,0,0,0,0,0,725,0.0,0.0,0.0,0.0,0.0,0.0,0.0,1,0,1,1.0,0.0,1.0
104194,0,0,0,0,0,0,0,20,0.0,0.0,0.0,0.0,0.0,0.0,0.0,14,0,14,1.0,0.0,1.0
210059,0,0,0,0,0,0,0,249,0.0,0.0,0.0,0.0,0.0,0.0,0.0,3,0,3,3.0,0.0,3.0
9901251,0,0,0,0,0,0,0,103,0.0,0.0,0.0,0.0,0.0,0.0,0.0,6,0,6,3.0,0.0,3.0
205285,0,0,0,0,0,0,0,122,,,,,,,,2,0,2,,,
209088,0,0,0,0,0,0,0,3,0.0,0.0,0.0,0.0,0.0,0.0,0.0,18,0,18,6.0,0.0,6.0
9706254,0,0,0,0,0,0,0,1230,0.0,0.0,0.0,0.0,0.0,0.0,0.0,4,0,4,,,
9809534,0,0,0,0,0,0,0,527,0.0,0.0,0.0,0.0,0.0,0.0,0.0,3,0,3,3.0,0.0,3.0
202057,0,0,0,0,0,0,0,177,0.0,0.0,0.0,0.0,0.0,0.0,0.0,14,0,14,11.0,0.0,11.0
210277,1,1,0,0,0,1,5,9,1.0,1.0,0.0,0.0,0.0,1.0,4.0,14,1,13,2.0,0.0,2.0
9710274,0,0,0,0,0,0,0,5,0.0,0.0,0.0,0.0,0.0,0.0,0.0,5,0,5,1.0,0.0,1.0
205307,1,1,0,0,0,1,6,104,1.0,1.0,0.0,0.0,0.0,1.0,4.0,11,1,10,5.0,1.0,4.0
106271,0,0,0,0,0,0,0,569,0.0,0.0,0.0,0.0,0.0,0.0,0.0,2,0,2,2.0,0.0,2.0
9909277,0,0,0,0,0,0,0,832,,,,,,,,5,0,5,1.0,0.0,1.0
106041,0,0,0,0,0,0,0,105,0.0,0.0,0.0,0.0,0.0,0.0,0.0,3,0,3,,,
202060,0,0,0,0,0,0,0,187,,,,,,,,2,0,2,2.0,0.0,2.0
205005,0,0,0,0,0,0,0,18,0.0,0.0,0.0,0.0,0.0,0.0,0.0,20,0,20,9.0,0.0,9.0
9296,0,0,0,0,0,0,0,9,0.0,0.0,0.0,0.0,0.0,0.0,0.0,13,0,13,,,
9507272,0,0,0,0,0,0,0,16,0.0,0.0,0.0,0.0,0.0,0.0,0.0,7,0,7,1.0,0.0,1.0
207250,0,0,0,0,0,0,0,105,0.0,0.0,0.0,0.0,0.0,0.0,0.0,9,0,9,7.0,0.0,7.0
11039,0,0,0,0,0,0,0,13,0.0,0.0,0.0,0.0,0.0,0.0,0.0,18,0,18,9.0,0.0,9.0
9308357,0,0,0,0,0,0,0,1671,0.0,0.0,0.0,0.0,0.0,0.0,0.0,4,0,4,1.0,0.0,1.0
101339,0,0,0,0,0,0,0,62,0.0,0.0,0.0,0.0,0.0,0.0,0.0,31,0,31,7.0,0.0,7.0
9604379,0,0,0,0,0,0,0,61,0.0,0.0,0.0,0.0,0.0,0.0,0.0,22,0,22,1.0,0.0,1.0
212119,1,1,0,0,0,1,3,645,1.0,1.0,0.0,0.0,0.0,1.0,1.0,4,1,3,1.0,1.0,0.0
212320,1,1,0,0,0,1,2,167,1.0,1.0,0.0,0.0,0.0,1.0,1.0,9,1,8,6.0,1.0,5.0
302235,0,0,0,0,0,0,0,56,0.0,0.0,0.0,0.0,0.0,0.0,0.0,15,0,15,2.0,0.0,2.0
9609526,0,0,0,0,0,0,0,41,0.0,0.0,0.0,0.0,0.0,0.0,0.0,10,0,10,2.0,0.0,2.0
9511394,0,0,0,0,0,0,0,389,0.0,0.0,0.0,0.0,0.0,0.0,0.0,1,0,1,1.0,0.0,1.0
9910482,0,0,0,0,0,0,0,5,0.0,0.0,0.0,0.0,0.0,0.0,0.0,17,0,17,2.0,0.0,2.0
9709471,0,0,0,0,0,0,0,47,0.0,0.0,0.0,0.0,0.0,0.0,0.0,7,0,7,3.0,0.0,3.0
9608489,0,0,0,0,0,0,0,5,0.0,0.0,0.0,0.0,0.0,0.0,0.0,41,0,41,1.0,0.0,1.0
210064,0,0,0,0,0,0,0,113,0.0,0.0,0.0,0.0,0.0,0.0,0.0,9,0,9,4.0,0.0,4.0
9509302,0,0,0,0,0,0,0,1896,0.0,0.0,0.0,0.0,0.0,0.0,0.0,2,0,2,,,
102212,1,1,0,0,0,1,1,314,1.0,1.0,0.0,0.0,0.0,1.0,1.0,12,1,11,4.0,1.0,3.0
9501205,0,0,0,0,0,0,0,2105,,,,,,,,2,0,2,,,
9810483,0,0,0,0,0,0,0,1393,,,,,,,,1,0,1,,,
9907402,0,0,0,0,0,0,0,379,0.0,0.0,0.0,0.0,0.0,0.0,0.0,2,0,2,2.0,0.0,2.0
9607375,1,1,0,0,0,1,2,181,1.0,1.0,0.0,0.0,0.0,1.0,1.0,5,1,4,1.0,1.0,0.0
9056,0,0,0,0,0,0,0,224,0.0,0.0,0.0,0.0,0.0,0.0,0.0,4,0,4,3.0,0.0,3.0
9906531,0,0,0,0,0,0,0,139,0.0,0.0,0.0,0.0,0.0,0.0,0.0,7,0,7,6.0,0.0,6.0
9506414,0,0,0,0,0,0,0,98,,,,,,,,2,0,2,1.0,0.0,1.0
9808422,0,0,0,0,0,0,0,108,0.0,0.0,0.0,0.0,0.0,0.0,0.0,7,0,7,6.0,0.0,6.0
106117,0,0,0,0,0,0,0,229,0.0,0.0,0.0,0.0,0.0,0.0,0.0,3,0,3,2.0,0.0,2.0
4088,1,1,0,0,1,0,0,21,1.0,1.0,0.0,0.0,1.0,0.0,0.0,8,1,7,3.0,0.0,3.0
301069,1,1,0,0,0,1,8,19,1.0,1.0,0.0,0.0,0.0,1.0,8.0,15,1,14,1.0,0.0,1.0
9705371,0,0,0,0,0,0,0,1614,,,,,,,,2,0,2,,,
205222,0,0,0,0,0,0,0,15,0.0,0.0,0.0,0.0,0.0,0.0,0.0,10,0,10,2.0,0.0,2.0
210262,0,0,0,0,0,0,0,38,0.0,0.0,0.0,0.0,0.0,0.0,0.0,14,0,14,5.0,0.0,5.0
9507405,0,0,0,0,0,0,0,1,0.0,0.0,0.0,0.0,0.0,0.0,0.0,2,0,2,1.0,0.0,1.0
9506458,0,0,0,0,0,0,0,399,0.0,0.0,0.0,0.0,0.0,0.0,0.0,3,0,3,2.0,0.0,2.0
9904294,0,0,0,0,0,0,0,216,0.0,0.0,0.0,0.0,0.0,0.0,0.0,3,0,3,1.0,0.0,1.0
3211,0,0,0,0,0,0,0,43,0.0,0.0,0.0,0.0,0.0,0.0,0.0,9,0,9,3.0,0.0,3.0
210253,0,0,0,0,0,0,0,4,0.0,0.0,0.0,0.0,0.0,0.0,0.0,18,0,18,2.0,0.0,2.0
9711271,0,0,0,0,0,0,0,88,0.0,0.0,0.0,0.0,0.0,0.0,0.0,5,0,5,2.0,0.0,2.0
9809375,0,0,0,0,0,0,0,73,0.0,0.0,0.0,0.0,0.0,0.0,0.0,15,0,15,1.0,0.0,1.0
4082,0,0,0,0,0,0,0,421,0.0,0.0,0.0,0.0,0.0,0.0,0.0,6,0,6,2.0,0.0,2.0
11381,0,0,0,0,0,0,0,80,0.0,0.0,0.0,0.0,0.0,0.0,0.0,14,0,14,3.0,0.0,3.0
211201,0,0,0,0,0,0,0,27,0.0,0.0,0.0,0.0,0.0,0.0,0.0,10,0,10,2.0,0.0,2.0
1210,0,0,0,0,0,0,0,148,0.0,0.0,0.0,0.0,0.0,0.0,0.0,3,0,3,1.0,0.0,1.0
212247,0,0,0,0,0,0,0,109,0.0,0.0,0.0,0.0,0.0,0.0,0.0,6,0,6,,,
9509219,0,0,0,0,0,0,0,353,0.0,0.0,0.0,0.0,0.0,0.0,0.0,1,0,1,1.0,0.0,1.0
210036,0,0,0,0,0,0,0,18,0.0,0.0,0.0,0.0,0.0,0.0,0.0,31,0,31,9.0,0.0,9.0
209319,0,0,0,0,0,0,0,1712,,,,,,,,1,0,1,,,
211238,0,0,0,0,0,0,0,15,0.0,0.0,0.0,0.0,0.0,0.0,0.0,24,0,24,8.0,0.0,8.0
211427,0,0,0,0,0,0,0,32,0.0,0.0,0.0,0.0,0.0,0.0,0.0,23,0,23,3.0,0.0,3.0
204103,0,0,0,0,0,0,0,1708,,,,,,,,1,0,1,,,
12343,0,0,0,0,0,0,0,1318,,,,,,,,1,0,1,,,
9605274,0,0,0,0,0,0,0,8,0.0,0.0,0.0,0.0,0.0,0.0,0.0,8,0,8,1.0,0.0,1.0
110116,0,0,0,0,0,0,0,391,0.0,0.0,0.0,0.0,0.0,0.0,0.0,3,0,3,1.0,0.0,1.0
9405415,0,0,0,0,0,0,0,483,0.0,0.0,0.0,0.0,0.0,0.0,0.0,1,0,1,1.0,0.0,1.0
9405397,0,0,0,0,0,0,0,1116,0.0,0.0,0.0,0.0,0.0,0.0,0.0,1,0,1,,,
9502274,4,3,1,1,4,0,0,491,1.0,1.0,0.0,0.0,1.0,0.0,0.0,4,4,0,1.0,1.0,0.0
9501265,87,6,81,503,29,58,222,34,42.0,4.0,38.0,291.0,1.0,41.0,146.0,95,87,8,33.0,28.0,5.0
7136,6,3,3,4,1,5,19,1,0.0,0.0,0.0,0.0,0.0,0.0,0.0,21,6,15,4.0,0.0,4.0
9607447,83,9,74,426,20,63,185,1,29.0,4.0,25.0,100.0,5.0,24.0,50.0,93,83,10,24.0,20.0,4.0
9207214,301,27,274,3049,301,0,0,6,152.0,11.0,141.0,1804.0,152.0,0.0,0.0,301,301,0,45.0,45.0,0.0
9402347,50,9,41,156,12,38,139,58,12.0,5.0,7.0,8.0,2.0,10.0,15.0,59,50,9,10.0,9.0,1.0
9503414,35,18,17,26,12,23,79,6,1.0,1.0,0.0,0.0,0.0,1.0,1.0,78,35,43,3.0,1.0,2.0
9612262,20,7,13,22,1,19,88,7,1.0,1.0,0.0,0.0,0.0,1.0,13.0,108,20,88,7.0,0.0,7.0
9908520,14,5,9,10,4,10,27,1,1.0,1.0,0.0,0.0,1.0,0.0,0.0,32,14,18,2.0,1.0,1.0
8151,10,7,3,6,2,8,67,2,1.0,1.0,0.0,0.0,0.0,1.0,16.0,33,10,23,3.0,3.0,0.0
9709382,26,5,21,39,16,10,11,299,9.0,5.0,4.0,6.0,4.0,5.0,5.0,29,26,3,9.0,8.0,1.0
301097,0,0,0,0,0,0,0,4,0.0,0.0,0.0,0.0,0.0,0.0,0.0,27,0,27,4.0,0.0,4.0
9407408,49,8,41,164,29,20,23,33,12.0,1.0,11.0,23.0,5.0,7.0,7.0,53,49,4,12.0,11.0,1.0
9508343,312,21,291,2345,140,172,471,4,97.0,4.0,93.0,1048.0,20.0,77.0,239.0,320,312,8,61.0,56.0,5.0
9504426,70,17,53,172,13,57,97,35,33.0,3.0,30.0,111.0,3.0,30.0,50.0,78,70,8,10.0,9.0,1.0
9705234,65,2,63,407,8,57,304,43,42.0,1.0,41.0,296.0,3.0,39.0,191.0,107,65,42,45.0,29.0,16.0
1048,8,4,4,4,2,6,19,33,2.0,2.0,0.0,0.0,0.0,2.0,5.0,27,8,19,3.0,1.0,2.0
9403366,51,4,47,147,38,13,21,33,17.0,4.0,13.0,40.0,17.0,0.0,0.0,54,51,3,5.0,5.0,0.0
9605369,2,2,0,0,0,2,4,281,1.0,1.0,0.0,0.0,0.0,1.0,2.0,12,2,10,4.0,1.0,3.0
9705341,33,5,28,80,2,31,193,48,18.0,3.0,15.0,39.0,1.0,17.0,59.0,71,33,38,19.0,10.0,9.0
9804343,11,4,7,13,1,10,37,33,7.0,2.0,5.0,9.0,0.0,7.0,21.0,34,11,23,9.0,0.0,9.0
9903212,2,1,1,1,0,2,2,61,0.0,0.0,0.0,0.0,0.0,0.0,0.0,9,2,7,6.0,0.0,6.0
108245,9,2,7,15,0,9,138,4,5.0,2.0,3.0,3.0,0.0,5.0,71.0,71,9,62,25.0,0.0,25.0
7020,4,4,0,0,1,3,15,26,1.0,1.0,0.0,0.0,0.0,1.0,3.0,12,4,8,4.0,1.0,3.0
9210231,24,9,15,31,24,0,0,26,10.0,6.0,4.0,7.0,10.0,0.0,0.0,24,24,0,2.0,2.0,0.0
9603311,46,7,39,127,17,29,71,26,29.0,4.0,25.0,99.0,7.0,22.0,52.0,54,46,8,19.0,16.0,3.0
9809523,19,13,6,13,5,14,41,26,4.0,3.0,1.0,2.0,0.0,4.0,17.0,37,19,18,5.0,2.0,3.0
9702393,50,7,43,151,7,43,175,71,8.0,1.0,7.0,15.0,0.0,8.0,60.0,82,50,32,16.0,7.0,9.0
9204211,84,23,61,231,84,0,0,35,28.0,5.0,23.0,83.0,28.0,0.0,0.0,84,84,0,11.0,11.0,0.0
9512278,12,4,8,12,0,12,35,10,5.0,3.0,2.0,3.0,0.0,5.0,18.0,21,12,9,9.0,5.0,4.0
9703444,25,3,22,65,8,17,50,36,14.0,1.0,13.0,32.0,6.0,8.0,13.0,34,25,9,2.0,2.0,0.0
9307342,74,22,52,120,74,0,0,4,22.0,4.0,18.0,39.0,22.0,0.0,0.0,74,74,0,13.0,13.0,0.0
102023,14,6,8,10,4,10,35,93,2.0,2.0,0.0,0.0,0.0,2.0,10.0,22,14,8,3.0,2.0,1.0
112286,4,4,0,0,2,2,5,35,0.0,0.0,0.0,0.0,0.0,0.0,0.0,16,4,12,2.0,0.0,2.0
208036,2,1,1,1,0,2,3,4,0.0,0.0,0.0,0.0,0.0,0.0,0.0,23,2,21,4.0,0.0,4.0
9906242,3,3,0,0,0,3,6,20,1.0,1.0,0.0,0.0,1.0,0.0,0.0,7,3,4,,,
9311307,9,4,5,6,3,6,8,358,6.0,2.0,4.0,5.0,0.0,6.0,7.0,13,9,4,5.0,3.0,2.0
9211247,31,13,18,32,31,0,0,53,6.0,3.0,3.0,3.0,6.0,0.0,0.0,31,31,0,3.0,3.0,0.0
9609432,1,1,0,0,0,1,4,25,1.0,1.0,0.0,0.0,0.0,1.0,4.0,5,1,4,,,
9503320,13,6,7,13,10,3,4,204,5.0,1.0,4.0,4.0,5.0,0.0,0.0,18,13,5,2.0,2.0,0.0
9304299,141,12,129,790,127,14,14,5,45.0,5.0,40.0,251.0,45.0,0.0,0.0,143,141,2,27.0,27.0,0.0
9403338,260,25,235,1835,103,157,258,3,73.0,6.0,67.0,453.0,30.0,43.0,61.0,265,260,5,36.0,35.0,1.0
9309240,14,6,8,21,11,3,6,3,3.0,2.0,1.0,1.0,3.0,0.0,0.0,18,14,4,3.0,3.0,0.0
9509379,76,12,64,329,48,28,61,32,8.0,4.0,4.0,8.0,0.0,8.0,16.0,85,76,9,7.0,7.0,0.0
9812460,1,1,0,0,0,1,1,144,1.0,1.0,0.0,0.0,0.0,1.0,1.0,2,1,1,2.0,1.0,1.0
9703351,81,3,78,705,22,59,131,0,60.0,1.0,59.0,551.0,16.0,44.0,94.0,87,81,6,48.0,45.0,3.0
9808296,89,7,82,538,0,89,623,3,59.0,1.0,58.0,384.0,0.0,59.0,423.0,128,89,39,50.0,34.0,16.0
9304271,16,4,12,39,16,0,0,0,11.0,1.0,10.0,34.0,11.0,0.0,0.0,16,16,0,4.0,4.0,0.0
9402229,46,14,32,113,5,41,102,3,19.0,5.0,14.0,73.0,3.0,16.0,31.0,50,46,4,12.0,9.0,3.0
9904465,19,5,14,24,6,13,20,0,3.0,2.0,1.0,1.0,1.0,2.0,3.0,23,19,4,1.0,1.0,0.0
9807308,9,3,6,11,0,9,90,3,4.0,3.0,1.0,1.0,0.0,4.0,32.0,42,9,33,14.0,2.0,12.0
9904303,21,6,15,36,1,20,70,3,7.0,1.0,6.0,18.0,7.0,0.0,0.0,40,21,19,6.0,1.0,5.0
9206228,8,5,3,4,8,0,0,581,7.0,4.0,3.0,4.0,7.0,0.0,0.0,8,8,0,6.0,6.0,0.0
9806408,4,3,1,1,1,3,15,28,3.0,2.0,1.0,1.0,0.0,3.0,11.0,34,4,30,13.0,3.0,10.0
9902261,7,3,4,6,1,6,15,3,1.0,1.0,0.0,0.0,0.0,1.0,3.0,29,7,22,4.0,1.0,3.0
9807315,21,6,15,48,12,9,29,3,4.0,1.0,3.0,4.0,0.0,4.0,12.0,31,21,10,7.0,4.0,3.0
9812403,13,6,7,13,0,13,56,0,1.0,1.0,0.0,0.0,0.0,1.0,1.0,42,13,29,6.0,6.0,0.0
9406351,18,4,14,30,13,5,5,3,10.0,1.0,9.0,18.0,10.0,0.0,0.0,20,18,2,5.0,5.0,0.0
9906275,32,5,27,118,0,32,509,0,25.0,3.0,22.0,97.0,0.0,25.0,415.0,86,32,54,44.0,13.0,31.0
9504287,40,10,30,128,31,9,11,0,12.0,3.0,9.0,23.0,10.0,2.0,2.0,42,40,2,9.0,9.0,0.0
9807475,6,3,3,3,4,2,8,431,1.0,1.0,0.0,0.0,1.0,0.0,0.0,13,6,7,3.0,0.0,3.0
9901316,7,3,4,6,5,2,26,0,2.0,2.0,0.0,0.0,0.0,2.0,26.0,21,7,14,3.0,2.0,1.0
9910506,12,10,2,2,2,10,40,18,2.0,2.0,0.0,0.0,0.0,2.0,8.0,48,12,36,13.0,2.0,11.0
9807341,2,2,0,0,0,2,6,81,2.0,2.0,0.0,0.0,0.0,2.0,6.0,10,2,8,6.0,1.0,5.0
9504244,16,7,9,22,8,8,16,172,5.0,2.0,3.0,8.0,0.0,5.0,5.0,20,16,4,7.0,6.0,1.0
9712446,6,3,3,4,0,6,12,81,0.0,0.0,0.0,0.0,0.0,0.0,0.0,18,6,12,2.0,0.0,2.0
9605377,30,2,28,96,3,27,181,3,13.0,2.0,11.0,19.0,0.0,13.0,103.0,50,30,20,24.0,11.0,13.0
9606388,139,15,124,1093,4,135,656,12,91.0,2.0,89.0,845.0,1.0,90.0,345.0,202,139,63,51.0,46.0,5.0
9603222,9,8,1,1,3,6,17,87,2.0,2.0,0.0,0.0,2.0,0.0,0.0,14,9,5,1.0,1.0,0.0
9403212,23,10,13,35,2,21,37,10,11.0,4.0,7.0,19.0,2.0,9.0,11.0,27,23,4,2.0,2.0,0.0
9707311,8,5,3,3,3,5,25,81,4.0,3.0,1.0,1.0,1.0,3.0,9.0,30,8,22,7.0,2.0,5.0
9511239,27,10,17,46,8,19,34,3,12.0,3.0,9.0,24.0,2.0,10.0,17.0,33,27,6,14.0,12.0,2.0
9710434,27,20,7,8,11,16,90,36,2.0,1.0,1.0,1.0,0.0,2.0,38.0,106,27,79,33.0,2.0,31.0
9602391,11,9,2,2,1,10,45,10,4.0,3.0,1.0,1.0,0.0,4.0,9.0,29,11,18,8.0,3.0,5.0
9211204,69,12,57,375,69,0,0,12,26.0,4.0,22.0,162.0,26.0,0.0,0.0,69,69,0,8.0,8.0,0.0
9701381,37,8,29,71,15,22,45,12,12.0,4.0,8.0,17.0,2.0,10.0,24.0,47,37,10,14.0,9.0,5.0
9405428,34,2,32,125,26,8,13,10,15.0,1.0,14.0,46.0,15.0,0.0,0.0,37,34,3,12.0,12.0,0.0
110022,12,9,3,3,0,12,84,1,7.0,5.0,2.0,2.0,0.0,7.0,49.0,42,12,30,9.0,2.0,7.0
9907341,34,4,30,177,28,6,8,34,26.0,3.0,23.0,162.0,26.0,0.0,0.0,39,34,5,8.0,8.0,0.0
9801298,30,8,22,42,0,30,89,58,9.0,1.0,8.0,11.0,0.0,9.0,24.0,41,30,11,10.0,5.0,5.0
9806347,4,1,3,4,0,4,16,1,1.0,1.0,0.0,0.0,1.0,0.0,0.0,13,4,9,3.0,1.0,2.0
102122,164,17,147,1413,43,121,594,23,78.0,5.0,73.0,971.0,27.0,51.0,232.0,208,164,44,45.0,36.0,9.0
2235,20,5,15,43,0,20,195,34,19.0,4.0,15.0,43.0,0.0,19.0,194.0,37,20,17,32.0,15.0,17.0
9912294,8,6,2,3,5,3,6,67,1.0,1.0,0.0,0.0,1.0,0.0,0.0,18,8,10,4.0,0.0,4.0
9910396,20,5,15,53,2,18,78,34,15.0,3.0,12.0,43.0,1.0,14.0,61.0,44,20,24,12.0,7.0,5.0
9608243,9,3,6,9,4,5,13,158,7.0,3.0,4.0,6.0,7.0,0.0,0.0,12,9,3,3.0,3.0,0.0
9704206,21,5,16,37,0,21,77,5,12.0,3.0,9.0,20.0,1.0,11.0,43.0,37,21,16,2.0,1.0,1.0
5292,16,10,6,8,1,15,103,3,6.0,5.0,1.0,2.0,0.0,6.0,32.0,50,16,34,6.0,4.0,2.0
9205202,33,16,17,33,33,0,0,32,5.0,3.0,2.0,3.0,5.0,0.0,0.0,33,33,0,5.0,5.0,0.0
9511256,23,5,18,60,2,21,81,33,17.0,3.0,14.0,45.0,0.0,17.0,58.0,36,23,13,16.0,11.0,5.0
10089,19,5,14,20,15,4,4,257,7.0,3.0,4.0,7.0,5.0,2.0,2.0,20,19,1,5.0,5.0,0.0
5089,27,5,22,36,8,19,43,74,7.0,1.0,6.0,13.0,1.0,6.0,13.0,37,27,10,6.0,4.0,2.0
9305304,29,10,19,44,4,25,49,6,16.0,5.0,11.0,22.0,5.0,11.0,18.0,36,29,7,3.0,2.0,1.0
9605264,100,11,89,357,41,59,146,9,24.0,5.0,19.0,61.0,6.0,18.0,42.0,110,100,10,18.0,15.0,3.0
9609512,76,12,64,336,8,68,314,7,22.0,7.0,15.0,51.0,1.0,21.0,68.0,111,76,35,20.0,3.0,17.0
9701238,71,13,58,208,9,62,236,29,26.0,4.0,22.0,78.0,0.0,26.0,75.0,98,71,27,21.0,17.0,4.0
9910297,2,2,0,0,0,2,8,1,1.0,1.0,0.0,0.0,0.0,1.0,1.0,10,2,8,1.0,0.0,1.0
9804274,25,5,20,85,1,24,171,7,18.0,3.0,15.0,56.0,0.0,18.0,113.0,54,25,29,25.0,17.0,8.0
9807430,6,1,5,8,0,6,6,313,6.0,1.0,5.0,8.0,0.0,6.0,6.0,9,6,3,7.0,6.0,1.0
9803422,3,3,0,0,0,3,12,114,1.0,1.0,0.0,0.0,0.0,1.0,5.0,31,3,28,12.0,1.0,11.0
6301,1,1,0,0,0,1,3,31,0.0,0.0,0.0,0.0,0.0,0.0,0.0,6,1,5,2.0,0.0,2.0
9608205,111,7,104,666,14,97,405,21,44.0,3.0,41.0,244.0,6.0,38.0,180.0,127,111,16,33.0,25.0,8.0
9501276,26,5,21,73,26,0,0,7,21.0,3.0,18.0,67.0,21.0,0.0,0.0,29,26,3,16.0,16.0,0.0
9312258,30,10,20,36,3,27,53,29,8.0,5.0,3.0,5.0,0.0,8.0,8.0,34,30,4,5.0,5.0,0.0
9704268,23,6,17,44,2,21,129,7,8.0,2.0,6.0,16.0,0.0,8.0,46.0,44,23,21,16.0,8.0,8.0
9805217,100,5,95,697,15,85,134,2,52.0,1.0,51.0,503.0,8.0,44.0,53.0,106,100,6,36.0,35.0,1.0
9607401,46,4,42,313,25,21,30,12,39.0,2.0,37.0,284.0,18.0,21.0,30.0,49,46,3,35.0,35.0,0.0
9601293,42,9,33,71,4,38,182,61,12.0,2.0,10.0,24.0,0.0,12.0,92.0,75,42,33,18.0,8.0,10.0
9306318,24,5,19,52,23,1,1,32,14.0,2.0,12.0,37.0,14.0,0.0,0.0,25,24,1,2.0,2.0,0.0
9711460,32,7,25,69,2,30,126,98,19.0,5.0,14.0,28.0,0.0,19.0,96.0,45,32,13,16.0,10.0,6.0
9808492,2,2,0,0,0,2,2,76,,,,,,,,3,2,1,2.0,1.0,1.0
9804296,28,12,16,27,6,22,59,19,8.0,3.0,5.0,6.0,0.0,8.0,23.0,48,28,20,4.0,3.0,1.0
9403226,71,7,64,665,19,52,122,19,54.0,1.0,53.0,597.0,13.0,41.0,69.0,78,71,7,33.0,33.0,0.0
9702424,32,8,24,105,5,27,227,19,20.0,3.0,17.0,88.0,0.0,20.0,151.0,59,32,27,15.0,4.0,11.0
9805424,54,5,49,293,1,53,313,24,37.0,2.0,35.0,216.0,0.0,37.0,208.0,75,54,21,38.0,27.0,11.0
9909495,5,4,1,1,0,5,26,24,0.0,0.0,0.0,0.0,0.0,0.0,0.0,18,5,13,5.0,1.0,4.0
9504374,74,18,56,213,67,7,7,47,14.0,3.0,11.0,30.0,14.0,0.0,0.0,76,74,2,10.0,10.0,0.0
9409362,24,5,19,81,5,19,19,11,14.0,3.0,11.0,55.0,0.0,14.0,14.0,25,24,1,13.0,12.0,1.0
9608401,66,2,64,273,59,7,7,16,31.0,1.0,30.0,146.0,31.0,0.0,0.0,67,66,1,24.0,24.0,0.0
9611432,7,2,5,7,2,5,11,30,1.0,1.0,0.0,0.0,0.0,1.0,2.0,11,7,4,6.0,3.0,3.0
9807480,44,2,42,254,3,41,151,4,34.0,2.0,32.0,192.0,3.0,31.0,74.0,56,44,12,31.0,28.0,3.0
9706339,39,1,38,204,6,33,126,30,31.0,1.0,30.0,179.0,3.0,28.0,102.0,47,39,8,30.0,24.0,6.0
9905443,50,8,42,207,0,50,352,4,23.0,2.0,21.0,88.0,2.0,21.0,91.0,101,50,51,25.0,19.0,6.0
9812415,22,5,17,38,1,21,71,39,10.0,2.0,8.0,18.0,8.0,2.0,2.0,57,22,35,4.0,4.0,0.0
9305247,31,19,12,20,31,0,0,44,7.0,2.0,5.0,10.0,7.0,0.0,0.0,31,31,0,3.0,3.0,0.0
9705230,18,9,9,17,1,17,50,31,4.0,1.0,3.0,5.0,0.0,4.0,14.0,27,18,9,9.0,4.0,5.0
9703437,47,1,46,166,6,41,225,6,29.0,1.0,28.0,93.0,1.0,28.0,175.0,64,47,17,11.0,10.0,1.0
9311254,5,3,2,3,5,0,0,113,2.0,2.0,0.0,0.0,2.0,0.0,0.0,5,5,0,3.0,3.0,0.0
9610543,20,5,15,64,0,20,115,6,9.0,4.0,5.0,12.0,0.0,9.0,72.0,38,20,18,17.0,15.0,2.0
9507425,20,4,16,41,4,16,38,85,10.0,1.0,9.0,27.0,10.0,0.0,0.0,26,20,6,8.0,5.0,3.0
9512395,11,4,7,10,2,9,59,6,5.0,1.0,4.0,6.0,0.0,5.0,25.0,45,11,34,4.0,0.0,4.0
7343,1,1,0,0,0,1,2,96,0.0,0.0,0.0,0.0,0.0,0.0,0.0,6,1,5,2.0,1.0,1.0
9403383,77,13,64,187,24,53,91,14,24.0,6.0,18.0,55.0,5.0,19.0,28.0,83,77,6,9.0,8.0,1.0
105340,1,1,0,0,0,1,5,348,1.0,1.0,0.0,0.0,0.0,1.0,3.0,6,1,5,4.0,1.0,3.0
106141,8,1,7,19,0,8,33,38,6.0,1.0,5.0,11.0,0.0,6.0,13.0,20,8,12,10.0,7.0,3.0
9712280,14,5,9,19,2,12,21,22,7.0,2.0,5.0,7.0,0.0,7.0,12.0,17,14,3,7.0,5.0,2.0
9802442,20,8,12,24,6,14,43,45,9.0,3.0,6.0,12.0,1.0,8.0,11.0,31,20,11,12.0,8.0,4.0
7109,25,11,14,36,2,23,158,38,14.0,4.0,10.0,20.0,0.0,14.0,103.0,44,25,19,19.0,9.0,10.0
1216,16,4,12,18,0,16,127,22,7.0,3.0,4.0,5.0,0.0,7.0,92.0,43,16,27,27.0,6.0,21.0
9610415,49,4,45,161,15,34,85,22,23.0,3.0,20.0,81.0,4.0,19.0,43.0,57,49,8,13.0,10.0,3.0
9912307,9,1,8,13,0,9,43,22,6.0,1.0,5.0,7.0,0.0,6.0,39.0,20,9,11,15.0,5.0,10.0
9602266,3,2,1,1,1,2,6,203,2.0,1.0,1.0,1.0,1.0,1.0,1.0,13,3,10,5.0,2.0,3.0
9409273,5,3,2,2,4,1,1,25,1.0,1.0,0.0,0.0,0.0,1.0,1.0,6,5,1,1.0,1.0,0.0
3141,6,4,2,3,1,5,53,21,5.0,3.0,2.0,3.0,0.0,5.0,53.0,23,6,17,19.0,5.0,14.0
9703422,25,11,14,24,0,25,139,40,10.0,5.0,5.0,7.0,0.0,10.0,66.0,49,25,24,19.0,6.0,13.0
8191,15,3,12,39,1,14,59,66,10.0,1.0,9.0,30.0,0.0,10.0,26.0,25,15,10,12.0,10.0,2.0
9604313,69,5,64,352,23,46,269,43,34.0,1.0,33.0,199.0,7.0,27.0,149.0,91,69,22,31.0,22.0,9.0
9806484,42,5,37,156,0,42,212,43,25.0,2.0,23.0,87.0,0.0,25.0,145.0,59,42,17,18.0,11.0,7.0
9905518,6,3,3,3,3,3,8,77,0.0,0.0,0.0,0.0,0.0,0.0,0.0,15,6,9,,,
9505404,30,9,21,73,23,7,10,43,11.0,2.0,9.0,34.0,11.0,0.0,0.0,33,30,3,2.0,2.0,0.0
9612398,65,3,62,322,2,63,179,39,45.0,2.0,43.0,218.0,2.0,43.0,106.0,78,65,13,37.0,32.0,5.0
9409433,24,3,21,65,24,0,0,28,4.0,3.0,1.0,1.0,4.0,0.0,0.0,24,24,0,3.0,3.0,0.0
107024,7,3,4,7,0,7,67,20,7.0,3.0,4.0,7.0,0.0,7.0,67.0,23,7,16,3.0,1.0,2.0
3327,9,1,8,13,0,9,124,20,8.0,1.0,7.0,12.0,0.0,8.0,121.0,29,9,20,26.0,7.0,19.0
9209269,55,18,37,165,55,0,0,6,27.0,6.0,21.0,103.0,27.0,0.0,0.0,55,55,0,2.0,2.0,0.0
9406300,32,5,27,67,3,29,49,29,12.0,1.0,11.0,27.0,1.0,11.0,11.0,38,32,6,12.0,11.0,1.0
9910225,46,5,41,213,0,46,629,20,41.0,3.0,38.0,203.0,0.0,41.0,586.0,75,46,29,58.0,31.0,27.0
9902419,11,4,7,13,3,8,70,90,6.0,1.0,5.0,11.0,2.0,4.0,24.0,49,11,38,15.0,1.0,14.0
107003,4,1,3,4,0,4,29,20,4.0,1.0,3.0,4.0,0.0,4.0,29.0,27,4,23,6.0,4.0,2.0
9602375,64,27,37,65,59,5,7,54,8.0,2.0,6.0,8.0,8.0,0.0,0.0,70,64,6,7.0,7.0,0.0
210134,3,2,1,1,0,3,18,37,1.0,1.0,0.0,0.0,0.0,1.0,4.0,18,3,15,4.0,0.0,4.0
9402311,1,1,0,0,1,0,0,143,1.0,1.0,0.0,0.0,1.0,0.0,0.0,5,1,4,1.0,1.0,0.0
9510377,25,8,17,40,2,23,195,6,12.0,3.0,9.0,22.0,0.0,12.0,149.0,66,25,41,26.0,8.0,18.0
9801449,13,4,9,21,0,13,30,18,7.0,3.0,4.0,10.0,0.0,7.0,11.0,18,13,5,10.0,8.0,2.0
9312248,54,13,41,139,54,0,0,18,14.0,9.0,5.0,6.0,14.0,0.0,0.0,55,54,1,10.0,10.0,0.0
9810457,172,14,158,1581,15,157,562,32,103.0,7.0,96.0,1153.0,3.0,100.0,421.0,183,172,11,63.0,56.0,7.0
9511350,15,7,8,15,2,13,23,5,9.0,4.0,5.0,9.0,0.0,9.0,14.0,25,15,10,2.0,1.0,1.0
8058,29,4,25,83,0,29,77,73,22.0,3.0,19.0,61.0,0.0,22.0,61.0,34,29,5,14.0,13.0,1.0
9503233,26,6,20,56,7,19,27,99,14.0,5.0,9.0,21.0,3.0,11.0,15.0,30,26,4,13.0,11.0,2.0
9707273,26,4,22,64,0,26,107,42,17.0,3.0,14.0,38.0,1.0,16.0,67.0,41,26,15,11.0,5.0,6.0
9705201,33,5,28,128,1,32,278,15,27.0,5.0,22.0,118.0,0.0,27.0,252.0,51,33,18,34.0,19.0,15.0
9606429,28,5,23,97,13,15,27,30,17.0,3.0,14.0,71.0,9.0,8.0,8.0,32,28,4,12.0,11.0,1.0
9306319,29,11,18,49,10,19,27,4,17.0,6.0,11.0,34.0,5.0,12.0,18.0,31,29,2,8.0,7.0,1.0
9406258,37,4,33,202,7,30,31,71,31.0,1.0,30.0,187.0,5.0,26.0,26.0,39,37,2,26.0,25.0,1.0
9510349,4,3,1,1,3,1,1,87,0.0,0.0,0.0,0.0,0.0,0.0,0.0,8,4,4,2.0,0.0,2.0
9507461,34,4,30,142,10,24,144,61,13.0,1.0,12.0,32.0,1.0,12.0,31.0,61,34,27,23.0,16.0,7.0
9902270,9,1,8,23,0,9,51,4,5.0,1.0,4.0,8.0,0.0,5.0,14.0,20,9,11,11.0,6.0,5.0
9904404,136,14,122,832,12,124,510,11,84.0,5.0,79.0,676.0,3.0,81.0,406.0,147,136,11,63.0,57.0,6.0
9606280,69,11,58,243,14,55,127,11,30.0,2.0,28.0,143.0,15.0,15.0,15.0,85,69,16,7.0,4.0,3.0
9501269,39,3,36,169,39,0,0,82,33.0,1.0,32.0,160.0,33.0,0.0,0.0,39,39,0,22.0,22.0,0.0
9806293,25,9,16,31,4,21,52,18,6.0,2.0,4.0,6.0,3.0,3.0,4.0,37,25,12,5.0,5.0,0.0
9502259,7,4,3,3,4,3,8,29,2.0,1.0,1.0,1.0,0.0,2.0,5.0,16,7,9,2.0,1.0,1.0
9209207,9,4,5,8,9,0,0,41,3.0,2.0,1.0,1.0,3.0,0.0,0.0,9,9,0,3.0,3.0,0.0
9903387,24,15,9,23,7,17,48,48,0.0,0.0,0.0,0.0,0.0,0.0,0.0,94,24,70,10.0,0.0,10.0
9505422,96,26,70,220,87,9,19,110,23.0,3.0,20.0,44.0,15.0,8.0,18.0,99,96,3,15.0,15.0,0.0
9305344,6,4,2,3,5,1,1,583,2.0,2.0,0.0,0.0,2.0,0.0,0.0,7,6,1,2.0,2.0,0.0
9406243,1,1,0,0,1,0,0,49,,,,,,,,2,1,1,,,
9703408,2,1,1,1,2,0,0,631,1.0,1.0,0.0,0.0,1.0,0.0,0.0,5,2,3,2.0,0.0,2.0
208177,47,12,35,60,18,29,198,23,19.0,6.0,13.0,21.0,0.0,19.0,149.0,83,47,36,25.0,7.0,18.0
9801305,10,4,6,15,0,10,18,89,6.0,2.0,4.0,8.0,0.0,6.0,11.0,14,10,4,2.0,0.0,2.0
9504306,49,15,34,126,27,22,61,74,19.0,6.0,13.0,31.0,19.0,0.0,0.0,55,49,6,11.0,11.0,0.0
9512337,17,9,8,12,7,10,26,18,2.0,2.0,0.0,0.0,0.0,2.0,6.0,25,17,8,6.0,3.0,3.0
9510309,136,7,129,960,26,110,284,55,74.0,3.0,71.0,555.0,6.0,68.0,192.0,146,136,10,49.0,44.0,5.0
9803354,6,3,3,6,1,5,20,5,3.0,2.0,1.0,2.0,2.0,1.0,1.0,29,6,23,1.0,0.0,1.0
9304218,20,14,6,13,20,0,0,60,2.0,2.0,0.0,0.0,2.0,0.0,0.0,20,20,0,2.0,2.0,0.0
9706272,6,2,4,6,0,6,37,5,4.0,1.0,3.0,5.0,0.0,4.0,22.0,16,6,10,4.0,4.0,0.0
9901210,12,4,8,19,0,12,60,3,3.0,1.0,2.0,2.0,0.0,3.0,16.0,25,12,13,10.0,2.0,8.0
9402320,13,4,9,21,13,0,0,116,6.0,1.0,5.0,13.0,6.0,0.0,0.0,13,13,0,4.0,4.0,0.0
9510268,6,2,4,9,0,6,62,124,5.0,1.0,4.0,9.0,0.0,5.0,58.0,28,6,22,20.0,5.0,15.0
9355,40,9,31,137,7,33,192,18,16.0,2.0,14.0,38.0,0.0,16.0,66.0,80,40,40,13.0,8.0,5.0
9509260,53,6,47,230,1,52,201,18,31.0,3.0,28.0,142.0,2.0,29.0,94.0,67,53,14,12.0,9.0,3.0
9208213,203,19,184,1343,203,0,0,27,122.0,3.0,119.0,1041.0,122.0,0.0,0.0,203,203,0,28.0,28.0,0.0
9906233,42,8,34,107,2,40,214,5,12.0,4.0,8.0,13.0,1.0,11.0,71.0,64,42,22,15.0,6.0,9.0
9904469,15,5,10,19,1,14,114,18,8.0,1.0,7.0,15.0,0.0,8.0,68.0,77,15,62,17.0,8.0,9.0
9811362,29,4,25,142,0,29,191,32,17.0,3.0,14.0,77.0,0.0,17.0,94.0,49,29,20,25.0,17.0,8.0
9505340,46,20,26,75,20,26,36,120,18.0,10.0,8.0,29.0,1.0,17.0,23.0,48,46,2,11.0,10.0,1.0
104258,15,5,10,25,0,15,221,18,7.0,3.0,4.0,7.0,0.0,7.0,91.0,63,15,48,24.0,7.0,17.0
9904393,64,12,52,267,14,50,265,32,38.0,4.0,34.0,192.0,4.0,34.0,193.0,82,64,18,32.0,24.0,8.0
9803384,33,10,23,85,5,28,127,23,13.0,3.0,10.0,38.0,1.0,12.0,30.0,46,33,13,2.0,2.0,0.0
106207,121,7,114,632,83,38,75,0,37.0,2.0,35.0,215.0,21.0,16.0,38.0,131,121,10,22.0,22.0,0.0
4204,2,1,1,1,0,2,3,1620,,,,,,,,5,2,3,,,
9304208,13,8,5,9,13,0,0,97,4.0,4.0,0.0,0.0,4.0,0.0,0.0,13,13,0,4.0,4.0,0.0
9304255,30,10,20,53,12,18,23,164,18.0,6.0,12.0,34.0,2.0,16.0,16.0,33,30,3,18.0,17.0,1.0
7108,54,5,49,262,0,54,486,11,43.0,5.0,38.0,230.0,0.0,43.0,433.0,82,54,28,21.0,9.0,12.0
7236,3,3,0,0,1,2,6,118,1.0,1.0,0.0,0.0,0.0,1.0,3.0,6,3,3,4.0,1.0,3.0
9410341,3,3,0,0,0,3,6,16,2.0,2.0,0.0,0.0,0.0,2.0,4.0,5,3,2,1.0,1.0,0.0
9711225,2,2,0,0,1,1,1,252,1.0,1.0,0.0,0.0,1.0,0.0,0.0,3,2,1,2.0,1.0,1.0
9907409,26,7,19,40,1,25,138,16,16.0,5.0,11.0,20.0,0.0,16.0,98.0,41,26,15,21.0,8.0,13.0
9703387,12,5,7,13,0,12,34,4,1.0,1.0,0.0,0.0,0.0,1.0,2.0,40,12,28,1.0,0.0,1.0
9511310,8,3,5,6,4,4,9,25,2.0,1.0,1.0,1.0,1.0,1.0,1.0,14,8,6,1.0,1.0,0.0
9807424,30,9,21,46,5,25,68,4,3.0,1.0,2.0,2.0,0.0,3.0,9.0,39,30,9,8.0,4.0,4.0
9512367,43,8,35,114,2,41,128,8,17.0,3.0,14.0,50.0,0.0,17.0,33.0,61,43,18,12.0,10.0,2.0
5221,12,9,3,3,1,11,56,39,4.0,3.0,1.0,1.0,0.0,4.0,31.0,37,12,25,17.0,3.0,14.0
9510253,4,3,1,1,1,3,3,39,3.0,2.0,1.0,1.0,0.0,3.0,3.0,8,4,4,1.0,1.0,0.0
8144,30,3,27,98,2,28,287,2,24.0,1.0,23.0,87.0,0.0,24.0,131.0,54,30,24,34.0,20.0,14.0
9310256,9,6,3,7,7,2,2,317,5.0,3.0,2.0,5.0,3.0,2.0,2.0,11,9,2,6.0,5.0,1.0
9908505,21,5,16,40,0,21,212,2,14.0,4.0,10.0,25.0,0.0,14.0,183.0,49,21,28,22.0,7.0,15.0
109040,1,1,0,0,0,1,4,9,0.0,0.0,0.0,0.0,0.0,0.0,0.0,57,1,56,6.0,0.0,6.0
9601220,11,1,10,18,1,10,46,11,5.0,1.0,4.0,5.0,0.0,5.0,19.0,20,11,9,7.0,4.0,3.0
9901222,33,11,22,46,6,27,59,16,9.0,3.0,6.0,16.0,0.0,9.0,17.0,37,33,4,4.0,4.0,0.0
9307323,7,2,5,9,7,0,0,210,3.0,2.0,1.0,2.0,3.0,0.0,0.0,7,7,0,4.0,4.0,0.0
111234,8,2,6,12,0,8,65,80,4.0,1.0,3.0,5.0,0.0,4.0,35.0,34,8,26,17.0,5.0,12.0
10002,16,3,13,29,0,16,115,43,10.0,3.0,7.0,16.0,0.0,10.0,95.0,44,16,28,34.0,7.0,27.0
201146,7,4,3,4,1,6,113,19,3.0,2.0,1.0,1.0,0.0,3.0,31.0,179,7,172,21.0,2.0,19.0
9808242,23,6,17,54,5,18,72,25,9.0,2.0,7.0,14.0,0.0,9.0,43.0,39,23,16,18.0,8.0,10.0
201248,23,4,19,96,0,23,299,28,22.0,3.0,19.0,96.0,0.0,22.0,248.0,40,23,17,35.0,20.0,15.0
9807264,81,13,68,298,31,50,75,28,25.0,4.0,21.0,56.0,17.0,8.0,10.0,94,81,13,12.0,12.0,0.0
4128,8,2,6,13,0,8,35,2,7.0,2.0,5.0,10.0,0.0,7.0,30.0,13,8,5,8.0,5.0,3.0
9612318,31,8,23,52,5,26,49,105,15.0,5.0,10.0,17.0,1.0,14.0,22.0,42,31,11,12.0,11.0,1.0
9702436,15,9,6,10,1,14,41,91,4.0,3.0,1.0,1.0,0.0,4.0,14.0,27,15,12,8.0,4.0,4.0
9607350,3,3,0,0,1,2,3,1841,,,,,,,,6,3,3,,,
9909555,19,9,10,20,0,19,115,2,10.0,5.0,5.0,8.0,0.0,10.0,63.0,35,19,16,5.0,4.0,1.0
101278,16,6,10,14,0,16,152,2,10.0,5.0,5.0,8.0,0.0,10.0,83.0,50,16,34,7.0,6.0,1.0
9411272,14,3,11,33,13,1,1,146,11.0,1.0,10.0,32.0,11.0,0.0,0.0,15,14,1,10.0,10.0,0.0
9211279,2,2,0,0,2,0,0,212,,,,,,,,2,2,0,1.0,1.0,0.0
101122,8,6,2,3,1,7,14,55,1.0,1.0,0.0,0.0,0.0,1.0,4.0,28,8,20,2.0,0.0,2.0
9308265,17,3,14,32,17,0,0,90,12.0,3.0,9.0,25.0,12.0,0.0,0.0,17,17,0,5.0,5.0,0.0
9703204,11,11,0,0,6,5,10,300,5.0,5.0,0.0,0.0,4.0,1.0,1.0,22,11,11,2.0,1.0,1.0
9805391,1,1,0,0,0,1,1,120,1.0,1.0,0.0,0.0,0.0,1.0,1.0,7,1,6,,,
9406296,34,13,21,46,14,20,22,128,6.0,1.0,5.0,8.0,6.0,0.0,0.0,37,34,3,7.0,6.0,1.0
9610319,13,10,3,3,7,6,9,50,5.0,3.0,2.0,2.0,2.0,3.0,3.0,16,13,3,5.0,3.0,2.0
9903554,36,8,28,98,26,10,20,0,12.0,3.0,9.0,18.0,3.0,9.0,17.0,39,36,3,7.0,5.0,2.0
9310301,10,8,2,2,10,0,0,2134,2.0,1.0,1.0,1.0,2.0,0.0,0.0,10,10,0,2.0,2.0,0.0
112034,10,6,4,9,0,10,64,3,2.0,2.0,0.0,0.0,0.0,2.0,9.0,53,10,43,11.0,4.0,7.0
9409377,10,6,4,4,8,2,2,214,2.0,1.0,1.0,1.0,0.0,2.0,2.0,11,10,1,3.0,2.0,1.0
4010,20,6,14,31,1,19,130,1,10.0,3.0,7.0,16.0,0.0,10.0,75.0,41,20,21,18.0,6.0,12.0
12162,5,5,0,0,2,3,17,1,1.0,1.0,0.0,0.0,0.0,1.0,2.0,41,5,36,6.0,1.0,5.0
9711377,28,3,25,59,2,26,47,58,8.0,1.0,7.0,8.0,0.0,8.0,11.0,34,28,6,9.0,6.0,3.0
4120,2,2,0,0,0,2,2,1,0.0,0.0,0.0,0.0,0.0,0.0,0.0,13,2,11,4.0,0.0,4.0
8147,9,6,3,3,1,8,39,79,6.0,4.0,2.0,2.0,0.0,6.0,23.0,20,9,11,7.0,3.0,4.0
9302268,7,1,6,9,7,0,0,196,6.0,1.0,5.0,6.0,6.0,0.0,0.0,7,7,0,5.0,5.0,0.0
9255,73,9,64,266,4,69,585,9,40.0,4.0,36.0,171.0,0.0,40.0,343.0,113,73,40,18.0,18.0,0.0
9705380,30,8,22,57,2,28,113,22,11.0,2.0,9.0,21.0,0.0,11.0,58.0,37,30,7,4.0,3.0,1.0
9703370,6,2,4,7,0,6,44,17,5.0,1.0,4.0,7.0,0.0,5.0,42.0,23,6,17,4.0,4.0,0.0
9701210,14,1,13,24,0,14,52,17,12.0,1.0,11.0,21.0,0.0,12.0,49.0,23,14,9,6.0,5.0,1.0
9505313,13,4,9,14,1,12,14,26,8.0,2.0,6.0,10.0,0.0,8.0,8.0,17,13,4,4.0,4.0,0.0
9512333,4,2,2,2,2,2,4,211,2.0,1.0,1.0,1.0,1.0,1.0,1.0,7,4,3,4.0,2.0,2.0
9605407,8,4,4,5,0,8,14,162,4.0,3.0,1.0,1.0,0.0,4.0,9.0,12,8,4,7.0,5.0,2.0
9602255,26,16,10,18,18,8,52,13,3.0,2.0,1.0,1.0,0.0,3.0,17.0,46,26,20,5.0,1.0,4.0
9501245,5,2,3,6,2,3,5,104,3.0,2.0,1.0,2.0,1.0,2.0,3.0,7,5,2,2.0,2.0,0.0
9512203,25,7,18,70,9,16,16,8,14.0,2.0,12.0,43.0,1.0,13.0,13.0,26,25,1,5.0,5.0,0.0
9701261,8,3,5,7,5,3,9,182,3.0,2.0,1.0,1.0,0.0,3.0,9.0,12,8,4,6.0,3.0,3.0
3178,9,3,6,11,0,9,101,4,8.0,3.0,5.0,10.0,0.0,8.0,89.0,31,9,22,21.0,6.0,15.0
9905486,12,2,10,28,0,12,99,12,6.0,3.0,3.0,6.0,0.0,6.0,34.0,40,12,28,16.0,4.0,12.0
9507267,29,9,20,48,3,26,48,29,11.0,2.0,9.0,24.0,0.0,11.0,11.0,37,29,8,11.0,10.0,1.0
8321,9,3,6,20,3,6,15,62,7.0,1.0,6.0,20.0,2.0,5.0,9.0,24,9,15,9.0,7.0,2.0
9312300,3,3,0,0,1,2,2,253,0.0,0.0,0.0,0.0,0.0,0.0,0.0,8,3,5,1.0,0.0,1.0
4232,15,8,7,15,5,10,15,106,5.0,1.0,4.0,10.0,5.0,0.0,0.0,18,15,3,5.0,5.0,0.0
9909541,31,4,27,68,1,30,160,54,20.0,4.0,16.0,35.0,0.0,20.0,82.0,54,31,23,10.0,7.0,3.0
9602213,20,8,12,24,17,3,7,101,9.0,2.0,7.0,12.0,7.0,2.0,2.0,26,20,6,6.0,6.0,0.0
1053,1,1,0,0,0,1,2,54,0.0,0.0,0.0,0.0,0.0,0.0,0.0,9,1,8,3.0,0.0,3.0
110277,5,3,2,2,0,5,36,24,4.0,2.0,2.0,2.0,0.0,4.0,33.0,24,5,19,16.0,3.0,13.0
3107,27,2,25,86,0,27,390,24,22.0,1.0,21.0,79.0,0.0,22.0,338.0,66,27,39,46.0,15.0,31.0
9810303,4,4,0,0,0,4,10,69,0.0,0.0,0.0,0.0,0.0,0.0,0.0,8,4,4,2.0,0.0,2.0
9503347,2,1,1,1,0,2,2,88,1.0,1.0,0.0,0.0,0.0,1.0,1.0,4,2,2,2.0,1.0,1.0
9401312,46,14,32,102,37,9,9,57,28.0,5.0,23.0,81.0,19.0,9.0,9.0,47,46,1,10.0,10.0,0.0
9903268,36,8,28,68,0,36,195,9,19.0,6.0,13.0,30.0,0.0,19.0,50.0,48,36,12,18.0,15.0,3.0
9803229,25,3,22,79,1,24,88,14,17.0,2.0,15.0,57.0,0.0,17.0,67.0,37,25,12,22.0,16.0,6.0
9710414,8,4,4,7,6,2,3,14,3.0,2.0,1.0,1.0,3.0,0.0,0.0,12,8,4,3.0,3.0,0.0
9502334,51,14,37,92,27,24,30,117,11.0,3.0,8.0,13.0,11.0,0.0,0.0,55,51,4,10.0,10.0,0.0
9401224,2,2,0,0,2,0,0,1565,0.0,0.0,0.0,0.0,0.0,0.0,0.0,4,2,2,1.0,0.0,1.0
9808426,51,5,46,196,0,51,174,27,41.0,1.0,40.0,173.0,0.0,41.0,140.0,68,51,17,30.0,27.0,3.0
9910388,16,6,10,31,1,15,60,73,12.0,3.0,9.0,30.0,0.0,12.0,57.0,25,16,9,18.0,11.0,7.0
9411253,19,5,14,35,9,10,20,13,11.0,2.0,9.0,27.0,3.0,8.0,16.0,27,19,8,8.0,8.0,0.0
9407208,6,5,1,1,2,4,22,10,3.0,3.0,0.0,0.0,0.0,3.0,16.0,14,6,8,7.0,0.0,7.0
9506454,34,13,21,42,8,26,37,11,6.0,4.0,2.0,3.0,0.0,6.0,11.0,37,34,3,12.0,10.0,2.0
9711453,22,6,16,49,16,6,6,45,14.0,3.0,11.0,32.0,14.0,0.0,0.0,24,22,2,11.0,11.0,0.0
9511263,22,8,14,31,10,12,64,16,7.0,6.0,1.0,4.0,0.0,7.0,42.0,33,22,11,15.0,8.0,7.0
9303216,10,4,6,8,6,4,4,162,4.0,1.0,3.0,4.0,4.0,0.0,0.0,11,10,1,2.0,2.0,0.0
9409249,1,1,0,0,1,0,0,368,0.0,0.0,0.0,0.0,0.0,0.0,0.0,4,1,3,2.0,0.0,2.0
9508285,4,3,1,1,1,3,6,16,0.0,0.0,0.0,0.0,0.0,0.0,0.0,10,4,6,1.0,0.0,1.0
9702223,4,3,1,1,0,4,38,16,2.0,2.0,0.0,0.0,0.0,2.0,20.0,49,4,45,15.0,2.0,13.0
9708266,1,1,0,0,0,1,1,54,0.0,0.0,0.0,0.0,0.0,0.0,0.0,8,1,7,,,
9602421,28,4,24,74,5,23,69,13,15.0,1.0,14.0,54.0,0.0,15.0,46.0,39,28,11,19.0,14.0,5.0
9410324,8,7,1,1,2,6,14,29,0.0,0.0,0.0,0.0,0.0,0.0,0.0,22,8,14,6.0,2.0,4.0
9910226,13,4,9,15,0,13,50,97,10.0,3.0,7.0,8.0,0.0,10.0,34.0,21,13,8,8.0,5.0,3.0
9802214,22,9,13,20,3,19,41,8,5.0,1.0,4.0,9.0,5.0,0.0,0.0,58,22,36,5.0,5.0,0.0
9308310,20,8,12,29,20,0,0,15,6.0,2.0,4.0,7.0,6.0,0.0,0.0,20,20,0,4.0,4.0,0.0
9501317,15,1,14,49,0,15,57,15,5.0,2.0,3.0,5.0,2.0,3.0,4.0,25,15,10,7.0,3.0,4.0
9305248,13,3,10,33,13,0,0,4,4.0,2.0,2.0,5.0,4.0,0.0,0.0,20,13,7,4.0,4.0,0.0
9512439,35,10,25,49,16,19,28,42,11.0,1.0,10.0,14.0,2.0,9.0,14.0,44,35,9,7.0,5.0,2.0
9608306,26,5,21,66,1,25,135,33,21.0,3.0,18.0,59.0,2.0,19.0,112.0,38,26,12,25.0,17.0,8.0
106149,23,7,16,46,0,23,104,0,16.0,3.0,13.0,38.0,0.0,16.0,70.0,39,23,16,20.0,13.0,7.0
9801309,1,1,0,0,1,0,0,1638,1.0,1.0,0.0,0.0,1.0,0.0,0.0,1,1,0,1.0,1.0,0.0
104218,28,6,22,60,0,28,237,0,11.0,3.0,8.0,16.0,0.0,11.0,126.0,78,28,50,26.0,9.0,17.0
9607226,4,2,2,2,2,2,6,243,2.0,1.0,1.0,1.0,0.0,2.0,4.0,9,4,5,4.0,2.0,2.0
9501411,2,2,0,0,2,0,0,52,,,,,,,,2,2,0,1.0,1.0,0.0
9902289,3,3,0,0,1,2,7,52,1.0,1.0,0.0,0.0,0.0,1.0,4.0,14,3,11,1.0,1.0,0.0
9803375,7,3,4,6,3,4,7,30,3.0,2.0,1.0,1.0,2.0,1.0,1.0,14,7,7,2.0,1.0,1.0
9806210,12,4,8,17,1,11,17,318,3.0,2.0,1.0,1.0,0.0,3.0,7.0,18,12,6,6.0,3.0,3.0
2243,4,4,0,0,1,3,6,1,1.0,1.0,0.0,0.0,0.0,1.0,1.0,17,4,13,1.0,0.0,1.0
3010,2,2,0,0,2,0,0,280,1.0,1.0,0.0,0.0,1.0,0.0,0.0,3,2,1,,,
2232,8,8,0,0,1,7,34,5,0.0,0.0,0.0,0.0,0.0,0.0,0.0,76,8,68,3.0,0.0,3.0
9605459,8,5,3,5,8,0,0,213,6.0,4.0,2.0,3.0,6.0,0.0,0.0,8,8,0,3.0,3.0,0.0
9310227,33,10,23,51,28,5,5,155,19.0,4.0,15.0,39.0,19.0,0.0,0.0,34,33,1,13.0,13.0,0.0
9507255,7,6,1,1,1,6,7,25,0.0,0.0,0.0,0.0,0.0,0.0,0.0,10,7,3,1.0,1.0,0.0
9803491,8,1,7,7,3,5,13,67,3.0,1.0,2.0,2.0,2.0,1.0,3.0,14,8,6,3.0,3.0,0.0
111209,8,2,6,14,0,8,79,4,7.0,1.0,6.0,13.0,0.0,7.0,52.0,35,8,27,16.0,7.0,9.0
9501266,35,6,29,87,22,13,22,123,18.0,3.0,15.0,42.0,10.0,8.0,12.0,38,35,3,12.0,11.0,1.0
9701416,7,4,3,6,2,5,8,123,5.0,2.0,3.0,5.0,3.0,2.0,2.0,9,7,2,5.0,3.0,2.0
9307205,8,5,3,4,8,0,0,123,4.0,2.0,2.0,2.0,4.0,0.0,0.0,8,8,0,3.0,3.0,0.0
9901224,13,2,11,50,0,13,124,49,11.0,1.0,10.0,43.0,0.0,11.0,49.0,34,13,21,17.0,11.0,6.0
209039,0,0,0,0,0,0,0,111,0.0,0.0,0.0,0.0,0.0,0.0,0.0,2,0,2,2.0,0.0,2.0
9911424,10,5,5,7,0,10,37,14,8.0,4.0,4.0,5.0,0.0,8.0,20.0,29,10,19,11.0,7.0,4.0
7062,1,1,0,0,0,1,1,225,0.0,0.0,0.0,0.0,0.0,0.0,0.0,7,1,6,1.0,1.0,0.0
5121,11,3,8,17,0,11,67,30,7.0,4.0,3.0,6.0,0.0,7.0,35.0,34,11,23,11.0,3.0,8.0
9410377,8,6,2,3,2,6,9,170,1.0,1.0,0.0,0.0,0.0,1.0,2.0,11,8,3,2.0,1.0,1.0
9909377,9,1,8,16,0,9,283,2,8.0,1.0,7.0,15.0,0.0,8.0,276.0,87,9,78,59.0,8.0,51.0
9401319,20,9,11,19,16,4,8,7,8.0,4.0,4.0,6.0,8.0,0.0,0.0,28,20,8,4.0,4.0,0.0
2115,13,5,8,12,0,13,41,92,0.0,0.0,0.0,0.0,0.0,0.0,0.0,45,13,32,11.0,0.0,11.0
9506255,12,8,4,12,12,0,0,227,4.0,2.0,2.0,4.0,4.0,0.0,0.0,13,12,1,2.0,2.0,0.0
105123,2,1,1,1,0,2,4,89,0.0,0.0,0.0,0.0,0.0,0.0,0.0,7,2,5,3.0,0.0,3.0
9711357,15,4,11,23,6,9,21,5,3.0,1.0,2.0,2.0,0.0,3.0,8.0,22,15,7,2.0,2.0,0.0
9704334,18,5,13,20,0,18,34,123,10.0,3.0,7.0,10.0,0.0,10.0,14.0,29,18,11,9.0,7.0,2.0
9505341,8,3,5,5,0,8,39,112,8.0,3.0,5.0,5.0,1.0,7.0,14.0,18,8,10,5.0,2.0,3.0
9311321,14,3,11,26,14,0,0,181,11.0,2.0,9.0,21.0,11.0,0.0,0.0,14,14,0,9.0,9.0,0.0
208159,8,3,5,8,0,8,81,7,4.0,3.0,1.0,1.0,0.0,4.0,37.0,41,8,33,17.0,5.0,12.0
9709315,4,2,2,2,1,3,14,36,3.0,1.0,2.0,2.0,0.0,3.0,8.0,16,4,12,9.0,2.0,7.0
110215,73,25,48,108,32,41,96,66,14.0,2.0,12.0,27.0,6.0,8.0,15.0,90,73,17,14.0,10.0,4.0
9610397,7,2,5,7,1,6,26,36,3.0,1.0,2.0,3.0,0.0,3.0,11.0,15,7,8,4.0,2.0,2.0
210114,0,0,0,0,0,0,0,218,0.0,0.0,0.0,0.0,0.0,0.0,0.0,8,0,8,4.0,0.0,4.0
109056,21,9,12,20,2,19,125,89,14.0,4.0,10.0,17.0,0.0,14.0,84.0,47,21,26,25.0,12.0,13.0
110141,4,2,2,2,0,4,14,257,0.0,0.0,0.0,0.0,0.0,0.0,0.0,27,4,23,3.0,0.0,3.0
9307245,42,7,35,210,38,4,4,53,36.0,3.0,33.0,203.0,36.0,0.0,0.0,43,42,1,26.0,26.0,0.0
9507234,10,6,4,4,2,8,18,0,4.0,3.0,1.0,1.0,4.0,0.0,0.0,22,10,12,2.0,2.0,0.0
9911235,4,4,0,0,1,3,25,30,2.0,2.0,0.0,0.0,0.0,2.0,12.0,24,4,20,6.0,2.0,4.0
9707456,6,4,2,2,4,2,6,42,1.0,1.0,0.0,0.0,0.0,1.0,3.0,16,6,10,3.0,0.0,3.0
9403284,4,3,1,1,4,0,0,243,2.0,2.0,0.0,0.0,2.0,0.0,0.0,8,4,4,2.0,1.0,1.0
9211227,4,3,1,2,4,0,0,200,1.0,1.0,0.0,0.0,1.0,0.0,0.0,4,4,0,1.0,1.0,0.0
5138,0,0,0,0,0,0,0,1760,,,,,,,,1,0,1,,,
9706214,8,2,6,6,1,7,7,1,0.0,0.0,0.0,0.0,0.0,0.0,0.0,14,8,6,1.0,0.0,1.0
9507258,6,3,3,3,4,2,2,34,1.0,1.0,0.0,0.0,1.0,0.0,0.0,9,6,3,1.0,1.0,0.0
9907245,17,7,10,24,2,15,53,44,9.0,3.0,6.0,16.0,1.0,8.0,24.0,33,17,16,8.0,7.0,1.0
9603308,11,2,9,16,3,8,15,154,11.0,2.0,9.0,16.0,3.0,8.0,15.0,14,11,3,10.0,7.0,3.0
9806481,0,0,0,0,0,0,0,1404,0.0,0.0,0.0,0.0,0.0,0.0,0.0,5,0,5,,,
9403410,7,2,5,13,7,0,0,150,6.0,1.0,5.0,13.0,6.0,0.0,0.0,7,7,0,6.0,6.0,0.0
9807277,9,2,7,16,1,8,22,191,8.0,1.0,7.0,16.0,0.0,8.0,22.0,16,9,7,13.0,8.0,5.0
9510396,20,1,19,41,8,12,21,13,5.0,1.0,4.0,6.0,0.0,5.0,6.0,23,20,3,9.0,9.0,0.0
9801345,11,7,4,9,5,6,10,83,7.0,6.0,1.0,1.0,7.0,0.0,0.0,16,11,5,4.0,4.0,0.0
7152,12,7,5,8,0,12,101,8,3.0,3.0,0.0,0.0,0.0,3.0,13.0,58,12,46,7.0,1.0,6.0
104020,4,3,1,1,0,4,24,6,3.0,2.0,1.0,1.0,0.0,3.0,13.0,30,4,26,15.0,3.0,12.0
9501340,1,1,0,0,0,1,1,119,1.0,1.0,0.0,0.0,0.0,1.0,1.0,3,1,2,,,
9804404,24,8,16,33,9,15,25,47,7.0,3.0,4.0,8.0,7.0,0.0,0.0,31,24,7,6.0,5.0,1.0
9908350,4,2,2,3,0,4,19,42,3.0,2.0,1.0,1.0,0.0,3.0,8.0,16,4,12,9.0,2.0,7.0
9505307,4,3,1,1,0,4,14,22,2.0,2.0,0.0,0.0,0.0,2.0,4.0,13,4,9,2.0,1.0,1.0
9701354,9,5,4,6,7,2,5,22,1.0,1.0,0.0,0.0,0.0,1.0,1.0,12,9,3,2.0,2.0,0.0
112241,1,1,0,0,0,1,7,0,1.0,1.0,0.0,0.0,0.0,1.0,6.0,15,1,14,1.0,0.0,1.0
103252,6,4,2,3,0,6,28,0,0.0,0.0,0.0,0.0,0.0,0.0,0.0,34,6,28,15.0,2.0,13.0
9807294,24,13,11,17,8,16,27,202,6.0,3.0,3.0,3.0,0.0,6.0,7.0,34,24,10,4.0,4.0,0.0
9704352,4,3,1,1,1,3,4,91,3.0,2.0,1.0,1.0,0.0,3.0,3.0,6,4,2,4.0,3.0,1.0
9905222,16,8,8,19,1,15,120,3,10.0,4.0,6.0,15.0,0.0,10.0,90.0,53,16,37,24.0,2.0,22.0
9903492,7,4,3,4,0,7,27,42,3.0,3.0,0.0,0.0,0.0,3.0,13.0,16,7,9,4.0,3.0,1.0
9602393,5,4,1,1,3,2,2,160,2.0,1.0,1.0,1.0,2.0,0.0,0.0,8,5,3,2.0,2.0,0.0
8024,1,1,0,0,0,1,8,0,1.0,1.0,0.0,0.0,0.0,1.0,8.0,16,1,15,,,
10077,8,3,5,9,0,8,68,0,6.0,3.0,3.0,6.0,0.0,6.0,57.0,53,8,45,20.0,6.0,14.0
9909217,21,6,15,27,1,20,210,3,11.0,2.0,9.0,14.0,0.0,11.0,165.0,84,21,63,38.0,4.0,34.0
9511424,12,6,6,9,9,3,4,260,5.0,2.0,3.0,6.0,5.0,0.0,0.0,16,12,4,5.0,5.0,0.0
9604311,8,3,5,7,8,0,0,25,4.0,2.0,2.0,3.0,4.0,0.0,0.0,12,8,4,2.0,1.0,1.0
9810323,7,3,4,5,3,4,9,109,3.0,2.0,1.0,1.0,0.0,3.0,6.0,11,7,4,5.0,3.0,2.0
103286,8,2,6,9,0,8,21,122,6.0,2.0,4.0,5.0,0.0,6.0,16.0,12,8,4,10.0,7.0,3.0
9812225,8,2,6,12,7,1,1,32,1.0,1.0,0.0,0.0,1.0,0.0,0.0,9,8,1,4.0,4.0,0.0
9901411,9,7,2,3,4,5,9,48,2.0,2.0,0.0,0.0,2.0,0.0,0.0,19,9,10,3.0,1.0,2.0
9403314,19,9,10,23,19,0,0,54,10.0,5.0,5.0,17.0,10.0,0.0,0.0,19,19,0,8.0,8.0,0.0
9802404,11,5,6,8,2,9,25,83,8.0,2.0,6.0,8.0,0.0,8.0,21.0,20,11,9,10.0,6.0,4.0
9508415,4,3,1,1,2,2,2,74,2.0,2.0,0.0,0.0,1.0,1.0,1.0,12,4,8,2.0,1.0,1.0
9508278,7,3,4,11,2,5,8,33,7.0,3.0,4.0,11.0,3.0,4.0,4.0,21,7,14,4.0,3.0,1.0
9604335,28,8,20,45,9,19,25,6,11.0,3.0,8.0,16.0,11.0,0.0,0.0,31,28,3,8.0,8.0,0.0
9611343,18,5,13,35,4,14,25,5,8.0,3.0,5.0,14.0,0.0,8.0,15.0,20,18,2,13.0,11.0,2.0
9606300,2,2,0,0,0,2,2,1922,,,,,,,,4,2,2,2.0,1.0,1.0
9208239,6,4,2,3,6,0,0,248,3.0,1.0,2.0,3.0,3.0,0.0,0.0,6,6,0,3.0,3.0,0.0
111317,8,4,4,5,4,4,10,0,1.0,1.0,0.0,0.0,0.0,1.0,2.0,13,8,5,4.0,1.0,3.0
9612272,12,4,8,11,3,9,22,12,0.0,0.0,0.0,0.0,0.0,0.0,0.0,30,12,18,5.0,1.0,4.0
9907365,8,2,6,11,0,8,79,15,7.0,1.0,6.0,11.0,0.0,7.0,65.0,51,8,43,22.0,3.0,19.0
9905424,8,6,2,2,2,6,19,135,1.0,1.0,0.0,0.0,0.0,1.0,1.0,17,8,9,6.0,2.0,4.0
112126,17,7,10,16,0,17,127,7,5.0,3.0,2.0,3.0,0.0,5.0,54.0,65,17,48,23.0,3.0,20.0
9712369,13,3,10,25,1,12,53,67,11.0,3.0,8.0,22.0,1.0,10.0,48.0,22,13,9,15.0,9.0,6.0
9709342,13,6,7,13,10,3,3,27,4.0,3.0,1.0,2.0,4.0,0.0,0.0,14,13,1,6.0,5.0,1.0
9711488,35,7,28,106,0,35,95,27,30.0,6.0,24.0,88.0,0.0,30.0,84.0,42,35,7,11.0,10.0,1.0
108216,39,13,26,91,8,31,100,46,21.0,4.0,17.0,65.0,0.0,21.0,44.0,59,39,20,21.0,17.0,4.0
105278,6,3,3,3,0,6,14,46,0.0,0.0,0.0,0.0,0.0,0.0,0.0,18,6,12,1.0,0.0,1.0
7016,6,4,2,3,0,6,75,12,1.0,1.0,0.0,0.0,0.0,1.0,10.0,69,6,63,25.0,0.0,25.0
205053,38,5,33,106,14,24,113,0,14.0,1.0,13.0,28.0,3.0,11.0,24.0,61,38,23,19.0,9.0,10.0
201262,26,5,21,121,0,26,63,107,18.0,3.0,15.0,84.0,2.0,16.0,16.0,32,26,6,18.0,17.0,1.0
9410376,9,5,4,6,8,1,1,548,3.0,3.0,0.0,0.0,3.0,0.0,0.0,10,9,1,4.0,4.0,0.0
106072,7,2,5,8,0,7,54,37,5.0,2.0,3.0,4.0,0.0,5.0,22.0,22,7,15,9.0,5.0,4.0
9512335,9,8,1,1,4,5,21,10,1.0,1.0,0.0,0.0,0.0,1.0,9.0,60,9,51,6.0,0.0,6.0
5311,7,1,6,15,0,7,30,47,6.0,1.0,5.0,12.0,0.0,6.0,27.0,31,7,24,13.0,5.0,8.0
9505310,6,5,1,1,2,4,4,401,4.0,3.0,1.0,1.0,4.0,0.0,0.0,7,6,1,3.0,3.0,0.0
12046,9,4,5,9,0,9,32,3,3.0,1.0,2.0,3.0,0.0,3.0,12.0,56,9,47,21.0,0.0,21.0
203117,4,1,3,5,0,4,19,3,0.0,0.0,0.0,0.0,0.0,0.0,0.0,22,4,18,4.0,3.0,1.0
9404238,14,9,5,8,8,6,7,243,5.0,2.0,3.0,6.0,5.0,0.0,0.0,16,14,2,4.0,4.0,0.0
9502272,4,2,2,2,3,1,1,228,3.0,1.0,2.0,2.0,3.0,0.0,0.0,5,4,1,2.0,1.0,1.0
9905375,2,2,0,0,0,2,4,264,1.0,1.0,0.0,0.0,0.0,1.0,2.0,4,2,2,2.0,1.0,1.0
9609386,0,0,0,0,0,0,0,35,0.0,0.0,0.0,0.0,0.0,0.0,0.0,5,0,5,5.0,0.0,5.0
9801210,7,5,2,2,0,7,43,100,3.0,2.0,1.0,1.0,0.0,3.0,20.0,28,7,21,15.0,3.0,12.0
9707508,3,3,0,0,0,3,10,43,1.0,1.0,0.0,0.0,0.0,1.0,1.0,37,3,34,3.0,0.0,3.0
9904362,2,2,0,0,0,2,4,272,1.0,1.0,0.0,0.0,0.0,1.0,2.0,7,2,5,5.0,1.0,4.0
103210,13,7,6,7,0,13,99,16,3.0,3.0,0.0,0.0,0.0,3.0,29.0,51,13,38,5.0,0.0,5.0
9808486,11,8,3,3,3,8,30,11,2.0,1.0,1.0,1.0,0.0,2.0,9.0,48,11,37,5.0,0.0,5.0
9510318,9,3,6,13,2,7,13,13,3.0,1.0,2.0,3.0,3.0,0.0,0.0,13,9,4,4.0,4.0,0.0
9211301,19,1,18,68,19,0,0,142,18.0,1.0,17.0,66.0,18.0,0.0,0.0,19,19,0,9.0,9.0,0.0
103289,7,5,2,2,2,5,9,59,5.0,3.0,2.0,2.0,2.0,3.0,3.0,18,7,11,6.0,4.0,2.0
9402240,3,2,1,1,3,0,0,250,2.0,1.0,1.0,1.0,2.0,0.0,0.0,3,3,0,2.0,2.0,0.0
4205,10,5,5,8,0,10,26,18,2.0,1.0,1.0,1.0,2.0,0.0,0.0,23,10,13,1.0,1.0,0.0
9808375,8,4,4,7,0,8,62,39,6.0,3.0,3.0,6.0,0.0,6.0,39.0,25,8,17,14.0,4.0,10.0
9503207,6,2,4,6,6,0,0,144,3.0,1.0,2.0,3.0,3.0,0.0,0.0,6,6,0,3.0,3.0,0.0
6324,8,2,6,8,2,6,7,121,7.0,2.0,5.0,7.0,2.0,5.0,5.0,13,8,5,4.0,4.0,0.0
9810531,7,2,5,5,3,4,8,168,3.0,2.0,1.0,1.0,3.0,0.0,0.0,15,7,8,7.0,5.0,2.0
9408329,1,1,0,0,0,1,1,75,0.0,0.0,0.0,0.0,0.0,0.0,0.0,19,1,18,7.0,0.0,7.0
206201,2,2,0,0,1,1,4,257,2.0,2.0,0.0,0.0,1.0,1.0,1.0,7,2,5,2.0,1.0,1.0
9302214,17,8,9,15,17,0,0,291,4.0,2.0,2.0,2.0,4.0,0.0,0.0,17,17,0,2.0,2.0,0.0
9707212,2,2,0,0,0,2,3,212,0.0,0.0,0.0,0.0,0.0,0.0,0.0,5,2,3,2.0,0.0,2.0
112139,1,1,0,0,0,1,1,88,0.0,0.0,0.0,0.0,0.0,0.0,0.0,8,1,7,1.0,1.0,0.0
205057,5,3,2,3,1,4,16,37,0.0,0.0,0.0,0.0,0.0,0.0,0.0,26,5,21,7.0,1.0,6.0
112273,12,4,8,14,0,12,161,109,9.0,3.0,6.0,12.0,0.0,9.0,153.0,36,12,24,29.0,8.0,21.0
9806488,7,3,4,7,1,6,14,4,2.0,1.0,1.0,1.0,0.0,2.0,2.0,18,7,11,1.0,0.0,1.0
9611219,5,4,1,1,0,5,16,81,3.0,2.0,1.0,1.0,0.0,3.0,11.0,15,5,10,3.0,1.0,2.0
9905301,2,2,0,0,0,2,5,119,1.0,1.0,0.0,0.0,0.0,1.0,3.0,8,2,6,1.0,0.0,1.0
7246,6,3,3,3,2,4,26,28,3.0,2.0,1.0,1.0,0.0,3.0,14.0,24,6,18,3.0,3.0,0.0
201191,1,1,0,0,0,1,3,83,1.0,1.0,0.0,0.0,0.0,1.0,1.0,8,1,7,2.0,0.0,2.0
9803418,10,6,4,4,8,2,4,0,1.0,1.0,0.0,0.0,1.0,0.0,0.0,16,10,6,2.0,2.0,0.0
9609429,12,3,9,15,6,6,9,244,5.0,1.0,4.0,5.0,4.0,1.0,1.0,17,12,5,3.0,3.0,0.0
9608483,3,1,2,3,0,3,11,36,3.0,1.0,2.0,3.0,0.0,3.0,8.0,8,3,5,8.0,3.0,5.0
2065,34,12,22,47,4,30,155,8,6.0,4.0,2.0,5.0,0.0,6.0,27.0,64,34,30,5.0,4.0,1.0
9411282,23,8,15,30,5,18,37,6,9.0,3.0,6.0,14.0,2.0,7.0,7.0,28,23,5,11.0,9.0,2.0
9801390,3,1,2,3,0,3,12,646,1.0,1.0,0.0,0.0,0.0,1.0,2.0,9,3,6,1.0,1.0,0.0
9703336,13,4,9,16,5,8,15,1,5.0,2.0,3.0,3.0,4.0,1.0,2.0,21,13,8,4.0,3.0,1.0
9602256,5,3,2,2,0,5,21,6,1.0,1.0,0.0,0.0,1.0,0.0,0.0,11,5,6,3.0,2.0,1.0
9902246,1,1,0,0,1,0,0,389,0.0,0.0,0.0,0.0,0.0,0.0,0.0,2,1,1,1.0,0.0,1.0
9904363,9,2,7,13,0,9,47,49,7.0,2.0,5.0,11.0,0.0,7.0,37.0,27,9,18,6.0,3.0,3.0
9706409,19,2,17,77,1,18,63,8,18.0,2.0,16.0,75.0,0.0,18.0,45.0,31,19,12,20.0,16.0,4.0
9903327,16,5,11,13,0,16,108,9,10.0,3.0,7.0,8.0,0.0,10.0,68.0,30,16,14,5.0,4.0,1.0
9810549,4,2,2,4,0,4,17,17,1.0,1.0,0.0,0.0,0.0,1.0,2.0,26,4,22,4.0,2.0,2.0
204043,5,3,2,5,2,3,3,24,4.0,3.0,1.0,3.0,2.0,2.0,2.0,11,5,6,3.0,1.0,2.0
9312255,4,3,1,1,4,0,0,184,1.0,1.0,0.0,0.0,1.0,0.0,0.0,6,4,2,1.0,1.0,0.0
9503224,2,1,1,1,2,0,0,51,2.0,1.0,1.0,1.0,2.0,0.0,0.0,2,2,0,2.0,2.0,0.0
9911503,1,1,0,0,0,1,1,178,0.0,0.0,0.0,0.0,0.0,0.0,0.0,5,1,4,3.0,1.0,2.0
9604429,13,1,12,24,2,11,11,53,11.0,1.0,10.0,18.0,2.0,9.0,9.0,14,13,1,12.0,11.0,1.0
9503365,3,1,2,3,3,0,0,95,1.0,1.0,0.0,0.0,1.0,0.0,0.0,3,3,0,1.0,1.0,0.0
9411403,1,1,0,0,0,1,5,4,1.0,1.0,0.0,0.0,0.0,1.0,4.0,10,1,9,5.0,1.0,4.0
104291,34,16,18,50,16,18,43,9,4.0,1.0,3.0,3.0,1.0,3.0,3.0,42,34,8,5.0,4.0,1.0
9709446,2,1,1,1,0,2,2,14,0.0,0.0,0.0,0.0,0.0,0.0,0.0,12,2,10,3.0,2.0,1.0
9806243,0,0,0,0,0,0,0,113,,,,,,,,2,0,2,,,
9907399,22,3,19,51,2,20,44,0,9.0,5.0,4.0,6.0,1.0,8.0,13.0,44,22,22,14.0,13.0,1.0
9508399,14,4,10,23,2,12,20,133,10.0,4.0,6.0,10.0,2.0,8.0,13.0,18,14,4,8.0,6.0,2.0
9310209,2,1,1,1,2,0,0,86,2.0,1.0,1.0,1.0,2.0,0.0,0.0,2,2,0,2.0,2.0,0.0
9606380,13,6,7,15,12,1,1,101,4.0,1.0,3.0,5.0,4.0,0.0,0.0,17,13,4,2.0,2.0,0.0
9702332,3,3,0,0,1,2,2,31,1.0,1.0,0.0,0.0,1.0,0.0,0.0,7,3,4,1.0,1.0,0.0
9602357,11,8,3,3,3,8,11,131,3.0,2.0,1.0,1.0,1.0,2.0,2.0,15,11,4,3.0,2.0,1.0
9707333,7,3,4,4,0,7,19,18,3.0,1.0,2.0,2.0,0.0,3.0,3.0,12,7,5,7.0,4.0,3.0
5125,4,1,3,6,0,4,26,50,4.0,1.0,3.0,6.0,0.0,4.0,16.0,17,4,13,13.0,4.0,9.0
9803350,5,4,1,1,0,5,12,86,2.0,2.0,0.0,0.0,0.0,2.0,7.0,11,5,6,3.0,2.0,1.0
110355,1,1,0,0,0,1,4,14,0.0,0.0,0.0,0.0,0.0,0.0,0.0,16,1,15,6.0,0.0,6.0
9802386,3,2,1,1,0,3,36,14,3.0,2.0,1.0,1.0,0.0,3.0,17.0,20,3,17,11.0,3.0,8.0
107157,9,5,4,5,0,9,66,68,8.0,4.0,4.0,5.0,0.0,8.0,56.0,25,9,16,20.0,7.0,13.0
9806383,10,2,8,17,1,9,16,143,8.0,2.0,6.0,13.0,0.0,8.0,15.0,12,10,2,9.0,7.0,2.0
9807509,7,2,5,7,0,7,36,12,2.0,1.0,1.0,1.0,0.0,2.0,6.0,28,7,21,7.0,0.0,7.0
9808353,4,3,1,1,0,4,8,0,,,,,,,,15,4,11,,,
9912304,1,1,0,0,0,1,3,56,1.0,1.0,0.0,0.0,0.0,1.0,3.0,12,1,11,2.0,0.0,2.0
9210274,2,1,1,1,2,0,0,649,1.0,1.0,0.0,0.0,1.0,0.0,0.0,2,2,0,1.0,1.0,0.0
9706367,3,2,1,1,0,3,9,13,3.0,2.0,1.0,1.0,0.0,3.0,6.0,11,3,8,3.0,2.0,1.0
208202,12,3,9,11,0,12,125,7,3.0,1.0,2.0,2.0,0.0,3.0,21.0,42,12,30,6.0,0.0,6.0
9209273,5,2,3,4,5,0,0,246,4.0,2.0,2.0,3.0,4.0,0.0,0.0,5,5,0,3.0,3.0,0.0
9808424,4,2,2,2,1,3,28,38,3.0,1.0,2.0,2.0,0.0,3.0,28.0,25,4,21,16.0,3.0,13.0
9805435,4,2,2,2,2,2,4,22,0.0,0.0,0.0,0.0,0.0,0.0,0.0,12,4,8,1.0,0.0,1.0
201293,3,1,2,2,0,3,37,15,3.0,1.0,2.0,2.0,0.0,3.0,36.0,38,3,35,18.0,1.0,17.0
9706288,8,4,4,11,0,8,141,36,8.0,4.0,4.0,11.0,0.0,8.0,139.0,32,8,24,30.0,7.0,23.0
9603250,7,1,6,9,2,5,19,1,0.0,0.0,0.0,0.0,0.0,0.0,0.0,15,7,8,3.0,3.0,0.0
9907488,8,3,5,12,0,8,44,27,6.0,2.0,4.0,11.0,0.0,6.0,37.0,16,8,8,7.0,4.0,3.0
110147,1,1,0,0,0,1,5,7,0.0,0.0,0.0,0.0,0.0,0.0,0.0,37,1,36,6.0,0.0,6.0
9802393,5,1,4,6,0,5,32,142,5.0,1.0,4.0,6.0,0.0,5.0,32.0,18,5,13,14.0,5.0,9.0
9706383,4,2,2,2,1,3,8,87,0.0,0.0,0.0,0.0,0.0,0.0,0.0,10,4,6,6.0,1.0,5.0
9901413,2,2,0,0,0,2,2,131,2.0,2.0,0.0,0.0,0.0,2.0,2.0,4,2,2,2.0,1.0,1.0
101348,21,6,15,40,1,20,69,16,13.0,3.0,10.0,27.0,1.0,12.0,26.0,36,21,15,12.0,8.0,4.0
5233,4,1,3,6,1,3,4,43,0.0,0.0,0.0,0.0,0.0,0.0,0.0,53,4,49,14.0,0.0,14.0
4147,3,2,1,1,3,0,0,49,,,,,,,,3,3,0,,,
9906269,6,5,1,1,1,5,14,1,0.0,0.0,0.0,0.0,0.0,0.0,0.0,23,6,17,2.0,1.0,1.0
9808379,13,2,11,48,0,13,41,12,12.0,2.0,10.0,46.0,0.0,12.0,38.0,23,13,10,15.0,11.0,4.0
9706394,16,8,8,14,2,14,21,78,5.0,3.0,2.0,4.0,5.0,0.0,0.0,20,16,4,4.0,4.0,0.0
208024,3,3,0,0,1,2,10,0,0.0,0.0,0.0,0.0,0.0,0.0,0.0,34,3,31,10.0,0.0,10.0
110136,3,1,2,3,0,3,38,73,3.0,1.0,2.0,3.0,0.0,3.0,28.0,22,3,19,6.0,1.0,5.0
9603416,3,3,0,0,0,3,7,35,1.0,1.0,0.0,0.0,1.0,0.0,0.0,6,3,3,5.0,3.0,2.0
206068,4,4,0,0,0,4,23,13,1.0,1.0,0.0,0.0,0.0,1.0,4.0,39,4,35,15.0,0.0,15.0
9711386,5,5,0,0,1,4,34,6,2.0,2.0,0.0,0.0,0.0,2.0,22.0,61,5,56,4.0,1.0,3.0
9801372,8,6,2,3,4,4,12,8,2.0,1.0,1.0,1.0,2.0,0.0,0.0,21,8,13,1.0,1.0,0.0
9404210,1,1,0,0,0,1,2,81,1.0,1.0,0.0,0.0,0.0,1.0,2.0,6,1,5,4.0,0.0,4.0
103192,7,5,2,2,1,6,50,50,5.0,3.0,2.0,2.0,0.0,5.0,44.0,26,7,19,19.0,3.0,16.0
9809598,11,7,4,6,2,9,40,50,1.0,1.0,0.0,0.0,0.0,1.0,4.0,27,11,16,9.0,1.0,8.0
9711489,5,4,1,1,0,5,15,61,1.0,1.0,0.0,0.0,0.0,1.0,8.0,21,5,16,9.0,1.0,8.0
9610315,9,4,5,14,1,8,28,150,4.0,2.0,2.0,4.0,0.0,4.0,11.0,15,9,6,8.0,4.0,4.0
9605237,9,4,5,12,1,8,13,278,5.0,1.0,4.0,9.0,5.0,0.0,0.0,14,9,5,7.0,6.0,1.0
9803312,8,3,5,9,2,6,10,13,5.0,2.0,3.0,4.0,3.0,2.0,2.0,12,8,4,6.0,4.0,2.0
9911527,1,1,0,0,0,1,3,78,1.0,1.0,0.0,0.0,0.0,1.0,2.0,9,1,8,3.0,1.0,2.0
5250,10,5,5,6,1,9,34,57,7.0,5.0,2.0,2.0,0.0,7.0,26.0,20,10,10,5.0,3.0,2.0
106203,7,6,1,2,0,7,35,7,4.0,4.0,0.0,0.0,0.0,4.0,11.0,24,7,17,3.0,1.0,2.0
9411230,3,2,1,1,3,0,0,183,2.0,1.0,1.0,1.0,2.0,0.0,0.0,3,3,0,1.0,1.0,0.0
9806265,4,3,1,2,0,4,16,140,1.0,1.0,0.0,0.0,0.0,1.0,1.0,15,4,11,4.0,1.0,3.0
9409392,6,5,1,2,4,2,3,22,3.0,3.0,0.0,0.0,3.0,0.0,0.0,10,6,4,2.0,2.0,0.0
3151,12,6,6,8,5,7,20,84,3.0,2.0,1.0,2.0,2.0,1.0,1.0,23,12,11,5.0,4.0,1.0
9604407,5,3,2,3,0,5,12,21,0.0,0.0,0.0,0.0,0.0,0.0,0.0,9,5,4,4.0,3.0,1.0
106330,6,5,1,1,1,5,27,11,3.0,2.0,1.0,1.0,0.0,3.0,6.0,19,6,13,7.0,3.0,4.0
9906461,4,1,3,5,0,4,26,48,4.0,1.0,3.0,5.0,0.0,4.0,20.0,16,4,12,10.0,4.0,6.0
9903489,19,7,12,33,0,19,61,9,8.0,2.0,6.0,14.0,8.0,0.0,0.0,30,19,11,14.0,12.0,2.0
9802206,13,6,7,11,0,13,91,117,9.0,4.0,5.0,9.0,0.0,9.0,61.0,33,13,20,17.0,6.0,11.0
9603382,5,4,1,1,1,4,5,28,2.0,2.0,0.0,0.0,1.0,1.0,1.0,9,5,4,3.0,3.0,0.0
4034,2,1,1,1,0,2,18,32,0.0,0.0,0.0,0.0,0.0,0.0,0.0,14,2,12,5.0,0.0,5.0
205295,7,4,3,10,0,7,89,0,6.0,3.0,3.0,10.0,0.0,6.0,88.0,47,7,40,35.0,4.0,31.0
7361,1,1,0,0,1,0,0,197,0.0,0.0,0.0,0.0,0.0,0.0,0.0,3,1,2,1.0,0.0,1.0
9506370,13,3,10,27,13,0,0,8,9.0,1.0,8.0,22.0,9.0,0.0,0.0,13,13,0,8.0,8.0,0.0
9509404,6,3,3,3,5,1,1,65,2.0,1.0,1.0,1.0,2.0,0.0,0.0,9,6,3,2.0,2.0,0.0
210265,0,0,0,0,0,0,0,51,0.0,0.0,0.0,0.0,0.0,0.0,0.0,9,0,9,5.0,0.0,5.0
9404255,6,5,1,2,3,3,11,332,4.0,3.0,1.0,1.0,1.0,3.0,11.0,12,6,6,9.0,3.0,6.0
12088,8,3,5,8,2,6,40,0,6.0,2.0,4.0,7.0,1.0,5.0,26.0,41,8,33,15.0,1.0,14.0
112189,8,1,7,12,1,7,22,119,6.0,1.0,5.0,9.0,1.0,5.0,14.0,20,8,12,10.0,6.0,4.0
9612465,0,0,0,0,0,0,0,161,,,,,,,,2,0,2,,,
109162,1,1,0,0,0,1,8,81,1.0,1.0,0.0,0.0,0.0,1.0,8.0,22,1,21,12.0,0.0,12.0
112025,1,1,0,0,0,1,1,31,1.0,1.0,0.0,0.0,1.0,0.0,0.0,11,1,10,3.0,0.0,3.0
9509359,3,3,0,0,1,2,6,15,0.0,0.0,0.0,0.0,0.0,0.0,0.0,7,3,4,1.0,0.0,1.0
9606259,3,3,0,0,1,2,9,531,0.0,0.0,0.0,0.0,0.0,0.0,0.0,10,3,7,,,
4053,8,5,3,3,1,7,39,2,2.0,2.0,0.0,0.0,0.0,2.0,14.0,43,8,35,28.0,1.0,27.0
208016,15,2,13,51,0,15,55,1,12.0,3.0,9.0,38.0,0.0,12.0,22.0,34,15,19,13.0,11.0,2.0
208201,2,2,0,0,1,1,12,29,1.0,1.0,0.0,0.0,0.0,1.0,11.0,18,2,16,13.0,1.0,12.0
110081,11,7,4,10,4,7,34,31,0.0,0.0,0.0,0.0,0.0,0.0,0.0,37,11,26,6.0,1.0,5.0
9404203,1,1,0,0,1,0,0,1168,,,,,,,,1,1,0,,,
9310231,2,1,1,1,0,2,2,293,2.0,1.0,1.0,1.0,0.0,2.0,2.0,3,2,1,3.0,2.0,1.0
2142,5,4,1,1,0,5,18,35,0.0,0.0,0.0,0.0,0.0,0.0,0.0,33,5,28,7.0,3.0,4.0
9903296,1,1,0,0,1,0,0,259,0.0,0.0,0.0,0.0,0.0,0.0,0.0,3,1,2,1.0,0.0,1.0
9706220,6,4,2,2,1,5,30,36,5.0,3.0,2.0,2.0,0.0,5.0,30.0,35,6,29,21.0,1.0,20.0
102321,19,3,16,61,0,19,322,11,17.0,2.0,15.0,58.0,0.0,17.0,293.0,57,19,38,42.0,16.0,26.0
9410321,7,2,5,8,0,7,15,54,5.0,2.0,3.0,5.0,0.0,5.0,9.0,13,7,6,2.0,1.0,1.0
203126,9,3,6,10,2,7,53,37,3.0,1.0,2.0,3.0,0.0,3.0,38.0,35,9,26,16.0,3.0,13.0
209208,13,6,7,13,0,13,119,1,7.0,3.0,4.0,6.0,0.0,7.0,65.0,35,13,22,15.0,5.0,10.0
210372,3,2,1,1,0,3,6,4,2.0,1.0,1.0,1.0,2.0,0.0,0.0,11,3,8,,,
9903245,16,3,13,25,1,15,120,12,8.0,1.0,7.0,15.0,0.0,8.0,83.0,49,16,33,26.0,6.0,20.0
9805353,7,3,4,7,0,7,27,66,6.0,2.0,4.0,7.0,0.0,6.0,16.0,17,7,10,8.0,5.0,3.0
9705406,13,7,6,11,2,11,35,87,5.0,3.0,2.0,2.0,0.0,5.0,23.0,23,13,10,11.0,5.0,6.0
1218,10,7,3,3,0,10,62,53,6.0,4.0,2.0,2.0,0.0,6.0,44.0,29,10,19,17.0,4.0,13.0
9508348,1,1,0,0,1,0,0,1689,1.0,1.0,0.0,0.0,1.0,0.0,0.0,1,1,0,,,
207010,12,6,6,7,1,11,80,4,4.0,1.0,3.0,3.0,0.0,4.0,40.0,51,12,39,5.0,1.0,4.0
9603231,1,1,0,0,0,1,1,16,0.0,0.0,0.0,0.0,0.0,0.0,0.0,8,1,7,1.0,0.0,1.0
9502409,6,5,1,1,6,0,0,156,1.0,1.0,0.0,0.0,1.0,0.0,0.0,7,6,1,2.0,2.0,0.0
9402232,0,0,0,0,0,0,0,207,0.0,0.0,0.0,0.0,0.0,0.0,0.0,15,0,15,1.0,0.0,1.0
110210,1,1,0,0,0,1,2,2044,,,,,,,,6,1,5,1.0,0.0,1.0
9506389,4,2,2,5,0,4,4,268,4.0,2.0,2.0,5.0,0.0,4.0,4.0,6,4,2,5.0,4.0,1.0
203133,1,1,0,0,0,1,4,21,1.0,1.0,0.0,0.0,1.0,0.0,0.0,18,1,17,2.0,1.0,1.0
107073,5,3,2,2,0,5,24,27,2.0,2.0,0.0,0.0,0.0,2.0,12.0,28,5,23,4.0,2.0,2.0
110087,3,3,0,0,0,3,21,7,0.0,0.0,0.0,0.0,0.0,0.0,0.0,96,3,93,19.0,0.0,19.0
202232,1,1,0,0,1,0,0,431,0.0,0.0,0.0,0.0,0.0,0.0,0.0,9,1,8,1.0,0.0,1.0
202055,1,1,0,0,0,1,3,3,0.0,0.0,0.0,0.0,0.0,0.0,0.0,24,1,23,2.0,0.0,2.0
203270,16,2,14,37,0,16,142,4,9.0,2.0,7.0,16.0,0.0,9.0,50.0,53,16,37,10.0,4.0,6.0
106012,66,22,44,110,1,65,742,9,40.0,8.0,32.0,86.0,0.0,40.0,513.0,176,66,110,43.0,7.0,36.0
103119,22,7,15,35,1,21,69,129,13.0,4.0,9.0,18.0,0.0,13.0,42.0,43,22,21,10.0,3.0,7.0
3124,2,2,0,0,0,2,11,17,1.0,1.0,0.0,0.0,0.0,1.0,10.0,14,2,12,2.0,1.0,1.0
11209,4,2,2,2,2,2,7,289,3.0,1.0,2.0,2.0,1.0,2.0,5.0,17,4,13,6.0,3.0,3.0
9902264,2,2,0,0,1,1,1,387,1.0,1.0,0.0,0.0,1.0,0.0,0.0,4,2,2,1.0,1.0,0.0
9910423,7,2,5,9,1,6,25,145,6.0,1.0,5.0,9.0,0.0,6.0,19.0,22,7,15,11.0,6.0,5.0
9910415,5,3,2,2,1,4,46,34,4.0,2.0,2.0,2.0,0.0,4.0,42.0,26,5,21,6.0,0.0,6.0
9297,9,5,4,5,0,9,88,27,4.0,3.0,1.0,1.0,0.0,4.0,45.0,40,9,31,9.0,2.0,7.0
9906289,2,2,0,0,1,1,9,14,1.0,1.0,0.0,0.0,0.0,1.0,7.0,40,2,38,5.0,0.0,5.0
9308358,3,1,2,2,0,3,3,108,3.0,1.0,2.0,2.0,0.0,3.0,3.0,4,3,1,4.0,3.0,1.0
110157,2,2,0,0,0,2,22,23,1.0,1.0,0.0,0.0,0.0,1.0,7.0,29,2,27,5.0,0.0,5.0
9405220,12,5,7,18,6,6,6,103,11.0,4.0,7.0,18.0,5.0,6.0,6.0,13,12,1,7.0,6.0,1.0
9408286,2,1,1,1,0,2,5,40,,,,,,,,5,2,3,1.0,1.0,0.0
204357,3,1,2,2,2,1,1,28,,,,,,,,4,3,1,,,
9710429,2,2,0,0,1,1,3,49,0.0,0.0,0.0,0.0,0.0,0.0,0.0,17,2,15,4.0,0.0,4.0
9809477,1,1,0,0,0,1,3,167,0.0,0.0,0.0,0.0,0.0,0.0,0.0,15,1,14,9.0,0.0,9.0
9709353,24,6,18,38,4,20,64,117,19.0,4.0,15.0,34.0,1.0,18.0,62.0,34,24,10,19.0,14.0,5.0
9802311,2,2,0,0,1,1,2,103,1.0,1.0,0.0,0.0,0.0,1.0,2.0,9,2,7,2.0,1.0,1.0
206143,2,1,1,1,0,2,13,32,2.0,1.0,1.0,1.0,0.0,2.0,13.0,22,2,20,3.0,0.0,3.0
9808384,1,1,0,0,0,1,7,43,1.0,1.0,0.0,0.0,0.0,1.0,7.0,12,1,11,1.0,0.0,1.0
9411264,1,1,0,0,1,0,0,6,,,,,,,,11,1,10,1.0,0.0,1.0
9711338,3,3,0,0,2,1,2,85,0.0,0.0,0.0,0.0,0.0,0.0,0.0,15,3,12,4.0,0.0,4.0
9501410,2,1,1,1,2,0,0,802,1.0,1.0,0.0,0.0,1.0,0.0,0.0,2,2,0,1.0,1.0,0.0
9909269,3,2,1,2,0,3,11,66,1.0,1.0,0.0,0.0,0.0,1.0,5.0,9,3,6,6.0,1.0,5.0
9711458,7,6,1,1,5,2,2,110,3.0,3.0,0.0,0.0,3.0,0.0,0.0,9,7,2,4.0,3.0,1.0
9503444,9,6,3,5,3,6,6,304,5.0,2.0,3.0,5.0,5.0,0.0,0.0,11,9,2,4.0,4.0,0.0
9612473,1,1,0,0,0,1,2,13,,,,,,,,6,1,5,,,
9805361,5,2,3,7,0,5,29,137,5.0,2.0,3.0,7.0,0.0,5.0,29.0,21,5,16,15.0,3.0,12.0
9701402,1,1,0,0,1,0,0,756,0.0,0.0,0.0,0.0,0.0,0.0,0.0,2,1,1,,,
7209,4,3,1,1,4,0,0,20,2.0,1.0,1.0,1.0,2.0,0.0,0.0,7,4,3,1.0,0.0,1.0
9404356,12,4,8,19,2,10,22,40,7.0,2.0,5.0,15.0,7.0,0.0,0.0,18,12,6,6.0,6.0,0.0
9802308,40,7,33,88,5,35,178,29,16.0,3.0,13.0,34.0,0.0,16.0,68.0,63,40,23,15.0,11.0,4.0
105146,6,6,0,0,0,6,24,16,3.0,3.0,0.0,0.0,0.0,3.0,16.0,23,6,17,11.0,3.0,8.0
9810312,3,3,0,0,2,1,1,88,2.0,2.0,0.0,0.0,1.0,1.0,1.0,8,3,5,4.0,1.0,3.0
204277,9,2,7,14,0,9,96,11,6.0,2.0,4.0,6.0,0.0,6.0,83.0,47,9,38,28.0,5.0,23.0
9505406,3,1,2,3,0,3,5,44,3.0,1.0,2.0,3.0,0.0,3.0,5.0,5,3,2,2.0,1.0,1.0
7015,4,1,3,4,0,4,27,103,4.0,1.0,3.0,4.0,0.0,4.0,26.0,12,4,8,9.0,4.0,5.0
9402313,1,1,0,0,1,0,0,75,,,,,,,,3,1,2,1.0,1.0,0.0
9902472,1,1,0,0,0,1,16,2,1.0,1.0,0.0,0.0,0.0,1.0,16.0,27,1,26,3.0,0.0,3.0
9811380,5,3,2,3,0,5,12,106,4.0,2.0,2.0,3.0,4.0,0.0,0.0,13,5,8,4.0,3.0,1.0
9304243,7,7,0,0,7,0,0,406,3.0,3.0,0.0,0.0,3.0,0.0,0.0,7,7,0,2.0,2.0,0.0
9309230,3,2,1,1,3,0,0,85,0.0,0.0,0.0,0.0,0.0,0.0,0.0,5,3,2,1.0,0.0,1.0
9304207,9,5,4,5,9,0,0,25,3.0,1.0,2.0,2.0,3.0,0.0,0.0,9,9,0,3.0,3.0,0.0
302102,2,2,0,0,0,2,23,4,1.0,1.0,0.0,0.0,0.0,1.0,11.0,48,2,46,9.0,0.0,9.0
210038,6,2,4,11,0,6,25,4,2.0,1.0,1.0,1.0,0.0,2.0,12.0,33,6,27,8.0,6.0,2.0
9206251,1,1,0,0,1,0,0,125,,,,,,,,1,1,0,,,
205254,8,5,3,4,0,8,82,7,2.0,2.0,0.0,0.0,0.0,2.0,9.0,31,8,23,11.0,3.0,8.0
203110,3,3,0,0,0,3,44,55,3.0,3.0,0.0,0.0,0.0,3.0,42.0,28,3,25,22.0,3.0,19.0
9903438,2,1,1,1,0,2,2,44,0.0,0.0,0.0,0.0,0.0,0.0,0.0,4,2,2,1.0,0.0,1.0
106066,11,8,3,4,1,10,23,64,9.0,6.0,3.0,4.0,1.0,8.0,19.0,18,11,7,7.0,4.0,3.0
9806248,5,2,3,5,1,4,8,31,0.0,0.0,0.0,0.0,0.0,0.0,0.0,15,5,10,2.0,2.0,0.0
9806443,1,1,0,0,1,0,0,62,0.0,0.0,0.0,0.0,0.0,0.0,0.0,4,1,3,2.0,0.0,2.0
9707346,3,3,0,0,2,1,1,106,1.0,1.0,0.0,0.0,1.0,0.0,0.0,4,3,1,1.0,1.0,0.0
9907567,15,3,12,25,2,13,35,45,8.0,2.0,6.0,12.0,0.0,8.0,15.0,23,15,8,12.0,9.0,3.0
9812313,4,3,1,2,0,4,25,29,3.0,2.0,1.0,2.0,0.0,3.0,7.0,23,4,19,9.0,1.0,8.0
204328,5,3,2,2,0,5,45,59,3.0,1.0,2.0,2.0,0.0,3.0,29.0,36,5,31,20.0,1.0,19.0
103165,5,4,1,1,0,5,26,3,1.0,1.0,0.0,0.0,0.0,1.0,2.0,29,5,24,8.0,1.0,7.0
9507222,15,2,13,32,3,12,18,133,10.0,2.0,8.0,14.0,0.0,10.0,10.0,18,15,3,8.0,7.0,1.0
9704451,1,1,0,0,0,1,2,104,1.0,1.0,0.0,0.0,0.0,1.0,1.0,11,1,10,5.0,0.0,5.0
109288,7,6,1,2,3,4,16,18,2.0,2.0,0.0,0.0,2.0,0.0,0.0,20,7,13,1.0,1.0,0.0
202009,12,3,9,21,0,12,75,18,10.0,2.0,8.0,18.0,0.0,10.0,66.0,29,12,17,17.0,9.0,8.0
9804280,1,1,0,0,0,1,8,15,1.0,1.0,0.0,0.0,0.0,1.0,8.0,26,1,25,2.0,0.0,2.0
9603295,2,2,0,0,2,0,0,49,0.0,0.0,0.0,0.0,0.0,0.0,0.0,7,2,5,1.0,0.0,1.0
108231,1,1,0,0,1,0,0,13,0.0,0.0,0.0,0.0,0.0,0.0,0.0,13,1,12,1.0,0.0,1.0
9409411,4,4,0,0,4,0,0,272,2.0,2.0,0.0,0.0,2.0,0.0,0.0,5,4,1,3.0,2.0,1.0
9706407,0,0,0,0,0,0,0,1474,,,,,,,,1,0,1,1.0,0.0,1.0
201170,6,5,1,1,2,4,14,65,4.0,3.0,1.0,1.0,0.0,4.0,13.0,18,6,12,11.0,4.0,7.0
9408227,2,2,0,0,2,0,0,657,1.0,1.0,0.0,0.0,1.0,0.0,0.0,2,2,0,1.0,1.0,0.0
9503462,11,5,6,11,11,0,0,268,6.0,2.0,4.0,9.0,6.0,0.0,0.0,11,11,0,5.0,5.0,0.0
9311310,2,2,0,0,1,1,2,256,0.0,0.0,0.0,0.0,0.0,0.0,0.0,5,2,3,2.0,0.0,2.0
9310202,2,2,0,0,2,0,0,768,1.0,1.0,0.0,0.0,1.0,0.0,0.0,5,2,3,2.0,1.0,1.0
9806211,2,2,0,0,1,1,3,194,1.0,1.0,0.0,0.0,0.0,1.0,2.0,12,2,10,5.0,1.0,4.0
204354,1,1,0,0,0,1,3,95,1.0,1.0,0.0,0.0,0.0,1.0,2.0,18,1,17,4.0,1.0,3.0
9707366,4,4,0,0,0,4,13,8,0.0,0.0,0.0,0.0,0.0,0.0,0.0,23,4,19,5.0,1.0,4.0
9210275,1,1,0,0,1,0,0,653,1.0,1.0,0.0,0.0,1.0,0.0,0.0,2,1,1,1.0,1.0,0.0
9411412,1,1,0,0,1,0,0,220,1.0,1.0,0.0,0.0,1.0,0.0,0.0,2,1,1,1.0,0.0,1.0
9410227,5,4,1,1,5,0,0,444,2.0,2.0,0.0,0.0,2.0,0.0,0.0,6,5,1,2.0,2.0,0.0
9807482,8,5,3,4,5,3,3,42,5.0,3.0,2.0,3.0,5.0,0.0,0.0,9,8,1,3.0,3.0,0.0
9611466,1,1,0,0,1,0,0,253,1.0,1.0,0.0,0.0,1.0,0.0,0.0,5,1,4,1.0,1.0,0.0
9906500,5,3,2,3,1,4,9,185,4.0,2.0,2.0,3.0,0.0,4.0,4.0,20,5,15,4.0,3.0,1.0
9611398,11,2,9,21,1,10,28,137,10.0,2.0,8.0,20.0,0.0,10.0,28.0,14,11,3,13.0,10.0,3.0
205051,3,3,0,0,2,1,4,28,1.0,1.0,0.0,0.0,0.0,1.0,4.0,29,3,26,10.0,1.0,9.0
9409402,5,3,2,2,5,0,0,125,1.0,1.0,0.0,0.0,1.0,0.0,0.0,5,5,0,,,
9910521,6,3,3,5,1,5,6,24,0.0,0.0,0.0,0.0,0.0,0.0,0.0,28,6,22,3.0,2.0,1.0
9710291,1,1,0,0,0,1,4,17,1.0,1.0,0.0,0.0,1.0,0.0,0.0,5,1,4,1.0,0.0,1.0
9512330,4,3,1,1,0,4,21,133,2.0,1.0,1.0,1.0,0.0,2.0,4.0,22,4,18,5.0,2.0,3.0
9710287,9,2,7,16,9,0,0,7,7.0,1.0,6.0,12.0,7.0,0.0,0.0,9,9,0,6.0,6.0,0.0
9903444,3,2,1,1,0,3,7,111,3.0,2.0,1.0,1.0,0.0,3.0,4.0,6,3,3,4.0,3.0,1.0
9511440,7,3,4,8,6,1,1,328,5.0,1.0,4.0,8.0,5.0,0.0,0.0,8,7,1,5.0,5.0,0.0
9601335,4,3,1,1,0,4,11,16,3.0,3.0,0.0,0.0,0.0,3.0,3.0,11,4,7,4.0,2.0,2.0
107192,4,2,2,2,1,3,4,293,2.0,1.0,1.0,1.0,1.0,1.0,1.0,13,4,9,3.0,2.0,1.0
103212,3,2,1,2,0,3,6,139,1.0,1.0,0.0,0.0,0.0,1.0,2.0,5,3,2,3.0,1.0,2.0
112283,7,3,4,5,0,7,67,16,6.0,2.0,4.0,5.0,0.0,6.0,59.0,25,7,18,12.0,5.0,7.0
209066,3,2,1,1,0,3,8,46,2.0,1.0,1.0,1.0,0.0,2.0,7.0,16,3,13,,,
111394,1,1,0,0,1,0,0,64,0.0,0.0,0.0,0.0,0.0,0.0,0.0,8,1,7,5.0,0.0,5.0
9512213,5,2,3,4,0,5,41,8,3.0,2.0,1.0,1.0,0.0,3.0,8.0,21,5,16,2.0,1.0,1.0
9809393,5,2,3,5,0,5,27,29,3.0,1.0,2.0,3.0,0.0,3.0,16.0,18,5,13,12.0,4.0,8.0
212001,1,1,0,0,1,0,0,593,0.0,0.0,0.0,0.0,0.0,0.0,0.0,7,1,6,3.0,0.0,3.0
9211252,5,2,3,4,5,0,0,102,4.0,2.0,2.0,2.0,4.0,0.0,0.0,5,5,0,3.0,3.0,0.0
9605403,2,2,0,0,2,0,0,114,0.0,0.0,0.0,0.0,0.0,0.0,0.0,9,2,7,1.0,1.0,0.0
9606440,6,5,1,2,0,6,28,113,3.0,2.0,1.0,2.0,0.0,3.0,12.0,18,6,12,8.0,2.0,6.0
205191,1,1,0,0,0,1,8,28,1.0,1.0,0.0,0.0,0.0,1.0,7.0,20,1,19,9.0,1.0,8.0
101179,3,3,0,0,0,3,6,115,0.0,0.0,0.0,0.0,0.0,0.0,0.0,16,3,13,1.0,1.0,0.0
9708477,7,3,4,8,5,2,8,7,2.0,2.0,0.0,0.0,2.0,0.0,0.0,13,7,6,3.0,3.0,0.0
110156,4,2,2,3,1,3,15,31,3.0,1.0,2.0,2.0,0.0,3.0,5.0,37,4,33,4.0,3.0,1.0
9710285,2,2,0,0,0,2,6,124,0.0,0.0,0.0,0.0,0.0,0.0,0.0,10,2,8,2.0,1.0,1.0
9910227,7,6,1,1,3,4,4,333,2.0,2.0,0.0,0.0,0.0,2.0,2.0,11,7,4,1.0,1.0,0.0
2212,7,2,5,11,1,6,25,2,6.0,1.0,5.0,11.0,5.0,1.0,1.0,18,7,11,7.0,6.0,1.0
210127,2,2,0,0,0,2,22,1,2.0,2.0,0.0,0.0,0.0,2.0,22.0,24,2,22,14.0,1.0,13.0
9712500,2,1,1,1,2,0,0,506,0.0,0.0,0.0,0.0,0.0,0.0,0.0,6,2,4,2.0,0.0,2.0
109211,1,1,0,0,0,1,6,125,0.0,0.0,0.0,0.0,0.0,0.0,0.0,9,1,8,8.0,0.0,8.0
5078,1,1,0,0,0,1,1,252,1.0,1.0,0.0,0.0,0.0,1.0,1.0,11,1,10,3.0,1.0,2.0
9902405,5,1,4,6,0,5,23,10,5.0,1.0,4.0,6.0,5.0,0.0,0.0,13,5,8,9.0,5.0,4.0
110225,3,3,0,0,2,1,2,780,2.0,2.0,0.0,0.0,1.0,1.0,1.0,5,3,2,1.0,1.0,0.0
10132,0,0,0,0,0,0,0,27,,,,,,,,5,0,5,1.0,0.0,1.0
207247,2,1,1,1,0,2,32,12,0.0,0.0,0.0,0.0,0.0,0.0,0.0,54,2,52,10.0,1.0,9.0
9709457,13,1,12,34,0,13,69,6,6.0,4.0,2.0,2.0,6.0,0.0,0.0,23,13,10,16.0,13.0,3.0
9610281,6,6,0,0,4,2,2,122,2.0,2.0,0.0,0.0,0.0,2.0,2.0,10,6,4,3.0,2.0,1.0
9309251,5,2,3,4,5,0,0,163,5.0,2.0,3.0,4.0,5.0,0.0,0.0,6,5,1,5.0,5.0,0.0
9406410,1,1,0,0,1,0,0,295,1.0,1.0,0.0,0.0,1.0,0.0,0.0,2,1,1,1.0,0.0,1.0
9604255,6,2,4,9,0,6,9,147,5.0,1.0,4.0,9.0,0.0,5.0,8.0,9,6,3,7.0,5.0,2.0
9611444,4,2,2,3,0,4,6,57,4.0,2.0,2.0,3.0,1.0,3.0,3.0,7,4,3,3.0,3.0,0.0
101080,1,1,0,0,0,1,4,9,0.0,0.0,0.0,0.0,0.0,0.0,0.0,26,1,25,6.0,0.0,6.0
9212316,3,2,1,1,3,0,0,196,2.0,2.0,0.0,0.0,2.0,0.0,0.0,3,3,0,1.0,1.0,0.0
9908251,1,1,0,0,1,0,0,168,0.0,0.0,0.0,0.0,0.0,0.0,0.0,18,1,17,4.0,0.0,4.0
211131,0,0,0,0,0,0,0,7,0.0,0.0,0.0,0.0,0.0,0.0,0.0,25,0,25,15.0,0.0,15.0
7111,13,8,5,6,0,13,39,57,6.0,3.0,3.0,4.0,0.0,6.0,7.0,29,13,16,6.0,3.0,3.0
203142,1,1,0,0,1,0,0,99,0.0,0.0,0.0,0.0,0.0,0.0,0.0,18,1,17,6.0,0.0,6.0
112009,1,1,0,0,0,1,2,73,0.0,0.0,0.0,0.0,0.0,0.0,0.0,33,1,32,13.0,0.0,13.0
9309323,7,4,3,5,7,0,0,40,2.0,2.0,0.0,0.0,2.0,0.0,0.0,7,7,0,2.0,2.0,0.0
107116,3,1,2,3,0,3,32,11,3.0,1.0,2.0,3.0,0.0,3.0,19.0,37,3,34,12.0,2.0,10.0
205105,4,2,2,3,0,4,22,80,1.0,1.0,0.0,0.0,0.0,1.0,6.0,14,4,10,8.0,2.0,6.0
9811246,3,3,0,0,1,2,6,40,,,,,,,,9,3,6,1.0,1.0,0.0
9612487,2,1,1,1,0,2,6,123,2.0,1.0,1.0,1.0,0.0,2.0,4.0,8,2,6,4.0,1.0,3.0
208234,3,3,0,0,1,2,3,86,0.0,0.0,0.0,0.0,0.0,0.0,0.0,12,3,9,6.0,0.0,6.0
9811457,6,5,1,1,0,6,28,7,1.0,1.0,0.0,0.0,1.0,0.0,0.0,24,6,18,1.0,0.0,1.0
9803347,8,3,5,7,3,5,9,147,6.0,3.0,3.0,5.0,6.0,0.0,0.0,11,8,3,3.0,3.0,0.0
204088,5,3,2,2,0,5,12,65,4.0,2.0,2.0,2.0,0.0,4.0,10.0,16,5,11,9.0,4.0,5.0
104049,11,4,7,11,2,9,49,30,6.0,2.0,4.0,7.0,0.0,6.0,32.0,28,11,17,12.0,5.0,7.0
9014,4,2,2,2,1,3,34,24,3.0,1.0,2.0,2.0,0.0,3.0,28.0,43,4,39,17.0,0.0,17.0
204184,3,3,0,0,0,3,13,112,3.0,3.0,0.0,0.0,0.0,3.0,10.0,12,3,9,8.0,3.0,5.0
203168,1,1,0,0,1,0,0,107,0.0,0.0,0.0,0.0,0.0,0.0,0.0,6,1,5,1.0,0.0,1.0
106107,3,1,2,2,1,2,2,46,0.0,0.0,0.0,0.0,0.0,0.0,0.0,16,3,13,3.0,3.0,0.0
11280,1,1,0,0,0,1,5,9,0.0,0.0,0.0,0.0,0.0,0.0,0.0,22,1,21,8.0,0.0,8.0
9903254,4,2,2,3,0,4,4,137,4.0,2.0,2.0,3.0,0.0,4.0,4.0,8,4,4,4.0,3.0,1.0
9303254,3,2,1,1,3,0,0,2009,1.0,1.0,0.0,0.0,1.0,0.0,0.0,3,3,0,1.0,1.0,0.0
9803413,0,0,0,0,0,0,0,195,0.0,0.0,0.0,0.0,0.0,0.0,0.0,1,0,1,,,
9211205,2,1,1,1,2,0,0,231,2.0,1.0,1.0,1.0,2.0,0.0,0.0,2,2,0,1.0,1.0,0.0
108237,1,1,0,0,0,1,1,29,1.0,1.0,0.0,0.0,0.0,1.0,1.0,9,1,8,2.0,1.0,1.0
9805457,3,2,1,1,0,3,16,5,1.0,1.0,0.0,0.0,0.0,1.0,13.0,26,3,23,11.0,0.0,11.0
111421,1,1,0,0,1,0,0,1948,0.0,0.0,0.0,0.0,0.0,0.0,0.0,3,1,2,,,
9409422,2,2,0,0,2,0,0,438,2.0,2.0,0.0,0.0,2.0,0.0,0.0,5,2,3,2.0,2.0,0.0
211247,0,0,0,0,0,0,0,165,0.0,0.0,0.0,0.0,0.0,0.0,0.0,20,0,20,15.0,0.0,15.0
6210,4,2,2,2,0,4,4,70,3.0,2.0,1.0,1.0,3.0,0.0,0.0,6,4,2,5.0,4.0,1.0
9709459,1,1,0,0,0,1,3,13,1.0,1.0,0.0,0.0,0.0,1.0,3.0,9,1,8,3.0,1.0,2.0
110038,5,2,3,4,5,0,0,77,3.0,1.0,2.0,3.0,3.0,0.0,0.0,10,5,5,1.0,0.0,1.0
9702284,4,2,2,2,1,3,8,148,4.0,2.0,2.0,2.0,1.0,3.0,8.0,8,4,4,5.0,4.0,1.0
9905336,2,2,0,0,0,2,6,27,1.0,1.0,0.0,0.0,0.0,1.0,5.0,13,2,11,3.0,0.0,3.0
9405363,0,0,0,0,0,0,0,479,0.0,0.0,0.0,0.0,0.0,0.0,0.0,3,0,3,1.0,0.0,1.0
9608432,1,1,0,0,0,1,4,70,1.0,1.0,0.0,0.0,1.0,0.0,0.0,5,1,4,1.0,1.0,0.0
9907411,3,2,1,1,2,1,1,271,2.0,1.0,1.0,1.0,2.0,0.0,0.0,4,3,1,2.0,2.0,0.0
9305338,5,2,3,4,5,0,0,173,4.0,2.0,2.0,2.0,4.0,0.0,0.0,5,5,0,2.0,2.0,0.0
9812327,1,1,0,0,0,1,1,125,0.0,0.0,0.0,0.0,0.0,0.0,0.0,7,1,6,1.0,0.0,1.0
9712229,3,2,1,1,1,2,12,31,3.0,2.0,1.0,1.0,1.0,2.0,10.0,11,3,8,2.0,2.0,0.0
9608323,1,1,0,0,0,1,2,10,1.0,1.0,0.0,0.0,0.0,1.0,1.0,13,1,12,1.0,0.0,1.0
205085,11,5,6,11,0,11,129,38,10.0,4.0,6.0,11.0,0.0,10.0,118.0,40,11,29,32.0,9.0,23.0
9601238,3,3,0,0,3,0,0,249,0.0,0.0,0.0,0.0,0.0,0.0,0.0,7,3,4,4.0,0.0,4.0
9810233,4,3,1,1,2,2,6,3,2.0,1.0,1.0,1.0,2.0,0.0,0.0,14,4,10,3.0,2.0,1.0
203059,5,1,4,5,0,5,29,65,3.0,1.0,2.0,2.0,0.0,3.0,23.0,26,5,21,12.0,3.0,9.0
9610538,5,3,2,3,5,0,0,161,3.0,1.0,2.0,3.0,3.0,0.0,0.0,9,5,4,1.0,1.0,0.0
3056,1,1,0,0,0,1,2,144,0.0,0.0,0.0,0.0,0.0,0.0,0.0,9,1,8,5.0,0.0,5.0
301056,0,0,0,0,0,0,0,7,0.0,0.0,0.0,0.0,0.0,0.0,0.0,13,0,13,7.0,0.0,7.0
9906468,6,2,4,8,1,5,10,161,5.0,1.0,4.0,8.0,0.0,5.0,10.0,13,6,7,7.0,5.0,2.0
5096,2,1,1,1,0,2,37,11,2.0,1.0,1.0,1.0,0.0,2.0,29.0,62,2,60,11.0,1.0,10.0
209233,5,4,1,1,0,5,59,1,4.0,3.0,1.0,1.0,0.0,4.0,45.0,45,5,40,10.0,1.0,9.0
109014,2,1,1,1,2,0,0,82,,,,,,,,2,2,0,,,
9712475,1,1,0,0,1,0,0,184,0.0,0.0,0.0,0.0,0.0,0.0,0.0,9,1,8,1.0,0.0,1.0
9263,1,1,0,0,1,0,0,67,,,,,,,,4,1,3,1.0,1.0,0.0
9711314,3,3,0,0,1,2,16,134,0.0,0.0,0.0,0.0,0.0,0.0,0.0,34,3,31,17.0,0.0,17.0
9807539,1,1,0,0,1,0,0,31,0.0,0.0,0.0,0.0,0.0,0.0,0.0,4,1,3,1.0,0.0,1.0
9809314,2,2,0,0,0,2,4,45,1.0,1.0,0.0,0.0,0.0,1.0,1.0,6,2,4,3.0,1.0,2.0
9809465,7,1,6,13,6,1,1,262,7.0,1.0,6.0,13.0,7.0,0.0,0.0,8,7,1,7.0,7.0,0.0
9306206,2,2,0,0,2,0,0,269,1.0,1.0,0.0,0.0,1.0,0.0,0.0,2,2,0,1.0,1.0,0.0
106056,2,2,0,0,0,2,3,61,0.0,0.0,0.0,0.0,0.0,0.0,0.0,33,2,31,6.0,0.0,6.0
12122,0,0,0,0,0,0,0,18,,,,,,,,5,0,5,,,
9705457,2,2,0,0,0,2,6,5,2.0,2.0,0.0,0.0,0.0,2.0,6.0,14,2,12,1.0,1.0,0.0
212181,2,2,0,0,0,2,7,17,2.0,2.0,0.0,0.0,0.0,2.0,5.0,11,2,9,8.0,2.0,6.0
10254,5,3,2,2,0,5,18,44,3.0,3.0,0.0,0.0,0.0,3.0,11.0,14,5,9,11.0,3.0,8.0
206212,0,0,0,0,0,0,0,123,0.0,0.0,0.0,0.0,0.0,0.0,0.0,4,0,4,1.0,0.0,1.0
112001,2,2,0,0,0,2,8,92,0.0,0.0,0.0,0.0,0.0,0.0,0.0,10,2,8,4.0,1.0,3.0
9607486,5,1,4,6,1,4,4,118,4.0,1.0,3.0,5.0,0.0,4.0,4.0,7,5,2,5.0,4.0,1.0
108054,4,2,2,3,0,4,29,1,3.0,1.0,2.0,3.0,0.0,3.0,10.0,28,4,24,9.0,4.0,5.0
9711274,2,2,0,0,1,1,2,365,1.0,1.0,0.0,0.0,0.0,1.0,1.0,8,2,6,1.0,0.0,1.0
9909246,8,2,6,12,1,7,24,90,7.0,1.0,6.0,12.0,1.0,6.0,23.0,17,8,9,6.0,5.0,1.0
9808391,2,2,0,0,2,0,0,240,2.0,2.0,0.0,0.0,2.0,0.0,0.0,2,2,0,1.0,1.0,0.0
9901343,1,1,0,0,0,1,8,411,1.0,1.0,0.0,0.0,0.0,1.0,6.0,12,1,11,8.0,1.0,7.0
11272,3,2,1,1,2,1,17,70,1.0,1.0,0.0,0.0,0.0,1.0,17.0,21,3,18,18.0,1.0,17.0
9812262,1,1,0,0,0,1,1,81,1.0,1.0,0.0,0.0,0.0,1.0,1.0,11,1,10,1.0,0.0,1.0
9912262,5,3,2,2,0,5,18,25,3.0,1.0,2.0,2.0,0.0,3.0,11.0,11,5,6,7.0,3.0,4.0
202258,6,1,5,12,0,6,57,2,5.0,1.0,4.0,10.0,0.0,5.0,22.0,26,6,20,11.0,5.0,6.0
9911227,4,3,1,1,3,1,2,96,4.0,3.0,1.0,1.0,3.0,1.0,2.0,12,4,8,7.0,1.0,6.0
211286,2,2,0,0,0,2,5,18,1.0,1.0,0.0,0.0,0.0,1.0,3.0,44,2,42,4.0,0.0,4.0
1232,1,1,0,0,0,1,2,13,1.0,1.0,0.0,0.0,0.0,1.0,2.0,7,1,6,1.0,0.0,1.0
211115,0,0,0,0,0,0,0,73,0.0,0.0,0.0,0.0,0.0,0.0,0.0,14,0,14,,,
9404233,1,1,0,0,0,1,3,15,1.0,1.0,0.0,0.0,0.0,1.0,1.0,4,1,3,1.0,1.0,0.0
9606349,2,2,0,0,2,0,0,338,1.0,1.0,0.0,0.0,1.0,0.0,0.0,3,2,1,1.0,0.0,1.0
9906236,0,0,0,0,0,0,0,8,,,,,,,,5,0,5,,,
9805203,0,0,0,0,0,0,0,247,0.0,0.0,0.0,0.0,0.0,0.0,0.0,2,0,2,2.0,0.0,2.0
9603387,4,3,1,1,3,1,1,203,3.0,2.0,1.0,1.0,2.0,1.0,1.0,10,4,6,4.0,1.0,3.0
102028,3,1,2,3,0,3,4,34,2.0,1.0,1.0,1.0,2.0,0.0,0.0,10,3,7,3.0,3.0,0.0
9605292,2,2,0,0,2,0,0,447,1.0,1.0,0.0,0.0,1.0,0.0,0.0,3,2,1,2.0,1.0,1.0
9609452,1,1,0,0,1,0,0,174,1.0,1.0,0.0,0.0,1.0,0.0,0.0,1,1,0,1.0,1.0,0.0
9902442,2,2,0,0,2,0,0,143,1.0,1.0,0.0,0.0,1.0,0.0,0.0,2,2,0,1.0,1.0,0.0
102260,0,0,0,0,0,0,0,88,0.0,0.0,0.0,0.0,0.0,0.0,0.0,4,0,4,1.0,0.0,1.0
209235,1,1,0,0,0,1,1,64,,,,,,,,2,1,1,1.0,1.0,0.0
211409,0,0,0,0,0,0,0,2,0.0,0.0,0.0,0.0,0.0,0.0,0.0,9,0,9,1.0,0.0,1.0
2129,3,3,0,0,0,3,23,2,1.0,1.0,0.0,0.0,0.0,1.0,15.0,25,3,22,3.0,0.0,3.0
204167,2,2,0,0,1,1,1,24,1.0,1.0,0.0,0.0,0.0,1.0,1.0,6,2,4,2.0,0.0,2.0
9811391,2,2,0,0,2,0,0,392,1.0,1.0,0.0,0.0,1.0,0.0,0.0,3,2,1,1.0,1.0,0.0
201155,4,2,2,3,0,4,25,96,2.0,1.0,1.0,1.0,0.0,2.0,7.0,22,4,18,6.0,2.0,4.0
9412216,2,2,0,0,2,0,0,369,1.0,1.0,0.0,0.0,1.0,0.0,0.0,3,2,1,1.0,1.0,0.0
104265,0,0,0,0,0,0,0,45,0.0,0.0,0.0,0.0,0.0,0.0,0.0,2,0,2,,,
212113,4,4,0,0,2,2,16,0,0.0,0.0,0.0,0.0,0.0,0.0,0.0,51,4,47,20.0,0.0,20.0
9803240,1,1,0,0,0,1,3,111,1.0,1.0,0.0,0.0,0.0,1.0,1.0,6,1,5,1.0,0.0,1.0
9811419,0,0,0,0,0,0,0,0,0.0,0.0,0.0,0.0,0.0,0.0,0.0,34,0,34,4.0,0.0,4.0
9812321,2,2,0,0,0,2,2,149,2.0,2.0,0.0,0.0,0.0,2.0,2.0,3,2,1,3.0,2.0,1.0
1030,2,2,0,0,0,2,12,114,1.0,1.0,0.0,0.0,0.0,1.0,6.0,17,2,15,7.0,0.0,7.0
210172,3,2,1,2,1,2,5,128,2.0,1.0,1.0,1.0,1.0,1.0,1.0,8,3,5,3.0,1.0,2.0
9612343,1,1,0,0,0,1,1,759,1.0,1.0,0.0,0.0,0.0,1.0,1.0,2,1,1,2.0,1.0,1.0
110380,0,0,0,0,0,0,0,275,0.0,0.0,0.0,0.0,0.0,0.0,0.0,12,0,12,4.0,0.0,4.0
5283,1,1,0,0,0,1,1,19,0.0,0.0,0.0,0.0,0.0,0.0,0.0,11,1,10,1.0,0.0,1.0
9901271,0,0,0,0,0,0,0,383,0.0,0.0,0.0,0.0,0.0,0.0,0.0,5,0,5,3.0,0.0,3.0
9806227,3,2,1,1,0,3,3,111,1.0,1.0,0.0,0.0,0.0,1.0,1.0,4,3,1,1.0,0.0,1.0
111162,1,1,0,0,0,1,2,311,1.0,1.0,0.0,0.0,0.0,1.0,2.0,4,1,3,4.0,1.0,3.0
106134,0,0,0,0,0,0,0,290,0.0,0.0,0.0,0.0,0.0,0.0,0.0,1,0,1,1.0,0.0,1.0
9903470,2,1,1,1,0,2,22,44,1.0,1.0,0.0,0.0,0.0,1.0,10.0,22,2,20,11.0,0.0,11.0
3304,11,7,4,6,0,11,28,195,10.0,6.0,4.0,6.0,1.0,9.0,9.0,22,11,11,8.0,7.0,1.0
301213,0,0,0,0,0,0,0,79,0.0,0.0,0.0,0.0,0.0,0.0,0.0,11,0,11,3.0,0.0,3.0
9811372,1,1,0,0,0,1,2,136,0.0,0.0,0.0,0.0,0.0,0.0,0.0,7,1,6,2.0,0.0,2.0
204339,3,3,0,0,0,3,16,31,3.0,3.0,0.0,0.0,0.0,3.0,12.0,22,3,19,7.0,2.0,5.0
102190,1,1,0,0,0,1,3,282,1.0,1.0,0.0,0.0,0.0,1.0,2.0,6,1,5,2.0,0.0,2.0
9910203,7,2,5,7,0,7,8,72,6.0,2.0,4.0,5.0,6.0,0.0,0.0,10,7,3,4.0,4.0,0.0
9606455,1,1,0,0,1,0,0,13,0.0,0.0,0.0,0.0,0.0,0.0,0.0,9,1,8,1.0,1.0,0.0
101248,4,2,2,3,0,4,24,8,1.0,1.0,0.0,0.0,0.0,1.0,5.0,36,4,32,2.0,0.0,2.0
9909210,4,3,1,1,0,4,8,34,0.0,0.0,0.0,0.0,0.0,0.0,0.0,13,4,9,6.0,0.0,6.0
110077,2,2,0,0,1,1,8,177,1.0,1.0,0.0,0.0,0.0,1.0,5.0,13,2,11,5.0,0.0,5.0
107109,2,2,0,0,0,2,7,91,2.0,2.0,0.0,0.0,0.0,2.0,7.0,12,2,10,6.0,2.0,4.0
5032,2,1,1,1,2,0,0,566,2.0,1.0,1.0,1.0,2.0,0.0,0.0,2,2,0,2.0,2.0,0.0
9408247,2,2,0,0,2,0,0,230,2.0,2.0,0.0,0.0,2.0,0.0,0.0,2,2,0,2.0,2.0,0.0
209180,8,4,4,5,0,8,23,42,0.0,0.0,0.0,0.0,0.0,0.0,0.0,33,8,25,8.0,0.0,8.0
104270,1,1,0,0,0,1,12,13,1.0,1.0,0.0,0.0,0.0,1.0,12.0,24,1,23,9.0,1.0,8.0
111135,2,1,1,1,2,0,0,185,2.0,1.0,1.0,1.0,2.0,0.0,0.0,7,2,5,2.0,2.0,0.0
212178,1,1,0,0,0,1,15,16,1.0,1.0,0.0,0.0,0.0,1.0,8.0,29,1,28,11.0,1.0,10.0
6004,4,3,1,1,0,4,10,14,1.0,1.0,0.0,0.0,0.0,1.0,1.0,11,4,7,4.0,1.0,3.0
2029,1,1,0,0,0,1,1,620,1.0,1.0,0.0,0.0,0.0,1.0,1.0,5,1,4,1.0,1.0,0.0
110416,1,1,0,0,0,1,5,262,1.0,1.0,0.0,0.0,0.0,1.0,5.0,7,1,6,7.0,1.0,6.0
9911493,4,2,2,3,0,4,4,122,4.0,2.0,2.0,3.0,0.0,4.0,4.0,5,4,1,4.0,3.0,1.0
202144,3,1,2,3,0,3,12,187,3.0,1.0,2.0,3.0,0.0,3.0,12.0,7,3,4,7.0,3.0,4.0
9207252,1,1,0,0,1,0,0,1199,1.0,1.0,0.0,0.0,1.0,0.0,0.0,1,1,0,1.0,1.0,0.0
9274,1,1,0,0,0,1,6,104,1.0,1.0,0.0,0.0,0.0,1.0,5.0,9,1,8,6.0,1.0,5.0
301055,2,1,1,1,0,2,22,193,1.0,1.0,0.0,0.0,0.0,1.0,9.0,15,2,13,10.0,1.0,9.0
9711372,1,1,0,0,1,0,0,69,,,,,,,,4,1,3,,,
6283,1,1,0,0,0,1,7,2,0.0,0.0,0.0,0.0,0.0,0.0,0.0,16,1,15,2.0,1.0,1.0
9310226,0,0,0,0,0,0,0,234,0.0,0.0,0.0,0.0,0.0,0.0,0.0,3,0,3,1.0,0.0,1.0
5180,4,2,2,2,3,1,1,40,0.0,0.0,0.0,0.0,0.0,0.0,0.0,16,4,12,4.0,0.0,4.0
9712288,2,2,0,0,0,2,6,299,1.0,1.0,0.0,0.0,0.0,1.0,5.0,7,2,5,6.0,1.0,5.0
105265,1,1,0,0,0,1,1,0,0.0,0.0,0.0,0.0,0.0,0.0,0.0,34,1,33,16.0,0.0,16.0
102198,0,0,0,0,0,0,0,43,,,,,,,,4,0,4,,,
9505273,7,4,3,4,0,7,7,352,7.0,4.0,3.0,4.0,0.0,7.0,7.0,8,7,1,8.0,7.0,1.0
9311241,1,1,0,0,1,0,0,75,0.0,0.0,0.0,0.0,0.0,0.0,0.0,15,1,14,7.0,0.0,7.0
9811486,1,1,0,0,1,0,0,331,1.0,1.0,0.0,0.0,1.0,0.0,0.0,7,1,6,2.0,1.0,1.0
9410257,2,2,0,0,2,0,0,236,1.0,1.0,0.0,0.0,1.0,0.0,0.0,2,2,0,2.0,2.0,0.0
209071,0,0,0,0,0,0,0,518,0.0,0.0,0.0,0.0,0.0,0.0,0.0,1,0,1,1.0,0.0,1.0
9318,2,2,0,0,0,2,3,334,1.0,1.0,0.0,0.0,0.0,1.0,2.0,23,2,21,3.0,1.0,2.0
8240,3,2,1,1,3,0,0,148,3.0,2.0,1.0,1.0,3.0,0.0,0.0,3,3,0,3.0,3.0,0.0
9804210,5,3,2,2,0,5,40,35,4.0,2.0,2.0,2.0,0.0,4.0,32.0,38,5,33,12.0,2.0,10.0
9912339,0,0,0,0,0,0,0,308,0.0,0.0,0.0,0.0,0.0,0.0,0.0,7,0,7,,,
212250,2,2,0,0,0,2,8,129,0.0,0.0,0.0,0.0,0.0,0.0,0.0,25,2,23,6.0,0.0,6.0
9808390,3,2,1,1,2,1,2,91,1.0,1.0,0.0,0.0,0.0,1.0,2.0,8,3,5,3.0,2.0,1.0
9810217,1,1,0,0,0,1,3,1935,,,,,,,,4,1,3,,,
9706463,2,1,1,1,0,2,4,299,2.0,1.0,1.0,1.0,0.0,2.0,4.0,5,2,3,4.0,2.0,2.0
3247,1,1,0,0,0,1,4,175,1.0,1.0,0.0,0.0,0.0,1.0,4.0,8,1,7,7.0,1.0,6.0
9905471,0,0,0,0,0,0,0,90,0.0,0.0,0.0,0.0,0.0,0.0,0.0,14,0,14,10.0,0.0,10.0
9208,3,3,0,0,3,0,0,250,2.0,2.0,0.0,0.0,2.0,0.0,0.0,3,3,0,2.0,2.0,0.0
107203,1,1,0,0,0,1,6,400,1.0,1.0,0.0,0.0,0.0,1.0,2.0,15,1,14,3.0,1.0,2.0
203170,1,1,0,0,0,1,1,240,0.0,0.0,0.0,0.0,0.0,0.0,0.0,9,1,8,3.0,0.0,3.0
9708418,1,1,0,0,0,1,4,154,1.0,1.0,0.0,0.0,0.0,1.0,4.0,8,1,7,8.0,1.0,7.0
9710203,0,0,0,0,0,0,0,22,0.0,0.0,0.0,0.0,0.0,0.0,0.0,7,0,7,5.0,0.0,5.0
9912414,1,1,0,0,0,1,1,747,,,,,,,,2,1,1,1.0,1.0,0.0
110311,1,1,0,0,0,1,7,209,1.0,1.0,0.0,0.0,0.0,1.0,6.0,15,1,14,10.0,1.0,9.0
9812219,1,1,0,0,1,0,0,35,0.0,0.0,0.0,0.0,0.0,0.0,0.0,18,1,17,6.0,0.0,6.0
210429,2,2,0,0,0,2,17,8,1.0,1.0,0.0,0.0,0.0,1.0,12.0,45,2,43,4.0,1.0,3.0
9603242,3,2,1,1,3,0,0,91,2.0,1.0,1.0,1.0,2.0,0.0,0.0,4,3,1,2.0,2.0,0.0
7123,5,2,3,5,1,4,9,125,4.0,2.0,2.0,3.0,1.0,3.0,3.0,9,5,4,7.0,4.0,3.0
105256,0,0,0,0,0,0,0,79,0.0,0.0,0.0,0.0,0.0,0.0,0.0,9,0,9,6.0,0.0,6.0
7138,0,0,0,0,0,0,0,205,0.0,0.0,0.0,0.0,0.0,0.0,0.0,2,0,2,1.0,0.0,1.0
9601340,0,0,0,0,0,0,0,303,0.0,0.0,0.0,0.0,0.0,0.0,0.0,4,0,4,2.0,0.0,2.0
211463,0,0,0,0,0,0,0,165,0.0,0.0,0.0,0.0,0.0,0.0,0.0,8,0,8,2.0,0.0,2.0
9808402,0,0,0,0,0,0,0,17,0.0,0.0,0.0,0.0,0.0,0.0,0.0,18,0,18,7.0,0.0,7.0
208261,6,2,4,9,0,6,32,2,5.0,1.0,4.0,9.0,0.0,5.0,27.0,26,6,20,12.0,5.0,7.0
301267,0,0,0,0,0,0,0,31,0.0,0.0,0.0,0.0,0.0,0.0,0.0,26,0,26,4.0,0.0,4.0
302205,0,0,0,0,0,0,0,250,0.0,0.0,0.0,0.0,0.0,0.0,0.0,11,0,11,1.0,0.0,1.0
105271,0,0,0,0,0,0,0,122,0.0,0.0,0.0,0.0,0.0,0.0,0.0,16,0,16,11.0,0.0,11.0
211114,0,0,0,0,0,0,0,12,,,,,,,,11,0,11,,,
110333,5,4,1,1,1,4,22,89,2.0,1.0,1.0,1.0,0.0,2.0,12.0,22,5,17,5.0,3.0,2.0
209354,4,4,0,0,4,0,0,145,1.0,1.0,0.0,0.0,1.0,0.0,0.0,4,4,0,2.0,2.0,0.0
9906239,3,1,2,3,3,0,0,128,3.0,1.0,2.0,3.0,3.0,0.0,0.0,3,3,0,3.0,3.0,0.0
202027,3,2,1,1,1,2,9,104,2.0,1.0,1.0,1.0,0.0,2.0,7.0,11,3,8,6.0,2.0,4.0
103309,3,1,2,2,0,3,14,95,3.0,1.0,2.0,2.0,0.0,3.0,11.0,14,3,11,4.0,3.0,1.0
9805226,0,0,0,0,0,0,0,9,0.0,0.0,0.0,0.0,0.0,0.0,0.0,13,0,13,1.0,0.0,1.0
9805313,0,0,0,0,0,0,0,157,0.0,0.0,0.0,0.0,0.0,0.0,0.0,6,0,6,4.0,0.0,4.0
211350,0,0,0,0,0,0,0,1322,,,,,,,,2,0,2,1.0,0.0,1.0
9704293,2,2,0,0,0,2,3,79,2.0,2.0,0.0,0.0,0.0,2.0,3.0,4,2,2,4.0,2.0,2.0
212017,0,0,0,0,0,0,0,9,0.0,0.0,0.0,0.0,0.0,0.0,0.0,36,0,36,26.0,0.0,26.0
9409268,0,0,0,0,0,0,0,1608,,,,,,,,1,0,1,,,
9503426,0,0,0,0,0,0,0,238,0.0,0.0,0.0,0.0,0.0,0.0,0.0,5,0,5,2.0,0.0,2.0
12249,1,1,0,0,0,1,6,16,1.0,1.0,0.0,0.0,0.0,1.0,1.0,44,1,43,3.0,0.0,3.0
102002,0,0,0,0,0,0,0,988,,,,,,,,1,0,1,,,
9807370,0,0,0,0,0,0,0,82,,,,,,,,5,0,5,,,
212389,0,0,0,0,0,0,0,24,0.0,0.0,0.0,0.0,0.0,0.0,0.0,22,0,22,10.0,0.0,10.0
8055,0,0,0,0,0,0,0,140,0.0,0.0,0.0,0.0,0.0,0.0,0.0,3,0,3,1.0,0.0,1.0
208187,1,1,0,0,1,0,0,19,0.0,0.0,0.0,0.0,0.0,0.0,0.0,16,1,15,2.0,0.0,2.0
9709451,0,0,0,0,0,0,0,142,,,,,,,,1,0,1,,,
107303,0,0,0,0,0,0,0,249,0.0,0.0,0.0,0.0,0.0,0.0,0.0,4,0,4,3.0,0.0,3.0
9809586,0,0,0,0,0,0,0,85,0.0,0.0,0.0,0.0,0.0,0.0,0.0,11,0,11,4.0,0.0,4.0
9802434,0,0,0,0,0,0,0,697,0.0,0.0,0.0,0.0,0.0,0.0,0.0,3,0,3,1.0,0.0,1.0
212309,0,0,0,0,0,0,0,7,0.0,0.0,0.0,0.0,0.0,0.0,0.0,54,0,54,14.0,0.0,14.0
9708383,1,1,0,0,1,0,0,793,0.0,0.0,0.0,0.0,0.0,0.0,0.0,5,1,4,1.0,0.0,1.0
210211,0,0,0,0,0,0,0,4,0.0,0.0,0.0,0.0,0.0,0.0,0.0,35,0,35,7.0,0.0,7.0
211165,0,0,0,0,0,0,0,152,0.0,0.0,0.0,0.0,0.0,0.0,0.0,23,0,23,8.0,0.0,8.0
9169,1,1,0,0,0,1,1,325,1.0,1.0,0.0,0.0,0.0,1.0,1.0,2,1,1,2.0,1.0,1.0
301186,0,0,0,0,0,0,0,51,0.0,0.0,0.0,0.0,0.0,0.0,0.0,9,0,9,3.0,0.0,3.0
9809383,0,0,0,0,0,0,0,40,0.0,0.0,0.0,0.0,0.0,0.0,0.0,9,0,9,3.0,0.0,3.0
9708297,0,0,0,0,0,0,0,172,0.0,0.0,0.0,0.0,0.0,0.0,0.0,6,0,6,6.0,0.0,6.0
211415,0,0,0,0,0,0,0,109,0.0,0.0,0.0,0.0,0.0,0.0,0.0,3,0,3,1.0,0.0,1.0
209118,0,0,0,0,0,0,0,40,0.0,0.0,0.0,0.0,0.0,0.0,0.0,9,0,9,6.0,0.0,6.0
10290,0,0,0,0,0,0,0,40,,,,,,,,4,0,4,2.0,0.0,2.0
9508240,1,1,0,0,1,0,0,345,1.0,1.0,0.0,0.0,1.0,0.0,0.0,1,1,0,1.0,1.0,0.0
9510459,0,0,0,0,0,0,0,406,0.0,0.0,0.0,0.0,0.0,0.0,0.0,3,0,3,1.0,0.0,1.0
9806452,0,0,0,0,0,0,0,183,0.0,0.0,0.0,0.0,0.0,0.0,0.0,6,0,6,,,
9406420,1,1,0,0,1,0,0,124,0.0,0.0,0.0,0.0,0.0,0.0,0.0,3,1,2,,,
9406376,0,0,0,0,0,0,0,1777,,,,,,,,4,0,4,1.0,0.0,1.0
9031,0,0,0,0,0,0,0,325,0.0,0.0,0.0,0.0,0.0,0.0,0.0,1,0,1,1.0,0.0,1.0
8218,0,0,0,0,0,0,0,357,0.0,0.0,0.0,0.0,0.0,0.0,0.0,9,0,9,6.0,0.0,6.0
111116,0,0,0,0,0,0,0,50,0.0,0.0,0.0,0.0,0.0,0.0,0.0,14,0,14,8.0,0.0,8.0
111282,0,0,0,0,0,0,0,158,0.0,0.0,0.0,0.0,0.0,0.0,0.0,4,0,4,1.0,0.0,1.0
9902249,0,0,0,0,0,0,0,110,0.0,0.0,0.0,0.0,0.0,0.0,0.0,3,0,3,1.0,0.0,1.0
9706492,0,0,0,0,0,0,0,9,,,,,,,,7,0,7,,,
210204,1,1,0,0,0,1,9,0,0.0,0.0,0.0,0.0,0.0,0.0,0.0,42,1,41,8.0,0.0,8.0
9506221,1,1,0,0,1,0,0,766,0.0,0.0,0.0,0.0,0.0,0.0,0.0,6,1,5,1.0,0.0,1.0
211334,2,2,0,0,1,1,9,3,1.0,1.0,0.0,0.0,0.0,1.0,6.0,35,2,33,6.0,1.0,5.0
201175,0,0,0,0,0,0,0,117,,,,,,,,5,0,5,1.0,0.0,1.0
207063,0,0,0,0,0,0,0,31,0.0,0.0,0.0,0.0,0.0,0.0,0.0,5,0,5,3.0,0.0,3.0
112314,1,1,0,0,0,1,2,22,0.0,0.0,0.0,0.0,0.0,0.0,0.0,20,1,19,1.0,0.0,1.0
9309315,0,0,0,0,0,0,0,41,0.0,0.0,0.0,0.0,0.0,0.0,0.0,3,0,3,1.0,0.0,1.0
9712527,0,0,0,0,0,0,0,1,0.0,0.0,0.0,0.0,0.0,0.0,0.0,10,0,10,1.0,0.0,1.0
9307349,2,1,1,1,2,0,0,342,2.0,1.0,1.0,1.0,2.0,0.0,0.0,2,2,0,2.0,2.0,0.0
103171,4,3,1,1,0,4,11,268,4.0,3.0,1.0,1.0,0.0,4.0,10.0,8,4,4,7.0,4.0,3.0
10330,0,0,0,0,0,0,0,35,0.0,0.0,0.0,0.0,0.0,0.0,0.0,5,0,5,,,
9310203,0,0,0,0,0,0,0,102,0.0,0.0,0.0,0.0,0.0,0.0,0.0,3,0,3,,,
209332,3,3,0,0,0,3,21,34,3.0,3.0,0.0,0.0,0.0,3.0,20.0,16,3,13,6.0,1.0,5.0
9907395,1,1,0,0,0,1,1,306,0.0,0.0,0.0,0.0,0.0,0.0,0.0,3,1,2,2.0,0.0,2.0
211014,0,0,0,0,0,0,0,66,0.0,0.0,0.0,0.0,0.0,0.0,0.0,9,0,9,6.0,0.0,6.0
9312328,3,2,1,2,3,0,0,490,3.0,2.0,1.0,2.0,3.0,0.0,0.0,3,3,0,3.0,3.0,0.0
210343,0,0,0,0,0,0,0,103,0.0,0.0,0.0,0.0,0.0,0.0,0.0,14,0,14,14.0,0.0,14.0
9605251,1,1,0,0,1,0,0,298,1.0,1.0,0.0,0.0,1.0,0.0,0.0,4,1,3,1.0,1.0,0.0
9608381,0,0,0,0,0,0,0,38,,,,,,,,3,0,3,,,
9502326,0,0,0,0,0,0,0,52,0.0,0.0,0.0,0.0,0.0,0.0,0.0,3,0,3,1.0,0.0,1.0
9604435,1,1,0,0,1,0,0,58,1.0,1.0,0.0,0.0,1.0,0.0,0.0,3,1,2,2.0,1.0,1.0
107191,0,0,0,0,0,0,0,1985,,,,,,,,1,0,1,,,
210143,0,0,0,0,0,0,0,2094,,,,,,,,2,0,2,,,
9906430,0,0,0,0,0,0,0,125,0.0,0.0,0.0,0.0,0.0,0.0,0.0,12,0,12,6.0,0.0,6.0
206228,0,0,0,0,0,0,0,40,0.0,0.0,0.0,0.0,0.0,0.0,0.0,18,0,18,13.0,0.0,13.0
211097,0,0,0,0,0,0,0,55,0.0,0.0,0.0,0.0,0.0,0.0,0.0,15,0,15,3.0,0.0,3.0
9903461,0,0,0,0,0,0,0,12,0.0,0.0,0.0,0.0,0.0,0.0,0.0,20,0,20,3.0,0.0,3.0
106170,0,0,0,0,0,0,0,117,0.0,0.0,0.0,0.0,0.0,0.0,0.0,13,0,13,9.0,0.0,9.0
207027,1,1,0,0,0,1,5,16,1.0,1.0,0.0,0.0,0.0,1.0,4.0,17,1,16,6.0,1.0,5.0
111280,0,0,0,0,0,0,0,33,0.0,0.0,0.0,0.0,0.0,0.0,0.0,9,0,9,1.0,0.0,1.0
9811459,1,1,0,0,1,0,0,762,1.0,1.0,0.0,0.0,1.0,0.0,0.0,1,1,0,1.0,1.0,0.0
9403222,0,0,0,0,0,0,0,196,,,,,,,,1,0,1,,,
210236,5,4,1,2,0,5,93,11,3.0,3.0,0.0,0.0,0.0,3.0,78.0,72,5,67,51.0,2.0,49.0
9911412,0,0,0,0,0,0,0,147,0.0,0.0,0.0,0.0,0.0,0.0,0.0,1,0,1,,,
302080,0,0,0,0,0,0,0,461,0.0,0.0,0.0,0.0,0.0,0.0,0.0,9,0,9,2.0,0.0,2.0
9411284,0,0,0,0,0,0,0,170,0.0,0.0,0.0,0.0,0.0,0.0,0.0,3,0,3,1.0,0.0,1.0
111250,0,0,0,0,0,0,0,191,0.0,0.0,0.0,0.0,0.0,0.0,0.0,5,0,5,2.0,0.0,2.0
9509235,0,0,0,0,0,0,0,98,,,,,,,,1,0,1,,,
9706226,0,0,0,0,0,0,0,96,0.0,0.0,0.0,0.0,0.0,0.0,0.0,4,0,4,,,
6316,0,0,0,0,0,0,0,532,0.0,0.0,0.0,0.0,0.0,0.0,0.0,2,0,2,2.0,0.0,2.0
9908430,0,0,0,0,0,0,0,79,0.0,0.0,0.0,0.0,0.0,0.0,0.0,9,0,9,4.0,0.0,4.0
211397,0,0,0,0,0,0,0,568,0.0,0.0,0.0,0.0,0.0,0.0,0.0,3,0,3,2.0,0.0,2.0
9909216,2,1,1,1,1,1,1,98,2.0,1.0,1.0,1.0,2.0,0.0,0.0,7,2,5,3.0,2.0,1.0
208140,0,0,0,0,0,0,0,18,,,,,,,,4,0,4,,,
107315,0,0,0,0,0,0,0,1643,,,,,,,,1,0,1,,,
9612418,1,1,0,0,0,1,1,84,1.0,1.0,0.0,0.0,1.0,0.0,0.0,4,1,3,1.0,1.0,0.0
201202,1,1,0,0,0,1,1,349,1.0,1.0,0.0,0.0,0.0,1.0,1.0,4,1,3,3.0,1.0,2.0
9811439,0,0,0,0,0,0,0,1781,,,,,,,,1,0,1,,,
9405275,0,0,0,0,0,0,0,399,0.0,0.0,0.0,0.0,0.0,0.0,0.0,3,0,3,1.0,0.0,1.0
105036,2,2,0,0,0,2,9,4,1.0,1.0,0.0,0.0,0.0,1.0,3.0,21,2,19,4.0,1.0,3.0
9808374,0,0,0,0,0,0,0,102,,,,,,,,1,0,1,,,
301073,1,1,0,0,0,1,15,28,1.0,1.0,0.0,0.0,0.0,1.0,11.0,37,1,36,22.0,1.0,21.0
9257,0,0,0,0,0,0,0,140,0.0,0.0,0.0,0.0,0.0,0.0,0.0,4,0,4,4.0,0.0,4.0
103098,0,0,0,0,0,0,0,149,0.0,0.0,0.0,0.0,0.0,0.0,0.0,3,0,3,,,
103075,1,1,0,0,0,1,4,2,0.0,0.0,0.0,0.0,0.0,0.0,0.0,12,1,11,2.0,0.0,2.0
9608334,0,0,0,0,0,0,0,156,0.0,0.0,0.0,0.0,0.0,0.0,0.0,3,0,3,3.0,0.0,3.0
9805453,3,1,2,2,3,0,0,387,3.0,1.0,2.0,2.0,3.0,0.0,0.0,4,3,1,4.0,3.0,1.0
9912375,1,1,0,0,0,1,2,210,1.0,1.0,0.0,0.0,0.0,1.0,1.0,3,1,2,2.0,1.0,1.0
212377,1,1,0,0,0,1,1,54,0.0,0.0,0.0,0.0,0.0,0.0,0.0,23,1,22,7.0,0.0,7.0
9808439,0,0,0,0,0,0,0,15,0.0,0.0,0.0,0.0,0.0,0.0,0.0,16,0,16,,,
9807437,0,0,0,0,0,0,0,194,0.0,0.0,0.0,0.0,0.0,0.0,0.0,6,0,6,3.0,0.0,3.0
302114,0,0,0,0,0,0,0,111,0.0,0.0,0.0,0.0,0.0,0.0,0.0,4,0,4,2.0,0.0,2.0
202036,1,1,0,0,1,0,0,46,0.0,0.0,0.0,0.0,0.0,0.0,0.0,4,1,3,1.0,0.0,1.0
7263,0,0,0,0,0,0,0,29,,,,,,,,6,0,6,1.0,0.0,1.0
12312,0,0,0,0,0,0,0,159,0.0,0.0,0.0,0.0,0.0,0.0,0.0,13,0,13,2.0,0.0,2.0
211106,0,0,0,0,0,0,0,70,0.0,0.0,0.0,0.0,0.0,0.0,0.0,4,0,4,1.0,0.0,1.0
9411407,0,0,0,0,0,0,0,162,0.0,0.0,0.0,0.0,0.0,0.0,0.0,2,0,2,1.0,0.0,1.0
111464,0,0,0,0,0,0,0,62,0.0,0.0,0.0,0.0,0.0,0.0,0.0,15,0,15,5.0,0.0,5.0
301192,0,0,0,0,0,0,0,11,0.0,0.0,0.0,0.0,0.0,0.0,0.0,14,0,14,1.0,0.0,1.0
104286,0,0,0,0,0,0,0,325,0.0,0.0,0.0,0.0,0.0,0.0,0.0,7,0,7,1.0,0.0,1.0
9409425,0,0,0,0,0,0,0,1843,,,,,,,,1,0,1,,,
9909457,0,0,0,0,0,0,0,0,0.0,0.0,0.0,0.0,0.0,0.0,0.0,20,0,20,2.0,0.0,2.0
106281,1,1,0,0,1,0,0,364,0.0,0.0,0.0,0.0,0.0,0.0,0.0,8,1,7,5.0,0.0,5.0
301138,0,0,0,0,0,0,0,24,0.0,0.0,0.0,0.0,0.0,0.0,0.0,44,0,44,4.0,0.0,4.0
9312354,0,0,0,0,0,0,0,147,,,,,,,,5,0,5,,,
203157,1,1,0,0,1,0,0,1942,1.0,1.0,0.0,0.0,1.0,0.0,0.0,1,1,0,1.0,1.0,0.0
1131,0,0,0,0,0,0,0,160,0.0,0.0,0.0,0.0,0.0,0.0,0.0,7,0,7,2.0,0.0,2.0
9710469,0,0,0,0,0,0,0,175,0.0,0.0,0.0,0.0,0.0,0.0,0.0,3,0,3,3.0,0.0,3.0
9905454,0,0,0,0,0,0,0,571,0.0,0.0,0.0,0.0,0.0,0.0,0.0,1,0,1,1.0,0.0,1.0
110229,0,0,0,0,0,0,0,14,0.0,0.0,0.0,0.0,0.0,0.0,0.0,26,0,26,7.0,0.0,7.0
10340,1,1,0,0,1,0,0,725,1.0,1.0,0.0,0.0,1.0,0.0,0.0,1,1,0,1.0,1.0,0.0
9906449,0,0,0,0,0,0,0,336,0.0,0.0,0.0,0.0,0.0,0.0,0.0,2,0,2,2.0,0.0,2.0
6112,0,0,0,0,0,0,0,297,0.0,0.0,0.0,0.0,0.0,0.0,0.0,2,0,2,1.0,0.0,1.0
209344,0,0,0,0,0,0,0,206,0.0,0.0,0.0,0.0,0.0,0.0,0.0,10,0,10,7.0,0.0,7.0
201163,0,0,0,0,0,0,0,50,0.0,0.0,0.0,0.0,0.0,0.0,0.0,3,0,3,3.0,0.0,3.0
302111,0,0,0,0,0,0,0,23,,,,,,,,13,0,13,1.0,0.0,1.0
9005,0,0,0,0,0,0,0,1228,,,,,,,,2,0,2,,,
9610550,0,0,0,0,0,0,0,97,0.0,0.0,0.0,0.0,0.0,0.0,0.0,4,0,4,1.0,0.0,1.0
212190,0,0,0,0,0,0,0,110,0.0,0.0,0.0,0.0,0.0,0.0,0.0,3,0,3,1.0,0.0,1.0
111017,0,0,0,0,0,0,0,929,0.0,0.0,0.0,0.0,0.0,0.0,0.0,1,0,1,,,
9508394,0,0,0,0,0,0,0,205,0.0,0.0,0.0,0.0,0.0,0.0,0.0,1,0,1,,,
201145,0,0,0,0,0,0,0,1955,,,,,,,,6,0,6,,,
9505323,0,0,0,0,0,0,0,171,0.0,0.0,0.0,0.0,0.0,0.0,0.0,3,0,3,2.0,0.0,2.0
104282,0,0,0,0,0,0,0,1351,,,,,,,,3,0,3,,,
9511438,0,0,0,0,0,0,0,1564,0.0,0.0,0.0,0.0,0.0,0.0,0.0,3,0,3,,,
9912477,0,0,0,0,0,0,0,6,0.0,0.0,0.0,0.0,0.0,0.0,0.0,5,0,5,,,
9909382,0,0,0,0,0,0,0,1529,,,,,,,,1,0,1,,,
206142,0,0,0,0,0,0,0,193,0.0,0.0,0.0,0.0,0.0,0.0,0.0,10,0,10,10.0,0.0,10.0
204130,0,0,0,0,0,0,0,56,0.0,0.0,0.0,0.0,0.0,0.0,0.0,20,0,20,6.0,0.0,6.0
9302218,0,0,0,0,0,0,0,530,0.0,0.0,0.0,0.0,0.0,0.0,0.0,1,0,1,1.0,0.0,1.0
9611404,0,0,0,0,0,0,0,110,0.0,0.0,0.0,0.0,0.0,0.0,0.0,9,0,9,3.0,0.0,3.0
103220,0,0,0,0,0,0,0,0,0.0,0.0,0.0,0.0,0.0,0.0,0.0,24,0,24,2.0,0.0,2.0
210107,0,0,0,0,0,0,0,148,0.0,0.0,0.0,0.0,0.0,0.0,0.0,6,0,6,5.0,0.0,5.0
101254,0,0,0,0,0,0,0,241,0.0,0.0,0.0,0.0,0.0,0.0,0.0,9,0,9,5.0,0.0,5.0
203207,0,0,0,0,0,0,0,483,0.0,0.0,0.0,0.0,0.0,0.0,0.0,5,0,5,3.0,0.0,3.0
210338,0,0,0,0,0,0,0,1932,0.0,0.0,0.0,0.0,0.0,0.0,0.0,2,0,2,1.0,0.0,1.0
112256,0,0,0,0,0,0,0,160,0.0,0.0,0.0,0.0,0.0,0.0,0.0,5,0,5,2.0,0.0,2.0
112193,1,1,0,0,0,1,2,139,1.0,1.0,0.0,0.0,0.0,1.0,2.0,5,1,4,4.0,1.0,3.0
9805431,0,0,0,0,0,0,0,17,,,,,,,,6,0,6,,,
207309,0,0,0,0,0,0,0,27,0.0,0.0,0.0,0.0,0.0,0.0,0.0,37,0,37,2.0,0.0,2.0
212239,0,0,0,0,0,0,0,3,,,,,,,,11,0,11,6.0,0.0,6.0
9020,0,0,0,0,0,0,0,1710,,,,,,,,5,0,5,1.0,0.0,1.0
9411420,0,0,0,0,0,0,0,34,0.0,0.0,0.0,0.0,0.0,0.0,0.0,10,0,10,4.0,0.0,4.0
9908394,0,0,0,0,0,0,0,25,0.0,0.0,0.0,0.0,0.0,0.0,0.0,5,0,5,1.0,0.0,1.0
301200,0,0,0,0,0,0,0,11,0.0,0.0,0.0,0.0,0.0,0.0,0.0,27,0,27,5.0,0.0,5.0
103347,0,0,0,0,0,0,0,575,0.0,0.0,0.0,0.0,0.0,0.0,0.0,2,0,2,2.0,0.0,2.0
201101,1,1,0,0,0,1,1,88,0.0,0.0,0.0,0.0,0.0,0.0,0.0,17,1,16,7.0,0.0,7.0
1176,0,0,0,0,0,0,0,111,0.0,0.0,0.0,0.0,0.0,0.0,0.0,3,0,3,3.0,0.0,3.0
9711343,0,0,0,0,0,0,0,7,0.0,0.0,0.0,0.0,0.0,0.0,0.0,11,0,11,2.0,0.0,2.0
211004,0,0,0,0,0,0,0,14,0.0,0.0,0.0,0.0,0.0,0.0,0.0,16,0,16,2.0,0.0,2.0
10126,0,0,0,0,0,0,0,263,0.0,0.0,0.0,0.0,0.0,0.0,0.0,5,0,5,2.0,0.0,2.0
101315,0,0,0,0,0,0,0,148,0.0,0.0,0.0,0.0,0.0,0.0,0.0,17,0,17,2.0,0.0,2.0
210144,0,0,0,0,0,0,0,17,0.0,0.0,0.0,0.0,0.0,0.0,0.0,12,0,12,3.0,0.0,3.0
106078,0,0,0,0,0,0,0,76,0.0,0.0,0.0,0.0,0.0,0.0,0.0,2,0,2,,,
209065,0,0,0,0,0,0,0,857,,,,,,,,1,0,1,1.0,0.0,1.0
205303,1,1,0,0,0,1,14,63,1.0,1.0,0.0,0.0,0.0,1.0,4.0,20,1,19,4.0,1.0,3.0
301276,0,0,0,0,0,0,0,0,0.0,0.0,0.0,0.0,0.0,0.0,0.0,50,0,50,16.0,0.0,16.0
9607346,0,0,0,0,0,0,0,97,0.0,0.0,0.0,0.0,0.0,0.0,0.0,6,0,6,2.0,0.0,2.0
212337,0,0,0,0,0,0,0,1928,,,,,,,,1,0,1,,,
111292,0,0,0,0,0,0,0,128,0.0,0.0,0.0,0.0,0.0,0.0,0.0,6,0,6,1.0,0.0,1.0
105313,0,0,0,0,0,0,0,22,0.0,0.0,0.0,0.0,0.0,0.0,0.0,8,0,8,1.0,0.0,1.0
6221,0,0,0,0,0,0,0,26,0.0,0.0,0.0,0.0,0.0,0.0,0.0,34,0,34,4.0,0.0,4.0
9509317,0,0,0,0,0,0,0,14,0.0,0.0,0.0,0.0,0.0,0.0,0.0,5,0,5,1.0,0.0,1.0
9802261,0,0,0,0,0,0,0,564,0.0,0.0,0.0,0.0,0.0,0.0,0.0,1,0,1,1.0,0.0,1.0
302113,0,0,0,0,0,0,0,98,,,,,,,,3,0,3,1.0,0.0,1.0
212363,0,0,0,0,0,0,0,7,0.0,0.0,0.0,0.0,0.0,0.0,0.0,16,0,16,2.0,0.0,2.0
111273,0,0,0,0,0,0,0,636,0.0,0.0,0.0,0.0,0.0,0.0,0.0,4,0,4,1.0,0.0,1.0
302033,0,0,0,0,0,0,0,0,0.0,0.0,0.0,0.0,0.0,0.0,0.0,33,0,33,16.0,0.0,16.0
9805399,0,0,0,0,0,0,0,69,0.0,0.0,0.0,0.0,0.0,0.0,0.0,9,0,9,2.0,0.0,2.0
9906353,0,0,0,0,0,0,0,125,0.0,0.0,0.0,0.0,0.0,0.0,0.0,4,0,4,3.0,0.0,3.0
9808316,0,0,0,0,0,0,0,26,0.0,0.0,0.0,0.0,0.0,0.0,0.0,9,0,9,5.0,0.0,5.0
9904264,0,0,0,0,0,0,0,249,0.0,0.0,0.0,0.0,0.0,0.0,0.0,6,0,6,1.0,0.0,1.0
9911531,0,0,0,0,0,0,0,316,0.0,0.0,0.0,0.0,0.0,0.0,0.0,2,0,2,2.0,0.0,2.0
109218,0,0,0,0,0,0,0,21,0.0,0.0,0.0,0.0,0.0,0.0,0.0,17,0,17,16.0,0.0,16.0
302024,0,0,0,0,0,0,0,95,0.0,0.0,0.0,0.0,0.0,0.0,0.0,22,0,22,6.0,0.0,6.0
301052,0,0,0,0,0,0,0,45,0.0,0.0,0.0,0.0,0.0,0.0,0.0,23,0,23,5.0,0.0,5.0
9912346,0,0,0,0,0,0,0,13,0.0,0.0,0.0,0.0,0.0,0.0,0.0,20,0,20,2.0,0.0,2.0
9906384,0,0,0,0,0,0,0,446,0.0,0.0,0.0,0.0,0.0,0.0,0.0,9,0,9,1.0,0.0,1.0
211013,0,0,0,0,0,0,0,8,0.0,0.0,0.0,0.0,0.0,0.0,0.0,32,0,32,22.0,0.0,22.0
201269,0,0,0,0,0,0,0,366,0.0,0.0,0.0,0.0,0.0,0.0,0.0,7,0,7,1.0,0.0,1.0
110373,0,0,0,0,0,0,0,553,0.0,0.0,0.0,0.0,0.0,0.0,0.0,1,0,1,1.0,0.0,1.0
9503474,21,5,16,31,13,8,9,100,8.0,2.0,6.0,9.0,6.0,2.0,3.0,23,21,2,7.0,6.0,1.0
9512380,550,62,488,3660,213,337,1533,1,54.0,1.0,53.0,425.0,6.0,48.0,223.0,635,550,85,43.0,34.0,9.0
7256,37,15,22,72,2,35,146,1,16.0,5.0,11.0,34.0,0.0,16.0,51.0,47,37,10,14.0,10.0,4.0
9703353,107,6,101,727,26,81,329,1,50.0,2.0,48.0,364.0,8.0,42.0,159.0,135,107,28,28.0,24.0,4.0
9207222,18,3,15,44,18,0,0,58,9.0,3.0,6.0,15.0,9.0,0.0,0.0,18,18,0,9.0,9.0,0.0
9402363,32,6,26,164,6,26,83,34,20.0,3.0,17.0,117.0,1.0,19.0,62.0,37,32,5,21.0,17.0,4.0
9503492,114,24,90,336,23,91,439,6,47.0,8.0,39.0,159.0,1.0,46.0,303.0,131,114,17,36.0,22.0,14.0
9612313,263,15,248,1981,79,184,812,7,109.0,5.0,104.0,1042.0,8.0,101.0,501.0,279,263,16,61.0,53.0,8.0
9909478,32,6,26,60,1,31,289,1,17.0,5.0,12.0,25.0,0.0,17.0,206.0,73,32,41,24.0,6.0,18.0
8298,10,5,5,8,0,10,40,1,5.0,4.0,1.0,1.0,3.0,2.0,2.0,21,10,11,2.0,2.0,0.0
9712417,26,18,8,13,4,22,113,6,8.0,6.0,2.0,2.0,1.0,7.0,24.0,47,26,21,12.0,4.0,8.0
3033,74,30,44,89,7,67,477,33,13.0,4.0,9.0,13.0,0.0,13.0,131.0,266,74,192,28.0,6.0,22.0
9408228,137,25,112,750,105,32,35,61,52.0,4.0,48.0,320.0,45.0,7.0,7.0,139,137,2,33.0,33.0,0.0
9511342,66,15,51,232,21,45,106,4,15.0,3.0,12.0,46.0,2.0,13.0,13.0,78,66,12,11.0,11.0,0.0
9506457,10,6,4,4,3,7,15,35,6.0,6.0,0.0,0.0,1.0,5.0,8.0,16,10,6,6.0,4.0,2.0
9705337,120,36,84,285,20,100,470,4,9.0,4.0,5.0,7.0,0.0,9.0,63.0,186,120,66,14.0,2.0,12.0
1304,7,2,5,9,2,5,26,33,7.0,2.0,5.0,9.0,2.0,5.0,23.0,28,7,21,9.0,4.0,5.0
9404247,81,26,55,146,22,59,61,4,17.0,11.0,6.0,10.0,1.0,16.0,16.0,83,81,2,12.0,11.0,1.0
9605419,16,3,13,39,2,14,68,61,0.0,0.0,0.0,0.0,0.0,0.0,0.0,42,16,26,7.0,6.0,1.0
9705388,11,3,8,31,0,11,19,33,10.0,2.0,8.0,31.0,0.0,10.0,11.0,26,11,15,12.0,10.0,2.0
9805358,9,4,5,10,0,9,44,33,6.0,4.0,2.0,3.0,0.0,6.0,14.0,33,9,24,5.0,0.0,5.0
9903215,16,7,9,15,1,15,116,33,9.0,4.0,5.0,10.0,0.0,9.0,89.0,42,16,26,20.0,7.0,13.0
109166,55,27,28,50,49,6,13,4,0.0,0.0,0.0,0.0,0.0,0.0,0.0,75,55,20,3.0,3.0,0.0
7286,14,10,4,6,2,12,89,26,6.0,4.0,2.0,4.0,0.0,6.0,46.0,36,14,22,2.0,2.0,0.0
9210233,47,6,41,203,2,45,45,26,33.0,1.0,32.0,176.0,0.0,33.0,33.0,48,47,1,20.0,19.0,1.0
9603349,35,9,26,70,3,32,61,26,11.0,5.0,6.0,13.0,3.0,8.0,14.0,40,35,5,11.0,9.0,2.0
9810252,8,5,3,4,1,7,26,26,4.0,3.0,1.0,1.0,0.0,4.0,22.0,17,8,9,4.0,3.0,1.0
9804355,40,7,33,152,9,31,58,32,22.0,2.0,20.0,103.0,1.0,21.0,31.0,54,40,14,21.0,19.0,2.0
9406316,20,7,13,44,4,16,26,35,8.0,2.0,6.0,22.0,3.0,5.0,5.0,24,20,4,4.0,4.0,0.0
9512401,36,2,34,198,6,30,65,60,20.0,1.0,19.0,130.0,1.0,19.0,31.0,43,36,7,23.0,21.0,2.0
9704220,12,4,8,12,10,2,2,86,2.0,2.0,0.0,0.0,0.0,2.0,2.0,15,12,3,2.0,1.0,1.0
9504241,55,16,39,82,7,48,109,4,13.0,4.0,9.0,23.0,0.0,13.0,33.0,70,55,15,13.0,8.0,5.0
102083,4,3,1,1,0,4,21,4,0.0,0.0,0.0,0.0,0.0,0.0,0.0,20,4,16,2.0,0.0,2.0
112302,30,17,13,36,6,24,57,121,8.0,3.0,5.0,11.0,6.0,2.0,2.0,76,30,46,10.0,9.0,1.0
9606317,0,0,0,0,0,0,0,511,0.0,0.0,0.0,0.0,0.0,0.0,0.0,3,0,3,1.0,0.0,1.0
9906340,57,8,49,255,5,52,257,38,42.0,2.0,40.0,231.0,0.0,42.0,228.0,70,57,13,41.0,32.0,9.0
9603434,2,2,0,0,0,2,3,149,1.0,1.0,0.0,0.0,0.0,1.0,1.0,6,2,4,2.0,1.0,1.0
9304275,33,7,26,92,33,0,0,13,17.0,1.0,16.0,55.0,17.0,0.0,0.0,33,33,0,11.0,11.0,0.0
9305335,58,16,42,149,58,0,0,94,20.0,5.0,15.0,43.0,20.0,0.0,0.0,58,58,0,10.0,10.0,0.0
9606391,12,3,9,13,7,5,5,308,4.0,1.0,3.0,5.0,0.0,4.0,4.0,14,12,2,5.0,4.0,1.0
9304307,240,22,218,1459,229,11,11,5,44.0,4.0,40.0,267.0,44.0,0.0,0.0,241,240,1,27.0,27.0,0.0
9406245,124,13,111,449,71,53,64,5,16.0,2.0,14.0,82.0,9.0,7.0,7.0,131,124,7,16.0,15.0,1.0
9309266,82,21,61,324,13,69,157,36,32.0,10.0,22.0,105.0,6.0,26.0,73.0,88,82,6,30.0,24.0,6.0
9509410,65,12,53,206,6,59,254,3,16.0,2.0,14.0,30.0,1.0,15.0,65.0,83,65,18,12.0,12.0,0.0
9809266,20,7,13,23,15,5,10,144,8.0,2.0,6.0,12.0,7.0,1.0,2.0,26,20,6,7.0,7.0,0.0
9705208,65,2,63,468,4,61,182,0,45.0,1.0,44.0,347.0,0.0,45.0,121.0,73,65,8,41.0,37.0,4.0
9808301,102,3,99,854,0,102,392,3,81.0,3.0,78.0,705.0,1.0,80.0,323.0,112,102,10,49.0,42.0,7.0
9602342,18,4,14,37,8,10,63,0,8.0,3.0,5.0,13.0,1.0,7.0,18.0,31,18,13,6.0,4.0,2.0
9402231,75,13,62,200,71,4,4,0,20.0,4.0,16.0,40.0,20.0,0.0,0.0,77,75,2,8.0,8.0,0.0
9906487,78,7,71,541,4,74,590,0,55.0,2.0,53.0,455.0,0.0,55.0,298.0,130,78,52,47.0,35.0,12.0
9807386,47,6,41,206,0,47,211,3,35.0,5.0,30.0,162.0,0.0,35.0,148.0,61,47,14,29.0,21.0,8.0
9904338,32,7,25,76,3,29,106,3,22.0,4.0,18.0,55.0,2.0,20.0,89.0,42,32,10,2.0,2.0,0.0
9608311,24,5,19,47,2,22,38,0,14.0,3.0,11.0,27.0,2.0,12.0,14.0,33,24,9,2.0,1.0,1.0
9209215,82,22,60,186,82,0,0,3,19.0,3.0,16.0,44.0,19.0,0.0,0.0,82,82,0,14.0,14.0,0.0
9706239,55,8,47,203,9,46,128,0,20.0,2.0,18.0,69.0,2.0,18.0,29.0,66,55,11,18.0,13.0,5.0
9807376,5,2,3,6,5,0,0,128,1.0,1.0,0.0,0.0,1.0,0.0,0.0,5,5,0,,,
9601346,26,3,23,65,10,16,19,0,12.0,2.0,10.0,23.0,1.0,11.0,14.0,28,26,2,9.0,8.0,1.0
9808284,11,6,5,9,1,10,18,107,3.0,1.0,2.0,3.0,0.0,3.0,3.0,25,11,14,4.0,3.0,1.0
9406241,49,12,37,149,49,0,0,3,24.0,2.0,22.0,86.0,24.0,0.0,0.0,49,49,0,12.0,12.0,0.0
9506271,24,4,20,121,24,0,0,82,21.0,2.0,19.0,108.0,21.0,0.0,0.0,26,24,2,19.0,19.0,0.0
9808240,3,2,1,1,2,1,1,539,1.0,1.0,0.0,0.0,0.0,1.0,1.0,4,3,1,2.0,1.0,1.0
9901320,28,3,25,90,0,28,275,3,24.0,2.0,22.0,80.0,0.0,24.0,242.0,61,28,33,29.0,13.0,16.0
2292,13,3,10,16,4,9,55,81,9.0,1.0,8.0,14.0,0.0,9.0,55.0,27,13,14,13.0,6.0,7.0
9907476,2,2,0,0,0,2,3,81,,,,,,,,4,2,2,1.0,0.0,1.0
9504338,6,5,1,1,1,5,5,51,3.0,3.0,0.0,0.0,0.0,3.0,3.0,7,6,1,2.0,2.0,0.0
9806386,17,5,12,21,9,8,25,64,8.0,1.0,7.0,12.0,3.0,5.0,17.0,26,17,9,10.0,5.0,5.0
9606251,80,4,76,598,1,79,275,12,55.0,1.0,54.0,469.0,1.0,54.0,132.0,105,80,25,23.0,23.0,0.0
9707457,11,7,4,6,0,11,20,0,0.0,0.0,0.0,0.0,0.0,0.0,0.0,22,11,11,4.0,1.0,3.0
9606381,38,2,36,121,18,20,92,71,17.0,1.0,16.0,54.0,3.0,14.0,79.0,51,38,13,23.0,13.0,10.0
9504406,8,2,6,9,1,7,26,10,3.0,1.0,2.0,3.0,3.0,0.0,0.0,17,8,9,2.0,1.0,1.0
9707434,13,6,7,8,7,6,6,60,2.0,1.0,1.0,1.0,2.0,0.0,0.0,16,13,3,2.0,2.0,0.0
9703261,6,3,3,5,1,5,9,99,5.0,2.0,3.0,5.0,0.0,5.0,7.0,10,6,4,2.0,1.0,1.0
9403296,3,2,1,1,1,2,2,99,1.0,1.0,0.0,0.0,1.0,0.0,0.0,5,3,2,1.0,1.0,0.0
9610431,25,6,19,50,1,24,89,3,5.0,1.0,4.0,7.0,0.0,5.0,22.0,43,25,18,7.0,2.0,5.0
9305342,32,6,26,77,32,0,0,5,12.0,3.0,9.0,28.0,12.0,0.0,0.0,32,32,0,10.0,10.0,0.0
9703255,9,4,5,5,6,3,3,36,8.0,4.0,4.0,4.0,6.0,2.0,2.0,11,9,2,2.0,2.0,0.0
9503366,28,6,22,67,0,28,85,10,13.0,4.0,9.0,22.0,0.0,13.0,27.0,41,28,13,14.0,10.0,4.0
110037,2,2,0,0,2,0,0,381,1.0,1.0,0.0,0.0,1.0,0.0,0.0,4,2,2,,,
9909473,22,2,20,84,1,21,22,34,18.0,1.0,17.0,77.0,0.0,18.0,18.0,25,22,3,7.0,6.0,1.0
9802405,102,12,90,678,19,83,509,34,56.0,4.0,52.0,447.0,3.0,53.0,385.0,128,102,26,55.0,38.0,17.0
9806348,68,12,56,412,1,67,732,1,51.0,6.0,45.0,333.0,0.0,51.0,614.0,101,68,33,51.0,37.0,14.0
102145,117,6,111,1101,10,107,474,23,78.0,2.0,76.0,848.0,5.0,73.0,225.0,149,117,32,52.0,47.0,5.0
5156,22,5,17,59,1,21,211,67,13.0,5.0,8.0,28.0,0.0,13.0,153.0,50,22,28,33.0,11.0,22.0
9912513,20,4,16,52,0,20,62,34,19.0,4.0,15.0,50.0,0.0,19.0,61.0,26,20,6,6.0,6.0,0.0
9910537,30,6,24,80,4,26,138,13,16.0,3.0,13.0,44.0,0.0,16.0,88.0,50,30,20,19.0,15.0,4.0
9608276,49,6,43,174,19,30,156,5,20.0,4.0,16.0,98.0,0.0,20.0,124.0,64,49,15,27.0,19.0,8.0
9704225,19,2,17,74,1,18,210,5,17.0,2.0,15.0,71.0,0.0,17.0,206.0,38,19,19,34.0,16.0,18.0
106093,3,3,0,0,0,3,10,3,1.0,1.0,0.0,0.0,1.0,0.0,0.0,31,3,28,5.0,2.0,3.0
9205247,57,6,51,232,57,0,0,69,21.0,1.0,20.0,60.0,21.0,0.0,0.0,57,57,0,15.0,15.0,0.0
9511305,25,15,10,18,6,19,48,55,2.0,2.0,0.0,0.0,2.0,0.0,0.0,30,25,5,4.0,2.0,2.0
11049,14,10,4,5,7,7,54,67,3.0,2.0,1.0,1.0,1.0,2.0,16.0,54,14,40,20.0,1.0,19.0
5124,19,7,12,35,1,18,125,6,8.0,5.0,3.0,6.0,0.0,8.0,31.0,34,19,15,15.0,6.0,9.0
9411296,41,6,35,117,7,34,128,6,26.0,5.0,21.0,79.0,3.0,23.0,103.0,48,41,7,12.0,12.0,0.0
9702443,93,19,74,251,5,88,215,9,22.0,8.0,14.0,42.0,0.0,22.0,69.0,109,93,16,18.0,13.0,5.0
9808328,64,12,52,178,7,57,171,32,15.0,2.0,13.0,40.0,2.0,13.0,13.0,83,64,19,13.0,8.0,5.0
9706303,52,3,49,224,15,37,63,29,31.0,1.0,30.0,112.0,1.0,30.0,54.0,54,52,2,24.0,22.0,2.0
10312,14,6,8,9,1,13,30,32,3.0,1.0,2.0,2.0,0.0,3.0,8.0,50,14,36,4.0,1.0,3.0
105073,6,5,1,1,1,5,5,424,3.0,2.0,1.0,1.0,0.0,3.0,3.0,10,6,4,4.0,3.0,1.0
9908353,6,2,4,4,0,6,11,313,5.0,2.0,3.0,3.0,0.0,5.0,10.0,8,6,2,7.0,5.0,2.0
9806307,8,3,5,8,1,7,42,114,6.0,2.0,4.0,6.0,0.0,6.0,25.0,21,8,13,13.0,5.0,8.0
9403264,77,6,71,267,68,9,9,31,37.0,3.0,34.0,163.0,37.0,0.0,0.0,78,77,1,17.0,17.0,0.0
9303281,175,26,149,886,77,98,118,40,94.0,11.0,83.0,667.0,27.0,67.0,86.0,177,175,2,40.0,39.0,1.0
9512253,28,3,25,74,4,24,63,7,19.0,2.0,17.0,45.0,2.0,17.0,24.0,43,28,15,18.0,15.0,3.0
9312262,12,9,3,5,9,3,4,75,3.0,2.0,1.0,1.0,3.0,0.0,0.0,18,12,6,2.0,1.0,1.0
9511363,73,15,58,249,35,38,51,1,23.0,5.0,18.0,92.0,4.0,19.0,24.0,77,73,4,7.0,6.0,1.0
9805471,79,4,75,684,4,75,150,2,50.0,2.0,48.0,477.0,1.0,49.0,104.0,82,79,3,31.0,28.0,3.0
9511447,3,3,0,0,2,1,4,12,1.0,1.0,0.0,0.0,0.0,1.0,4.0,8,3,5,1.0,1.0,0.0
9602267,13,6,7,13,0,13,28,61,3.0,2.0,1.0,1.0,0.0,3.0,7.0,18,13,5,3.0,1.0,2.0
9602299,69,7,62,414,22,47,91,32,44.0,2.0,42.0,302.0,15.0,29.0,32.0,83,69,14,28.0,27.0,1.0
9803399,16,6,10,17,2,14,42,76,5.0,2.0,3.0,5.0,0.0,5.0,22.0,23,16,7,10.0,3.0,7.0
9601271,4,1,3,6,4,0,0,76,4.0,1.0,3.0,6.0,4.0,0.0,0.0,6,4,2,4.0,4.0,0.0
9305266,90,27,63,207,72,18,18,19,23.0,7.0,16.0,42.0,12.0,11.0,11.0,91,90,1,13.0,13.0,0.0
9503362,24,7,17,27,18,6,11,10,2.0,2.0,0.0,0.0,1.0,1.0,3.0,35,24,11,5.0,5.0,0.0
9704308,9,4,5,11,4,5,10,19,5.0,1.0,4.0,8.0,1.0,4.0,8.0,11,9,2,7.0,5.0,2.0
9901394,38,10,28,104,2,36,99,24,15.0,8.0,7.0,15.0,1.0,14.0,29.0,47,38,9,12.0,9.0,3.0
9808351,6,5,1,1,2,4,6,126,4.0,3.0,1.0,1.0,1.0,3.0,5.0,10,6,4,4.0,1.0,3.0
9509239,52,13,39,154,15,37,66,47,24.0,3.0,21.0,71.0,9.0,15.0,26.0,58,52,6,18.0,16.0,2.0
9411368,44,19,25,62,24,20,21,202,8.0,2.0,6.0,16.0,8.0,0.0,0.0,46,44,2,6.0,6.0,0.0
9609490,18,7,11,18,3,15,33,202,9.0,2.0,7.0,11.0,6.0,3.0,3.0,28,18,10,4.0,3.0,1.0
9708463,15,7,8,14,0,15,56,98,11.0,4.0,7.0,12.0,0.0,11.0,44.0,25,15,10,12.0,8.0,4.0
9809244,34,7,27,173,0,34,103,4,29.0,5.0,24.0,146.0,0.0,29.0,59.0,51,34,17,30.0,27.0,3.0
9710521,57,7,50,230,3,54,280,30,41.0,2.0,39.0,194.0,1.0,40.0,184.0,73,57,16,37.0,28.0,9.0
9909435,23,4,19,63,0,23,184,4,19.0,5.0,14.0,36.0,0.0,19.0,135.0,45,23,22,27.0,16.0,11.0
9905495,11,9,2,2,3,8,45,19,2.0,2.0,0.0,0.0,0.0,2.0,8.0,31,11,20,13.0,1.0,12.0
9305280,5,5,0,0,2,3,6,108,2.0,2.0,0.0,0.0,0.0,2.0,5.0,8,5,3,5.0,2.0,3.0
9705401,40,6,34,103,19,21,65,59,18.0,3.0,15.0,50.0,0.0,18.0,57.0,46,40,6,20.0,15.0,5.0
9704278,13,4,9,14,11,2,3,6,3.0,1.0,2.0,2.0,3.0,0.0,0.0,20,13,7,3.0,3.0,0.0
9402350,1,1,0,0,1,0,0,102,0.0,0.0,0.0,0.0,0.0,0.0,0.0,2,1,1,1.0,1.0,0.0
9805488,17,6,11,23,1,16,96,6,9.0,5.0,4.0,8.0,0.0,9.0,72.0,51,17,34,16.0,7.0,9.0
9509230,7,1,6,14,0,7,27,85,6.0,1.0,5.0,13.0,0.0,6.0,12.0,16,7,9,7.0,6.0,1.0
9602265,41,4,37,123,25,16,16,6,21.0,2.0,19.0,71.0,11.0,10.0,10.0,42,41,1,13.0,12.0,1.0
9909350,2,1,1,1,2,0,0,96,1.0,1.0,0.0,0.0,1.0,0.0,0.0,3,2,1,2.0,2.0,0.0
9512218,130,15,115,518,97,33,34,14,60.0,5.0,55.0,280.0,36.0,24.0,25.0,132,130,2,26.0,25.0,1.0
12087,28,4,24,82,11,17,40,23,4.0,2.0,2.0,3.0,1.0,3.0,3.0,40,28,12,9.0,8.0,1.0
9408273,23,9,14,40,23,0,0,38,8.0,4.0,4.0,6.0,8.0,0.0,0.0,23,23,0,3.0,3.0,0.0
9801430,99,9,90,539,17,82,366,22,58.0,3.0,55.0,387.0,11.0,47.0,193.0,123,99,24,44.0,33.0,11.0
9803473,31,6,25,95,3,28,108,45,29.0,4.0,25.0,95.0,2.0,27.0,106.0,38,31,7,27.0,21.0,6.0
7175,9,6,3,4,9,0,0,161,3.0,1.0,2.0,3.0,3.0,0.0,0.0,9,9,0,1.0,1.0,0.0
4046,5,3,2,5,0,5,50,22,5.0,3.0,2.0,5.0,0.0,5.0,46.0,22,5,17,5.0,3.0,2.0
9611292,34,2,32,177,1,33,88,22,31.0,1.0,30.0,163.0,0.0,31.0,82.0,38,34,4,25.0,21.0,4.0
4016,4,2,2,2,2,2,8,38,2.0,1.0,1.0,1.0,0.0,2.0,8.0,9,4,5,,,
9602293,5,2,3,5,1,4,4,88,0.0,0.0,0.0,0.0,0.0,0.0,0.0,7,5,2,1.0,0.0,1.0
9410403,1,1,0,0,0,1,1,2057,0.0,0.0,0.0,0.0,0.0,0.0,0.0,3,1,2,1.0,0.0,1.0
9610477,82,4,78,503,1,81,360,21,51.0,2.0,49.0,315.0,0.0,51.0,269.0,95,82,13,41.0,31.0,10.0
9712506,16,5,11,30,0,16,104,21,10.0,3.0,7.0,19.0,0.0,10.0,31.0,34,16,18,17.0,9.0,8.0
11002,30,5,25,65,2,28,140,66,15.0,1.0,14.0,38.0,2.0,13.0,42.0,61,30,31,16.0,11.0,5.0
9607291,19,4,15,39,3,16,100,16,7.0,4.0,3.0,5.0,0.0,7.0,49.0,30,19,11,10.0,5.0,5.0
9808467,52,5,47,174,8,44,187,43,22.0,2.0,20.0,90.0,0.0,22.0,119.0,73,52,21,19.0,15.0,4.0
9905551,15,2,13,31,0,15,60,19,11.0,2.0,9.0,24.0,0.0,11.0,36.0,28,15,13,8.0,5.0,3.0
9506218,2,2,0,0,2,0,0,192,0.0,0.0,0.0,0.0,0.0,0.0,0.0,6,2,4,1.0,0.0,1.0
9707263,36,4,32,118,1,35,150,39,26.0,3.0,23.0,92.0,0.0,26.0,110.0,45,36,9,30.0,22.0,8.0
9601352,17,10,7,14,5,12,31,39,8.0,3.0,5.0,11.0,0.0,8.0,15.0,22,17,5,11.0,7.0,4.0
108036,8,4,4,5,0,8,31,20,5.0,2.0,3.0,3.0,2.0,3.0,7.0,17,8,9,6.0,3.0,3.0
6059,14,3,11,45,0,14,194,20,13.0,3.0,10.0,41.0,0.0,13.0,192.0,47,14,33,40.0,7.0,33.0
9211267,16,8,8,17,8,8,8,29,12.0,5.0,7.0,15.0,4.0,8.0,8.0,17,16,1,8.0,7.0,1.0
9406320,38,11,27,65,13,25,59,29,18.0,6.0,12.0,34.0,4.0,14.0,43.0,45,38,7,15.0,10.0,5.0
9910247,29,4,25,140,0,29,289,20,29.0,4.0,25.0,140.0,0.0,29.0,289.0,47,29,18,35.0,18.0,17.0
9903416,9,3,6,18,1,8,56,20,7.0,1.0,6.0,18.0,0.0,7.0,52.0,21,9,12,3.0,1.0,2.0
112028,3,2,1,1,0,3,18,20,3.0,2.0,1.0,1.0,0.0,3.0,18.0,14,3,11,6.0,3.0,3.0
9811347,7,2,5,8,1,6,42,20,4.0,1.0,3.0,6.0,0.0,4.0,8.0,18,7,11,,,
210257,4,2,2,3,0,4,21,37,3.0,1.0,2.0,3.0,0.0,3.0,14.0,21,4,17,3.0,0.0,3.0
9802223,4,3,1,1,0,4,12,6,1.0,1.0,0.0,0.0,0.0,1.0,1.0,24,4,20,10.0,0.0,10.0
9511392,38,19,19,27,15,23,75,8,6.0,3.0,3.0,5.0,1.0,5.0,5.0,47,38,9,9.0,6.0,3.0
9808275,29,9,20,59,2,27,205,18,11.0,2.0,9.0,24.0,0.0,11.0,62.0,73,29,44,19.0,11.0,8.0
9312251,32,12,20,46,21,11,16,18,10.0,6.0,4.0,5.0,10.0,0.0,0.0,37,32,5,10.0,10.0,0.0
9903425,28,7,21,89,3,25,76,32,22.0,4.0,18.0,77.0,0.0,22.0,59.0,36,28,8,2.0,2.0,0.0
9705417,41,4,37,200,25,16,27,10,26.0,2.0,24.0,131.0,17.0,9.0,10.0,48,41,7,21.0,21.0,0.0
106119,17,7,10,24,0,17,152,73,17.0,7.0,10.0,24.0,0.0,17.0,143.0,34,17,17,18.0,6.0,12.0
9503402,11,8,3,6,9,2,2,99,2.0,2.0,0.0,0.0,2.0,0.0,0.0,12,11,1,2.0,2.0,0.0
9707330,5,3,2,3,0,5,11,42,3.0,2.0,1.0,1.0,0.0,3.0,4.0,22,5,17,2.0,0.0,2.0
9510203,7,5,2,2,7,0,0,613,1.0,1.0,0.0,0.0,1.0,0.0,0.0,9,7,2,1.0,1.0,0.0
9512425,13,9,4,8,5,8,73,61,2.0,2.0,0.0,0.0,0.0,2.0,20.0,57,13,44,12.0,1.0,11.0
9312213,17,14,3,4,8,9,33,10,2.0,2.0,0.0,0.0,1.0,1.0,1.0,30,17,13,3.0,3.0,0.0
9412215,44,18,26,125,39,5,5,30,24.0,9.0,15.0,60.0,19.0,5.0,5.0,46,44,2,12.0,11.0,1.0
9510350,40,9,31,110,36,4,4,87,15.0,2.0,13.0,35.0,15.0,0.0,0.0,41,40,1,9.0,9.0,0.0
9508283,13,4,9,27,10,3,5,4,5.0,3.0,2.0,3.0,5.0,0.0,0.0,16,13,3,3.0,3.0,0.0
9902332,23,9,14,25,10,13,21,25,3.0,1.0,2.0,2.0,0.0,3.0,8.0,32,23,9,3.0,3.0,0.0
9905536,55,15,40,92,5,50,526,3,28.0,4.0,24.0,58.0,0.0,28.0,378.0,141,55,86,51.0,11.0,40.0
9606337,174,6,168,1794,8,166,676,11,125.0,2.0,123.0,1577.0,1.0,124.0,551.0,182,174,8,77.0,72.0,5.0
9604357,21,2,19,57,2,19,33,82,16.0,2.0,14.0,43.0,0.0,16.0,29.0,26,21,5,13.0,11.0,2.0
9807281,20,9,11,16,2,18,49,62,7.0,2.0,5.0,6.0,0.0,7.0,10.0,35,20,15,12.0,9.0,3.0
9603212,67,12,55,240,17,50,142,41,40.0,3.0,37.0,177.0,10.0,30.0,59.0,84,67,17,22.0,20.0,2.0
9212259,10,5,5,12,10,0,0,41,6.0,5.0,1.0,2.0,6.0,0.0,0.0,10,10,0,7.0,7.0,0.0
9710441,29,11,18,40,4,25,44,41,18.0,4.0,14.0,36.0,3.0,15.0,24.0,38,29,9,9.0,6.0,3.0
9510235,21,7,14,26,2,19,33,117,7.0,3.0,4.0,8.0,1.0,6.0,6.0,25,21,4,8.0,7.0,1.0
9208228,15,9,6,11,15,0,0,63,9.0,4.0,5.0,9.0,9.0,0.0,0.0,15,15,0,2.0,2.0,0.0
9405348,40,10,30,93,1,39,81,17,18.0,4.0,14.0,39.0,1.0,17.0,34.0,46,40,6,7.0,6.0,1.0
9704260,21,7,14,40,2,19,145,6,6.0,1.0,5.0,11.0,0.0,6.0,61.0,56,21,35,12.0,5.0,7.0
9410260,15,4,11,22,15,0,0,23,4.0,2.0,2.0,2.0,4.0,0.0,0.0,15,15,0,7.0,7.0,0.0
9805232,46,12,34,146,33,13,13,67,18.0,3.0,15.0,88.0,18.0,0.0,0.0,47,46,1,17.0,17.0,0.0
9505315,10,4,6,6,5,5,5,231,3.0,1.0,2.0,2.0,3.0,0.0,0.0,14,10,4,5.0,4.0,1.0
9501204,21,8,13,26,21,0,0,258,8.0,2.0,6.0,14.0,8.0,0.0,0.0,21,21,0,7.0,7.0,0.0
9604296,20,2,18,53,3,17,59,55,13.0,1.0,12.0,35.0,0.0,13.0,44.0,26,20,6,5.0,4.0,1.0
9810315,14,5,9,22,1,13,65,3,7.0,2.0,5.0,14.0,0.0,7.0,21.0,24,14,10,9.0,6.0,3.0
9302267,46,7,39,94,24,22,22,48,17.0,2.0,15.0,43.0,6.0,11.0,11.0,47,46,1,12.0,12.0,0.0
9706279,19,12,7,9,1,18,63,56,8.0,6.0,2.0,2.0,0.0,8.0,28.0,31,19,12,9.0,4.0,5.0
9904433,39,7,32,90,0,39,296,2,14.0,3.0,11.0,36.0,0.0,14.0,182.0,68,39,29,8.0,5.0,3.0
9509320,29,7,22,63,11,18,19,136,22.0,3.0,19.0,60.0,5.0,17.0,17.0,31,29,2,16.0,15.0,1.0
9607412,5,2,3,6,0,5,63,124,4.0,2.0,2.0,5.0,0.0,4.0,60.0,25,5,20,20.0,4.0,16.0
10194,18,4,14,49,5,13,111,23,12.0,3.0,9.0,40.0,4.0,8.0,45.0,53,18,35,3.0,2.0,1.0
9703293,11,7,4,7,1,10,23,10,0.0,0.0,0.0,0.0,0.0,0.0,0.0,38,11,27,7.0,0.0,7.0
9305309,72,13,59,225,72,0,0,27,31.0,2.0,29.0,115.0,31.0,0.0,0.0,72,72,0,13.0,13.0,0.0
9907505,33,10,23,62,2,31,147,5,7.0,6.0,1.0,2.0,0.0,7.0,49.0,55,33,22,14.0,4.0,10.0
9904497,14,2,12,27,2,12,104,18,9.0,2.0,7.0,15.0,1.0,8.0,67.0,37,14,23,6.0,1.0,5.0
9908311,33,5,28,126,0,33,301,32,19.0,3.0,16.0,67.0,0.0,19.0,212.0,62,33,29,35.0,19.0,16.0
9612376,8,8,0,0,0,8,52,61,4.0,4.0,0.0,0.0,0.0,4.0,30.0,23,8,15,15.0,4.0,11.0
106345,19,4,15,37,0,19,190,18,13.0,3.0,10.0,27.0,0.0,13.0,69.0,45,19,26,4.0,3.0,1.0
9909325,39,5,34,125,4,35,253,32,22.0,2.0,20.0,77.0,0.0,22.0,169.0,65,39,26,20.0,13.0,7.0
9803451,17,7,10,16,0,17,151,23,3.0,2.0,1.0,1.0,0.0,3.0,31.0,75,17,58,16.0,3.0,13.0
106247,162,16,146,747,37,125,295,0,45.0,2.0,43.0,200.0,2.0,43.0,160.0,183,162,21,21.0,19.0,2.0
9910387,26,9,17,50,3,23,95,0,14.0,3.0,11.0,38.0,1.0,13.0,37.0,45,26,19,10.0,4.0,6.0
9309264,1,1,0,0,1,0,0,111,,,,,,,,1,1,0,,,
9306209,25,8,17,58,7,18,23,164,19.0,4.0,15.0,47.0,2.0,17.0,21.0,27,25,2,20.0,18.0,2.0
9906322,71,8,63,330,5,66,231,11,49.0,5.0,44.0,226.0,0.0,49.0,193.0,78,71,7,32.0,27.0,5.0
12252,3,3,0,0,1,2,2,122,0.0,0.0,0.0,0.0,0.0,0.0,0.0,11,3,8,2.0,0.0,2.0
9501311,16,8,8,18,7,9,15,16,6.0,5.0,1.0,2.0,1.0,5.0,8.0,19,16,3,3.0,3.0,0.0
9712546,44,8,36,101,3,41,254,16,19.0,2.0,17.0,49.0,0.0,19.0,77.0,105,44,61,21.0,14.0,7.0
9907430,6,4,2,2,2,4,16,16,3.0,3.0,0.0,0.0,0.0,3.0,6.0,16,6,10,4.0,1.0,3.0
9705240,52,4,48,162,15,37,80,19,12.0,2.0,10.0,25.0,2.0,10.0,19.0,60,52,8,18.0,15.0,3.0
9511414,14,3,11,28,0,14,44,94,9.0,1.0,8.0,24.0,0.0,9.0,35.0,22,14,8,14.0,9.0,5.0
9808287,21,5,16,71,1,20,79,4,16.0,2.0,14.0,57.0,0.0,16.0,43.0,43,21,22,2.0,1.0,1.0
9603408,57,10,47,134,33,24,29,9,21.0,2.0,19.0,57.0,10.0,11.0,11.0,62,57,5,8.0,7.0,1.0
10344,6,4,2,2,0,6,32,39,2.0,1.0,1.0,1.0,0.0,2.0,13.0,19,6,13,10.0,2.0,8.0
2169,2,2,0,0,0,2,2,44,2.0,2.0,0.0,0.0,2.0,0.0,0.0,4,2,2,1.0,1.0,0.0
8209,14,3,11,19,3,11,74,2,8.0,2.0,6.0,9.0,0.0,8.0,26.0,32,14,18,2.0,2.0,0.0
9505394,6,3,3,4,3,3,3,317,3.0,2.0,1.0,1.0,1.0,2.0,2.0,7,6,1,3.0,2.0,1.0
9908515,15,6,9,19,1,14,103,2,7.0,3.0,4.0,8.0,0.0,7.0,67.0,34,15,19,6.0,6.0,0.0
9503275,18,5,13,25,8,10,11,138,12.0,4.0,8.0,16.0,9.0,3.0,3.0,20,18,2,8.0,7.0,1.0
9604383,101,7,94,641,52,49,72,11,53.0,2.0,51.0,338.0,37.0,16.0,16.0,110,101,9,20.0,20.0,0.0
9911242,13,3,10,25,0,13,120,16,8.0,2.0,6.0,13.0,0.0,8.0,92.0,51,13,38,17.0,2.0,15.0
9511322,2,1,1,1,0,2,2,210,1.0,1.0,0.0,0.0,0.0,1.0,1.0,4,2,2,3.0,2.0,1.0
111359,15,3,12,15,11,4,5,39,3.0,2.0,1.0,1.0,1.0,2.0,2.0,20,15,5,4.0,4.0,0.0
10289,41,19,22,31,16,25,56,135,9.0,5.0,4.0,5.0,1.0,8.0,23.0,53,41,12,13.0,5.0,8.0
201240,3,2,1,1,0,3,19,16,2.0,1.0,1.0,1.0,0.0,2.0,9.0,16,3,13,4.0,1.0,3.0
104315,17,11,6,8,0,17,58,19,0.0,0.0,0.0,0.0,0.0,0.0,0.0,37,17,20,12.0,2.0,10.0
202081,22,5,17,85,0,22,394,28,22.0,5.0,17.0,85.0,0.0,22.0,303.0,64,22,42,36.0,21.0,15.0
9807282,48,8,40,166,30,18,22,28,19.0,1.0,18.0,69.0,19.0,0.0,0.0,50,48,2,13.0,13.0,0.0
5286,20,2,18,80,0,20,135,2,19.0,2.0,17.0,78.0,0.0,19.0,110.0,33,20,13,24.0,17.0,7.0
9704207,304,21,283,2315,7,297,1182,9,161.0,6.0,155.0,1650.0,2.0,159.0,657.0,318,304,14,67.0,58.0,9.0
9402332,21,5,16,38,15,6,8,91,8.0,4.0,4.0,8.0,8.0,0.0,0.0,23,21,2,7.0,7.0,0.0
9607208,4,3,1,1,1,3,9,91,1.0,1.0,0.0,0.0,0.0,1.0,2.0,7,4,3,4.0,2.0,2.0
2297,24,18,6,9,24,0,0,128,4.0,1.0,3.0,4.0,4.0,0.0,0.0,24,24,0,2.0,2.0,0.0
102216,13,7,6,12,4,9,28,2,2.0,2.0,0.0,0.0,1.0,1.0,1.0,18,13,5,3.0,2.0,1.0
9909494,3,1,2,3,0,3,15,2,2.0,1.0,1.0,1.0,0.0,2.0,6.0,9,3,6,1.0,1.0,0.0
9302215,1,1,0,0,1,0,0,805,,,,,,,,1,1,0,,,
103251,15,4,11,25,1,14,62,37,8.0,2.0,6.0,10.0,1.0,7.0,28.0,30,15,15,12.0,5.0,7.0
9511419,17,4,13,41,8,9,13,10,5.0,2.0,3.0,4.0,3.0,2.0,2.0,30,17,13,6.0,5.0,1.0
9803257,27,16,11,19,5,22,100,4,2.0,2.0,0.0,0.0,0.0,2.0,5.0,72,27,45,7.0,4.0,3.0
9809371,8,1,7,14,3,5,8,120,6.0,1.0,5.0,11.0,1.0,5.0,8.0,17,8,9,8.0,6.0,2.0
9406308,5,4,1,1,5,0,0,544,1.0,1.0,0.0,0.0,1.0,0.0,0.0,5,5,0,2.0,2.0,0.0
9211258,13,4,9,19,2,11,11,164,10.0,3.0,7.0,11.0,0.0,10.0,10.0,14,13,1,12.0,11.0,1.0
9911458,15,5,10,42,0,15,54,0,9.0,2.0,7.0,32.0,0.0,9.0,35.0,22,15,7,15.0,10.0,5.0
9401349,16,10,6,6,16,0,0,61,2.0,1.0,1.0,1.0,2.0,0.0,0.0,16,16,0,1.0,1.0,0.0
9308352,5,3,2,3,5,0,0,2095,1.0,1.0,0.0,0.0,1.0,0.0,0.0,5,5,0,2.0,2.0,0.0
9302299,19,7,12,19,17,2,2,195,6.0,4.0,2.0,3.0,5.0,1.0,1.0,20,19,1,4.0,4.0,0.0
4101,14,4,10,27,0,14,100,12,4.0,2.0,2.0,3.0,0.0,4.0,56.0,54,14,40,11.0,9.0,2.0
12204,10,8,2,2,2,8,33,1,2.0,1.0,1.0,1.0,2.0,0.0,0.0,20,10,10,2.0,2.0,0.0
9802202,19,6,13,28,2,17,49,1,2.0,2.0,0.0,0.0,2.0,0.0,0.0,30,19,11,5.0,4.0,1.0
107066,3,3,0,0,0,3,8,1,2.0,2.0,0.0,0.0,0.0,2.0,2.0,9,3,6,3.0,2.0,1.0
9254,52,14,38,110,0,52,411,9,24.0,7.0,17.0,52.0,0.0,24.0,228.0,79,52,27,10.0,9.0,1.0
9303314,7,6,1,1,4,3,4,307,2.0,2.0,0.0,0.0,1.0,1.0,1.0,9,7,2,3.0,2.0,1.0
10296,29,4,25,96,0,29,214,9,25.0,3.0,22.0,87.0,0.0,25.0,197.0,51,29,22,21.0,15.0,6.0
9610476,2,2,0,0,1,1,1,45,0.0,0.0,0.0,0.0,0.0,0.0,0.0,4,2,2,1.0,0.0,1.0
9703429,47,13,34,101,2,45,395,17,33.0,7.0,26.0,81.0,0.0,33.0,341.0,91,47,44,39.0,13.0,26.0
9701324,10,2,8,24,1,9,22,17,5.0,1.0,4.0,8.0,4.0,1.0,2.0,19,10,9,3.0,1.0,2.0
9507289,12,6,6,12,0,12,43,26,10.0,5.0,5.0,10.0,0.0,10.0,36.0,21,12,9,6.0,5.0,1.0
9512339,7,4,3,5,7,0,0,148,3.0,2.0,1.0,1.0,3.0,0.0,0.0,7,7,0,4.0,4.0,0.0
9609487,54,11,43,115,16,38,73,56,20.0,7.0,13.0,33.0,1.0,19.0,25.0,70,54,16,11.0,8.0,3.0
9306321,13,5,8,10,2,11,18,35,3.0,2.0,1.0,1.0,0.0,3.0,8.0,18,13,5,7.0,2.0,5.0
9503467,14,5,9,13,10,4,8,104,3.0,3.0,0.0,0.0,2.0,1.0,1.0,19,14,5,3.0,2.0,1.0
9603359,12,4,8,11,5,7,11,8,2.0,1.0,1.0,1.0,2.0,0.0,0.0,16,12,4,2.0,0.0,2.0
9703249,19,6,13,31,4,15,15,182,15.0,3.0,12.0,30.0,1.0,14.0,14.0,20,19,1,13.0,12.0,1.0
7336,15,2,13,27,1,14,91,4,14.0,2.0,12.0,26.0,0.0,14.0,87.0,26,15,11,19.0,11.0,8.0
103041,0,0,0,0,0,0,0,7,0.0,0.0,0.0,0.0,0.0,0.0,0.0,48,0,48,9.0,0.0,9.0
9706310,3,3,0,0,1,2,30,6,2.0,2.0,0.0,0.0,0.0,2.0,27.0,31,3,28,6.0,2.0,4.0
9001,16,3,13,61,0,16,33,62,14.0,1.0,13.0,61.0,2.0,12.0,19.0,43,16,27,15.0,13.0,2.0
9512233,3,3,0,0,3,0,0,315,0.0,0.0,0.0,0.0,0.0,0.0,0.0,4,3,1,1.0,1.0,0.0
9709289,20,2,18,63,16,4,4,50,10.0,1.0,9.0,28.0,10.0,0.0,0.0,26,20,6,8.0,8.0,0.0
9910464,12,4,8,17,0,12,87,54,10.0,3.0,7.0,14.0,0.0,10.0,53.0,31,12,19,10.0,5.0,5.0
9506442,16,7,9,13,4,12,19,16,3.0,3.0,0.0,0.0,3.0,0.0,0.0,21,16,5,4.0,4.0,0.0
3324,6,6,0,0,2,4,11,54,2.0,2.0,0.0,0.0,0.0,2.0,8.0,14,6,8,1.0,1.0,0.0
9310236,83,16,67,422,83,0,0,24,46.0,2.0,44.0,330.0,46.0,0.0,0.0,83,83,0,16.0,16.0,0.0
4018,12,3,9,22,0,12,50,24,8.0,1.0,7.0,19.0,0.0,8.0,33.0,23,12,11,4.0,3.0,1.0
9210266,9,6,3,5,9,0,0,4,2.0,2.0,0.0,0.0,2.0,0.0,0.0,9,9,0,2.0,2.0,0.0
9610432,6,2,4,5,1,5,5,51,4.0,1.0,3.0,3.0,0.0,4.0,4.0,9,6,3,2.0,1.0,1.0
9407372,56,13,43,135,42,14,14,11,10.0,3.0,7.0,10.0,10.0,0.0,0.0,57,56,1,11.0,11.0,0.0
9905372,51,16,35,106,3,48,414,9,35.0,6.0,29.0,93.0,0.0,35.0,314.0,88,51,37,34.0,15.0,19.0
9803351,24,5,19,47,2,22,109,14,15.0,4.0,11.0,26.0,0.0,15.0,74.0,60,24,36,20.0,11.0,9.0
9808335,2,2,0,0,0,2,4,9,1.0,1.0,0.0,0.0,0.0,1.0,1.0,18,2,16,2.0,1.0,1.0
9505306,5,2,3,3,0,5,12,14,1.0,1.0,0.0,0.0,0.0,1.0,2.0,15,5,10,1.0,1.0,0.0
9501297,30,6,24,90,30,0,0,27,7.0,2.0,5.0,9.0,7.0,0.0,0.0,30,30,0,7.0,7.0,0.0
9811247,9,3,6,10,1,8,29,14,3.0,1.0,2.0,2.0,0.0,3.0,15.0,30,9,21,4.0,1.0,3.0
9806433,2,2,0,0,0,2,6,73,2.0,2.0,0.0,0.0,0.0,2.0,6.0,6,2,4,1.0,1.0,0.0
9412392,2,2,0,0,2,0,0,2081,1.0,1.0,0.0,0.0,1.0,0.0,0.0,4,2,2,2.0,1.0,1.0
9507291,5,5,0,0,1,4,33,75,0.0,0.0,0.0,0.0,0.0,0.0,0.0,38,5,33,9.0,0.0,9.0
9606485,4,2,2,2,4,0,0,118,2.0,1.0,1.0,1.0,2.0,0.0,0.0,4,4,0,1.0,1.0,0.0
9804234,20,6,14,36,7,13,14,45,13.0,4.0,9.0,23.0,3.0,10.0,10.0,22,20,2,12.0,11.0,1.0
9603230,8,7,1,1,5,3,5,16,2.0,2.0,0.0,0.0,2.0,0.0,0.0,13,8,5,2.0,2.0,0.0
9602226,11,4,7,11,7,4,9,162,2.0,2.0,0.0,0.0,0.0,2.0,4.0,14,11,3,7.0,6.0,1.0
9507320,2,1,1,1,0,2,2,115,0.0,0.0,0.0,0.0,0.0,0.0,0.0,11,2,9,2.0,2.0,0.0
9509225,11,5,6,10,3,8,9,14,6.0,1.0,5.0,9.0,6.0,0.0,0.0,13,11,2,7.0,6.0,1.0
9703328,5,3,2,2,0,5,27,16,2.0,2.0,0.0,0.0,0.0,2.0,5.0,16,5,11,6.0,3.0,3.0
9708362,8,7,1,1,0,8,20,150,2.0,2.0,0.0,0.0,0.0,2.0,5.0,17,8,9,2.0,1.0,1.0
9604270,20,5,15,44,5,15,43,25,8.0,3.0,5.0,9.0,1.0,7.0,23.0,32,20,12,9.0,4.0,5.0
9303310,4,3,1,1,4,0,0,158,1.0,1.0,0.0,0.0,1.0,0.0,0.0,4,4,0,1.0,1.0,0.0
9704319,15,4,11,19,1,14,27,97,10.0,3.0,7.0,11.0,0.0,10.0,20.0,22,15,7,12.0,8.0,4.0
9802218,22,3,19,42,1,21,115,8,5.0,2.0,3.0,3.0,0.0,5.0,21.0,60,22,38,10.0,1.0,9.0
9309242,6,1,5,9,1,5,5,15,2.0,1.0,1.0,1.0,2.0,0.0,0.0,8,6,2,2.0,2.0,0.0
9502313,18,4,14,33,2,16,54,15,2.0,2.0,0.0,0.0,0.0,2.0,2.0,27,18,9,4.0,4.0,0.0
9607218,7,3,4,7,6,1,1,23,,,,,,,,8,7,1,2.0,2.0,0.0
9601296,2,2,0,0,0,2,2,42,1.0,1.0,0.0,0.0,1.0,0.0,0.0,4,2,2,1.0,1.0,0.0
9610306,4,4,0,0,2,2,2,33,2.0,2.0,0.0,0.0,2.0,0.0,0.0,9,4,5,,,
107150,23,10,13,35,1,22,203,0,6.0,2.0,4.0,9.0,0.0,6.0,69.0,63,23,40,21.0,2.0,19.0
3084,32,15,17,33,1,31,177,3,11.0,6.0,5.0,11.0,0.0,11.0,69.0,92,32,60,9.0,1.0,8.0
105105,27,13,14,33,4,23,121,0,6.0,3.0,3.0,6.0,0.0,6.0,39.0,59,27,32,16.0,6.0,10.0
9809492,3,3,0,0,3,0,0,91,0.0,0.0,0.0,0.0,0.0,0.0,0.0,4,3,1,1.0,1.0,0.0
9503238,29,9,20,64,12,17,22,52,15.0,5.0,10.0,30.0,1.0,14.0,14.0,31,29,2,13.0,12.0,1.0
9903272,9,6,3,4,7,2,5,52,1.0,1.0,0.0,0.0,0.0,1.0,3.0,15,9,6,2.0,2.0,0.0
9904203,13,3,10,24,0,13,61,2,2.0,2.0,0.0,0.0,0.0,2.0,19.0,34,13,21,11.0,9.0,2.0
9809209,5,3,2,2,2,3,44,46,3.0,2.0,1.0,1.0,0.0,3.0,31.0,27,5,22,14.0,2.0,12.0
5248,22,11,11,15,1,21,56,1,5.0,3.0,2.0,3.0,0.0,5.0,5.0,30,22,8,5.0,4.0,1.0
3287,5,3,2,3,0,5,6,128,3.0,3.0,0.0,0.0,0.0,3.0,4.0,7,5,2,5.0,3.0,2.0
9905445,2,2,0,0,1,1,4,181,1.0,1.0,0.0,0.0,0.0,1.0,4.0,8,2,6,6.0,1.0,5.0
9608291,11,6,5,12,11,0,0,213,10.0,5.0,5.0,12.0,10.0,0.0,0.0,12,11,1,5.0,5.0,0.0
9403209,7,3,4,9,7,0,0,155,4.0,2.0,2.0,3.0,4.0,0.0,0.0,7,7,0,4.0,4.0,0.0
211370,2,1,1,1,0,2,16,10,0.0,0.0,0.0,0.0,0.0,0.0,0.0,83,2,81,17.0,0.0,17.0
9910332,13,7,6,8,2,11,31,67,2.0,2.0,0.0,0.0,0.0,2.0,4.0,35,13,22,4.0,1.0,3.0
112251,7,3,4,5,0,7,50,4,4.0,2.0,2.0,2.0,0.0,4.0,35.0,36,7,29,18.0,3.0,15.0
9501284,9,2,7,13,0,9,11,123,8.0,2.0,6.0,12.0,5.0,3.0,3.0,14,9,5,7.0,6.0,1.0
9709498,6,4,2,3,2,4,5,123,4.0,2.0,2.0,3.0,2.0,2.0,2.0,10,6,4,4.0,1.0,3.0
9307325,19,5,14,41,19,0,0,103,11.0,2.0,9.0,30.0,11.0,0.0,0.0,19,19,0,10.0,10.0,0.0
9502251,28,7,21,105,7,21,31,49,20.0,2.0,18.0,101.0,5.0,15.0,23.0,34,28,6,16.0,15.0,1.0
10190,2,2,0,0,0,2,2,111,2.0,2.0,0.0,0.0,0.0,2.0,2.0,8,2,6,5.0,2.0,3.0
9307238,8,3,5,6,8,0,0,403,4.0,3.0,1.0,1.0,4.0,0.0,0.0,8,8,0,3.0,3.0,0.0
108114,3,3,0,0,0,3,10,56,2.0,2.0,0.0,0.0,0.0,2.0,9.0,24,3,21,6.0,0.0,6.0
9311368,15,7,8,21,15,0,0,160,6.0,3.0,3.0,5.0,6.0,0.0,0.0,15,15,0,4.0,4.0,0.0
9511300,11,8,3,5,8,3,5,225,4.0,3.0,1.0,2.0,4.0,0.0,0.0,19,11,8,4.0,4.0,0.0
9411333,14,5,9,18,13,1,1,162,9.0,3.0,6.0,12.0,9.0,0.0,0.0,18,14,4,7.0,7.0,0.0
9406421,39,8,31,98,28,11,17,7,13.0,2.0,11.0,32.0,13.0,0.0,0.0,42,39,3,10.0,10.0,0.0
12110,4,3,1,1,1,3,19,33,2.0,1.0,1.0,1.0,0.0,2.0,9.0,24,4,20,9.0,0.0,9.0
9507263,15,2,13,36,0,15,30,23,2.0,2.0,0.0,0.0,0.0,2.0,7.0,25,15,10,1.0,1.0,0.0
107062,3,3,0,0,0,3,17,34,1.0,1.0,0.0,0.0,0.0,1.0,1.0,20,3,17,12.0,1.0,11.0
9712393,6,2,4,7,5,1,1,5,4.0,2.0,2.0,2.0,4.0,0.0,0.0,8,6,2,4.0,4.0,0.0
9708472,13,7,6,10,2,11,15,45,7.0,2.0,5.0,9.0,1.0,6.0,6.0,22,13,9,4.0,3.0,1.0
9506419,3,3,0,0,0,3,24,112,3.0,3.0,0.0,0.0,0.0,3.0,10.0,16,3,13,6.0,1.0,5.0
9603432,4,2,2,2,0,4,15,10,1.0,1.0,0.0,0.0,0.0,1.0,5.0,41,4,37,6.0,0.0,6.0
209306,7,3,4,4,0,7,107,32,1.0,1.0,0.0,0.0,0.0,1.0,25.0,83,7,76,20.0,2.0,18.0
9703346,31,3,28,177,2,29,152,36,28.0,2.0,26.0,171.0,0.0,28.0,151.0,39,31,8,31.0,25.0,6.0
9504210,22,10,12,22,10,12,29,63,9.0,3.0,6.0,14.0,8.0,1.0,3.0,43,22,21,8.0,8.0,0.0
9612254,9,2,7,18,0,9,55,36,6.0,2.0,4.0,6.0,0.0,6.0,30.0,20,9,11,15.0,6.0,9.0
4209,4,2,2,5,1,3,8,218,4.0,2.0,2.0,5.0,1.0,3.0,8.0,8,4,4,7.0,4.0,3.0
109077,9,5,4,5,0,9,54,89,8.0,4.0,4.0,5.0,0.0,8.0,39.0,35,9,26,13.0,7.0,6.0
111158,6,4,2,2,3,3,19,67,2.0,2.0,0.0,0.0,0.0,2.0,9.0,27,6,21,3.0,1.0,2.0
9607443,6,2,4,6,0,6,53,6,3.0,1.0,2.0,3.0,0.0,3.0,28.0,34,6,28,8.0,3.0,5.0
9907449,3,3,0,0,2,1,1,373,2.0,2.0,0.0,0.0,1.0,1.0,1.0,6,3,3,2.0,1.0,1.0
9503353,3,2,1,1,0,3,4,30,,,,,,,,7,3,4,,,
6168,5,4,1,1,0,5,15,42,2.0,2.0,0.0,0.0,0.0,2.0,7.0,13,5,8,6.0,2.0,4.0
9408314,2,2,0,0,0,2,2,243,0.0,0.0,0.0,0.0,0.0,0.0,0.0,4,2,2,1.0,0.0,1.0
9405254,5,3,2,2,1,4,13,14,2.0,1.0,1.0,1.0,0.0,2.0,4.0,12,5,7,1.0,0.0,1.0
111053,2,2,0,0,0,2,18,1,0.0,0.0,0.0,0.0,0.0,0.0,0.0,34,2,32,8.0,2.0,6.0
9612401,7,3,4,4,3,4,13,1,4.0,2.0,2.0,2.0,4.0,0.0,0.0,13,7,6,1.0,1.0,0.0
9310337,14,4,10,31,14,0,0,83,8.0,2.0,6.0,21.0,8.0,0.0,0.0,14,14,0,2.0,2.0,0.0
9508308,10,3,7,12,9,1,1,76,6.0,3.0,3.0,4.0,6.0,0.0,0.0,11,10,1,6.0,6.0,0.0
9609491,6,3,3,3,0,6,10,154,6.0,3.0,3.0,3.0,0.0,6.0,10.0,10,6,4,9.0,5.0,4.0
9602288,3,1,2,2,3,0,0,443,0.0,0.0,0.0,0.0,0.0,0.0,0.0,6,3,3,1.0,0.0,1.0
9501250,1,1,0,0,0,1,2,265,1.0,1.0,0.0,0.0,0.0,1.0,2.0,3,1,2,3.0,1.0,2.0
9702209,22,5,17,39,1,21,82,7,7.0,3.0,4.0,5.0,0.0,7.0,31.0,37,22,15,11.0,4.0,7.0
1322,6,3,3,8,0,6,115,33,5.0,2.0,3.0,8.0,0.0,5.0,79.0,71,6,65,26.0,5.0,21.0
7082,21,6,15,29,3,18,82,13,10.0,3.0,7.0,11.0,0.0,10.0,42.0,40,21,19,14.0,9.0,5.0
108197,11,8,3,4,2,9,45,8,2.0,2.0,0.0,0.0,0.0,2.0,6.0,25,11,14,7.0,2.0,5.0
9912353,3,3,0,0,0,3,7,29,0.0,0.0,0.0,0.0,0.0,0.0,0.0,29,3,26,7.0,0.0,7.0
9712292,7,6,1,1,4,3,3,91,2.0,1.0,1.0,1.0,0.0,2.0,2.0,14,7,7,1.0,0.0,1.0
9902294,25,12,13,40,4,21,76,47,14.0,5.0,9.0,34.0,2.0,12.0,34.0,38,25,13,15.0,12.0,3.0
9910437,14,6,8,15,1,13,51,21,6.0,4.0,2.0,3.0,0.0,6.0,17.0,23,14,9,4.0,4.0,0.0
9508201,5,2,3,4,3,2,4,270,1.0,1.0,0.0,0.0,0.0,1.0,1.0,15,5,10,3.0,0.0,3.0
9708363,25,10,15,31,4,21,65,22,10.0,1.0,9.0,12.0,0.0,10.0,33.0,37,25,12,13.0,9.0,4.0
11234,27,9,18,63,2,25,191,0,19.0,5.0,14.0,52.0,0.0,19.0,164.0,46,27,19,29.0,12.0,17.0
105293,7,2,5,10,1,6,39,0,3.0,1.0,2.0,3.0,0.0,3.0,19.0,26,7,19,12.0,2.0,10.0
9809577,1,1,0,0,0,1,2,200,1.0,1.0,0.0,0.0,0.0,1.0,2.0,6,1,5,3.0,1.0,2.0
9612393,4,2,2,2,0,4,7,1536,2.0,1.0,1.0,1.0,0.0,2.0,2.0,8,4,4,2.0,0.0,2.0
9907503,7,2,5,7,0,7,41,3,5.0,1.0,4.0,6.0,0.0,5.0,36.0,19,7,12,6.0,2.0,4.0
9809506,19,5,14,45,0,19,246,15,14.0,1.0,13.0,39.0,0.0,14.0,198.0,76,19,57,19.0,12.0,7.0
9707297,7,1,6,12,0,7,42,12,2.0,1.0,1.0,1.0,0.0,2.0,5.0,31,7,24,,,
8085,18,10,8,11,2,16,177,12,4.0,4.0,0.0,0.0,0.0,4.0,41.0,96,18,78,22.0,1.0,21.0
9211269,1,1,0,0,1,0,0,1568,,,,,,,,1,1,0,,,
4107,21,5,16,57,3,18,106,12,12.0,2.0,10.0,30.0,2.0,10.0,20.0,35,21,14,14.0,10.0,4.0
9708262,12,6,6,10,5,7,12,232,4.0,3.0,1.0,1.0,1.0,3.0,3.0,19,12,7,5.0,5.0,0.0
9707492,13,4,9,32,5,8,20,25,8.0,4.0,4.0,8.0,1.0,7.0,19.0,18,13,5,10.0,6.0,4.0
1246,3,3,0,0,1,2,2,46,,,,,,,,11,3,8,3.0,0.0,3.0
9301263,6,2,4,6,6,0,0,122,4.0,2.0,2.0,3.0,4.0,0.0,0.0,6,6,0,1.0,1.0,0.0
11293,4,4,0,0,0,4,10,152,1.0,1.0,0.0,0.0,0.0,1.0,4.0,12,4,8,6.0,1.0,5.0
9704439,4,3,1,1,0,4,9,158,3.0,2.0,1.0,1.0,1.0,2.0,3.0,19,4,15,7.0,3.0,4.0
9404208,3,1,2,3,2,1,2,253,1.0,1.0,0.0,0.0,0.0,1.0,1.0,7,3,4,3.0,1.0,2.0
9804390,2,1,1,1,0,2,3,83,2.0,1.0,1.0,1.0,0.0,2.0,3.0,5,2,3,1.0,0.0,1.0
9502275,9,2,7,10,9,0,0,74,1.0,1.0,0.0,0.0,1.0,0.0,0.0,10,9,1,1.0,0.0,1.0
9409274,3,2,1,1,3,0,0,223,1.0,1.0,0.0,0.0,1.0,0.0,0.0,3,3,0,1.0,1.0,0.0
9610515,11,9,2,2,0,11,62,6,3.0,2.0,1.0,1.0,0.0,3.0,25.0,38,11,27,6.0,2.0,4.0
9611387,10,4,6,11,0,10,44,5,4.0,1.0,3.0,4.0,0.0,4.0,12.0,24,10,14,9.0,6.0,3.0
9231,4,3,1,2,0,4,47,2,0.0,0.0,0.0,0.0,0.0,0.0,0.0,34,4,30,2.0,1.0,1.0
9310304,5,3,2,2,5,0,0,248,2.0,1.0,1.0,1.0,2.0,0.0,0.0,6,5,1,2.0,2.0,0.0
112119,25,5,20,91,1,24,198,0,20.0,3.0,17.0,82.0,0.0,20.0,149.0,53,25,28,16.0,13.0,3.0
9801294,11,3,8,12,2,9,54,33,7.0,2.0,5.0,8.0,0.0,7.0,42.0,24,11,13,11.0,5.0,6.0
9909521,1,1,0,0,0,1,2,15,,,,,,,,4,1,3,,,
9408337,1,1,0,0,1,0,0,176,0.0,0.0,0.0,0.0,0.0,0.0,0.0,23,1,22,16.0,0.0,16.0
9301237,31,8,23,74,26,5,5,61,16.0,5.0,11.0,42.0,11.0,5.0,5.0,32,31,1,13.0,13.0,0.0
9811263,14,7,7,14,0,14,44,67,9.0,5.0,4.0,10.0,0.0,9.0,34.0,21,14,7,12.0,5.0,7.0
9710223,47,7,40,156,4,43,118,27,39.0,3.0,36.0,139.0,0.0,39.0,104.0,56,47,9,13.0,11.0,2.0
9712351,23,7,16,29,1,22,87,117,19.0,4.0,15.0,28.0,1.0,18.0,61.0,41,23,18,19.0,14.0,5.0
110119,1,1,0,0,0,1,3,3,0.0,0.0,0.0,0.0,0.0,0.0,0.0,38,1,37,2.0,0.0,2.0
107014,25,4,21,88,0,25,205,46,18.0,2.0,16.0,65.0,0.0,18.0,123.0,67,25,42,30.0,16.0,14.0
7243,18,5,13,40,0,18,188,3,14.0,4.0,10.0,30.0,0.0,14.0,161.0,51,18,33,7.0,6.0,1.0
205234,5,4,1,1,2,3,36,3,3.0,2.0,1.0,1.0,2.0,1.0,1.0,20,5,15,3.0,2.0,1.0
201277,8,1,7,18,1,7,9,12,8.0,1.0,7.0,18.0,1.0,7.0,7.0,24,8,16,9.0,8.0,1.0
9909431,5,3,2,3,0,5,18,3,1.0,1.0,0.0,0.0,0.0,1.0,1.0,15,5,10,2.0,1.0,1.0
107233,8,6,2,4,0,8,59,37,6.0,5.0,1.0,1.0,0.0,6.0,31.0,22,8,14,10.0,4.0,6.0
9606414,5,5,0,0,2,3,9,10,1.0,1.0,0.0,0.0,1.0,0.0,0.0,12,5,7,2.0,1.0,1.0
7083,8,2,6,11,0,8,35,47,6.0,1.0,5.0,9.0,0.0,6.0,25.0,24,8,16,12.0,6.0,6.0
9506449,5,5,0,0,5,0,0,236,2.0,2.0,0.0,0.0,2.0,0.0,0.0,5,5,0,2.0,2.0,0.0
103265,8,3,5,9,0,8,110,3,3.0,2.0,1.0,1.0,0.0,3.0,50.0,72,8,64,14.0,3.0,11.0
203189,7,4,3,4,0,7,41,73,3.0,2.0,1.0,1.0,0.0,3.0,20.0,23,7,16,13.0,4.0,9.0
9408281,4,3,1,1,1,3,3,419,1.0,1.0,0.0,0.0,0.0,1.0,1.0,6,4,2,3.0,2.0,1.0
9509345,2,2,0,0,0,2,6,228,2.0,2.0,0.0,0.0,0.0,2.0,6.0,6,2,4,4.0,1.0,3.0
9906476,8,6,2,2,0,8,58,24,2.0,2.0,0.0,0.0,0.0,2.0,23.0,38,8,30,17.0,1.0,16.0
9411207,38,11,27,81,5,33,101,35,21.0,4.0,17.0,47.0,0.0,21.0,51.0,48,38,10,11.0,9.0,2.0
9804391,9,2,7,11,0,9,40,83,6.0,1.0,5.0,9.0,0.0,6.0,11.0,26,9,17,11.0,5.0,6.0
9712270,6,5,1,1,1,5,8,204,2.0,2.0,0.0,0.0,0.0,2.0,4.0,8,6,2,2.0,2.0,0.0
9912277,1,1,0,0,1,0,0,4,0.0,0.0,0.0,0.0,0.0,0.0,0.0,16,1,15,6.0,0.0,6.0
104038,26,3,23,104,0,26,275,11,21.0,1.0,20.0,96.0,0.0,21.0,238.0,46,26,20,35.0,18.0,17.0
9809474,6,3,3,4,0,6,38,115,3.0,3.0,0.0,0.0,0.0,3.0,21.0,19,6,13,3.0,1.0,2.0
9612417,3,2,1,1,0,3,7,13,0.0,0.0,0.0,0.0,0.0,0.0,0.0,9,3,6,1.0,0.0,1.0
9805477,10,1,9,19,2,8,15,142,8.0,1.0,7.0,17.0,1.0,7.0,7.0,14,10,4,7.0,6.0,1.0
103290,5,3,2,2,0,5,11,59,5.0,3.0,2.0,2.0,0.0,5.0,8.0,14,5,9,6.0,4.0,2.0
9203212,2,2,0,0,2,0,0,1965,,,,,,,,2,2,0,,,
5109,6,4,2,2,0,6,124,32,4.0,3.0,1.0,1.0,0.0,4.0,100.0,82,6,76,37.0,4.0,33.0
9902426,5,3,2,3,0,5,21,39,1.0,1.0,0.0,0.0,0.0,1.0,9.0,27,5,22,3.0,1.0,2.0
9510293,14,7,7,9,11,3,4,144,6.0,2.0,4.0,5.0,6.0,0.0,0.0,18,14,4,4.0,4.0,0.0
105069,3,3,0,0,0,3,4,121,2.0,2.0,0.0,0.0,0.0,2.0,3.0,6,3,3,1.0,1.0,0.0
9807222,12,5,7,19,2,10,49,25,7.0,2.0,5.0,12.0,0.0,7.0,34.0,20,12,8,12.0,6.0,6.0
9309316,3,3,0,0,2,1,1,317,1.0,1.0,0.0,0.0,1.0,0.0,0.0,7,3,4,1.0,0.0,1.0
9510283,5,4,1,3,0,5,16,8,3.0,2.0,1.0,2.0,0.0,3.0,11.0,21,5,16,2.0,2.0,0.0
9310369,64,1,63,434,13,51,132,53,52.0,1.0,51.0,380.0,3.0,49.0,128.0,67,64,3,41.0,38.0,3.0
9709291,17,6,11,30,0,17,148,1,11.0,1.0,10.0,27.0,0.0,11.0,122.0,41,17,24,16.0,5.0,11.0
10332,6,4,2,3,0,6,18,88,2.0,2.0,0.0,0.0,0.0,2.0,6.0,20,6,14,7.0,0.0,7.0
9802220,12,4,8,12,12,0,0,99,4.0,1.0,3.0,6.0,4.0,0.0,0.0,12,12,0,4.0,4.0,0.0
9809321,46,1,45,375,24,22,25,109,43.0,1.0,42.0,370.0,27.0,16.0,16.0,48,46,2,37.0,37.0,0.0
9307239,8,5,3,7,8,0,0,94,1.0,1.0,0.0,0.0,1.0,0.0,0.0,8,8,0,2.0,2.0,0.0
9811248,13,4,9,15,0,13,146,5,8.0,3.0,5.0,7.0,0.0,8.0,128.0,48,13,35,39.0,7.0,32.0
9803334,4,1,3,3,0,4,5,157,4.0,1.0,3.0,3.0,0.0,4.0,4.0,15,4,11,5.0,4.0,1.0
12056,13,5,8,15,4,9,36,28,4.0,3.0,1.0,1.0,0.0,4.0,21.0,38,13,25,8.0,5.0,3.0
7252,11,4,7,16,0,11,57,7,7.0,2.0,5.0,12.0,0.0,7.0,34.0,29,11,18,16.0,6.0,10.0
9904259,12,9,3,3,2,10,30,0,1.0,1.0,0.0,0.0,0.0,1.0,2.0,30,12,18,7.0,0.0,7.0
9811513,5,5,0,0,1,4,7,38,1.0,1.0,0.0,0.0,0.0,1.0,3.0,12,5,7,4.0,0.0,4.0
9612385,8,2,6,8,3,5,23,36,3.0,1.0,2.0,2.0,0.0,3.0,15.0,19,8,11,5.0,1.0,4.0
9608375,8,1,7,12,0,8,26,8,5.0,1.0,4.0,7.0,0.0,5.0,18.0,12,8,4,5.0,3.0,2.0
9612369,2,2,0,0,1,1,1,78,1.0,1.0,0.0,0.0,1.0,0.0,0.0,4,2,2,1.0,1.0,0.0
9802320,5,2,3,4,2,3,5,43,0.0,0.0,0.0,0.0,0.0,0.0,0.0,18,5,13,1.0,1.0,0.0
9708208,5,4,1,1,4,1,2,1,3.0,2.0,1.0,1.0,3.0,0.0,0.0,7,5,2,3.0,3.0,0.0
9409283,3,2,1,1,3,0,0,1,0.0,0.0,0.0,0.0,0.0,0.0,0.0,5,3,2,1.0,0.0,1.0
9709214,18,4,14,44,9,9,11,277,15.0,3.0,12.0,38.0,9.0,6.0,6.0,20,18,2,14.0,12.0,2.0
9908343,5,4,1,1,0,5,90,1,4.0,3.0,1.0,1.0,0.0,4.0,75.0,47,5,42,21.0,2.0,19.0
9708461,5,3,2,3,0,5,20,8,2.0,1.0,1.0,1.0,0.0,2.0,9.0,20,5,15,9.0,3.0,6.0
9905376,25,7,18,44,0,25,212,9,21.0,6.0,15.0,36.0,0.0,21.0,192.0,48,25,23,34.0,14.0,20.0
9906529,12,2,10,32,7,5,9,6,6.0,1.0,5.0,13.0,6.0,0.0,0.0,22,12,10,10.0,9.0,1.0
9505299,2,1,1,1,2,0,0,1418,2.0,1.0,1.0,1.0,2.0,0.0,0.0,2,2,0,1.0,1.0,0.0
4094,6,4,2,2,0,6,22,54,4.0,3.0,1.0,1.0,0.0,4.0,9.0,16,6,10,2.0,2.0,0.0
9712297,14,8,6,11,7,7,8,51,5.0,3.0,2.0,4.0,5.0,0.0,0.0,21,14,7,6.0,5.0,1.0
9507394,13,10,3,6,1,12,20,202,5.0,2.0,3.0,6.0,1.0,4.0,4.0,17,13,4,5.0,4.0,1.0
9606351,11,4,7,11,0,11,26,53,10.0,3.0,7.0,8.0,0.0,10.0,24.0,15,11,4,12.0,9.0,3.0
9504309,7,5,2,2,5,2,2,95,1.0,1.0,0.0,0.0,0.0,1.0,1.0,8,7,1,4.0,3.0,1.0
211065,3,3,0,0,1,2,4,121,0.0,0.0,0.0,0.0,0.0,0.0,0.0,24,3,21,6.0,0.0,6.0
9702401,5,4,1,1,3,2,3,77,2.0,2.0,0.0,0.0,2.0,0.0,0.0,7,5,2,2.0,2.0,0.0
9805434,6,3,3,5,1,5,18,147,3.0,1.0,2.0,3.0,0.0,3.0,9.0,22,6,16,5.0,2.0,3.0
9408326,36,9,27,102,14,22,22,113,22.0,6.0,16.0,66.0,5.0,17.0,17.0,37,36,1,19.0,18.0,1.0
9907478,10,7,3,3,1,9,53,119,6.0,5.0,1.0,1.0,0.0,6.0,30.0,30,10,20,13.0,4.0,9.0
9512272,6,4,2,2,2,4,15,14,0.0,0.0,0.0,0.0,0.0,0.0,0.0,38,6,32,4.0,0.0,4.0
9910324,0,0,0,0,0,0,0,257,0.0,0.0,0.0,0.0,0.0,0.0,0.0,1,0,1,,,
9911432,4,1,3,4,0,4,25,53,3.0,1.0,2.0,3.0,0.0,3.0,24.0,14,4,10,1.0,1.0,0.0
9706513,5,5,0,0,1,4,7,131,2.0,2.0,0.0,0.0,0.0,2.0,4.0,12,5,7,2.0,1.0,1.0
9608422,8,3,5,6,8,0,0,131,2.0,1.0,1.0,1.0,2.0,0.0,0.0,8,8,0,,,
9806506,6,5,1,1,5,1,1,99,1.0,1.0,0.0,0.0,1.0,0.0,0.0,9,6,3,1.0,0.0,1.0
9803498,7,2,5,8,1,6,35,42,4.0,2.0,2.0,3.0,0.0,4.0,29.0,21,7,14,17.0,4.0,13.0
107106,5,3,2,2,1,4,15,192,3.0,2.0,1.0,1.0,0.0,3.0,10.0,27,5,22,12.0,1.0,11.0
110367,1,1,0,0,0,1,2,14,1.0,1.0,0.0,0.0,0.0,1.0,2.0,13,1,12,5.0,0.0,5.0
9708337,4,3,1,1,1,3,4,41,2.0,2.0,0.0,0.0,1.0,1.0,1.0,8,4,4,3.0,2.0,1.0
110029,3,2,1,1,0,3,27,68,3.0,2.0,1.0,1.0,0.0,3.0,23.0,53,3,50,34.0,2.0,32.0
9808211,11,3,8,11,0,11,22,143,4.0,1.0,3.0,4.0,0.0,4.0,11.0,14,11,3,7.0,4.0,3.0
9810394,6,4,2,2,1,5,9,87,1.0,1.0,0.0,0.0,0.0,1.0,2.0,40,6,34,3.0,2.0,1.0
4133,4,2,2,2,0,4,13,5,0.0,0.0,0.0,0.0,0.0,0.0,0.0,39,4,35,13.0,0.0,13.0
9605347,7,3,4,6,0,7,29,56,6.0,3.0,3.0,3.0,0.0,6.0,26.0,12,7,5,9.0,4.0,5.0
9304273,11,7,4,10,11,0,0,112,4.0,3.0,1.0,2.0,4.0,0.0,0.0,11,11,0,1.0,1.0,0.0
9606277,18,5,13,25,3,15,26,152,8.0,3.0,5.0,7.0,0.0,8.0,15.0,22,18,4,9.0,7.0,2.0
9503341,2,2,0,0,0,2,6,124,1.0,1.0,0.0,0.0,0.0,1.0,3.0,8,2,6,1.0,0.0,1.0
9510392,2,1,1,1,0,2,4,75,1.0,1.0,0.0,0.0,0.0,1.0,1.0,8,2,6,1.0,0.0,1.0
9610447,4,2,2,2,0,4,7,415,3.0,1.0,2.0,2.0,0.0,3.0,3.0,10,4,6,4.0,3.0,1.0
9705334,10,4,6,13,0,10,11,240,6.0,2.0,4.0,9.0,6.0,0.0,0.0,12,10,2,5.0,5.0,0.0
202177,7,4,3,3,1,6,58,15,4.0,2.0,2.0,2.0,0.0,4.0,45.0,36,7,29,13.0,0.0,13.0
9707290,6,5,1,1,2,4,5,15,0.0,0.0,0.0,0.0,0.0,0.0,0.0,22,6,16,2.0,2.0,0.0
9706384,2,2,0,0,0,2,4,1086,0.0,0.0,0.0,0.0,0.0,0.0,0.0,8,2,6,,,
9402303,4,2,2,2,0,4,6,27,1.0,1.0,0.0,0.0,1.0,0.0,0.0,7,4,3,1.0,1.0,0.0
9149,6,3,3,3,0,6,33,7,3.0,3.0,0.0,0.0,0.0,3.0,7.0,31,6,25,3.0,0.0,3.0
9804230,12,9,3,4,7,5,9,91,3.0,2.0,1.0,2.0,1.0,2.0,4.0,18,12,6,4.0,1.0,3.0
9803279,8,3,5,5,6,2,3,190,0.0,0.0,0.0,0.0,0.0,0.0,0.0,15,8,7,4.0,4.0,0.0
9412217,8,4,4,5,7,1,1,205,3.0,1.0,2.0,2.0,3.0,0.0,0.0,9,8,1,3.0,3.0,0.0
107045,1,1,0,0,1,0,0,17,1.0,1.0,0.0,0.0,1.0,0.0,0.0,14,1,13,2.0,0.0,2.0
7238,13,5,8,16,2,11,34,192,9.0,2.0,7.0,13.0,3.0,6.0,14.0,23,13,10,9.0,5.0,4.0
4228,9,3,6,9,0,9,59,17,8.0,3.0,5.0,7.0,0.0,8.0,50.0,24,9,15,9.0,2.0,7.0
9906329,4,1,3,4,2,2,17,7,0.0,0.0,0.0,0.0,0.0,0.0,0.0,28,4,24,6.0,1.0,5.0
9610230,8,5,3,5,2,6,43,34,4.0,1.0,3.0,5.0,0.0,4.0,32.0,21,8,13,1.0,0.0,1.0
9709325,8,4,4,11,2,6,15,78,6.0,2.0,4.0,11.0,0.0,6.0,15.0,14,8,6,9.0,6.0,3.0
203195,4,2,2,4,0,4,26,73,4.0,2.0,2.0,4.0,0.0,4.0,26.0,13,4,9,12.0,3.0,9.0
110199,1,1,0,0,0,1,15,73,1.0,1.0,0.0,0.0,0.0,1.0,15.0,18,1,17,15.0,1.0,14.0
9909511,0,0,0,0,0,0,0,605,0.0,0.0,0.0,0.0,0.0,0.0,0.0,7,0,7,2.0,0.0,2.0
4226,11,3,8,11,0,11,83,13,7.0,2.0,5.0,6.0,0.0,7.0,52.0,39,11,28,15.0,5.0,10.0
9912445,4,4,0,0,2,2,2,16,0.0,0.0,0.0,0.0,0.0,0.0,0.0,45,4,41,16.0,0.0,16.0
9809564,2,2,0,0,0,2,6,98,1.0,1.0,0.0,0.0,0.0,1.0,2.0,8,2,6,1.0,0.0,1.0
9154,12,8,4,7,2,10,26,2,2.0,2.0,0.0,0.0,2.0,0.0,0.0,16,12,4,1.0,1.0,0.0
104148,5,2,3,4,0,5,24,82,4.0,2.0,2.0,3.0,0.0,4.0,19.0,13,5,8,9.0,3.0,6.0
9810456,10,2,8,14,10,0,0,50,5.0,2.0,3.0,4.0,5.0,0.0,0.0,12,10,2,6.0,6.0,0.0
202039,11,8,3,3,1,10,55,95,5.0,5.0,0.0,0.0,0.0,5.0,20.0,30,11,19,17.0,4.0,13.0
9708488,22,11,11,23,18,4,4,68,7.0,3.0,4.0,8.0,7.0,0.0,0.0,24,22,2,4.0,4.0,0.0
9903452,3,3,0,0,1,2,5,3,1.0,1.0,0.0,0.0,0.0,1.0,2.0,11,3,8,3.0,0.0,3.0
9804281,19,7,12,24,1,18,47,13,10.0,4.0,6.0,11.0,1.0,9.0,14.0,26,19,7,12.0,8.0,4.0
9301262,10,3,7,16,10,0,0,77,9.0,2.0,7.0,15.0,9.0,0.0,0.0,10,10,0,8.0,8.0,0.0
9411266,3,3,0,0,0,3,5,52,0.0,0.0,0.0,0.0,0.0,0.0,0.0,5,3,2,2.0,1.0,1.0
110328,1,1,0,0,0,1,3,7,1.0,1.0,0.0,0.0,0.0,1.0,2.0,9,1,8,3.0,1.0,2.0
9612443,3,2,1,1,0,3,8,183,3.0,2.0,1.0,1.0,0.0,3.0,5.0,9,3,6,6.0,3.0,3.0
9810258,5,3,2,2,1,4,6,135,0.0,0.0,0.0,0.0,0.0,0.0,0.0,8,5,3,4.0,1.0,3.0
9411317,6,4,2,2,6,0,0,172,3.0,2.0,1.0,1.0,3.0,0.0,0.0,6,6,0,2.0,2.0,0.0
11135,6,4,2,2,0,6,59,8,2.0,2.0,0.0,0.0,0.0,2.0,16.0,37,6,31,11.0,2.0,9.0
9601348,3,1,2,2,2,1,1,449,1.0,1.0,0.0,0.0,1.0,0.0,0.0,11,3,8,2.0,0.0,2.0
107301,3,3,0,0,0,3,11,11,1.0,1.0,0.0,0.0,0.0,1.0,4.0,17,3,14,7.0,1.0,6.0
103307,3,3,0,0,0,3,16,48,2.0,2.0,0.0,0.0,0.0,2.0,12.0,17,3,14,6.0,0.0,6.0
9907498,13,6,7,8,2,11,25,9,10.0,6.0,4.0,5.0,1.0,9.0,20.0,18,13,5,6.0,4.0,2.0
9511374,7,2,5,6,1,6,20,72,1.0,1.0,0.0,0.0,0.0,1.0,7.0,27,7,20,5.0,1.0,4.0
108204,5,2,3,4,0,5,13,28,5.0,2.0,3.0,4.0,0.0,5.0,11.0,12,5,7,3.0,1.0,2.0
9911452,5,3,2,4,0,5,17,4,5.0,3.0,2.0,4.0,0.0,5.0,10.0,23,5,18,5.0,3.0,2.0
206034,17,3,14,35,0,17,214,0,14.0,1.0,13.0,31.0,0.0,14.0,154.0,70,17,53,32.0,3.0,29.0
3289,8,4,4,6,2,6,11,197,8.0,4.0,4.0,6.0,2.0,6.0,11.0,12,8,4,8.0,5.0,3.0
9410351,8,3,5,10,8,0,0,178,4.0,1.0,3.0,6.0,4.0,0.0,0.0,9,8,1,4.0,4.0,0.0
9704301,36,4,32,113,25,11,12,65,22.0,2.0,20.0,81.0,15.0,7.0,8.0,40,36,4,19.0,18.0,1.0
2047,4,1,3,6,0,4,5,51,3.0,1.0,2.0,3.0,3.0,0.0,0.0,8,4,4,6.0,4.0,2.0
9211329,9,2,7,9,9,0,0,332,9.0,2.0,7.0,9.0,9.0,0.0,0.0,9,9,0,7.0,7.0,0.0
12230,4,4,0,0,1,3,24,0,1.0,1.0,0.0,0.0,0.0,1.0,6.0,26,4,22,15.0,1.0,14.0
205262,4,3,1,1,2,2,17,1,2.0,1.0,1.0,1.0,0.0,2.0,8.0,18,4,14,8.0,2.0,6.0
107227,13,4,9,13,1,12,58,45,9.0,1.0,8.0,11.0,0.0,9.0,28.0,36,13,23,9.0,5.0,4.0
7094,2,2,0,0,2,0,0,81,,,,,,,,3,2,1,,,
201171,9,3,6,8,3,6,21,31,4.0,1.0,3.0,3.0,0.0,4.0,19.0,20,9,11,4.0,0.0,4.0
9901307,3,3,0,0,1,2,3,15,2.0,2.0,0.0,0.0,2.0,0.0,0.0,8,3,5,2.0,2.0,0.0
9807414,6,2,4,7,0,6,23,1,2.0,2.0,0.0,0.0,0.0,2.0,5.0,17,6,11,6.0,2.0,4.0
9909427,8,7,1,3,1,7,29,77,4.0,3.0,1.0,3.0,0.0,4.0,11.0,28,8,20,6.0,3.0,3.0
208048,4,2,2,2,0,4,20,1,2.0,1.0,1.0,1.0,2.0,0.0,0.0,15,4,11,2.0,0.0,2.0
209001,1,1,0,0,1,0,0,424,1.0,1.0,0.0,0.0,1.0,0.0,0.0,6,1,5,1.0,1.0,0.0
9905250,5,5,0,0,4,1,6,59,1.0,1.0,0.0,0.0,1.0,0.0,0.0,14,5,9,2.0,1.0,1.0
107294,11,5,6,12,9,2,2,450,3.0,2.0,1.0,1.0,1.0,2.0,2.0,12,11,1,4.0,3.0,1.0
9307233,4,3,1,1,4,0,0,145,2.0,1.0,1.0,1.0,2.0,0.0,0.0,4,4,0,2.0,2.0,0.0
6062,1,1,0,0,0,1,3,30,0.0,0.0,0.0,0.0,0.0,0.0,0.0,11,1,10,1.0,0.0,1.0
9801438,0,0,0,0,0,0,0,237,0.0,0.0,0.0,0.0,0.0,0.0,0.0,6,0,6,2.0,0.0,2.0
107145,1,1,0,0,0,1,4,1,0.0,0.0,0.0,0.0,0.0,0.0,0.0,23,1,22,10.0,0.0,10.0
102337,11,3,8,18,0,11,186,11,10.0,2.0,8.0,18.0,0.0,10.0,168.0,50,11,39,32.0,9.0,23.0
9412353,4,2,2,2,0,4,9,54,1.0,1.0,0.0,0.0,0.0,1.0,1.0,7,4,3,2.0,1.0,1.0
205111,18,10,8,24,2,16,73,55,3.0,1.0,2.0,3.0,0.0,3.0,28.0,58,18,40,19.0,3.0,16.0
210091,8,5,3,4,0,8,90,7,4.0,2.0,2.0,3.0,0.0,4.0,23.0,42,8,34,14.0,3.0,11.0
210324,1,1,0,0,0,1,4,4,0.0,0.0,0.0,0.0,0.0,0.0,0.0,24,1,23,18.0,0.0,18.0
9903418,16,4,12,39,0,16,247,12,14.0,2.0,12.0,39.0,0.0,14.0,213.0,77,16,61,29.0,8.0,21.0
9805370,4,2,2,3,1,3,9,43,3.0,1.0,2.0,3.0,0.0,3.0,9.0,8,4,4,,,
9706221,2,2,0,0,1,1,1,238,0.0,0.0,0.0,0.0,0.0,0.0,0.0,12,2,10,2.0,1.0,1.0
9811217,2,2,0,0,0,2,2,83,1.0,1.0,0.0,0.0,0.0,1.0,1.0,3,2,1,1.0,0.0,1.0
9509368,1,1,0,0,1,0,0,1882,1.0,1.0,0.0,0.0,1.0,0.0,0.0,1,1,0,,,
207026,10,3,7,12,0,10,101,7,0.0,0.0,0.0,0.0,0.0,0.0,0.0,71,10,61,19.0,7.0,12.0
9711291,5,3,2,2,1,4,5,209,3.0,2.0,1.0,1.0,0.0,3.0,4.0,11,5,6,3.0,1.0,2.0
9401284,4,2,2,3,1,3,3,274,3.0,1.0,2.0,3.0,0.0,3.0,3.0,5,4,1,4.0,3.0,1.0
9307272,1,1,0,0,1,0,0,207,1.0,1.0,0.0,0.0,1.0,0.0,0.0,1,1,0,1.0,1.0,0.0
9808427,1,1,0,0,0,1,4,223,0.0,0.0,0.0,0.0,0.0,0.0,0.0,26,1,25,6.0,0.0,6.0
107139,10,6,4,4,1,9,50,161,2.0,1.0,1.0,1.0,0.0,2.0,13.0,39,10,29,13.0,2.0,11.0
210349,1,1,0,0,0,1,2,21,1.0,1.0,0.0,0.0,1.0,0.0,0.0,6,1,5,5.0,0.0,5.0
102003,6,3,3,4,0,6,12,27,2.0,1.0,1.0,1.0,0.0,2.0,4.0,16,6,10,4.0,2.0,2.0
9810451,4,1,3,6,0,4,12,179,2.0,1.0,1.0,1.0,0.0,2.0,5.0,13,4,9,10.0,4.0,6.0
203261,13,10,3,7,1,12,33,119,4.0,4.0,0.0,0.0,0.0,4.0,21.0,27,13,14,13.0,4.0,9.0
205047,3,2,1,1,1,2,16,0,0.0,0.0,0.0,0.0,0.0,0.0,0.0,21,3,18,2.0,0.0,2.0
204093,7,4,3,4,0,7,61,4,2.0,2.0,0.0,0.0,0.0,2.0,14.0,37,7,30,15.0,3.0,12.0
111048,2,2,0,0,0,2,8,9,1.0,1.0,0.0,0.0,0.0,1.0,1.0,21,2,19,6.0,2.0,4.0
105046,3,2,1,1,0,3,29,9,3.0,2.0,1.0,1.0,0.0,3.0,24.0,21,3,18,1.0,1.0,0.0
4257,4,4,0,0,0,4,10,6,1.0,1.0,0.0,0.0,0.0,1.0,1.0,19,4,15,5.0,0.0,5.0
9610270,10,4,6,12,7,3,4,289,6.0,1.0,5.0,11.0,5.0,1.0,2.0,14,10,4,6.0,6.0,0.0
11161,0,0,0,0,0,0,0,29,0.0,0.0,0.0,0.0,0.0,0.0,0.0,11,0,11,1.0,0.0,1.0
9705421,2,2,0,0,2,0,0,121,1.0,1.0,0.0,0.0,1.0,0.0,0.0,2,2,0,,,
111263,2,2,0,0,0,2,4,1737,,,,,,,,8,2,6,2.0,1.0,1.0
103136,9,5,4,5,0,9,55,68,7.0,4.0,3.0,4.0,0.0,7.0,37.0,30,9,21,15.0,6.0,9.0
9510319,12,7,5,6,12,0,0,68,4.0,4.0,0.0,0.0,4.0,0.0,0.0,12,12,0,3.0,3.0,0.0
3003,2,1,1,1,0,2,11,11,,,,,,,,9,2,7,,,
110383,5,3,2,2,0,5,91,23,4.0,2.0,2.0,2.0,0.0,4.0,76.0,33,5,28,26.0,4.0,22.0
9511225,2,1,1,1,2,0,0,103,2.0,1.0,1.0,1.0,2.0,0.0,0.0,3,2,1,2.0,2.0,0.0
9409218,1,1,0,0,0,1,1,40,,,,,,,,2,1,1,1.0,1.0,0.0
205052,3,2,1,1,0,3,65,28,3.0,2.0,1.0,1.0,0.0,3.0,56.0,34,3,31,19.0,3.0,16.0
5242,2,2,0,0,1,1,7,39,1.0,1.0,0.0,0.0,0.0,1.0,6.0,13,2,11,12.0,1.0,11.0
9904361,2,2,0,0,0,2,13,139,1.0,1.0,0.0,0.0,0.0,1.0,9.0,15,2,13,8.0,1.0,7.0
9709468,8,3,5,7,0,8,27,117,6.0,2.0,4.0,6.0,0.0,6.0,23.0,21,8,13,10.0,5.0,5.0
9902206,8,3,5,7,4,4,7,28,1.0,1.0,0.0,0.0,1.0,0.0,0.0,10,8,2,1.0,1.0,0.0
208142,7,3,4,5,1,6,129,32,4.0,2.0,2.0,3.0,0.0,4.0,85.0,56,7,49,27.0,3.0,24.0
9711507,5,4,1,1,1,4,9,105,0.0,0.0,0.0,0.0,0.0,0.0,0.0,17,5,12,3.0,0.0,3.0
9611411,2,2,0,0,1,1,4,6,1.0,1.0,0.0,0.0,0.0,1.0,1.0,9,2,7,,,
9111,2,1,1,1,0,2,14,17,2.0,1.0,1.0,1.0,0.0,2.0,14.0,23,2,21,8.0,1.0,7.0
9407290,8,5,3,6,2,6,27,62,5.0,4.0,1.0,3.0,0.0,5.0,21.0,18,8,10,10.0,5.0,5.0
9912423,30,11,19,50,9,21,74,127,14.0,2.0,12.0,26.0,1.0,13.0,42.0,45,30,15,14.0,10.0,4.0
9906444,3,3,0,0,0,3,11,54,1.0,1.0,0.0,0.0,0.0,1.0,3.0,30,3,27,3.0,1.0,2.0
9205245,9,4,5,5,9,0,0,304,6.0,1.0,5.0,5.0,6.0,0.0,0.0,9,9,0,3.0,3.0,0.0
9612486,3,3,0,0,0,3,5,367,1.0,1.0,0.0,0.0,0.0,1.0,1.0,8,3,5,2.0,0.0,2.0
9907358,3,1,2,3,0,3,18,137,3.0,1.0,2.0,3.0,0.0,3.0,12.0,15,3,12,1.0,0.0,1.0
9305233,3,1,2,2,3,0,0,394,3.0,1.0,2.0,2.0,3.0,0.0,0.0,4,3,1,3.0,3.0,0.0
101110,5,2,3,4,0,5,30,20,3.0,1.0,2.0,3.0,0.0,3.0,9.0,27,5,22,9.0,4.0,5.0
9611342,0,0,0,0,0,0,0,223,0.0,0.0,0.0,0.0,0.0,0.0,0.0,16,0,16,4.0,0.0,4.0
9503485,2,2,0,0,1,1,9,6,1.0,1.0,0.0,0.0,0.0,1.0,8.0,16,2,14,1.0,0.0,1.0
8068,4,3,1,1,0,4,8,80,3.0,2.0,1.0,1.0,0.0,3.0,4.0,7,4,3,3.0,2.0,1.0
104288,8,5,3,3,0,8,58,2,2.0,2.0,0.0,0.0,0.0,2.0,17.0,40,8,32,5.0,0.0,5.0
205167,12,5,7,14,0,12,145,11,11.0,5.0,6.0,13.0,0.0,11.0,141.0,37,12,25,26.0,8.0,18.0
9811260,5,2,3,3,0,5,38,44,5.0,2.0,3.0,3.0,0.0,5.0,32.0,25,5,20,11.0,4.0,7.0
9609401,11,5,6,15,3,8,28,103,8.0,2.0,6.0,15.0,0.0,8.0,27.0,16,11,5,10.0,7.0,3.0
9505331,5,4,1,1,4,1,1,206,1.0,1.0,0.0,0.0,0.0,1.0,1.0,10,5,5,5.0,1.0,4.0
9401283,8,3,5,8,8,0,0,25,3.0,3.0,0.0,0.0,3.0,0.0,0.0,8,8,0,1.0,1.0,0.0
9603338,8,4,4,7,0,8,21,14,2.0,2.0,0.0,0.0,0.0,2.0,5.0,22,8,14,4.0,1.0,3.0
9708336,8,3,5,6,8,0,0,356,7.0,2.0,5.0,6.0,7.0,0.0,0.0,9,8,1,4.0,4.0,0.0
12183,1,1,0,0,0,1,8,6,0.0,0.0,0.0,0.0,0.0,0.0,0.0,10,1,9,5.0,1.0,4.0
9705476,3,1,2,2,3,0,0,1699,2.0,2.0,0.0,0.0,2.0,0.0,0.0,5,3,2,1.0,1.0,0.0
9906342,2,1,1,1,0,2,15,5,0.0,0.0,0.0,0.0,0.0,0.0,0.0,33,2,31,22.0,0.0,22.0
9601284,5,2,3,3,1,4,19,4,1.0,1.0,0.0,0.0,0.0,1.0,6.0,17,5,12,6.0,2.0,4.0
9707286,13,2,11,38,6,7,8,125,12.0,2.0,10.0,36.0,12.0,0.0,0.0,17,13,4,11.0,11.0,0.0
9911425,5,3,2,2,0,5,27,78,3.0,3.0,0.0,0.0,0.0,3.0,16.0,28,5,23,10.0,3.0,7.0
9312301,5,5,0,0,5,0,0,133,2.0,2.0,0.0,0.0,2.0,0.0,0.0,5,5,0,2.0,2.0,0.0
9902359,2,2,0,0,1,1,2,258,0.0,0.0,0.0,0.0,0.0,0.0,0.0,14,2,12,3.0,0.0,3.0
110312,6,3,3,3,1,5,12,64,5.0,3.0,2.0,2.0,0.0,5.0,12.0,11,6,5,3.0,2.0,1.0
8284,2,2,0,0,2,0,0,1409,,,,,,,,6,2,4,,,
9411316,3,3,0,0,3,0,0,487,0.0,0.0,0.0,0.0,0.0,0.0,0.0,5,3,2,2.0,2.0,0.0
107244,0,0,0,0,0,0,0,187,,,,,,,,1,0,1,,,
9911322,3,2,1,1,0,3,11,45,2.0,1.0,1.0,1.0,0.0,2.0,6.0,11,3,8,5.0,2.0,3.0
9511455,23,5,18,53,7,16,45,29,12.0,2.0,10.0,29.0,3.0,9.0,15.0,31,23,8,13.0,9.0,4.0
204330,2,1,1,1,0,2,16,59,2.0,1.0,1.0,1.0,0.0,2.0,15.0,13,2,11,7.0,1.0,6.0
9311245,1,1,0,0,1,0,0,246,1.0,1.0,0.0,0.0,1.0,0.0,0.0,1,1,0,1.0,1.0,0.0
9706444,11,1,10,22,0,11,44,133,8.0,1.0,7.0,13.0,0.0,8.0,30.0,24,11,13,16.0,8.0,8.0
9506254,18,11,7,11,13,5,6,52,5.0,1.0,4.0,7.0,4.0,1.0,1.0,20,18,2,2.0,2.0,0.0
9306328,1,1,0,0,1,0,0,1789,0.0,0.0,0.0,0.0,0.0,0.0,0.0,2,1,1,1.0,0.0,1.0
103229,9,4,5,8,2,7,49,42,4.0,2.0,2.0,4.0,0.0,4.0,27.0,28,9,19,16.0,4.0,12.0
9810265,2,2,0,0,0,2,8,22,0.0,0.0,0.0,0.0,0.0,0.0,0.0,16,2,14,1.0,0.0,1.0
9802226,7,5,2,4,0,7,22,29,3.0,2.0,1.0,1.0,0.0,3.0,9.0,27,7,20,8.0,2.0,6.0
109025,2,2,0,0,0,2,6,58,1.0,1.0,0.0,0.0,0.0,1.0,1.0,10,2,8,4.0,1.0,3.0
12188,0,0,0,0,0,0,0,80,0.0,0.0,0.0,0.0,0.0,0.0,0.0,11,0,11,4.0,0.0,4.0
3311,2,1,1,1,2,0,0,324,2.0,1.0,1.0,1.0,2.0,0.0,0.0,3,2,1,2.0,2.0,0.0
202186,1,1,0,0,1,0,0,307,0.0,0.0,0.0,0.0,0.0,0.0,0.0,9,1,8,2.0,1.0,1.0
9504422,6,2,4,6,0,6,10,14,5.0,2.0,3.0,5.0,2.0,3.0,3.0,9,6,3,5.0,5.0,0.0
9505325,3,2,1,1,0,3,6,129,0.0,0.0,0.0,0.0,0.0,0.0,0.0,7,3,4,4.0,1.0,3.0
9712397,3,2,1,2,0,3,17,5,3.0,2.0,1.0,2.0,0.0,3.0,14.0,13,3,10,2.0,1.0,1.0
9404292,3,2,1,1,0,3,4,38,2.0,1.0,1.0,1.0,2.0,0.0,0.0,6,3,3,1.0,1.0,0.0
9808417,1,1,0,0,0,1,4,53,1.0,1.0,0.0,0.0,0.0,1.0,3.0,6,1,5,5.0,1.0,4.0
210212,1,1,0,0,0,1,5,95,1.0,1.0,0.0,0.0,0.0,1.0,1.0,11,1,10,,,
9612345,1,1,0,0,0,1,3,8,0.0,0.0,0.0,0.0,0.0,0.0,0.0,4,1,3,4.0,1.0,3.0
9802363,0,0,0,0,0,0,0,61,0.0,0.0,0.0,0.0,0.0,0.0,0.0,14,0,14,8.0,0.0,8.0
3044,1,1,0,0,1,0,0,133,0.0,0.0,0.0,0.0,0.0,0.0,0.0,2,1,1,2.0,1.0,1.0
107034,0,0,0,0,0,0,0,40,0.0,0.0,0.0,0.0,0.0,0.0,0.0,16,0,16,12.0,0.0,12.0
9505349,1,1,0,0,1,0,0,234,0.0,0.0,0.0,0.0,0.0,0.0,0.0,7,1,6,6.0,0.0,6.0
9027,3,2,1,1,1,2,6,285,2.0,1.0,1.0,1.0,0.0,2.0,5.0,11,3,8,5.0,2.0,3.0
9907273,6,5,1,1,6,0,0,185,4.0,3.0,1.0,1.0,4.0,0.0,0.0,6,6,0,2.0,2.0,0.0
9612205,8,4,4,12,0,8,43,137,7.0,3.0,4.0,12.0,0.0,7.0,39.0,17,8,9,13.0,7.0,6.0
208248,3,3,0,0,1,2,14,28,1.0,1.0,0.0,0.0,0.0,1.0,8.0,14,3,11,9.0,1.0,8.0
9906401,12,3,9,27,1,11,35,125,9.0,2.0,7.0,17.0,0.0,9.0,26.0,25,12,13,15.0,7.0,8.0
11148,1,1,0,0,0,1,5,2,1.0,1.0,0.0,0.0,0.0,1.0,4.0,8,1,7,,,
4111,3,2,1,1,0,3,25,9,2.0,1.0,1.0,1.0,0.0,2.0,4.0,27,3,24,4.0,2.0,2.0
9509318,3,3,0,0,0,3,3,133,2.0,2.0,0.0,0.0,0.0,2.0,2.0,4,3,1,2.0,1.0,1.0
9304222,1,1,0,0,1,0,0,1639,,,,,,,,1,1,0,1.0,1.0,0.0
9904486,0,0,0,0,0,0,0,403,0.0,0.0,0.0,0.0,0.0,0.0,0.0,1,0,1,1.0,0.0,1.0
9512297,2,2,0,0,1,1,1,192,1.0,1.0,0.0,0.0,1.0,0.0,0.0,4,2,2,1.0,1.0,0.0
9709303,2,1,1,1,0,2,5,1792,1.0,1.0,0.0,0.0,1.0,0.0,0.0,6,2,4,1.0,1.0,0.0
204264,1,1,0,0,0,1,1,83,1.0,1.0,0.0,0.0,0.0,1.0,1.0,9,1,8,2.0,1.0,1.0
9605227,9,5,4,8,3,6,15,139,4.0,1.0,3.0,6.0,1.0,3.0,6.0,18,9,9,4.0,2.0,2.0
206079,5,3,2,2,0,5,50,16,5.0,3.0,2.0,2.0,0.0,5.0,50.0,26,5,21,14.0,2.0,12.0
209083,4,3,1,1,1,3,10,0,0.0,0.0,0.0,0.0,0.0,0.0,0.0,52,4,48,9.0,0.0,9.0
111395,3,3,0,0,0,3,4,98,1.0,1.0,0.0,0.0,0.0,1.0,2.0,10,3,7,3.0,3.0,0.0
9909234,2,2,0,0,0,2,6,9,0.0,0.0,0.0,0.0,0.0,0.0,0.0,77,2,75,12.0,0.0,12.0
9606451,3,1,2,2,0,3,6,29,0.0,0.0,0.0,0.0,0.0,0.0,0.0,10,3,7,1.0,0.0,1.0
9901202,3,2,1,1,0,3,17,26,3.0,2.0,1.0,1.0,0.0,3.0,17.0,13,3,10,10.0,2.0,8.0
9306245,6,3,3,6,6,0,0,276,6.0,3.0,3.0,6.0,6.0,0.0,0.0,7,6,1,5.0,5.0,0.0
9606396,1,1,0,0,0,1,3,41,1.0,1.0,0.0,0.0,0.0,1.0,3.0,8,1,7,6.0,1.0,5.0
9706531,15,3,12,20,2,13,31,54,5.0,2.0,3.0,5.0,0.0,5.0,9.0,28,15,13,8.0,6.0,2.0
107027,4,3,1,1,3,1,1,797,2.0,2.0,0.0,0.0,2.0,0.0,0.0,6,4,2,1.0,1.0,0.0
103245,4,3,1,1,0,4,33,11,2.0,1.0,1.0,1.0,0.0,2.0,6.0,35,4,31,11.0,2.0,9.0
9801337,2,1,1,1,1,1,15,7,1.0,1.0,0.0,0.0,0.0,1.0,11.0,27,2,25,1.0,0.0,1.0
110357,1,1,0,0,0,1,4,31,1.0,1.0,0.0,0.0,0.0,1.0,4.0,8,1,7,2.0,0.0,2.0
9705346,8,3,5,13,3,5,5,455,6.0,4.0,2.0,7.0,6.0,0.0,0.0,10,8,2,8.0,8.0,0.0
9808372,1,1,0,0,1,0,0,102,,,,,,,,1,1,0,,,
12325,1,1,0,0,0,1,1,31,0.0,0.0,0.0,0.0,0.0,0.0,0.0,8,1,7,1.0,0.0,1.0
9408267,0,0,0,0,0,0,0,1153,,,,,,,,1,0,1,,,
9809308,9,6,3,4,5,4,6,85,2.0,2.0,0.0,0.0,2.0,0.0,0.0,13,9,4,2.0,2.0,0.0
9907381,1,1,0,0,0,1,7,22,0.0,0.0,0.0,0.0,0.0,0.0,0.0,21,1,20,4.0,0.0,4.0
9801278,2,2,0,0,0,2,6,115,1.0,1.0,0.0,0.0,0.0,1.0,5.0,7,2,5,1.0,0.0,1.0
9907561,2,1,1,1,0,2,13,10,2.0,1.0,1.0,1.0,0.0,2.0,2.0,12,2,10,8.0,2.0,6.0
212265,1,1,0,0,0,1,9,21,0.0,0.0,0.0,0.0,0.0,0.0,0.0,30,1,29,6.0,1.0,5.0
204131,3,3,0,0,1,2,6,88,0.0,0.0,0.0,0.0,0.0,0.0,0.0,14,3,11,1.0,0.0,1.0
9808338,2,2,0,0,1,1,3,12,,,,,,,,5,2,3,,,
9804249,4,1,3,6,0,4,31,6,1.0,1.0,0.0,0.0,0.0,1.0,1.0,15,4,11,8.0,4.0,4.0
9712214,1,1,0,0,0,1,1,4,0.0,0.0,0.0,0.0,0.0,0.0,0.0,12,1,11,2.0,0.0,2.0
9610393,1,1,0,0,0,1,4,163,1.0,1.0,0.0,0.0,1.0,0.0,0.0,5,1,4,1.0,0.0,1.0
9501400,2,1,1,1,1,1,1,295,2.0,1.0,1.0,1.0,1.0,1.0,1.0,5,2,3,3.0,2.0,1.0
9703368,3,2,1,1,0,3,4,147,2.0,2.0,0.0,0.0,0.0,2.0,2.0,5,3,2,2.0,1.0,1.0
9803296,4,3,1,1,0,4,12,57,2.0,1.0,1.0,1.0,0.0,2.0,5.0,17,4,13,3.0,2.0,1.0
9409370,0,0,0,0,0,0,0,1967,,,,,,,,2,0,2,,,
9609222,2,2,0,0,1,1,3,54,1.0,1.0,0.0,0.0,0.0,1.0,2.0,8,2,6,3.0,0.0,3.0
9405201,2,1,1,1,0,2,2,102,2.0,1.0,1.0,1.0,0.0,2.0,2.0,3,2,1,,,
210314,4,4,0,0,0,4,49,7,3.0,3.0,0.0,0.0,0.0,3.0,33.0,25,4,21,14.0,3.0,11.0
202216,4,3,1,1,0,4,16,57,3.0,2.0,1.0,1.0,0.0,3.0,10.0,15,4,11,3.0,3.0,0.0
9610409,10,4,6,12,10,0,0,31,5.0,2.0,3.0,4.0,5.0,0.0,0.0,10,10,0,5.0,5.0,0.0
1058,8,3,5,7,1,7,23,21,4.0,2.0,2.0,2.0,1.0,3.0,3.0,22,8,14,6.0,3.0,3.0
9708321,1,1,0,0,0,1,8,25,0.0,0.0,0.0,0.0,0.0,0.0,0.0,18,1,17,11.0,0.0,11.0
9902236,8,1,7,11,0,8,24,11,8.0,1.0,7.0,11.0,2.0,6.0,9.0,18,8,10,11.0,8.0,3.0
206208,5,2,3,4,0,5,60,4,3.0,1.0,2.0,3.0,0.0,3.0,25.0,43,5,38,10.0,1.0,9.0
9405349,3,2,1,1,1,2,2,225,2.0,1.0,1.0,1.0,0.0,2.0,2.0,11,3,8,2.0,0.0,2.0
4105,5,4,1,1,1,4,17,3,3.0,2.0,1.0,1.0,0.0,3.0,13.0,37,5,32,7.0,0.0,7.0
207294,4,4,0,0,1,3,6,86,2.0,2.0,0.0,0.0,0.0,2.0,2.0,11,4,7,3.0,2.0,1.0
110125,3,1,2,3,3,0,0,181,0.0,0.0,0.0,0.0,0.0,0.0,0.0,8,3,5,3.0,0.0,3.0
9904290,9,5,4,7,3,6,20,147,7.0,3.0,4.0,7.0,3.0,4.0,5.0,17,9,8,5.0,4.0,1.0
9608254,1,1,0,0,0,1,3,5,1.0,1.0,0.0,0.0,0.0,1.0,3.0,15,1,14,3.0,0.0,3.0
9910407,6,4,2,2,0,6,33,119,5.0,3.0,2.0,2.0,0.0,5.0,29.0,22,6,16,13.0,3.0,10.0
9146,3,1,2,2,0,3,49,24,2.0,1.0,1.0,1.0,0.0,2.0,26.0,29,3,26,15.0,3.0,12.0
207208,1,1,0,0,0,1,1,99,0.0,0.0,0.0,0.0,0.0,0.0,0.0,8,1,7,5.0,0.0,5.0
203188,6,3,3,7,0,6,53,107,6.0,3.0,3.0,7.0,0.0,6.0,35.0,27,6,21,12.0,6.0,6.0
9708371,3,1,2,3,0,3,12,264,3.0,1.0,2.0,3.0,0.0,3.0,9.0,12,3,9,1.0,1.0,0.0
201267,1,1,0,0,1,0,0,138,0.0,0.0,0.0,0.0,0.0,0.0,0.0,16,1,15,3.0,0.0,3.0
9508230,2,2,0,0,2,0,0,63,0.0,0.0,0.0,0.0,0.0,0.0,0.0,7,2,5,3.0,0.0,3.0
9407321,4,4,0,0,3,1,1,89,0.0,0.0,0.0,0.0,0.0,0.0,0.0,6,4,2,2.0,2.0,0.0
209296,0,0,0,0,0,0,0,146,0.0,0.0,0.0,0.0,0.0,0.0,0.0,4,0,4,,,
10243,2,2,0,0,0,2,2,180,2.0,2.0,0.0,0.0,0.0,2.0,2.0,3,2,1,2.0,2.0,0.0
9346,2,2,0,0,0,2,8,4,0.0,0.0,0.0,0.0,0.0,0.0,0.0,12,2,10,3.0,1.0,2.0
9402327,0,0,0,0,0,0,0,1328,0.0,0.0,0.0,0.0,0.0,0.0,0.0,1,0,1,,,
201166,6,3,3,6,2,4,16,40,4.0,1.0,3.0,6.0,0.0,4.0,8.0,11,6,5,6.0,4.0,2.0
112252,0,0,0,0,0,0,0,1884,0.0,0.0,0.0,0.0,0.0,0.0,0.0,3,0,3,1.0,0.0,1.0
202011,3,1,2,2,0,3,4,165,3.0,1.0,2.0,2.0,0.0,3.0,4.0,6,3,3,,,
211439,0,0,0,0,0,0,0,113,0.0,0.0,0.0,0.0,0.0,0.0,0.0,8,0,8,,,
209341,0,0,0,0,0,0,0,11,0.0,0.0,0.0,0.0,0.0,0.0,0.0,25,0,25,12.0,0.0,12.0
110348,6,4,2,3,1,5,34,77,5.0,3.0,2.0,3.0,0.0,5.0,25.0,34,6,28,12.0,4.0,8.0
9702326,6,4,2,2,4,2,5,148,5.0,3.0,2.0,2.0,3.0,2.0,5.0,10,6,4,5.0,3.0,2.0
206138,6,2,4,6,1,5,27,27,2.0,2.0,0.0,0.0,0.0,2.0,3.0,19,6,13,5.0,2.0,3.0
9211201,1,1,0,0,1,0,0,479,1.0,1.0,0.0,0.0,1.0,0.0,0.0,1,1,0,1.0,1.0,0.0
108128,1,1,0,0,0,1,13,2,1.0,1.0,0.0,0.0,0.0,1.0,7.0,15,1,14,1.0,0.0,1.0
9403343,2,1,1,1,0,2,2,26,,,,,,,,4,2,2,,,
9306238,5,3,2,4,5,0,0,112,4.0,2.0,2.0,4.0,4.0,0.0,0.0,6,5,1,4.0,4.0,0.0
9903318,8,5,3,3,4,4,7,15,2.0,2.0,0.0,0.0,0.0,2.0,3.0,24,8,16,7.0,2.0,5.0
4250,4,3,1,1,2,2,6,185,2.0,1.0,1.0,1.0,1.0,1.0,2.0,15,4,11,3.0,0.0,3.0
9711475,2,1,1,1,0,2,5,104,2.0,1.0,1.0,1.0,0.0,2.0,5.0,5,2,3,5.0,2.0,3.0
206229,4,1,3,3,0,4,10,38,4.0,1.0,3.0,3.0,0.0,4.0,9.0,12,4,8,6.0,3.0,3.0
302034,2,2,0,0,0,2,7,3,0.0,0.0,0.0,0.0,0.0,0.0,0.0,27,2,25,3.0,0.0,3.0
11385,5,1,4,6,0,5,50,21,1.0,1.0,0.0,0.0,0.0,1.0,14.0,55,5,50,7.0,0.0,7.0
207092,5,1,4,6,0,5,26,53,5.0,1.0,4.0,6.0,0.0,5.0,26.0,16,5,11,13.0,3.0,10.0
9309311,0,0,0,0,0,0,0,179,0.0,0.0,0.0,0.0,0.0,0.0,0.0,2,0,2,,,
9604421,4,3,1,1,3,1,7,49,1.0,1.0,0.0,0.0,0.0,1.0,6.0,15,4,11,5.0,1.0,4.0
210174,1,1,0,0,1,0,0,2007,,,,,,,,3,1,2,,,
9907274,5,2,3,6,1,4,4,161,5.0,2.0,3.0,6.0,1.0,4.0,4.0,7,5,2,5.0,4.0,1.0
10248,4,2,2,3,0,4,23,9,0.0,0.0,0.0,0.0,0.0,0.0,0.0,38,4,34,6.0,2.0,4.0
210102,1,1,0,0,0,1,3,1,1.0,1.0,0.0,0.0,0.0,1.0,2.0,23,1,22,4.0,0.0,4.0
109119,10,3,7,14,0,10,107,82,9.0,2.0,7.0,14.0,0.0,9.0,98.0,96,10,86,35.0,6.0,29.0
203151,4,4,0,0,1,3,18,51,2.0,2.0,0.0,0.0,0.0,2.0,11.0,28,4,24,8.0,1.0,7.0
211211,0,0,0,0,0,0,0,2,0.0,0.0,0.0,0.0,0.0,0.0,0.0,9,0,9,1.0,0.0,1.0
9903393,1,1,0,0,0,1,1,5,,,,,,,,10,1,9,1.0,0.0,1.0
208239,0,0,0,0,0,0,0,353,0.0,0.0,0.0,0.0,0.0,0.0,0.0,5,0,5,2.0,0.0,2.0
204322,0,0,0,0,0,0,0,68,0.0,0.0,0.0,0.0,0.0,0.0,0.0,17,0,17,11.0,0.0,11.0
9812527,7,1,6,9,1,6,6,262,7.0,1.0,6.0,9.0,1.0,6.0,6.0,8,7,1,8.0,7.0,1.0
9611275,1,1,0,0,0,1,3,76,1.0,1.0,0.0,0.0,0.0,1.0,3.0,7,1,6,6.0,1.0,5.0
110308,1,1,0,0,0,1,7,2,0.0,0.0,0.0,0.0,0.0,0.0,0.0,9,1,8,1.0,0.0,1.0
9711242,0,0,0,0,0,0,0,435,0.0,0.0,0.0,0.0,0.0,0.0,0.0,1,0,1,1.0,0.0,1.0
9509391,1,1,0,0,1,0,0,331,1.0,1.0,0.0,0.0,1.0,0.0,0.0,3,1,2,1.0,0.0,1.0
202206,3,2,1,1,0,3,14,2,3.0,2.0,1.0,1.0,0.0,3.0,9.0,19,3,16,5.0,2.0,3.0
9912514,2,2,0,0,0,2,5,44,2.0,2.0,0.0,0.0,0.0,2.0,5.0,16,2,14,11.0,2.0,9.0
9903522,0,0,0,0,0,0,0,35,0.0,0.0,0.0,0.0,0.0,0.0,0.0,8,0,8,4.0,0.0,4.0
109127,9,5,4,4,1,8,27,4,3.0,3.0,0.0,0.0,0.0,3.0,7.0,31,9,22,3.0,3.0,0.0
9603427,1,1,0,0,1,0,0,280,0.0,0.0,0.0,0.0,0.0,0.0,0.0,2,1,1,1.0,1.0,0.0
101292,5,1,4,7,0,5,50,1,4.0,1.0,3.0,6.0,0.0,4.0,11.0,35,5,30,9.0,5.0,4.0
9604362,0,0,0,0,0,0,0,256,0.0,0.0,0.0,0.0,0.0,0.0,0.0,10,0,10,2.0,0.0,2.0
12011,3,3,0,0,1,2,10,2,0.0,0.0,0.0,0.0,0.0,0.0,0.0,16,3,13,2.0,0.0,2.0
9911253,3,2,1,1,1,2,3,306,2.0,1.0,1.0,1.0,0.0,2.0,3.0,10,3,7,3.0,2.0,1.0
9812259,1,1,0,0,0,1,3,411,1.0,1.0,0.0,0.0,0.0,1.0,3.0,6,1,5,4.0,1.0,3.0
110388,0,0,0,0,0,0,0,7,0.0,0.0,0.0,0.0,0.0,0.0,0.0,8,0,8,,,
9212311,5,4,1,1,5,0,0,669,2.0,2.0,0.0,0.0,2.0,0.0,0.0,5,5,0,1.0,1.0,0.0
110257,4,1,3,4,0,4,12,80,2.0,1.0,1.0,1.0,0.0,2.0,6.0,10,4,6,7.0,3.0,4.0
203212,3,2,1,1,0,3,40,2,2.0,1.0,1.0,1.0,0.0,2.0,14.0,35,3,32,11.0,2.0,9.0
9801263,5,3,2,3,0,5,17,96,4.0,2.0,2.0,3.0,0.0,4.0,12.0,14,5,9,9.0,4.0,5.0
112134,2,2,0,0,0,2,64,18,2.0,2.0,0.0,0.0,0.0,2.0,25.0,40,2,38,5.0,2.0,3.0
301085,0,0,0,0,0,0,0,398,0.0,0.0,0.0,0.0,0.0,0.0,0.0,1,0,1,1.0,0.0,1.0
202038,3,3,0,0,1,2,11,5,1.0,1.0,0.0,0.0,1.0,0.0,0.0,27,3,24,2.0,0.0,2.0
212134,0,0,0,0,0,0,0,37,0.0,0.0,0.0,0.0,0.0,0.0,0.0,32,0,32,17.0,0.0,17.0
7121,3,2,1,1,1,2,6,177,2.0,1.0,1.0,1.0,0.0,2.0,6.0,8,3,5,5.0,2.0,3.0
9706533,3,2,1,1,0,3,5,103,2.0,1.0,1.0,1.0,0.0,2.0,4.0,7,3,4,2.0,2.0,0.0
9603215,1,1,0,0,0,1,2,179,1.0,1.0,0.0,0.0,0.0,1.0,1.0,5,1,4,2.0,1.0,1.0
9412252,1,1,0,0,0,1,1,203,0.0,0.0,0.0,0.0,0.0,0.0,0.0,3,1,2,1.0,0.0,1.0
11088,6,2,4,7,5,1,1,226,5.0,1.0,4.0,7.0,5.0,0.0,0.0,7,6,1,5.0,5.0,0.0
12131,1,1,0,0,0,1,7,70,1.0,1.0,0.0,0.0,0.0,1.0,5.0,9,1,8,4.0,1.0,3.0
9504227,0,0,0,0,0,0,0,233,0.0,0.0,0.0,0.0,0.0,0.0,0.0,1,0,1,1.0,0.0,1.0
204018,0,0,0,0,0,0,0,45,0.0,0.0,0.0,0.0,0.0,0.0,0.0,17,0,17,14.0,0.0,14.0
107070,0,0,0,0,0,0,0,406,0.0,0.0,0.0,0.0,0.0,0.0,0.0,3,0,3,1.0,0.0,1.0
9901268,1,1,0,0,1,0,0,45,0.0,0.0,0.0,0.0,0.0,0.0,0.0,8,1,7,,,
209325,3,3,0,0,0,3,5,2,1.0,1.0,0.0,0.0,0.0,1.0,1.0,9,3,6,1.0,1.0,0.0
111467,0,0,0,0,0,0,0,64,0.0,0.0,0.0,0.0,0.0,0.0,0.0,3,0,3,,,
9911532,6,6,0,0,5,1,2,359,1.0,1.0,0.0,0.0,1.0,0.0,0.0,31,6,25,3.0,0.0,3.0
102155,1,1,0,0,0,1,1,50,0.0,0.0,0.0,0.0,0.0,0.0,0.0,12,1,11,3.0,0.0,3.0
202161,1,1,0,0,0,1,6,20,0.0,0.0,0.0,0.0,0.0,0.0,0.0,21,1,20,2.0,0.0,2.0
9705220,3,1,2,3,3,0,0,139,3.0,1.0,2.0,3.0,3.0,0.0,0.0,3,3,0,3.0,3.0,0.0
205043,1,1,0,0,0,1,2,26,1.0,1.0,0.0,0.0,0.0,1.0,1.0,7,1,6,1.0,1.0,0.0
210131,1,1,0,0,0,1,1,263,0.0,0.0,0.0,0.0,0.0,0.0,0.0,5,1,4,1.0,0.0,1.0
209370,0,0,0,0,0,0,0,9,0.0,0.0,0.0,0.0,0.0,0.0,0.0,13,0,13,6.0,0.0,6.0
5153,0,0,0,0,0,0,0,67,0.0,0.0,0.0,0.0,0.0,0.0,0.0,9,0,9,1.0,0.0,1.0
9707411,3,1,2,2,0,3,10,195,2.0,2.0,0.0,0.0,1.0,1.0,2.0,8,3,5,4.0,1.0,3.0
206192,7,5,2,3,1,6,49,2,2.0,2.0,0.0,0.0,0.0,2.0,21.0,21,7,14,13.0,2.0,11.0
9611220,2,2,0,0,0,2,2,191,2.0,2.0,0.0,0.0,0.0,2.0,2.0,4,2,2,3.0,2.0,1.0
6344,1,1,0,0,0,1,9,73,1.0,1.0,0.0,0.0,0.0,1.0,9.0,16,1,15,2.0,0.0,2.0
207113,1,1,0,0,0,1,1,2,0.0,0.0,0.0,0.0,0.0,0.0,0.0,23,1,22,17.0,0.0,17.0
207018,0,0,0,0,0,0,0,3,0.0,0.0,0.0,0.0,0.0,0.0,0.0,20,0,20,2.0,0.0,2.0
9710430,0,0,0,0,0,0,0,13,0.0,0.0,0.0,0.0,0.0,0.0,0.0,12,0,12,3.0,0.0,3.0
9808373,1,1,0,0,0,1,16,76,1.0,1.0,0.0,0.0,0.0,1.0,5.0,26,1,25,5.0,0.0,5.0
9701255,2,1,1,1,2,0,0,225,2.0,1.0,1.0,1.0,2.0,0.0,0.0,6,2,4,3.0,2.0,1.0
101210,4,4,0,0,4,0,0,290,2.0,2.0,0.0,0.0,2.0,0.0,0.0,10,4,6,3.0,2.0,1.0
9905546,2,2,0,0,0,2,4,1067,0.0,0.0,0.0,0.0,0.0,0.0,0.0,7,2,5,2.0,0.0,2.0
110145,3,2,1,1,0,3,9,43,1.0,1.0,0.0,0.0,0.0,1.0,7.0,13,3,10,11.0,1.0,10.0
109005,3,2,1,1,0,3,10,79,3.0,2.0,1.0,1.0,0.0,3.0,8.0,12,3,9,4.0,2.0,2.0
9801249,1,1,0,0,1,0,0,629,0.0,0.0,0.0,0.0,0.0,0.0,0.0,4,1,3,1.0,1.0,0.0
2189,2,2,0,0,0,2,11,89,1.0,1.0,0.0,0.0,0.0,1.0,4.0,13,2,11,8.0,0.0,8.0
9511240,2,2,0,0,0,2,3,237,2.0,2.0,0.0,0.0,0.0,2.0,2.0,14,2,12,6.0,2.0,4.0
9611330,2,1,1,1,2,0,0,139,0.0,0.0,0.0,0.0,0.0,0.0,0.0,3,2,1,1.0,0.0,1.0
208070,9,7,2,5,0,9,45,21,4.0,3.0,1.0,3.0,0.0,4.0,19.0,21,9,12,10.0,4.0,6.0
107300,1,1,0,0,0,1,5,8,1.0,1.0,0.0,0.0,0.0,1.0,2.0,17,1,16,4.0,0.0,4.0
9909299,1,1,0,0,1,0,0,48,0.0,0.0,0.0,0.0,0.0,0.0,0.0,11,1,10,1.0,0.0,1.0
104216,2,2,0,0,0,2,4,177,2.0,2.0,0.0,0.0,0.0,2.0,4.0,4,2,2,4.0,2.0,2.0
9306247,0,0,0,0,0,0,0,248,0.0,0.0,0.0,0.0,0.0,0.0,0.0,4,0,4,2.0,0.0,2.0
102311,1,1,0,0,0,1,1,566,1.0,1.0,0.0,0.0,0.0,1.0,1.0,2,1,1,2.0,1.0,1.0
205063,0,0,0,0,0,0,0,103,0.0,0.0,0.0,0.0,0.0,0.0,0.0,18,0,18,5.0,0.0,5.0
211011,2,2,0,0,0,2,16,21,2.0,2.0,0.0,0.0,0.0,2.0,11.0,32,2,30,9.0,2.0,7.0
107332,2,2,0,0,0,2,16,13,2.0,2.0,0.0,0.0,0.0,2.0,15.0,16,2,14,,,
9803435,2,1,1,1,2,0,0,185,2.0,1.0,1.0,1.0,2.0,0.0,0.0,2,2,0,1.0,1.0,0.0
9902259,11,4,7,16,7,4,9,139,5.0,3.0,2.0,4.0,1.0,4.0,6.0,16,11,5,6.0,5.0,1.0
9211265,3,2,1,1,3,0,0,249,3.0,2.0,1.0,1.0,3.0,0.0,0.0,3,3,0,2.0,2.0,0.0
7097,4,3,1,1,1,3,6,170,2.0,1.0,1.0,1.0,0.0,2.0,4.0,9,4,5,6.0,2.0,4.0
9603268,1,1,0,0,0,1,4,71,1.0,1.0,0.0,0.0,0.0,1.0,2.0,7,1,6,3.0,1.0,2.0
9905399,4,1,3,3,1,3,11,122,2.0,1.0,1.0,1.0,0.0,2.0,8.0,9,4,5,7.0,2.0,5.0
9209212,1,1,0,0,1,0,0,187,,,,,,,,1,1,0,,,
9703306,0,0,0,0,0,0,0,238,0.0,0.0,0.0,0.0,0.0,0.0,0.0,7,0,7,2.0,0.0,2.0
9506431,0,0,0,0,0,0,0,62,,,,,,,,2,0,2,,,
301262,1,1,0,0,0,1,12,193,0.0,0.0,0.0,0.0,0.0,0.0,0.0,23,1,22,13.0,0.0,13.0
9908400,3,3,0,0,1,2,3,34,0.0,0.0,0.0,0.0,0.0,0.0,0.0,16,3,13,2.0,1.0,1.0
203085,4,3,1,1,0,4,9,461,2.0,2.0,0.0,0.0,0.0,2.0,2.0,8,4,4,2.0,1.0,1.0
110396,0,0,0,0,0,0,0,1501,0.0,0.0,0.0,0.0,0.0,0.0,0.0,5,0,5,1.0,0.0,1.0
101283,2,2,0,0,0,2,2,246,1.0,1.0,0.0,0.0,1.0,0.0,0.0,8,2,6,3.0,1.0,2.0
11025,3,3,0,0,1,2,15,13,2.0,2.0,0.0,0.0,0.0,2.0,15.0,24,3,21,12.0,1.0,11.0
9405211,2,2,0,0,2,0,0,443,2.0,2.0,0.0,0.0,2.0,0.0,0.0,2,2,0,2.0,2.0,0.0
9311338,0,0,0,0,0,0,0,26,0.0,0.0,0.0,0.0,0.0,0.0,0.0,4,0,4,1.0,0.0,1.0
9810330,2,2,0,0,2,0,0,64,1.0,1.0,0.0,0.0,1.0,0.0,0.0,4,2,2,1.0,1.0,0.0
6305,0,0,0,0,0,0,0,203,0.0,0.0,0.0,0.0,0.0,0.0,0.0,6,0,6,2.0,0.0,2.0
9402263,2,2,0,0,2,0,0,331,2.0,2.0,0.0,0.0,2.0,0.0,0.0,2,2,0,2.0,2.0,0.0
205146,1,1,0,0,0,1,1,93,0.0,0.0,0.0,0.0,0.0,0.0,0.0,23,1,22,5.0,0.0,5.0
302021,1,1,0,0,0,1,2,12,0.0,0.0,0.0,0.0,0.0,0.0,0.0,55,1,54,31.0,0.0,31.0
9903493,4,3,1,1,1,3,21,14,2.0,2.0,0.0,0.0,0.0,2.0,9.0,23,4,19,7.0,2.0,5.0
9909498,1,1,0,0,0,1,5,13,1.0,1.0,0.0,0.0,0.0,1.0,4.0,6,1,5,1.0,1.0,0.0
9608436,1,1,0,0,0,1,3,24,0.0,0.0,0.0,0.0,0.0,0.0,0.0,4,1,3,3.0,1.0,2.0
9705369,0,0,0,0,0,0,0,34,0.0,0.0,0.0,0.0,0.0,0.0,0.0,12,0,12,,,
203046,3,2,1,1,1,2,5,129,1.0,1.0,0.0,0.0,0.0,1.0,4.0,15,3,12,8.0,1.0,7.0
12095,1,1,0,0,1,0,0,2129,1.0,1.0,0.0,0.0,1.0,0.0,0.0,4,1,3,1.0,1.0,0.0
212003,1,1,0,0,0,1,16,25,1.0,1.0,0.0,0.0,0.0,1.0,9.0,22,1,21,12.0,1.0,11.0
207198,0,0,0,0,0,0,0,79,0.0,0.0,0.0,0.0,0.0,0.0,0.0,4,0,4,3.0,0.0,3.0
101184,1,1,0,0,1,0,0,175,,,,,,,,1,1,0,,,
9610511,0,0,0,0,0,0,0,13,0.0,0.0,0.0,0.0,0.0,0.0,0.0,5,0,5,,,
9411343,0,0,0,0,0,0,0,108,,,,,,,,1,0,1,1.0,0.0,1.0
301113,0,0,0,0,0,0,0,72,0.0,0.0,0.0,0.0,0.0,0.0,0.0,9,0,9,3.0,0.0,3.0
9509215,0,0,0,0,0,0,0,114,0.0,0.0,0.0,0.0,0.0,0.0,0.0,7,0,7,2.0,0.0,2.0
9308350,1,1,0,0,1,0,0,417,0.0,0.0,0.0,0.0,0.0,0.0,0.0,2,1,1,1.0,0.0,1.0
9712405,0,0,0,0,0,0,0,100,0.0,0.0,0.0,0.0,0.0,0.0,0.0,10,0,10,7.0,0.0,7.0
208119,1,1,0,0,0,1,4,43,0.0,0.0,0.0,0.0,0.0,0.0,0.0,10,1,9,2.0,1.0,1.0
109187,0,0,0,0,0,0,0,145,0.0,0.0,0.0,0.0,0.0,0.0,0.0,18,0,18,9.0,0.0,9.0
9608453,2,1,1,1,0,2,7,35,0.0,0.0,0.0,0.0,0.0,0.0,0.0,9,2,7,7.0,2.0,5.0
7141,1,1,0,0,1,0,0,43,,,,,,,,8,1,7,2.0,0.0,2.0
9606480,0,0,0,0,0,0,0,281,0.0,0.0,0.0,0.0,0.0,0.0,0.0,7,0,7,2.0,0.0,2.0
8318,1,1,0,0,0,1,9,125,1.0,1.0,0.0,0.0,0.0,1.0,2.0,11,1,10,6.0,1.0,5.0
103293,2,1,1,1,0,2,5,22,2.0,1.0,1.0,1.0,0.0,2.0,5.0,5,2,3,5.0,2.0,3.0
9209265,1,1,0,0,1,0,0,205,1.0,1.0,0.0,0.0,1.0,0.0,0.0,1,1,0,1.0,1.0,0.0
9509356,1,1,0,0,0,1,1,303,1.0,1.0,0.0,0.0,1.0,0.0,0.0,2,1,1,2.0,1.0,1.0
201033,1,1,0,0,0,1,6,13,1.0,1.0,0.0,0.0,0.0,1.0,6.0,23,1,22,13.0,0.0,13.0
211168,0,0,0,0,0,0,0,18,0.0,0.0,0.0,0.0,0.0,0.0,0.0,113,0,113,29.0,0.0,29.0
209262,5,1,4,8,0,5,32,2,5.0,1.0,4.0,8.0,0.0,5.0,29.0,24,5,19,13.0,5.0,8.0
9806271,2,2,0,0,2,0,0,337,1.0,1.0,0.0,0.0,1.0,0.0,0.0,3,2,1,2.0,1.0,1.0
9610227,1,1,0,0,1,0,0,250,1.0,1.0,0.0,0.0,1.0,0.0,0.0,2,1,1,1.0,1.0,0.0
302133,0,0,0,0,0,0,0,31,0.0,0.0,0.0,0.0,0.0,0.0,0.0,16,0,16,15.0,0.0,15.0
9707417,0,0,0,0,0,0,0,48,0.0,0.0,0.0,0.0,0.0,0.0,0.0,9,0,9,5.0,0.0,5.0
6109,0,0,0,0,0,0,0,1,0.0,0.0,0.0,0.0,0.0,0.0,0.0,16,0,16,1.0,0.0,1.0
9904326,2,2,0,0,1,1,1,145,1.0,1.0,0.0,0.0,1.0,0.0,0.0,7,2,5,4.0,0.0,4.0
210084,0,0,0,0,0,0,0,356,0.0,0.0,0.0,0.0,0.0,0.0,0.0,4,0,4,3.0,0.0,3.0
106019,7,3,4,10,1,6,13,104,6.0,2.0,4.0,10.0,2.0,4.0,6.0,13,7,6,5.0,5.0,0.0
9409347,0,0,0,0,0,0,0,1421,,,,,,,,3,0,3,1.0,0.0,1.0
9506349,2,1,1,1,2,0,0,51,2.0,1.0,1.0,1.0,2.0,0.0,0.0,2,2,0,2.0,2.0,0.0
105099,0,0,0,0,0,0,0,17,0.0,0.0,0.0,0.0,0.0,0.0,0.0,14,0,14,8.0,0.0,8.0
204293,2,2,0,0,1,1,6,5,0.0,0.0,0.0,0.0,0.0,0.0,0.0,28,2,26,5.0,0.0,5.0
201024,1,1,0,0,0,1,1,159,0.0,0.0,0.0,0.0,0.0,0.0,0.0,15,1,14,2.0,0.0,2.0
201265,3,3,0,0,0,3,32,9,3.0,3.0,0.0,0.0,0.0,3.0,31.0,34,3,31,21.0,2.0,19.0
301037,0,0,0,0,0,0,0,81,0.0,0.0,0.0,0.0,0.0,0.0,0.0,16,0,16,11.0,0.0,11.0
9907306,0,0,0,0,0,0,0,284,0.0,0.0,0.0,0.0,0.0,0.0,0.0,10,0,10,3.0,0.0,3.0
9902212,1,1,0,0,0,1,2,1635,1.0,1.0,0.0,0.0,1.0,0.0,0.0,5,1,4,2.0,1.0,1.0
203197,0,0,0,0,0,0,0,104,,,,,,,,5,0,5,1.0,0.0,1.0
203083,2,2,0,0,0,2,8,121,2.0,2.0,0.0,0.0,0.0,2.0,6.0,9,2,7,5.0,2.0,3.0
208031,4,2,2,2,0,4,38,24,4.0,2.0,2.0,2.0,0.0,4.0,34.0,28,4,24,10.0,2.0,8.0
211142,0,0,0,0,0,0,0,23,0.0,0.0,0.0,0.0,0.0,0.0,0.0,28,0,28,19.0,0.0,19.0
9507241,0,0,0,0,0,0,0,39,,,,,,,,3,0,3,,,
9807499,0,0,0,0,0,0,0,104,,,,,,,,1,0,1,,,
105133,0,0,0,0,0,0,0,50,0.0,0.0,0.0,0.0,0.0,0.0,0.0,7,0,7,,,
102285,0,0,0,0,0,0,0,132,0.0,0.0,0.0,0.0,0.0,0.0,0.0,5,0,5,1.0,0.0,1.0
9510416,1,1,0,0,1,0,0,697,1.0,1.0,0.0,0.0,1.0,0.0,0.0,3,1,2,2.0,1.0,1.0
9603352,3,2,1,1,0,3,4,340,3.0,2.0,1.0,1.0,0.0,3.0,4.0,6,3,3,3.0,2.0,1.0
207082,0,0,0,0,0,0,0,34,0.0,0.0,0.0,0.0,0.0,0.0,0.0,48,0,48,23.0,0.0,23.0
9605410,0,0,0,0,0,0,0,382,0.0,0.0,0.0,0.0,0.0,0.0,0.0,2,0,2,2.0,0.0,2.0
9608207,1,1,0,0,0,1,1,61,0.0,0.0,0.0,0.0,0.0,0.0,0.0,7,1,6,4.0,0.0,4.0
6065,3,2,1,1,3,0,0,325,2.0,1.0,1.0,1.0,2.0,0.0,0.0,9,3,6,3.0,3.0,0.0
205151,3,3,0,0,0,3,14,45,1.0,1.0,0.0,0.0,0.0,1.0,3.0,36,3,33,13.0,0.0,13.0
9503435,0,0,0,0,0,0,0,110,0.0,0.0,0.0,0.0,0.0,0.0,0.0,2,0,2,2.0,0.0,2.0
207148,0,0,0,0,0,0,0,43,0.0,0.0,0.0,0.0,0.0,0.0,0.0,7,0,7,2.0,0.0,2.0
9809221,0,0,0,0,0,0,0,90,0.0,0.0,0.0,0.0,0.0,0.0,0.0,12,0,12,7.0,0.0,7.0
202250,3,1,2,3,0,3,21,40,3.0,1.0,2.0,3.0,0.0,3.0,9.0,12,3,9,7.0,3.0,4.0
9911374,2,2,0,0,0,2,9,22,1.0,1.0,0.0,0.0,0.0,1.0,2.0,24,2,22,5.0,1.0,4.0
9605299,1,1,0,0,0,1,4,345,1.0,1.0,0.0,0.0,0.0,1.0,1.0,5,1,4,2.0,1.0,1.0
9509395,0,0,0,0,0,0,0,15,0.0,0.0,0.0,0.0,0.0,0.0,0.0,10,0,10,2.0,0.0,2.0
212271,1,1,0,0,0,1,8,24,0.0,0.0,0.0,0.0,0.0,0.0,0.0,31,1,30,9.0,0.0,9.0
211348,2,2,0,0,0,2,14,11,2.0,2.0,0.0,0.0,0.0,2.0,14.0,34,2,32,7.0,0.0,7.0
212398,0,0,0,0,0,0,0,106,0.0,0.0,0.0,0.0,0.0,0.0,0.0,5,0,5,1.0,0.0,1.0
9908509,0,0,0,0,0,0,0,417,0.0,0.0,0.0,0.0,0.0,0.0,0.0,3,0,3,1.0,0.0,1.0
211170,1,1,0,0,0,1,3,4,0.0,0.0,0.0,0.0,0.0,0.0,0.0,21,1,20,10.0,1.0,9.0
9710435,0,0,0,0,0,0,0,291,0.0,0.0,0.0,0.0,0.0,0.0,0.0,5,0,5,3.0,0.0,3.0
9902433,0,0,0,0,0,0,0,152,0.0,0.0,0.0,0.0,0.0,0.0,0.0,5,0,5,4.0,0.0,4.0
212334,0,0,0,0,0,0,0,31,0.0,0.0,0.0,0.0,0.0,0.0,0.0,4,0,4,1.0,0.0,1.0
103288,0,0,0,0,0,0,0,18,0.0,0.0,0.0,0.0,0.0,0.0,0.0,26,0,26,1.0,0.0,1.0
9610488,0,0,0,0,0,0,0,2135,,,,,,,,1,0,1,,,
9707498,0,0,0,0,0,0,0,99,0.0,0.0,0.0,0.0,0.0,0.0,0.0,8,0,8,1.0,0.0,1.0
212194,1,1,0,0,1,0,0,28,0.0,0.0,0.0,0.0,0.0,0.0,0.0,32,1,31,10.0,0.0,10.0
9704226,2,2,0,0,1,1,2,98,1.0,1.0,0.0,0.0,1.0,0.0,0.0,5,2,3,1.0,1.0,0.0
101189,0,0,0,0,0,0,0,20,0.0,0.0,0.0,0.0,0.0,0.0,0.0,28,0,28,2.0,0.0,2.0
9706286,2,1,1,1,1,1,1,7,0.0,0.0,0.0,0.0,0.0,0.0,0.0,12,2,10,1.0,0.0,1.0
9604384,0,0,0,0,0,0,0,79,,,,,,,,3,0,3,,,
9312332,0,0,0,0,0,0,0,41,0.0,0.0,0.0,0.0,0.0,0.0,0.0,4,0,4,4.0,0.0,4.0
9804329,6,2,4,10,0,6,19,256,5.0,1.0,4.0,10.0,0.0,5.0,18.0,10,6,4,10.0,6.0,4.0
9308250,0,0,0,0,0,0,0,633,0.0,0.0,0.0,0.0,0.0,0.0,0.0,2,0,2,1.0,0.0,1.0
203165,0,0,0,0,0,0,0,2,0.0,0.0,0.0,0.0,0.0,0.0,0.0,20,0,20,2.0,0.0,2.0
302109,0,0,0,0,0,0,0,144,0.0,0.0,0.0,0.0,0.0,0.0,0.0,8,0,8,4.0,0.0,4.0
9412223,1,1,0,0,0,1,2,48,1.0,1.0,0.0,0.0,1.0,0.0,0.0,4,1,3,1.0,1.0,0.0
6214,0,0,0,0,0,0,0,53,0.0,0.0,0.0,0.0,0.0,0.0,0.0,6,0,6,1.0,0.0,1.0
207204,1,1,0,0,0,1,6,66,1.0,1.0,0.0,0.0,0.0,1.0,6.0,31,1,30,7.0,1.0,6.0
9510240,0,0,0,0,0,0,0,346,0.0,0.0,0.0,0.0,0.0,0.0,0.0,6,0,6,1.0,0.0,1.0
9504367,1,1,0,0,1,0,0,371,1.0,1.0,0.0,0.0,1.0,0.0,0.0,2,1,1,1.0,1.0,0.0
9811461,1,1,0,0,1,0,0,10,0.0,0.0,0.0,0.0,0.0,0.0,0.0,15,1,14,1.0,0.0,1.0
9604299,3,3,0,0,2,1,1,279,1.0,1.0,0.0,0.0,0.0,1.0,1.0,5,3,2,2.0,1.0,1.0
9905532,1,1,0,0,1,0,0,142,0.0,0.0,0.0,0.0,0.0,0.0,0.0,17,1,16,16.0,0.0,16.0
112159,0,0,0,0,0,0,0,2,0.0,0.0,0.0,0.0,0.0,0.0,0.0,18,0,18,6.0,0.0,6.0
205021,0,0,0,0,0,0,0,110,0.0,0.0,0.0,0.0,0.0,0.0,0.0,3,0,3,1.0,0.0,1.0
9907309,0,0,0,0,0,0,0,111,0.0,0.0,0.0,0.0,0.0,0.0,0.0,4,0,4,,,
9609402,0,0,0,0,0,0,0,231,0.0,0.0,0.0,0.0,0.0,0.0,0.0,3,0,3,3.0,0.0,3.0
301035,0,0,0,0,0,0,0,20,0.0,0.0,0.0,0.0,0.0,0.0,0.0,30,0,30,5.0,0.0,5.0
9405408,0,0,0,0,0,0,0,149,,,,,,,,1,0,1,1.0,0.0,1.0
9807512,0,0,0,0,0,0,0,574,0.0,0.0,0.0,0.0,0.0,0.0,0.0,1,0,1,1.0,0.0,1.0
209004,0,0,0,0,0,0,0,256,0.0,0.0,0.0,0.0,0.0,0.0,0.0,11,0,11,10.0,0.0,10.0
11208,0,0,0,0,0,0,0,177,0.0,0.0,0.0,0.0,0.0,0.0,0.0,11,0,11,1.0,0.0,1.0
301252,0,0,0,0,0,0,0,1147,,,,,,,,1,0,1,,,
9701408,0,0,0,0,0,0,0,104,0.0,0.0,0.0,0.0,0.0,0.0,0.0,10,0,10,8.0,0.0,8.0
301245,0,0,0,0,0,0,0,144,0.0,0.0,0.0,0.0,0.0,0.0,0.0,12,0,12,1.0,0.0,1.0
211324,1,1,0,0,0,1,6,11,0.0,0.0,0.0,0.0,0.0,0.0,0.0,20,1,19,2.0,0.0,2.0
11093,1,1,0,0,0,1,9,6,0.0,0.0,0.0,0.0,0.0,0.0,0.0,22,1,21,7.0,1.0,6.0
2090,1,1,0,0,0,1,3,128,0.0,0.0,0.0,0.0,0.0,0.0,0.0,8,1,7,2.0,0.0,2.0
104257,0,0,0,0,0,0,0,51,0.0,0.0,0.0,0.0,0.0,0.0,0.0,12,0,12,5.0,0.0,5.0
9906550,0,0,0,0,0,0,0,1508,,,,,,,,3,0,3,,,
9706346,0,0,0,0,0,0,0,211,0.0,0.0,0.0,0.0,0.0,0.0,0.0,5,0,5,2.0,0.0,2.0
109057,1,1,0,0,0,1,4,91,1.0,1.0,0.0,0.0,0.0,1.0,4.0,7,1,6,1.0,0.0,1.0
4079,1,1,0,0,1,0,0,532,1.0,1.0,0.0,0.0,1.0,0.0,0.0,1,1,0,1.0,1.0,0.0
9802399,0,0,0,0,0,0,0,60,0.0,0.0,0.0,0.0,0.0,0.0,0.0,13,0,13,6.0,0.0,6.0
9810268,0,0,0,0,0,0,0,241,0.0,0.0,0.0,0.0,0.0,0.0,0.0,3,0,3,1.0,0.0,1.0
9610347,0,0,0,0,0,0,0,383,0.0,0.0,0.0,0.0,0.0,0.0,0.0,3,0,3,1.0,0.0,1.0
212289,0,0,0,0,0,0,0,70,0.0,0.0,0.0,0.0,0.0,0.0,0.0,5,0,5,,,
212376,0,0,0,0,0,0,0,334,0.0,0.0,0.0,0.0,0.0,0.0,0.0,8,0,8,5.0,0.0,5.0
11226,0,0,0,0,0,0,0,973,,,,,,,,1,0,1,,,
211226,0,0,0,0,0,0,0,8,0.0,0.0,0.0,0.0,0.0,0.0,0.0,26,0,26,4.0,0.0,4.0
211445,0,0,0,0,0,0,0,272,0.0,0.0,0.0,0.0,0.0,0.0,0.0,2,0,2,1.0,0.0,1.0
210160,0,0,0,0,0,0,0,79,,,,,,,,9,0,9,3.0,0.0,3.0
210311,0,0,0,0,0,0,0,89,0.0,0.0,0.0,0.0,0.0,0.0,0.0,14,0,14,5.0,0.0,5.0
205324,0,0,0,0,0,0,0,200,0.0,0.0,0.0,0.0,0.0,0.0,0.0,4,0,4,2.0,0.0,2.0
9908392,0,0,0,0,0,0,0,213,0.0,0.0,0.0,0.0,0.0,0.0,0.0,1,0,1,1.0,0.0,1.0
6002,0,0,0,0,0,0,0,7,0.0,0.0,0.0,0.0,0.0,0.0,0.0,109,0,109,9.0,0.0,9.0
9612414,0,0,0,0,0,0,0,386,0.0,0.0,0.0,0.0,0.0,0.0,0.0,2,0,2,2.0,0.0,2.0
212075,0,0,0,0,0,0,0,11,0.0,0.0,0.0,0.0,0.0,0.0,0.0,28,0,28,2.0,0.0,2.0
204094,2,2,0,0,1,1,1,54,0.0,0.0,0.0,0.0,0.0,0.0,0.0,4,2,2,1.0,0.0,1.0
9806454,1,1,0,0,0,1,3,387,1.0,1.0,0.0,0.0,0.0,1.0,3.0,4,1,3,4.0,1.0,3.0
9907463,0,0,0,0,0,0,0,387,0.0,0.0,0.0,0.0,0.0,0.0,0.0,5,0,5,1.0,0.0,1.0
9609349,0,0,0,0,0,0,0,1005,0.0,0.0,0.0,0.0,0.0,0.0,0.0,1,0,1,1.0,0.0,1.0
302251,0,0,0,0,0,0,0,28,0.0,0.0,0.0,0.0,0.0,0.0,0.0,20,0,20,3.0,0.0,3.0
9409226,0,0,0,0,0,0,0,34,,,,,,,,5,0,5,,,
9912544,1,1,0,0,1,0,0,111,1.0,1.0,0.0,0.0,1.0,0.0,0.0,1,1,0,,,
204189,1,1,0,0,0,1,4,46,1.0,1.0,0.0,0.0,0.0,1.0,3.0,18,1,17,2.0,0.0,2.0
9310254,0,0,0,0,0,0,0,75,,,,,,,,3,0,3,,,
112183,0,0,0,0,0,0,0,181,0.0,0.0,0.0,0.0,0.0,0.0,0.0,10,0,10,4.0,0.0,4.0
108269,1,1,0,0,1,0,0,1446,1.0,1.0,0.0,0.0,1.0,0.0,0.0,1,1,0,1.0,1.0,0.0
3175,2,2,0,0,0,2,4,48,2.0,2.0,0.0,0.0,0.0,2.0,3.0,9,2,7,2.0,1.0,1.0
210055,4,3,1,1,0,4,27,71,2.0,2.0,0.0,0.0,0.0,2.0,21.0,25,4,21,17.0,2.0,15.0
9810481,0,0,0,0,0,0,0,14,0.0,0.0,0.0,0.0,0.0,0.0,0.0,12,0,12,1.0,0.0,1.0
6258,1,1,0,0,0,1,2,325,1.0,1.0,0.0,0.0,0.0,1.0,1.0,7,1,6,3.0,0.0,3.0
206032,0,0,0,0,0,0,0,68,,,,,,,,2,0,2,,,
101261,0,0,0,0,0,0,0,30,0.0,0.0,0.0,0.0,0.0,0.0,0.0,19,0,19,4.0,0.0,4.0
206147,0,0,0,0,0,0,0,47,0.0,0.0,0.0,0.0,0.0,0.0,0.0,15,0,15,5.0,0.0,5.0
112194,0,0,0,0,0,0,0,20,0.0,0.0,0.0,0.0,0.0,0.0,0.0,13,0,13,1.0,0.0,1.0
9812466,2,1,1,1,2,0,0,212,0.0,0.0,0.0,0.0,0.0,0.0,0.0,8,2,6,3.0,0.0,3.0
204295,1,1,0,0,1,0,0,1862,1.0,1.0,0.0,0.0,1.0,0.0,0.0,1,1,0,1.0,1.0,0.0
201096,0,0,0,0,0,0,0,51,0.0,0.0,0.0,0.0,0.0,0.0,0.0,5,0,5,3.0,0.0,3.0
9902254,0,0,0,0,0,0,0,544,0.0,0.0,0.0,0.0,0.0,0.0,0.0,1,0,1,1.0,0.0,1.0
9904215,2,2,0,0,0,2,4,225,0.0,0.0,0.0,0.0,0.0,0.0,0.0,15,2,13,3.0,0.0,3.0
9805374,1,1,0,0,0,1,11,14,1.0,1.0,0.0,0.0,0.0,1.0,11.0,16,1,15,7.0,1.0,6.0
301196,0,0,0,0,0,0,0,45,0.0,0.0,0.0,0.0,0.0,0.0,0.0,7,0,7,,,
105202,0,0,0,0,0,0,0,52,0.0,0.0,0.0,0.0,0.0,0.0,0.0,4,0,4,2.0,0.0,2.0
210210,0,0,0,0,0,0,0,13,0.0,0.0,0.0,0.0,0.0,0.0,0.0,22,0,22,6.0,0.0,6.0
112097,0,0,0,0,0,0,0,146,0.0,0.0,0.0,0.0,0.0,0.0,0.0,2,0,2,2.0,0.0,2.0
108087,1,1,0,0,0,1,1,497,1.0,1.0,0.0,0.0,1.0,0.0,0.0,3,1,2,2.0,1.0,1.0
301135,0,0,0,0,0,0,0,7,0.0,0.0,0.0,0.0,0.0,0.0,0.0,25,0,25,2.0,0.0,2.0
206119,0,0,0,0,0,0,0,99,0.0,0.0,0.0,0.0,0.0,0.0,0.0,16,0,16,7.0,0.0,7.0
9904392,1,1,0,0,0,1,4,42,0.0,0.0,0.0,0.0,0.0,0.0,0.0,10,1,9,4.0,1.0,3.0
9605396,0,0,0,0,0,0,0,204,0.0,0.0,0.0,0.0,0.0,0.0,0.0,18,0,18,4.0,0.0,4.0
9411320,0,0,0,0,0,0,0,583,0.0,0.0,0.0,0.0,0.0,0.0,0.0,5,0,5,1.0,0.0,1.0
110205,0,0,0,0,0,0,0,21,0.0,0.0,0.0,0.0,0.0,0.0,0.0,24,0,24,14.0,0.0,14.0
9904406,0,0,0,0,0,0,0,191,0.0,0.0,0.0,0.0,0.0,0.0,0.0,13,0,13,9.0,0.0,9.0
210221,0,0,0,0,0,0,0,102,0.0,0.0,0.0,0.0,0.0,0.0,0.0,12,0,12,6.0,0.0,6.0
210076,0,0,0,0,0,0,0,351,0.0,0.0,0.0,0.0,0.0,0.0,0.0,3,0,3,2.0,0.0,2.0
205236,0,0,0,0,0,0,0,43,0.0,0.0,0.0,0.0,0.0,0.0,0.0,9,0,9,1.0,0.0,1.0
9809378,0,0,0,0,0,0,0,22,0.0,0.0,0.0,0.0,0.0,0.0,0.0,11,0,11,1.0,0.0,1.0
212106,0,0,0,0,0,0,0,53,0.0,0.0,0.0,0.0,0.0,0.0,0.0,32,0,32,17.0,0.0,17.0
202267,0,0,0,0,0,0,0,2,0.0,0.0,0.0,0.0,0.0,0.0,0.0,18,0,18,12.0,0.0,12.0
9401248,0,0,0,0,0,0,0,578,0.0,0.0,0.0,0.0,0.0,0.0,0.0,1,0,1,1.0,0.0,1.0
211304,0,0,0,0,0,0,0,84,0.0,0.0,0.0,0.0,0.0,0.0,0.0,9,0,9,6.0,0.0,6.0
207333,0,0,0,0,0,0,0,245,0.0,0.0,0.0,0.0,0.0,0.0,0.0,9,0,9,2.0,0.0,2.0
210097,0,0,0,0,0,0,0,78,0.0,0.0,0.0,0.0,0.0,0.0,0.0,23,0,23,8.0,0.0,8.0
4089,0,0,0,0,0,0,0,426,0.0,0.0,0.0,0.0,0.0,0.0,0.0,7,0,7,2.0,0.0,2.0
101240,0,0,0,0,0,0,0,183,0.0,0.0,0.0,0.0,0.0,0.0,0.0,2,0,2,1.0,0.0,1.0
9333,0,0,0,0,0,0,0,2039,0.0,0.0,0.0,0.0,0.0,0.0,0.0,3,0,3,1.0,0.0,1.0
9902331,0,0,0,0,0,0,0,90,0.0,0.0,0.0,0.0,0.0,0.0,0.0,2,0,2,,,
9253,0,0,0,0,0,0,0,325,0.0,0.0,0.0,0.0,0.0,0.0,0.0,2,0,2,2.0,0.0,2.0
9909247,0,0,0,0,0,0,0,2,0.0,0.0,0.0,0.0,0.0,0.0,0.0,19,0,19,3.0,0.0,3.0
9311233,0,0,0,0,0,0,0,918,0.0,0.0,0.0,0.0,0.0,0.0,0.0,1,0,1,,,
9311364,0,0,0,0,0,0,0,142,0.0,0.0,0.0,0.0,0.0,0.0,0.0,1,0,1,1.0,0.0,1.0
9612381,0,0,0,0,0,0,0,132,0.0,0.0,0.0,0.0,0.0,0.0,0.0,3,0,3,3.0,0.0,3.0
9910288,0,0,0,0,0,0,0,98,0.0,0.0,0.0,0.0,0.0,0.0,0.0,13,0,13,9.0,0.0,9.0
9511274,0,0,0,0,0,0,0,217,0.0,0.0,0.0,0.0,0.0,0.0,0.0,2,0,2,1.0,0.0,1.0
211379,0,0,0,0,0,0,0,513,0.0,0.0,0.0,0.0,0.0,0.0,0.0,3,0,3,1.0,0.0,1.0
9703405,0,0,0,0,0,0,0,43,,,,,,,,3,0,3,,,
9909276,0,0,0,0,0,0,0,6,0.0,0.0,0.0,0.0,0.0,0.0,0.0,13,0,13,6.0,0.0,6.0
9509266,0,0,0,0,0,0,0,156,,,,,,,,1,0,1,,,
301020,0,0,0,0,0,0,0,347,0.0,0.0,0.0,0.0,0.0,0.0,0.0,6,0,6,5.0,0.0,5.0
9710446,1,1,0,0,0,1,2,7,0.0,0.0,0.0,0.0,0.0,0.0,0.0,11,1,10,7.0,0.0,7.0
9410380,0,0,0,0,0,0,0,164,0.0,0.0,0.0,0.0,0.0,0.0,0.0,7,0,7,,,
9911451,0,0,0,0,0,0,0,305,0.0,0.0,0.0,0.0,0.0,0.0,0.0,20,0,20,9.0,0.0,9.0
9712528,0,0,0,0,0,0,0,53,0.0,0.0,0.0,0.0,0.0,0.0,0.0,7,0,7,3.0,0.0,3.0
110259,0,0,0,0,0,0,0,1591,0.0,0.0,0.0,0.0,0.0,0.0,0.0,8,0,8,4.0,0.0,4.0
9511390,0,0,0,0,0,0,0,452,0.0,0.0,0.0,0.0,0.0,0.0,0.0,5,0,5,1.0,0.0,1.0
212230,0,0,0,0,0,0,0,67,0.0,0.0,0.0,0.0,0.0,0.0,0.0,31,0,31,21.0,0.0,21.0
9905297,0,0,0,0,0,0,0,39,0.0,0.0,0.0,0.0,0.0,0.0,0.0,9,0,9,1.0,0.0,1.0
201169,0,0,0,0,0,0,0,98,0.0,0.0,0.0,0.0,0.0,0.0,0.0,7,0,7,3.0,0.0,3.0
109002,1,1,0,0,0,1,1,148,1.0,1.0,0.0,0.0,0.0,1.0,1.0,2,1,1,2.0,1.0,1.0
212039,0,0,0,0,0,0,0,133,0.0,0.0,0.0,0.0,0.0,0.0,0.0,10,0,10,2.0,0.0,2.0
9401222,0,0,0,0,0,0,0,164,,,,,,,,2,0,2,,,
210315,0,0,0,0,0,0,0,4,0.0,0.0,0.0,0.0,0.0,0.0,0.0,29,0,29,13.0,0.0,13.0
9511283,0,0,0,0,0,0,0,155,0.0,0.0,0.0,0.0,0.0,0.0,0.0,1,0,1,1.0,0.0,1.0
9907247,0,0,0,0,0,0,0,38,0.0,0.0,0.0,0.0,0.0,0.0,0.0,45,0,45,7.0,0.0,7.0
111119,0,0,0,0,0,0,0,72,0.0,0.0,0.0,0.0,0.0,0.0,0.0,4,0,4,3.0,0.0,3.0
210230,0,0,0,0,0,0,0,63,0.0,0.0,0.0,0.0,0.0,0.0,0.0,15,0,15,4.0,0.0,4.0
9406246,0,0,0,0,0,0,0,358,0.0,0.0,0.0,0.0,0.0,0.0,0.0,7,0,7,2.0,0.0,2.0
104133,0,0,0,0,0,0,0,106,0.0,0.0,0.0,0.0,0.0,0.0,0.0,10,0,10,6.0,0.0,6.0
9408259,0,0,0,0,0,0,0,578,0.0,0.0,0.0,0.0,0.0,0.0,0.0,1,0,1,1.0,0.0,1.0
105243,0,0,0,0,0,0,0,88,0.0,0.0,0.0,0.0,0.0,0.0,0.0,5,0,5,3.0,0.0,3.0
9801351,0,0,0,0,0,0,0,1052,,,,,,,,2,0,2,2.0,0.0,2.0
3106,0,0,0,0,0,0,0,22,0.0,0.0,0.0,0.0,0.0,0.0,0.0,17,0,17,5.0,0.0,5.0
211325,0,0,0,0,0,0,0,376,0.0,0.0,0.0,0.0,0.0,0.0,0.0,6,0,6,2.0,0.0,2.0
302045,0,0,0,0,0,0,0,82,0.0,0.0,0.0,0.0,0.0,0.0,0.0,6,0,6,1.0,0.0,1.0
9805359,0,0,0,0,0,0,0,97,0.0,0.0,0.0,0.0,0.0,0.0,0.0,2,0,2,,,
110044,0,0,0,0,0,0,0,1249,,,,,,,,1,0,1,,,
9412387,0,0,0,0,0,0,0,1054,,,,,,,,4,0,4,,,
212170,0,0,0,0,0,0,0,68,0.0,0.0,0.0,0.0,0.0,0.0,0.0,7,0,7,2.0,0.0,2.0
211055,0,0,0,0,0,0,0,4,0.0,0.0,0.0,0.0,0.0,0.0,0.0,63,0,63,29.0,0.0,29.0
9711317,0,0,0,0,0,0,0,508,0.0,0.0,0.0,0.0,0.0,0.0,0.0,1,0,1,1.0,0.0,1.0
9502294,0,0,0,0,0,0,0,2109,,,,,,,,1,0,1,1.0,0.0,1.0
111372,0,0,0,0,0,0,0,132,0.0,0.0,0.0,0.0,0.0,0.0,0.0,1,0,1,1.0,0.0,1.0
9302247,97,22,75,284,75,22,25,13,15.0,1.0,14.0,52.0,5.0,10.0,10.0,105,97,8,14.0,13.0,1.0
9607469,2,1,1,1,1,1,1,1563,0.0,0.0,0.0,0.0,0.0,0.0,0.0,5,2,3,1.0,1.0,0.0
7360,26,2,24,110,2,24,112,1,15.0,1.0,14.0,48.0,5.0,10.0,10.0,47,26,21,18.0,17.0,1.0
9704423,160,4,156,1773,37,123,400,1,100.0,3.0,97.0,1203.0,13.0,87.0,257.0,175,160,15,63.0,60.0,3.0
9209231,32,8,24,94,32,0,0,58,13.0,2.0,11.0,27.0,13.0,0.0,0.0,32,32,0,7.0,7.0,0.0
9403254,51,12,39,143,47,4,4,192,13.0,4.0,9.0,26.0,13.0,0.0,0.0,52,51,1,11.0,11.0,0.0
9505397,61,8,53,247,1,60,478,6,22.0,5.0,17.0,46.0,0.0,22.0,199.0,104,61,43,21.0,8.0,13.0
9703290,132,33,99,346,14,118,735,6,34.0,6.0,28.0,108.0,0.0,34.0,367.0,214,132,82,42.0,1.0,41.0
9911263,12,5,7,8,0,12,67,1,0.0,0.0,0.0,0.0,0.0,0.0,0.0,43,12,31,4.0,2.0,2.0
11396,5,3,2,2,0,5,29,1,3.0,3.0,0.0,0.0,0.0,3.0,10.0,37,5,32,7.0,2.0,5.0
9804254,36,10,26,129,1,35,140,1,23.0,5.0,18.0,100.0,0.0,23.0,99.0,46,36,10,6.0,4.0,2.0
106233,5,4,1,1,1,4,10,275,3.0,3.0,0.0,0.0,0.0,3.0,5.0,16,5,11,2.0,2.0,0.0
9409260,15,4,11,29,1,14,22,114,10.0,2.0,8.0,19.0,1.0,9.0,14.0,19,15,4,11.0,9.0,2.0
9602250,66,31,35,61,17,49,292,4,6.0,5.0,1.0,1.0,1.0,5.0,50.0,134,66,68,14.0,2.0,12.0
9507204,17,11,6,12,17,0,0,35,5.0,3.0,2.0,2.0,5.0,0.0,0.0,17,17,0,4.0,4.0,0.0
9707389,11,2,9,21,11,0,0,252,8.0,1.0,7.0,15.0,8.0,0.0,0.0,11,11,0,8.0,8.0,0.0
2006,18,2,16,40,0,18,86,33,17.0,1.0,16.0,40.0,0.0,17.0,70.0,49,18,31,20.0,6.0,14.0
9404359,8,6,2,3,8,0,0,364,1.0,1.0,0.0,0.0,1.0,0.0,0.0,9,8,1,2.0,1.0,1.0
9606231,38,8,30,151,1,37,149,48,24.0,4.0,20.0,98.0,2.0,22.0,58.0,52,38,14,24.0,21.0,3.0
9705398,49,12,37,173,4,45,200,33,31.0,6.0,25.0,132.0,2.0,29.0,144.0,66,49,17,30.0,19.0,11.0
9805372,2,1,1,1,0,2,7,33,1.0,1.0,0.0,0.0,0.0,1.0,3.0,9,2,7,4.0,0.0,4.0
9903260,53,6,47,305,0,53,539,24,44.0,5.0,39.0,275.0,0.0,44.0,414.0,80,53,27,43.0,30.0,13.0
201219,15,6,9,17,0,15,154,4,8.0,4.0,4.0,7.0,1.0,7.0,67.0,61,15,46,12.0,5.0,7.0
9271,24,8,16,52,8,16,43,4,13.0,7.0,6.0,12.0,2.0,11.0,21.0,31,24,7,12.0,9.0,3.0
9211292,40,2,38,193,0,40,40,26,32.0,1.0,31.0,171.0,0.0,32.0,32.0,41,40,1,20.0,19.0,1.0
9606233,38,8,30,100,0,38,171,26,28.0,5.0,23.0,83.0,0.0,28.0,127.0,54,38,16,19.0,15.0,4.0
9810367,40,8,32,103,5,35,136,26,16.0,3.0,13.0,38.0,0.0,16.0,61.0,56,40,16,20.0,15.0,5.0
9806286,7,1,6,9,1,6,11,364,5.0,1.0,4.0,6.0,1.0,4.0,6.0,16,7,9,6.0,4.0,2.0
9502309,26,10,16,47,1,25,102,35,8.0,4.0,4.0,7.0,0.0,8.0,39.0,40,26,14,10.0,7.0,3.0
9601357,32,4,28,124,1,31,99,60,16.0,1.0,15.0,79.0,0.0,16.0,32.0,52,32,20,20.0,16.0,4.0
9704322,44,9,35,106,1,43,305,36,22.0,4.0,18.0,74.0,0.0,22.0,215.0,63,44,19,32.0,19.0,13.0
9511340,10,3,7,12,3,7,7,173,6.0,2.0,4.0,7.0,0.0,6.0,6.0,11,10,1,4.0,4.0,0.0
102144,23,4,19,29,8,15,48,121,4.0,1.0,3.0,4.0,1.0,3.0,3.0,46,23,23,4.0,4.0,0.0
112334,12,8,4,10,2,10,39,4,1.0,1.0,0.0,0.0,0.0,1.0,7.0,25,12,13,3.0,2.0,1.0
9603380,14,8,6,9,10,4,4,41,7.0,2.0,5.0,8.0,7.0,0.0,0.0,21,14,7,6.0,6.0,0.0
9908480,17,6,11,36,4,13,125,20,10.0,1.0,9.0,33.0,0.0,10.0,120.0,31,17,14,22.0,10.0,12.0
9209203,27,10,17,69,27,0,0,176,22.0,7.0,15.0,65.0,22.0,0.0,0.0,27,27,0,18.0,18.0,0.0
9703264,3,2,1,1,0,3,14,25,2.0,1.0,1.0,1.0,0.0,2.0,12.0,19,3,16,9.0,2.0,7.0
9410310,63,6,57,217,40,23,31,61,27.0,2.0,25.0,82.0,24.0,3.0,3.0,67,63,4,23.0,23.0,0.0
9610222,13,9,4,5,7,6,44,1,2.0,2.0,0.0,0.0,0.0,2.0,24.0,77,13,64,14.0,1.0,13.0
9403259,14,4,10,23,8,6,13,223,3.0,3.0,0.0,0.0,0.0,3.0,5.0,20,14,6,5.0,3.0,2.0
9409324,18,8,10,30,9,9,10,374,10.0,3.0,7.0,23.0,3.0,7.0,7.0,20,18,2,4.0,4.0,0.0
9309310,131,17,114,670,121,10,10,36,38.0,4.0,34.0,283.0,38.0,0.0,0.0,133,131,2,27.0,26.0,1.0
9511317,16,6,10,26,1,15,63,5,4.0,3.0,1.0,1.0,0.0,4.0,23.0,29,16,13,3.0,1.0,2.0
9403270,10,4,6,9,10,0,0,144,8.0,3.0,5.0,7.0,8.0,0.0,0.0,10,10,0,4.0,4.0,0.0
9705339,159,29,130,513,92,67,108,0,21.0,5.0,16.0,42.0,21.0,0.0,0.0,173,159,14,8.0,1.0,7.0
9808333,74,7,67,410,2,72,325,3,49.0,3.0,46.0,342.0,0.0,49.0,246.0,89,74,15,45.0,36.0,9.0
9605413,47,2,45,291,34,13,25,0,25.0,1.0,24.0,160.0,18.0,7.0,7.0,52,47,5,21.0,21.0,0.0
9402333,70,8,62,314,45,25,33,3,33.0,2.0,31.0,204.0,33.0,0.0,0.0,73,70,3,10.0,10.0,0.0
9906516,36,4,32,179,0,36,223,0,31.0,2.0,29.0,160.0,0.0,31.0,165.0,51,36,15,34.0,24.0,10.0
9807449,11,5,6,17,5,6,12,3,1.0,1.0,0.0,0.0,0.0,1.0,4.0,23,11,12,5.0,1.0,4.0
9904366,28,11,17,31,10,18,57,3,1.0,1.0,0.0,0.0,0.0,1.0,3.0,59,28,31,4.0,4.0,0.0
9706228,9,6,3,5,0,9,22,0,4.0,2.0,2.0,2.0,4.0,0.0,0.0,16,9,7,2.0,2.0,0.0
9505201,28,5,23,83,7,21,46,182,24.0,5.0,19.0,75.0,4.0,20.0,43.0,32,28,4,21.0,19.0,2.0
9808485,11,1,10,31,1,10,10,0,10.0,1.0,9.0,27.0,1.0,9.0,9.0,12,11,1,3.0,3.0,0.0
9807517,25,4,21,86,0,25,158,3,18.0,2.0,16.0,77.0,0.0,18.0,114.0,67,25,42,22.0,13.0,9.0
9706300,11,3,8,18,1,10,26,255,9.0,2.0,7.0,16.0,4.0,5.0,15.0,17,11,6,6.0,2.0,4.0
9810272,34,9,25,100,0,34,272,3,23.0,6.0,17.0,62.0,0.0,23.0,205.0,53,34,19,26.0,13.0,13.0
9708366,46,10,36,107,11,35,57,3,26.0,4.0,22.0,68.0,6.0,20.0,25.0,51,46,5,14.0,13.0,1.0
9602295,12,2,10,41,8,4,4,0,11.0,2.0,9.0,37.0,11.0,0.0,0.0,17,12,5,9.0,9.0,0.0
9808307,13,5,8,11,7,6,18,215,1.0,1.0,0.0,0.0,0.0,1.0,1.0,19,13,6,5.0,0.0,5.0
9902364,23,4,19,63,0,23,218,3,5.0,1.0,4.0,4.0,0.0,5.0,88.0,77,23,54,27.0,4.0,23.0
9312214,4,3,1,1,1,3,9,81,3.0,2.0,1.0,1.0,1.0,2.0,7.0,11,4,7,5.0,1.0,4.0
9911459,69,12,57,319,2,67,628,55,41.0,6.0,35.0,161.0,0.0,41.0,252.0,144,69,75,40.0,27.0,13.0
9509285,42,14,28,54,23,19,27,11,4.0,3.0,1.0,2.0,4.0,0.0,0.0,46,42,4,3.0,3.0,0.0
9204215,59,16,43,143,59,0,0,10,7.0,3.0,4.0,8.0,7.0,0.0,0.0,59,59,0,8.0,8.0,0.0
9610540,109,10,99,843,0,109,595,12,74.0,6.0,68.0,653.0,0.0,74.0,336.0,137,109,28,33.0,28.0,5.0
9802287,31,5,26,77,1,30,101,0,6.0,2.0,4.0,9.0,0.0,6.0,15.0,50,31,19,11.0,7.0,4.0
9606398,26,8,18,40,12,14,28,30,8.0,4.0,4.0,4.0,5.0,3.0,3.0,30,26,4,11.0,9.0,2.0
9210260,37,18,19,32,34,3,3,10,6.0,4.0,2.0,2.0,6.0,0.0,0.0,38,37,1,5.0,5.0,0.0
9707435,195,33,162,909,46,149,781,12,39.0,5.0,34.0,208.0,3.0,36.0,155.0,240,195,45,24.0,14.0,10.0
9509399,27,11,16,30,9,18,40,99,10.0,5.0,5.0,9.0,2.0,8.0,23.0,32,27,5,5.0,4.0,1.0
9406366,4,4,0,0,1,3,7,10,1.0,1.0,0.0,0.0,1.0,0.0,0.0,10,4,6,1.0,1.0,0.0
9604251,12,4,8,11,2,10,42,3,5.0,1.0,4.0,4.0,0.0,5.0,26.0,22,12,10,12.0,5.0,7.0
9311286,1,1,0,0,1,0,0,1140,,,,,,,,1,1,0,,,
9703299,81,11,70,726,5,76,356,36,67.0,6.0,61.0,681.0,0.0,67.0,310.0,92,81,11,58.0,53.0,5.0
9508253,17,6,11,14,0,17,181,10,7.0,3.0,4.0,4.0,0.0,7.0,64.0,75,17,58,10.0,4.0,6.0
110350,1,1,0,0,1,0,0,69,0.0,0.0,0.0,0.0,0.0,0.0,0.0,12,1,11,1.0,0.0,1.0
12155,36,6,30,109,14,22,44,1,7.0,1.0,6.0,12.0,0.0,7.0,15.0,42,36,6,13.0,9.0,4.0
9905397,20,4,16,52,1,19,80,1,9.0,3.0,6.0,15.0,9.0,0.0,0.0,38,20,18,5.0,0.0,5.0
6345,13,5,8,11,0,13,61,6,5.0,2.0,3.0,4.0,0.0,5.0,34.0,38,13,25,3.0,3.0,0.0
102146,134,5,129,1573,43,91,312,23,90.0,3.0,87.0,1181.0,34.0,56.0,186.0,148,134,14,59.0,53.0,6.0
6172,19,6,13,32,1,18,75,34,13.0,2.0,11.0,29.0,0.0,13.0,58.0,28,19,9,6.0,4.0,2.0
9211248,95,20,75,279,56,39,45,29,14.0,4.0,10.0,28.0,8.0,6.0,6.0,97,95,2,10.0,9.0,1.0
9204201,12,9,3,3,12,0,0,403,1.0,1.0,0.0,0.0,1.0,0.0,0.0,12,12,0,1.0,1.0,0.0
9609344,20,5,15,64,0,20,126,5,18.0,3.0,15.0,62.0,0.0,18.0,115.0,30,20,10,19.0,9.0,10.0
9704246,12,4,8,21,1,11,11,5,9.0,2.0,7.0,18.0,0.0,9.0,9.0,13,12,1,2.0,2.0,0.0
9409355,7,2,5,9,4,3,3,208,3.0,2.0,1.0,1.0,2.0,1.0,1.0,12,7,5,2.0,2.0,0.0
9206262,80,26,54,215,80,0,0,93,23.0,5.0,18.0,75.0,23.0,0.0,0.0,80,80,0,13.0,13.0,0.0
9511326,28,14,14,34,1,27,56,231,9.0,5.0,4.0,6.0,0.0,9.0,16.0,37,28,9,10.0,8.0,2.0
101127,26,11,15,19,1,25,112,13,7.0,4.0,3.0,3.0,0.0,7.0,42.0,69,26,43,14.0,3.0,11.0
5181,39,12,27,61,6,33,81,74,14.0,5.0,9.0,25.0,1.0,13.0,37.0,48,39,9,17.0,11.0,6.0
9504235,47,12,35,128,20,27,62,6,18.0,4.0,14.0,48.0,7.0,11.0,21.0,55,47,8,19.0,16.0,3.0
9705221,73,25,48,107,16,57,147,9,16.0,4.0,12.0,24.0,2.0,14.0,18.0,88,73,15,13.0,11.0,2.0
9810520,15,9,6,7,5,10,110,1,1.0,1.0,0.0,0.0,0.0,1.0,13.0,67,15,52,4.0,4.0,0.0
9712372,68,9,59,262,3,65,426,1,42.0,7.0,35.0,150.0,0.0,42.0,285.0,93,68,25,33.0,18.0,15.0
12318,8,7,1,1,0,8,53,69,4.0,4.0,0.0,0.0,0.0,4.0,23.0,55,8,47,12.0,1.0,11.0
9504262,6,4,2,2,5,1,1,179,0.0,0.0,0.0,0.0,0.0,0.0,0.0,11,6,5,3.0,0.0,3.0
9507303,37,6,31,137,1,36,235,1,32.0,3.0,29.0,134.0,0.0,32.0,216.0,50,37,13,26.0,18.0,8.0
9307259,30,15,15,45,26,4,4,86,15.0,8.0,7.0,19.0,15.0,0.0,0.0,32,30,2,10.0,10.0,0.0
9606362,48,11,37,71,16,32,52,31,21.0,2.0,19.0,33.0,19.0,2.0,2.0,57,48,9,7.0,7.0,0.0
9304272,13,5,8,14,13,0,0,112,6.0,3.0,3.0,5.0,6.0,0.0,0.0,13,13,0,3.0,3.0,0.0
9610323,99,18,81,379,8,91,482,7,27.0,3.0,24.0,95.0,2.0,25.0,92.0,143,99,44,13.0,11.0,2.0
9409438,13,6,7,13,1,12,45,29,3.0,2.0,1.0,1.0,0.0,3.0,8.0,30,13,17,2.0,1.0,1.0
9608314,4,1,3,3,1,3,11,7,3.0,1.0,2.0,2.0,0.0,3.0,9.0,12,4,8,4.0,2.0,2.0
9807348,49,2,47,256,1,48,181,2,33.0,2.0,31.0,179.0,0.0,33.0,138.0,58,49,9,16.0,12.0,4.0
9512237,29,10,19,44,15,14,27,107,10.0,5.0,5.0,7.0,4.0,6.0,6.0,33,29,4,10.0,9.0,1.0
9411288,8,8,0,0,5,3,3,348,3.0,3.0,0.0,0.0,1.0,2.0,2.0,9,8,1,2.0,1.0,1.0
9702292,10,5,5,8,3,7,22,231,1.0,1.0,0.0,0.0,0.0,1.0,4.0,26,10,16,5.0,1.0,4.0
9805476,4,1,3,3,0,4,18,98,4.0,1.0,3.0,3.0,0.0,4.0,18.0,13,4,9,9.0,3.0,6.0
9701421,69,26,43,102,25,44,108,97,19.0,4.0,15.0,26.0,4.0,15.0,32.0,99,69,30,16.0,11.0,5.0
9509282,9,2,7,17,1,8,16,30,7.0,2.0,5.0,10.0,7.0,0.0,0.0,19,9,10,4.0,4.0,0.0
9506321,7,4,3,4,1,6,10,12,6.0,3.0,3.0,4.0,1.0,5.0,5.0,13,7,6,2.0,0.0,2.0
9706538,6,4,2,3,0,6,24,18,3.0,1.0,2.0,2.0,0.0,3.0,6.0,22,6,16,8.0,4.0,4.0
9910488,12,3,9,21,0,12,24,218,9.0,2.0,7.0,16.0,1.0,8.0,10.0,19,12,7,11.0,10.0,1.0
9607374,4,3,1,1,0,4,4,218,2.0,2.0,0.0,0.0,0.0,2.0,2.0,5,4,1,2.0,1.0,1.0
9611278,10,7,3,4,7,3,21,47,2.0,1.0,1.0,1.0,0.0,2.0,4.0,24,10,14,3.0,1.0,2.0
9305319,79,29,50,125,37,42,42,11,6.0,2.0,4.0,4.0,6.0,0.0,0.0,80,79,1,7.0,7.0,0.0
9610260,49,6,43,175,5,44,65,16,23.0,2.0,21.0,96.0,0.0,23.0,23.0,53,49,4,22.0,21.0,1.0
9709270,20,6,14,28,3,17,52,30,5.0,4.0,1.0,1.0,0.0,5.0,16.0,40,20,20,11.0,1.0,10.0
9906412,1,1,0,0,1,0,0,1728,,,,,,,,1,1,0,,,
9302225,164,31,133,732,164,0,0,19,36.0,2.0,34.0,281.0,36.0,0.0,0.0,164,164,0,11.0,11.0,0.0
9909526,5,4,1,2,0,5,28,4,1.0,1.0,0.0,0.0,0.0,1.0,1.0,16,5,11,7.0,1.0,6.0
9312357,8,1,7,21,4,4,4,4,7.0,1.0,6.0,20.0,5.0,2.0,2.0,10,8,2,8.0,7.0,1.0
9307257,2,2,0,0,1,1,2,190,0.0,0.0,0.0,0.0,0.0,0.0,0.0,4,2,2,2.0,0.0,2.0
9711319,11,5,6,12,0,11,43,59,10.0,4.0,6.0,12.0,0.0,10.0,40.0,19,11,8,13.0,5.0,8.0
9803385,12,9,3,4,4,8,16,6,2.0,2.0,0.0,0.0,1.0,1.0,1.0,56,12,44,4.0,0.0,4.0
9405238,30,5,25,65,29,1,1,84,18.0,2.0,16.0,43.0,18.0,0.0,0.0,31,30,1,8.0,8.0,0.0
9810427,9,5,4,6,1,8,57,6,5.0,3.0,2.0,2.0,0.0,5.0,32.0,26,9,17,11.0,4.0,7.0
9601321,16,7,9,22,3,13,33,85,7.0,2.0,5.0,14.0,2.0,5.0,5.0,24,16,8,6.0,4.0,2.0
9604425,40,6,34,102,9,31,63,6,20.0,2.0,18.0,57.0,2.0,18.0,35.0,45,40,5,15.0,15.0,0.0
9501388,11,4,7,14,2,9,47,96,11.0,4.0,7.0,14.0,2.0,9.0,47.0,21,11,10,17.0,9.0,8.0
9601302,44,10,34,182,6,38,97,39,30.0,5.0,25.0,134.0,0.0,30.0,76.0,51,44,7,29.0,25.0,4.0
12303,7,4,3,4,0,7,16,55,2.0,1.0,1.0,1.0,0.0,2.0,4.0,19,7,12,8.0,5.0,3.0
9408276,81,4,77,498,63,18,18,38,55.0,1.0,54.0,380.0,55.0,0.0,0.0,82,81,1,34.0,34.0,0.0
9807540,43,11,32,122,7,36,162,45,21.0,5.0,16.0,69.0,0.0,21.0,103.0,58,43,15,23.0,17.0,6.0
9804212,56,13,43,147,13,43,138,45,31.0,5.0,26.0,102.0,5.0,26.0,97.0,61,56,5,22.0,17.0,5.0
11250,24,7,17,50,1,23,130,38,17.0,5.0,12.0,31.0,0.0,17.0,121.0,40,24,16,23.0,11.0,12.0
5223,14,8,6,8,1,13,83,22,4.0,4.0,0.0,0.0,0.0,4.0,23.0,42,14,28,14.0,3.0,11.0
9611415,11,4,7,16,1,10,29,22,2.0,2.0,0.0,0.0,0.0,2.0,6.0,20,11,9,8.0,7.0,1.0
4052,8,5,3,5,2,6,11,38,4.0,2.0,2.0,4.0,0.0,4.0,4.0,11,8,3,5.0,3.0,2.0
9603234,8,2,6,9,1,7,26,104,4.0,4.0,0.0,0.0,0.0,4.0,11.0,17,8,9,10.0,4.0,6.0
9205231,22,7,15,38,22,0,0,38,10.0,4.0,6.0,10.0,10.0,0.0,0.0,22,22,0,7.0,7.0,0.0
9706274,28,6,22,82,0,28,147,21,17.0,5.0,12.0,36.0,0.0,17.0,102.0,40,28,12,19.0,15.0,4.0
9701304,15,6,9,16,3,12,71,21,7.0,2.0,5.0,9.0,1.0,6.0,36.0,40,15,25,15.0,5.0,10.0
9509406,87,26,61,165,87,0,0,14,17.0,2.0,15.0,48.0,17.0,0.0,0.0,87,87,0,3.0,3.0,0.0
9609263,35,12,23,50,8,27,140,16,6.0,5.0,1.0,3.0,1.0,5.0,34.0,63,35,28,18.0,5.0,13.0
9809397,6,2,4,4,0,6,25,19,1.0,1.0,0.0,0.0,0.0,1.0,1.0,14,6,8,4.0,3.0,1.0
9906222,16,6,10,23,0,16,251,16,9.0,3.0,6.0,11.0,0.0,9.0,106.0,54,16,38,31.0,8.0,23.0
9507253,76,4,72,436,3,73,263,8,57.0,1.0,56.0,374.0,0.0,57.0,186.0,85,76,9,41.0,36.0,5.0
9708302,10,6,4,6,3,7,15,16,3.0,3.0,0.0,0.0,0.0,3.0,8.0,15,10,5,1.0,1.0,0.0
9606314,90,7,83,448,25,65,137,54,51.0,2.0,49.0,267.0,17.0,34.0,68.0,100,90,10,26.0,23.0,3.0
108175,6,4,2,2,0,6,78,20,6.0,4.0,2.0,2.0,0.0,6.0,77.0,41,6,35,36.0,4.0,32.0
10156,3,3,0,0,0,3,33,20,3.0,3.0,0.0,0.0,0.0,3.0,33.0,22,3,19,1.0,0.0,1.0
9211302,38,11,27,75,20,18,21,85,12.0,3.0,9.0,21.0,6.0,6.0,6.0,40,38,2,8.0,8.0,0.0
9406339,61,15,46,249,9,52,74,49,30.0,4.0,26.0,142.0,1.0,29.0,36.0,65,61,4,24.0,22.0,2.0
9910313,46,3,43,275,0,46,475,20,44.0,2.0,42.0,272.0,0.0,44.0,465.0,64,46,18,51.0,34.0,17.0
9905465,5,1,4,9,0,5,18,20,0.0,0.0,0.0,0.0,0.0,0.0,0.0,14,5,9,1.0,0.0,1.0
112206,15,6,9,27,0,15,123,20,12.0,4.0,8.0,26.0,0.0,12.0,111.0,36,15,21,10.0,8.0,2.0
9906445,15,3,12,44,3,12,42,116,13.0,1.0,12.0,43.0,1.0,12.0,24.0,25,15,10,16.0,13.0,3.0
210415,6,2,4,8,1,5,32,37,5.0,1.0,4.0,8.0,0.0,5.0,32.0,16,6,10,15.0,5.0,10.0
9208248,59,11,48,186,59,0,0,124,27.0,4.0,23.0,113.0,27.0,0.0,0.0,59,59,0,20.0,20.0,0.0
9304286,18,5,13,27,18,0,0,78,8.0,2.0,6.0,13.0,8.0,0.0,0.0,18,18,0,4.0,4.0,0.0
9810374,32,12,20,38,2,30,138,18,11.0,2.0,9.0,15.0,2.0,9.0,44.0,59,32,27,16.0,9.0,7.0
9403240,76,18,58,212,58,18,18,18,15.0,9.0,6.0,7.0,15.0,0.0,0.0,80,76,4,10.0,10.0,0.0
9904444,16,4,12,25,0,16,94,60,6.0,2.0,4.0,8.0,0.0,6.0,29.0,42,16,26,14.0,5.0,9.0
9706429,1,1,0,0,0,1,2,60,0.0,0.0,0.0,0.0,0.0,0.0,0.0,10,1,9,,,
9701346,17,3,14,50,2,15,63,99,8.0,1.0,7.0,23.0,0.0,8.0,16.0,25,17,8,12.0,10.0,2.0
9404293,6,2,4,10,6,0,0,73,6.0,2.0,4.0,10.0,6.0,0.0,0.0,6,6,0,1.0,1.0,0.0
9707442,6,4,2,2,2,4,28,5,1.0,1.0,0.0,0.0,0.0,1.0,11.0,35,6,29,12.0,0.0,12.0
9510218,5,4,1,1,3,2,2,179,3.0,2.0,1.0,1.0,3.0,0.0,0.0,12,5,7,2.0,2.0,0.0
9304226,4,4,0,0,4,0,0,774,1.0,1.0,0.0,0.0,1.0,0.0,0.0,4,4,0,1.0,1.0,0.0
9402265,17,8,9,15,2,15,32,4,6.0,1.0,5.0,10.0,0.0,6.0,14.0,23,17,6,7.0,5.0,2.0
9503377,24,3,21,88,2,22,131,71,21.0,3.0,18.0,80.0,1.0,20.0,125.0,34,24,10,24.0,15.0,9.0
9512246,20,4,16,49,4,16,34,39,11.0,2.0,9.0,23.0,2.0,9.0,14.0,28,20,8,9.0,7.0,2.0
9509229,16,6,10,19,4,12,15,48,5.0,1.0,4.0,7.0,5.0,0.0,0.0,19,16,3,8.0,7.0,1.0
9903301,7,2,5,8,0,7,33,93,0.0,0.0,0.0,0.0,0.0,0.0,0.0,36,7,29,10.0,0.0,10.0
9906251,12,9,3,3,12,0,0,173,2.0,1.0,1.0,1.0,2.0,0.0,0.0,12,12,0,2.0,2.0,0.0
9704369,29,8,21,79,0,29,175,11,20.0,2.0,18.0,68.0,0.0,20.0,89.0,43,29,14,4.0,1.0,3.0
9802383,3,3,0,0,1,2,2,242,0.0,0.0,0.0,0.0,0.0,0.0,0.0,8,3,5,1.0,1.0,0.0
9903207,15,4,11,25,0,15,80,28,8.0,4.0,4.0,6.0,0.0,8.0,35.0,27,15,12,13.0,6.0,7.0
9604222,9,4,5,5,2,7,16,99,4.0,2.0,2.0,2.0,0.0,4.0,7.0,14,9,5,7.0,4.0,3.0
9303286,10,3,7,12,5,5,9,41,3.0,1.0,2.0,2.0,2.0,1.0,1.0,12,10,2,2.0,2.0,0.0
9801437,26,10,16,20,10,16,29,69,5.0,5.0,0.0,0.0,5.0,0.0,0.0,38,26,12,6.0,5.0,1.0
9601353,31,12,19,48,4,27,39,110,16.0,6.0,10.0,23.0,0.0,16.0,20.0,38,31,7,4.0,4.0,0.0
9605451,8,1,7,16,0,8,91,49,7.0,1.0,6.0,13.0,0.0,7.0,57.0,31,8,23,19.0,7.0,12.0
9412249,16,6,10,27,0,16,34,49,12.0,3.0,9.0,25.0,1.0,11.0,11.0,20,16,4,6.0,5.0,1.0
9705363,7,3,4,6,3,4,18,6,0.0,0.0,0.0,0.0,0.0,0.0,0.0,18,7,11,2.0,2.0,0.0
9812399,8,4,4,7,4,4,7,23,0.0,0.0,0.0,0.0,0.0,0.0,0.0,48,8,40,6.0,0.0,6.0
9808283,69,17,52,191,53,16,24,25,21.0,4.0,17.0,71.0,21.0,0.0,0.0,72,69,3,11.0,10.0,1.0
9506364,19,7,12,37,5,14,88,1,13.0,4.0,9.0,32.0,1.0,12.0,61.0,47,19,28,17.0,11.0,6.0
9508309,4,3,1,1,3,1,1,57,1.0,1.0,0.0,0.0,1.0,0.0,0.0,6,4,2,1.0,1.0,0.0
9605296,75,14,61,331,0,75,286,55,50.0,7.0,43.0,239.0,0.0,50.0,196.0,83,75,8,35.0,29.0,6.0
9811501,60,2,58,681,0,60,408,2,56.0,2.0,54.0,660.0,0.0,56.0,382.0,72,60,12,51.0,43.0,8.0
9409414,2,2,0,0,1,1,1,10,0.0,0.0,0.0,0.0,0.0,0.0,0.0,15,2,13,1.0,0.0,1.0
9707483,6,3,3,3,4,2,3,48,2.0,1.0,1.0,1.0,2.0,0.0,0.0,12,6,6,1.0,1.0,0.0
9906271,15,8,7,9,4,11,41,5,2.0,1.0,1.0,1.0,0.0,2.0,13.0,38,15,23,9.0,2.0,7.0
9504272,5,4,1,1,1,4,11,26,2.0,2.0,0.0,0.0,0.0,2.0,9.0,14,5,9,6.0,1.0,5.0
9703219,2,1,1,1,0,2,28,124,2.0,1.0,1.0,1.0,0.0,2.0,28.0,22,2,20,22.0,2.0,20.0
10244,14,4,10,20,3,11,48,18,5.0,2.0,3.0,5.0,0.0,5.0,27.0,30,14,16,7.0,6.0,1.0
9704403,56,11,45,169,1,55,390,18,29.0,5.0,24.0,80.0,0.0,29.0,171.0,89,56,33,16.0,8.0,8.0
9307235,50,13,37,126,27,23,23,27,18.0,2.0,16.0,46.0,2.0,16.0,16.0,51,50,1,12.0,12.0,0.0
9909499,17,10,7,17,9,8,26,32,6.0,2.0,4.0,12.0,6.0,0.0,0.0,30,17,13,6.0,6.0,0.0
9908326,60,8,52,265,6,54,329,32,38.0,6.0,32.0,202.0,0.0,38.0,250.0,91,60,31,35.0,27.0,8.0
9912223,40,14,26,75,9,31,328,4,23.0,6.0,17.0,49.0,0.0,23.0,284.0,73,40,33,36.0,16.0,20.0
9701292,4,3,1,1,4,0,0,81,2.0,1.0,1.0,1.0,2.0,0.0,0.0,9,4,5,2.0,2.0,0.0
9805378,21,10,11,15,7,14,40,10,5.0,2.0,3.0,5.0,0.0,5.0,15.0,33,21,12,6.0,3.0,3.0
9909485,38,3,35,152,2,36,398,32,29.0,3.0,26.0,114.0,0.0,29.0,332.0,75,38,37,45.0,22.0,23.0
9901357,11,6,5,5,6,5,9,103,3.0,2.0,1.0,1.0,3.0,0.0,0.0,22,11,11,2.0,1.0,1.0
106258,184,47,137,740,56,128,276,0,42.0,4.0,38.0,151.0,1.0,41.0,124.0,198,184,14,20.0,18.0,2.0
8019,70,12,58,241,13,57,283,0,19.0,2.0,17.0,73.0,0.0,19.0,140.0,110,70,40,25.0,10.0,15.0
9406360,2,1,1,1,2,0,0,111,1.0,1.0,0.0,0.0,1.0,0.0,0.0,2,2,0,,,
9312278,20,11,9,16,5,15,44,164,11.0,7.0,4.0,5.0,0.0,11.0,32.0,32,20,12,14.0,11.0,3.0
9909203,73,4,69,422,2,71,630,11,50.0,2.0,48.0,338.0,0.0,50.0,539.0,99,73,26,42.0,30.0,12.0
9602230,2,2,0,0,2,0,0,118,,,,,,,,2,2,0,,,
9506432,36,4,32,130,36,0,0,16,23.0,1.0,22.0,85.0,23.0,0.0,0.0,36,36,0,10.0,10.0,0.0
9801268,44,2,42,274,4,40,186,43,36.0,2.0,34.0,229.0,3.0,33.0,169.0,65,44,21,39.0,25.0,14.0
9908218,36,12,24,69,12,24,42,106,21.0,5.0,16.0,49.0,14.0,7.0,7.0,44,36,8,14.0,13.0,1.0
9503415,12,2,10,25,1,11,42,4,10.0,2.0,8.0,19.0,0.0,10.0,30.0,25,12,13,13.0,9.0,4.0
9605310,5,4,1,1,2,3,6,94,2.0,1.0,1.0,1.0,1.0,1.0,4.0,9,5,4,1.0,1.0,0.0
9810489,17,7,10,22,7,10,36,19,3.0,1.0,2.0,3.0,3.0,0.0,0.0,30,17,13,3.0,3.0,0.0
9702417,19,5,14,39,5,14,29,129,11.0,2.0,9.0,26.0,6.0,5.0,12.0,26,19,7,9.0,9.0,0.0
103138,3,3,0,0,1,2,8,39,2.0,2.0,0.0,0.0,1.0,1.0,4.0,19,3,16,6.0,2.0,4.0
9503384,104,16,88,386,91,13,13,44,47.0,4.0,43.0,217.0,38.0,9.0,9.0,106,104,2,21.0,21.0,0.0
10051,4,2,2,3,0,4,41,2,3.0,2.0,1.0,2.0,0.0,3.0,16.0,20,4,16,13.0,4.0,9.0
9507264,4,4,0,0,2,2,4,317,1.0,1.0,0.0,0.0,0.0,1.0,2.0,8,4,4,5.0,1.0,4.0
9908530,14,5,9,18,2,12,79,2,8.0,1.0,7.0,12.0,0.0,8.0,21.0,30,14,16,3.0,1.0,2.0
9504268,8,1,7,9,1,7,9,138,8.0,1.0,7.0,9.0,1.0,7.0,9.0,11,8,3,8.0,6.0,2.0
9605240,26,11,15,26,9,17,23,44,4.0,1.0,3.0,3.0,4.0,0.0,0.0,31,26,5,5.0,5.0,0.0
212315,0,0,0,0,0,0,0,19,0.0,0.0,0.0,0.0,0.0,0.0,0.0,35,0,35,28.0,0.0,28.0
9606238,22,7,15,35,4,18,52,25,13.0,3.0,10.0,22.0,0.0,13.0,45.0,34,22,12,18.0,11.0,7.0
201114,13,7,6,15,0,13,106,19,10.0,4.0,6.0,13.0,0.0,10.0,71.0,35,13,22,13.0,5.0,8.0
11031,10,5,5,6,1,9,36,30,5.0,3.0,2.0,2.0,0.0,5.0,20.0,25,10,15,4.0,2.0,2.0
201302,7,2,5,7,0,7,30,80,3.0,1.0,2.0,3.0,2.0,1.0,1.0,20,7,13,4.0,3.0,1.0
209295,3,1,2,2,0,3,39,19,3.0,1.0,2.0,2.0,0.0,3.0,39.0,39,3,36,29.0,2.0,27.0
202124,14,3,11,43,0,14,237,28,14.0,3.0,11.0,43.0,0.0,14.0,190.0,42,14,28,29.0,14.0,15.0
9902383,30,8,22,73,3,27,59,28,12.0,3.0,9.0,30.0,1.0,11.0,20.0,37,30,7,12.0,10.0,2.0
9906266,58,6,52,267,0,58,529,2,38.0,4.0,34.0,158.0,0.0,38.0,387.0,80,58,22,27.0,18.0,9.0
9705264,43,4,39,161,2,41,101,9,31.0,3.0,28.0,127.0,0.0,31.0,81.0,46,43,3,24.0,21.0,3.0
9501283,17,7,10,18,6,11,12,91,2.0,2.0,0.0,0.0,2.0,0.0,0.0,20,17,3,2.0,2.0,0.0
9610526,8,6,2,3,0,8,20,0,1.0,1.0,0.0,0.0,0.0,1.0,2.0,16,8,8,1.0,1.0,0.0
5123,40,22,18,41,11,29,94,21,8.0,3.0,5.0,11.0,1.0,7.0,15.0,72,40,32,3.0,2.0,1.0
106140,19,3,16,52,1,18,70,2,10.0,2.0,8.0,23.0,0.0,10.0,32.0,31,19,12,16.0,11.0,5.0
9705348,18,11,7,9,3,15,53,42,7.0,2.0,5.0,7.0,0.0,7.0,34.0,31,18,13,11.0,6.0,5.0
9407286,1,1,0,0,0,1,1,1997,,,,,,,,2,1,1,,,
104051,13,7,6,17,2,11,68,10,8.0,3.0,5.0,14.0,0.0,8.0,55.0,38,13,25,16.0,6.0,10.0
9512435,21,2,19,53,1,20,79,10,9.0,1.0,8.0,12.0,0.0,9.0,20.0,35,21,14,11.0,8.0,3.0
9807452,17,9,8,16,7,10,32,168,3.0,2.0,1.0,2.0,0.0,3.0,3.0,26,17,9,3.0,2.0,1.0
1128,5,1,4,7,1,4,12,28,5.0,1.0,4.0,7.0,1.0,4.0,12.0,10,5,5,9.0,4.0,5.0
9503327,5,4,1,1,4,1,2,0,0.0,0.0,0.0,0.0,0.0,0.0,0.0,18,5,13,5.0,0.0,5.0
9312347,33,10,23,61,19,14,31,164,13.0,4.0,9.0,14.0,1.0,12.0,27.0,36,33,3,15.0,12.0,3.0
9808203,1,1,0,0,0,1,4,1878,,,,,,,,5,1,4,,,
9703301,13,6,7,8,8,5,12,86,4.0,2.0,2.0,3.0,2.0,2.0,6.0,18,13,5,3.0,3.0,0.0
9904249,15,1,14,37,0,15,123,3,5.0,4.0,1.0,1.0,0.0,5.0,28.0,38,15,23,16.0,9.0,7.0
9206247,12,6,6,8,12,0,0,67,3.0,2.0,1.0,2.0,3.0,0.0,0.0,12,12,0,3.0,3.0,0.0
4255,13,2,11,31,0,13,90,1,11.0,2.0,9.0,22.0,0.0,11.0,79.0,25,13,12,16.0,7.0,9.0
12216,4,3,1,1,3,1,5,7,0.0,0.0,0.0,0.0,0.0,0.0,0.0,25,4,21,4.0,0.0,4.0
9804327,3,2,1,1,0,3,20,1,1.0,1.0,0.0,0.0,0.0,1.0,2.0,19,3,16,2.0,0.0,2.0
110365,6,5,1,1,0,6,62,1,4.0,3.0,1.0,1.0,0.0,4.0,52.0,36,6,30,19.0,2.0,17.0
9705477,154,49,105,267,82,72,142,72,25.0,4.0,21.0,62.0,10.0,15.0,20.0,190,154,36,16.0,15.0,1.0
9305224,3,2,1,1,3,0,0,72,1.0,1.0,0.0,0.0,1.0,0.0,0.0,3,3,0,2.0,2.0,0.0
9712251,40,2,38,168,0,40,275,9,32.0,1.0,31.0,139.0,0.0,32.0,249.0,58,40,18,35.0,21.0,14.0
9803359,8,7,1,1,1,7,32,77,3.0,2.0,1.0,1.0,0.0,3.0,18.0,31,8,23,6.0,2.0,4.0
9706541,5,3,2,3,0,5,47,17,5.0,3.0,2.0,3.0,0.0,5.0,45.0,21,5,16,6.0,4.0,2.0
9702385,3,3,0,0,0,3,19,17,1.0,1.0,0.0,0.0,0.0,1.0,16.0,48,3,45,23.0,1.0,22.0
9602332,3,1,2,2,2,1,2,62,0.0,0.0,0.0,0.0,0.0,0.0,0.0,10,3,7,4.0,3.0,1.0
9602274,23,6,17,62,19,4,4,161,16.0,3.0,13.0,56.0,16.0,0.0,0.0,25,23,2,10.0,10.0,0.0
9704224,39,12,27,62,6,33,72,56,15.0,3.0,12.0,29.0,4.0,11.0,26.0,44,39,5,10.0,6.0,4.0
9304310,4,1,3,3,0,4,14,35,4.0,1.0,3.0,3.0,0.0,4.0,12.0,9,4,5,8.0,4.0,4.0
9506282,8,5,3,5,3,5,25,104,3.0,3.0,0.0,0.0,0.0,3.0,13.0,15,8,7,9.0,4.0,5.0
9604431,4,4,0,0,2,2,2,8,2.0,2.0,0.0,0.0,2.0,0.0,0.0,11,4,7,1.0,1.0,0.0
9508369,2,2,0,0,0,2,7,182,2.0,2.0,0.0,0.0,0.0,2.0,7.0,7,2,5,6.0,2.0,4.0
8308,18,7,11,31,0,18,104,4,15.0,6.0,9.0,24.0,0.0,15.0,91.0,33,18,15,19.0,10.0,9.0
12113,8,6,2,3,1,7,9,55,2.0,1.0,1.0,1.0,2.0,0.0,0.0,13,8,5,1.0,1.0,0.0
9710354,48,5,43,173,5,43,192,1,27.0,4.0,23.0,78.0,1.0,26.0,98.0,61,48,13,17.0,12.0,5.0
10106,8,1,7,17,0,8,91,29,8.0,1.0,7.0,17.0,0.0,8.0,68.0,84,8,76,25.0,8.0,17.0
9603257,4,4,0,0,4,0,0,110,0.0,0.0,0.0,0.0,0.0,0.0,0.0,8,4,4,2.0,0.0,2.0
9710415,20,5,15,50,1,19,55,137,12.0,1.0,11.0,36.0,0.0,12.0,44.0,28,20,8,12.0,6.0,6.0
9912370,7,5,2,2,1,6,29,101,1.0,1.0,0.0,0.0,0.0,1.0,9.0,40,7,33,9.0,1.0,8.0
9512406,256,50,206,1029,124,132,252,14,81.0,13.0,68.0,449.0,26.0,55.0,122.0,267,256,11,37.0,34.0,3.0
9907317,8,7,1,1,0,8,45,45,2.0,2.0,0.0,0.0,0.0,2.0,9.0,35,8,27,4.0,2.0,2.0
9403400,32,5,27,83,32,0,0,24,19.0,2.0,17.0,55.0,19.0,0.0,0.0,32,32,0,11.0,11.0,0.0
6096,12,4,8,18,0,12,120,24,11.0,3.0,8.0,18.0,0.0,11.0,107.0,41,12,29,26.0,9.0,17.0
5067,2,1,1,1,0,2,3,224,0.0,0.0,0.0,0.0,0.0,0.0,0.0,13,2,11,4.0,0.0,4.0
9612325,7,4,3,5,3,4,13,76,4.0,1.0,3.0,5.0,0.0,4.0,13.0,12,7,5,9.0,4.0,5.0
103111,2,2,0,0,1,1,1,214,1.0,1.0,0.0,0.0,0.0,1.0,1.0,5,2,3,2.0,1.0,1.0
9907495,27,11,16,38,2,25,90,9,10.0,2.0,8.0,20.0,0.0,10.0,35.0,47,27,20,15.0,10.0,5.0
9809255,21,12,9,15,10,11,12,178,6.0,3.0,3.0,5.0,6.0,0.0,0.0,27,21,6,5.0,5.0,0.0
9406350,30,5,25,72,16,14,16,14,13.0,3.0,10.0,21.0,13.0,0.0,0.0,35,30,5,6.0,6.0,0.0
9505311,7,6,1,1,3,4,10,14,3.0,3.0,0.0,0.0,0.0,3.0,6.0,13,7,6,5.0,2.0,3.0
9503290,93,9,84,442,28,65,66,27,62.0,3.0,59.0,343.0,12.0,50.0,50.0,95,93,2,29.0,28.0,1.0
9901339,17,8,9,16,10,7,15,189,8.0,3.0,5.0,10.0,4.0,4.0,10.0,26,17,9,10.0,5.0,5.0
9810230,8,4,4,8,0,8,35,73,8.0,4.0,4.0,8.0,0.0,8.0,35.0,14,8,6,12.0,6.0,6.0
9509217,12,5,7,12,5,7,11,13,7.0,2.0,5.0,10.0,0.0,7.0,11.0,15,12,3,7.0,6.0,1.0
9808334,4,1,3,6,3,1,1,120,4.0,1.0,3.0,6.0,3.0,1.0,1.0,7,4,3,5.0,4.0,1.0
9707466,17,8,9,17,9,8,11,11,4.0,1.0,3.0,6.0,3.0,1.0,1.0,29,17,12,6.0,6.0,0.0
9808479,20,7,13,23,2,18,85,9,14.0,4.0,10.0,18.0,0.0,14.0,67.0,32,20,12,6.0,6.0,0.0
9605395,15,8,7,18,6,9,15,16,5.0,3.0,2.0,3.0,0.0,5.0,10.0,18,15,3,2.0,2.0,0.0
9203225,54,15,39,127,54,0,0,29,15.0,5.0,10.0,27.0,15.0,0.0,0.0,54,54,0,8.0,8.0,0.0
9507332,15,7,8,13,3,12,23,14,7.0,1.0,6.0,11.0,7.0,0.0,0.0,20,15,5,7.0,7.0,0.0
9509244,8,4,4,4,5,3,3,54,2.0,1.0,1.0,1.0,2.0,0.0,0.0,11,8,3,2.0,2.0,0.0
9705233,2,2,0,0,0,2,5,16,1.0,1.0,0.0,0.0,1.0,0.0,0.0,6,2,4,1.0,0.0,1.0
9708474,1,1,0,0,0,1,1,1015,,,,,,,,3,1,2,1.0,0.0,1.0
9607205,7,1,6,9,0,7,7,13,6.0,1.0,5.0,7.0,0.0,6.0,6.0,8,7,1,1.0,1.0,0.0
9602294,2,2,0,0,1,1,3,50,0.0,0.0,0.0,0.0,0.0,0.0,0.0,15,2,13,2.0,0.0,2.0
9707322,4,1,3,3,0,4,9,132,4.0,1.0,3.0,3.0,0.0,4.0,8.0,7,4,3,6.0,4.0,2.0
9403213,2,2,0,0,2,0,0,111,1.0,1.0,0.0,0.0,1.0,0.0,0.0,2,2,0,1.0,1.0,0.0
9310240,4,4,0,0,4,0,0,176,1.0,1.0,0.0,0.0,1.0,0.0,0.0,4,4,0,,,
9502327,3,3,0,0,1,2,17,15,1.0,1.0,0.0,0.0,0.0,1.0,13.0,21,3,18,4.0,0.0,4.0
9607326,6,6,0,0,1,5,29,61,1.0,1.0,0.0,0.0,0.0,1.0,11.0,31,6,25,15.0,3.0,12.0
9512345,10,2,8,14,1,9,27,10,5.0,2.0,3.0,5.0,0.0,5.0,16.0,17,10,7,5.0,3.0,2.0
9411395,37,8,29,102,16,21,32,24,14.0,4.0,10.0,19.0,5.0,9.0,14.0,41,37,4,10.0,9.0,1.0
108043,24,9,15,65,1,23,191,0,13.0,2.0,11.0,41.0,0.0,13.0,65.0,64,24,40,21.0,11.0,10.0
104088,20,9,11,18,5,15,45,3,3.0,1.0,2.0,2.0,0.0,3.0,4.0,43,20,23,6.0,5.0,1.0
9909512,10,4,6,9,1,9,20,0,4.0,2.0,2.0,2.0,0.0,4.0,10.0,18,10,8,7.0,5.0,2.0
2168,9,6,3,5,0,9,72,3,6.0,4.0,2.0,2.0,0.0,6.0,38.0,51,9,42,2.0,1.0,1.0
9506314,16,8,8,19,14,2,2,52,6.0,1.0,5.0,12.0,6.0,0.0,0.0,17,16,1,3.0,2.0,1.0
9905241,17,11,6,13,9,8,12,31,3.0,2.0,1.0,1.0,0.0,3.0,4.0,30,17,13,2.0,1.0,1.0
9905295,21,3,18,104,0,21,459,2,20.0,3.0,17.0,102.0,0.0,20.0,450.0,53,21,32,42.0,17.0,25.0
9811240,10,2,8,12,0,10,58,46,4.0,1.0,3.0,4.0,0.0,4.0,24.0,29,10,19,4.0,2.0,2.0
9911338,16,8,8,9,2,14,28,1,3.0,2.0,1.0,1.0,3.0,0.0,0.0,22,16,6,2.0,2.0,0.0
5037,14,10,4,4,3,11,31,128,4.0,2.0,2.0,2.0,0.0,4.0,14.0,31,14,17,9.0,3.0,6.0
1249,23,4,19,94,1,22,109,5,19.0,2.0,17.0,83.0,1.0,18.0,93.0,31,23,8,22.0,16.0,6.0
9804465,3,2,1,1,1,2,3,213,2.0,1.0,1.0,1.0,0.0,2.0,3.0,10,3,7,3.0,2.0,1.0
9403293,17,9,8,10,5,12,14,217,6.0,3.0,3.0,4.0,6.0,0.0,0.0,20,17,3,3.0,3.0,0.0
4189,12,5,7,10,3,9,48,24,5.0,2.0,3.0,3.0,5.0,0.0,0.0,28,12,16,3.0,0.0,3.0
9405332,15,9,6,8,6,9,9,243,7.0,6.0,1.0,1.0,1.0,6.0,6.0,16,15,1,4.0,4.0,0.0
202166,21,10,11,34,0,21,115,4,14.0,5.0,9.0,30.0,0.0,14.0,98.0,35,21,14,21.0,8.0,13.0
9503223,12,4,8,14,7,5,10,123,5.0,2.0,3.0,6.0,2.0,3.0,5.0,17,12,5,5.0,4.0,1.0
9606223,18,3,15,32,8,10,16,15,8.0,2.0,6.0,12.0,8.0,0.0,0.0,25,18,7,8.0,8.0,0.0
9310262,3,1,2,2,3,0,0,103,2.0,1.0,1.0,1.0,2.0,0.0,0.0,3,3,0,1.0,1.0,0.0
9607314,28,5,23,123,10,18,33,49,25.0,4.0,21.0,110.0,10.0,15.0,15.0,34,28,6,18.0,16.0,2.0
9910489,4,2,2,2,2,2,5,111,3.0,1.0,2.0,2.0,2.0,1.0,2.0,8,4,4,5.0,3.0,2.0
9605209,19,3,16,31,3,16,50,14,4.0,2.0,2.0,3.0,0.0,4.0,14.0,29,19,10,4.0,3.0,1.0
202082,1,1,0,0,0,1,1,95,0.0,0.0,0.0,0.0,0.0,0.0,0.0,19,1,18,8.0,0.0,8.0
9602302,27,7,20,70,3,24,116,30,19.0,5.0,14.0,42.0,0.0,19.0,101.0,40,27,13,17.0,6.0,11.0
9610377,3,3,0,0,1,2,5,225,1.0,1.0,0.0,0.0,0.0,1.0,1.0,6,3,3,2.0,1.0,1.0
9606311,31,9,22,55,8,23,62,87,15.0,4.0,11.0,29.0,1.0,14.0,31.0,41,31,10,12.0,10.0,2.0
9410269,13,5,8,15,5,8,49,60,7.0,2.0,5.0,12.0,0.0,7.0,47.0,22,13,9,13.0,7.0,6.0
104076,22,2,20,69,0,22,73,55,10.0,2.0,8.0,19.0,0.0,10.0,31.0,36,22,14,15.0,11.0,4.0
9605267,3,2,1,1,3,0,0,125,,,,,,,,6,3,3,1.0,1.0,0.0
107127,4,4,0,0,0,4,14,13,0.0,0.0,0.0,0.0,0.0,0.0,0.0,23,4,19,4.0,0.0,4.0
4186,17,9,8,15,7,10,46,8,5.0,1.0,4.0,10.0,0.0,5.0,10.0,57,17,40,2.0,2.0,0.0
9809346,22,7,15,46,2,20,144,22,9.0,3.0,6.0,16.0,0.0,9.0,43.0,47,22,25,22.0,10.0,12.0
9211314,15,8,7,13,15,0,0,90,6.0,3.0,3.0,6.0,6.0,0.0,0.0,15,15,0,3.0,3.0,0.0
9504294,13,3,10,15,11,2,2,181,10.0,2.0,8.0,12.0,8.0,2.0,2.0,14,13,1,8.0,7.0,1.0
210031,5,3,2,2,0,5,46,7,1.0,1.0,0.0,0.0,0.0,1.0,9.0,36,5,31,10.0,1.0,9.0
9703375,43,3,40,261,1,42,259,36,38.0,3.0,35.0,249.0,0.0,38.0,251.0,52,43,9,38.0,30.0,8.0
9703316,16,4,12,28,13,3,3,36,14.0,3.0,11.0,26.0,14.0,0.0,0.0,17,16,1,2.0,2.0,0.0
103178,14,9,5,7,0,14,40,48,2.0,2.0,0.0,0.0,0.0,2.0,5.0,32,14,18,2.0,2.0,0.0
6016,4,2,2,2,2,2,6,218,2.0,1.0,1.0,1.0,0.0,2.0,5.0,9,4,5,6.0,2.0,4.0
111140,5,4,1,1,0,5,31,89,5.0,4.0,1.0,1.0,0.0,5.0,31.0,18,5,13,13.0,4.0,9.0
9608211,36,13,23,54,0,36,390,6,24.0,9.0,15.0,32.0,0.0,24.0,298.0,65,36,29,31.0,12.0,19.0
9406217,4,3,1,1,4,0,0,196,1.0,1.0,0.0,0.0,1.0,0.0,0.0,4,4,0,,,
3276,1,1,0,0,0,1,3,373,0.0,0.0,0.0,0.0,0.0,0.0,0.0,7,1,6,4.0,0.0,4.0
9903315,15,2,13,33,3,12,23,35,7.0,1.0,6.0,10.0,2.0,5.0,8.0,19,15,4,9.0,7.0,2.0
11389,2,2,0,0,0,2,4,42,1.0,1.0,0.0,0.0,1.0,0.0,0.0,12,2,10,2.0,2.0,0.0
9507323,15,8,7,11,4,11,32,10,3.0,1.0,2.0,2.0,0.0,3.0,16.0,32,15,17,2.0,2.0,0.0
9407284,0,0,0,0,0,0,0,342,0.0,0.0,0.0,0.0,0.0,0.0,0.0,5,0,5,1.0,0.0,1.0
102186,2,1,1,1,0,2,8,2110,1.0,1.0,0.0,0.0,0.0,1.0,2.0,7,2,5,5.0,2.0,3.0
9801284,13,1,12,40,7,6,7,145,10.0,1.0,9.0,31.0,9.0,1.0,1.0,18,13,5,10.0,10.0,0.0
9312239,9,3,6,11,1,8,8,83,4.0,1.0,3.0,6.0,0.0,4.0,4.0,10,9,1,1.0,1.0,0.0
9709205,15,4,11,26,3,12,27,98,13.0,2.0,11.0,26.0,2.0,11.0,26.0,20,15,5,10.0,6.0,4.0
9803285,6,2,4,6,6,0,0,154,5.0,1.0,4.0,6.0,5.0,0.0,0.0,6,6,0,2.0,2.0,0.0
9604436,22,3,19,61,22,0,0,135,9.0,1.0,8.0,15.0,9.0,0.0,0.0,22,22,0,8.0,8.0,0.0
9210219,29,13,16,31,29,0,0,265,13.0,4.0,9.0,22.0,13.0,0.0,0.0,29,29,0,10.0,10.0,0.0
9806277,6,5,1,1,3,3,13,6,2.0,1.0,1.0,1.0,0.0,2.0,6.0,18,6,12,2.0,2.0,0.0
4040,7,4,3,3,7,0,0,129,4.0,2.0,2.0,2.0,4.0,0.0,0.0,12,7,5,2.0,0.0,2.0
9607432,49,10,39,102,11,38,119,13,16.0,6.0,10.0,21.0,1.0,15.0,46.0,69,49,20,10.0,8.0,2.0
110193,9,3,6,9,1,8,65,67,4.0,1.0,3.0,4.0,0.0,4.0,31.0,43,9,34,16.0,4.0,12.0
9812521,17,8,9,15,5,12,32,8,5.0,3.0,2.0,2.0,2.0,3.0,3.0,32,17,15,3.0,2.0,1.0
9307284,3,2,1,1,1,2,2,15,1.0,1.0,0.0,0.0,1.0,0.0,0.0,5,3,2,1.0,1.0,0.0
10267,18,3,15,53,0,18,176,8,16.0,3.0,13.0,51.0,0.0,16.0,173.0,35,18,17,27.0,10.0,17.0
9308359,13,6,7,11,8,5,5,281,6.0,2.0,4.0,6.0,6.0,0.0,0.0,14,13,1,5.0,5.0,0.0
1230,10,3,7,15,1,9,26,22,8.0,2.0,6.0,14.0,1.0,7.0,7.0,19,10,9,8.0,7.0,1.0
9801266,2,2,0,0,1,1,8,22,0.0,0.0,0.0,0.0,0.0,0.0,0.0,16,2,14,1.0,0.0,1.0
102111,16,5,11,34,0,16,77,0,14.0,3.0,11.0,32.0,0.0,14.0,69.0,29,16,13,21.0,10.0,11.0
109003,2,1,1,1,0,2,12,0,0.0,0.0,0.0,0.0,0.0,0.0,0.0,11,2,9,8.0,2.0,6.0
9811450,1,1,0,0,0,1,6,200,1.0,1.0,0.0,0.0,0.0,1.0,3.0,11,1,10,4.0,0.0,4.0
9402203,25,9,16,23,25,0,0,59,12.0,4.0,8.0,11.0,12.0,0.0,0.0,25,25,0,8.0,8.0,0.0
9803272,23,7,16,31,6,17,38,7,8.0,3.0,5.0,8.0,6.0,2.0,2.0,35,23,12,8.0,7.0,1.0
9908333,9,1,8,19,0,9,40,21,8.0,1.0,7.0,16.0,0.0,8.0,27.0,22,9,13,12.0,8.0,4.0
9802323,9,7,2,3,0,9,30,12,4.0,3.0,1.0,1.0,0.0,4.0,6.0,18,9,9,6.0,5.0,1.0
10308,11,5,6,11,1,10,36,0,2.0,2.0,0.0,0.0,0.0,2.0,9.0,26,11,15,3.0,1.0,2.0
9605354,4,4,0,0,1,3,18,63,3.0,3.0,0.0,0.0,0.0,3.0,13.0,15,4,11,7.0,2.0,5.0
5262,22,4,18,35,2,20,155,12,11.0,3.0,8.0,13.0,0.0,11.0,89.0,50,22,28,10.0,7.0,3.0
9804302,7,7,0,0,2,5,11,232,2.0,2.0,0.0,0.0,1.0,1.0,2.0,16,7,9,3.0,2.0,1.0
9402223,26,2,24,64,14,12,13,25,12.0,2.0,10.0,20.0,6.0,6.0,6.0,28,26,2,8.0,8.0,0.0
12101,13,5,8,9,0,13,64,2,1.0,1.0,0.0,0.0,0.0,1.0,2.0,67,13,54,23.0,0.0,23.0
9905506,3,3,0,0,1,2,5,336,2.0,2.0,0.0,0.0,0.0,2.0,5.0,13,3,10,3.0,0.0,3.0
106023,8,5,3,6,0,8,55,32,6.0,3.0,3.0,6.0,0.0,6.0,45.0,25,8,17,6.0,5.0,1.0
9801361,9,4,5,6,0,9,38,23,0.0,0.0,0.0,0.0,0.0,0.0,0.0,24,9,15,1.0,1.0,0.0
9412370,5,4,1,1,1,4,5,330,0.0,0.0,0.0,0.0,0.0,0.0,0.0,11,5,6,1.0,0.0,1.0
9805294,15,4,11,27,0,15,48,83,6.0,2.0,4.0,10.0,0.0,6.0,12.0,21,15,6,11.0,7.0,4.0
201133,2,1,1,1,0,2,11,56,2.0,1.0,1.0,1.0,0.0,2.0,11.0,8,2,6,1.0,0.0,1.0
9610404,4,2,2,2,1,3,10,26,1.0,1.0,0.0,0.0,0.0,1.0,1.0,11,4,7,4.0,1.0,3.0
9611259,4,4,0,0,0,4,65,6,4.0,4.0,0.0,0.0,0.0,4.0,61.0,50,4,46,29.0,1.0,28.0
9701370,10,5,5,11,0,10,38,5,5.0,2.0,3.0,8.0,0.0,5.0,12.0,17,10,7,8.0,6.0,2.0
4155,4,2,2,2,1,3,5,70,2.0,2.0,0.0,0.0,2.0,0.0,0.0,10,4,6,2.0,2.0,0.0
9410205,6,3,3,3,6,0,0,248,3.0,1.0,2.0,2.0,3.0,0.0,0.0,6,6,0,3.0,3.0,0.0
112121,3,3,0,0,1,2,5,0,1.0,1.0,0.0,0.0,0.0,1.0,3.0,22,3,19,7.0,1.0,6.0
9803271,4,4,0,0,0,4,11,69,0.0,0.0,0.0,0.0,0.0,0.0,0.0,17,4,13,3.0,1.0,2.0
9802276,14,4,10,33,0,14,61,15,12.0,3.0,9.0,30.0,0.0,12.0,42.0,27,14,13,10.0,4.0,6.0
9209240,18,6,12,46,18,0,0,176,18.0,6.0,12.0,46.0,18.0,0.0,0.0,18,18,0,16.0,16.0,0.0
9309245,4,4,0,0,2,2,2,304,2.0,2.0,0.0,0.0,2.0,0.0,0.0,8,4,4,3.0,1.0,2.0
9708410,2,2,0,0,0,2,6,42,2.0,2.0,0.0,0.0,1.0,1.0,2.0,9,2,7,1.0,1.0,0.0
9410337,21,6,15,40,5,16,27,27,11.0,4.0,7.0,21.0,0.0,11.0,20.0,24,21,3,3.0,3.0,0.0
9804323,6,3,3,3,2,4,5,27,2.0,1.0,1.0,1.0,0.0,2.0,2.0,18,6,12,2.0,1.0,1.0
206245,8,5,3,6,0,8,83,46,6.0,3.0,3.0,6.0,0.0,6.0,63.0,49,8,41,25.0,5.0,20.0
108172,17,2,15,64,0,17,159,46,16.0,2.0,14.0,56.0,0.0,16.0,135.0,50,17,33,31.0,15.0,16.0
9087,1,1,0,0,0,1,5,3,0.0,0.0,0.0,0.0,0.0,0.0,0.0,17,1,16,4.0,0.0,4.0
9911212,8,3,5,7,0,8,52,3,2.0,2.0,0.0,0.0,0.0,2.0,22.0,20,8,12,14.0,3.0,11.0
201307,16,3,13,62,0,16,68,107,13.0,2.0,11.0,50.0,0.0,13.0,36.0,29,16,13,16.0,13.0,3.0
9901433,24,7,17,29,8,16,67,0,8.0,2.0,6.0,11.0,0.0,8.0,24.0,51,24,27,8.0,6.0,2.0
107084,6,3,3,5,1,5,16,99,2.0,1.0,1.0,1.0,0.0,2.0,6.0,14,6,8,6.0,2.0,4.0
1083,27,8,19,49,4,23,84,2,10.0,2.0,8.0,17.0,10.0,0.0,0.0,55,27,28,9.0,9.0,0.0
7359,20,6,14,50,3,17,29,47,15.0,2.0,13.0,47.0,1.0,14.0,21.0,25,20,5,15.0,13.0,2.0
9503372,12,4,8,13,12,0,0,139,7.0,2.0,5.0,8.0,7.0,0.0,0.0,14,12,2,6.0,6.0,0.0
104035,16,5,11,32,1,15,39,3,8.0,3.0,5.0,12.0,0.0,8.0,8.0,26,16,10,12.0,11.0,1.0
203198,29,9,20,37,1,28,244,28,13.0,7.0,6.0,10.0,0.0,13.0,125.0,79,29,50,26.0,9.0,17.0
9706352,7,3,4,7,3,4,14,243,4.0,1.0,3.0,4.0,1.0,3.0,3.0,20,7,13,4.0,3.0,1.0
9509380,13,5,8,10,9,4,7,228,6.0,2.0,4.0,5.0,3.0,3.0,6.0,15,13,2,3.0,3.0,0.0
9908292,9,4,5,7,0,9,25,8,4.0,1.0,3.0,4.0,0.0,4.0,13.0,24,9,15,7.0,1.0,6.0
9310364,1,1,0,0,1,0,0,1612,,,,,,,,1,1,0,,,
9805201,1,1,0,0,0,1,1,297,0.0,0.0,0.0,0.0,0.0,0.0,0.0,7,1,6,2.0,0.0,2.0
9812215,8,4,4,5,1,7,15,35,1.0,1.0,0.0,0.0,0.0,1.0,3.0,28,8,20,5.0,1.0,4.0
5326,2,1,1,1,0,2,3,76,0.0,0.0,0.0,0.0,0.0,0.0,0.0,6,2,4,4.0,1.0,3.0
104097,15,6,9,18,3,12,41,65,11.0,5.0,6.0,14.0,4.0,7.0,15.0,31,15,16,6.0,4.0,2.0
9810359,1,1,0,0,0,1,1,115,0.0,0.0,0.0,0.0,0.0,0.0,0.0,9,1,8,3.0,0.0,3.0
9701327,1,1,0,0,0,1,1,811,0.0,0.0,0.0,0.0,0.0,0.0,0.0,4,1,3,1.0,0.0,1.0
9702419,10,2,8,13,3,7,7,290,7.0,4.0,3.0,5.0,2.0,5.0,5.0,12,10,2,6.0,4.0,2.0
9604355,19,4,15,23,3,16,25,84,11.0,3.0,8.0,13.0,0.0,11.0,17.0,22,19,3,10.0,8.0,2.0
9310267,6,3,3,6,6,0,0,15,2.0,2.0,0.0,0.0,2.0,0.0,0.0,6,6,0,2.0,2.0,0.0
8022,15,5,10,22,0,15,69,18,12.0,4.0,8.0,18.0,0.0,12.0,44.0,40,15,25,2.0,1.0,1.0
9506474,11,8,3,3,4,7,15,17,2.0,1.0,1.0,1.0,2.0,0.0,0.0,21,11,10,2.0,1.0,1.0
9707408,3,3,0,0,0,3,3,68,0.0,0.0,0.0,0.0,0.0,0.0,0.0,17,3,14,2.0,0.0,2.0
109037,4,1,3,4,0,4,8,121,3.0,1.0,2.0,2.0,0.0,3.0,7.0,7,4,3,6.0,3.0,3.0
9512445,11,2,9,21,2,9,22,61,6.0,1.0,5.0,9.0,4.0,2.0,2.0,19,11,8,7.0,5.0,2.0
9405216,6,5,1,1,3,3,5,159,4.0,3.0,1.0,1.0,1.0,3.0,3.0,8,6,2,2.0,2.0,0.0
9602275,8,4,4,5,2,6,16,57,3.0,2.0,1.0,1.0,0.0,3.0,3.0,13,8,5,3.0,2.0,1.0
212043,0,0,0,0,0,0,0,222,0.0,0.0,0.0,0.0,0.0,0.0,0.0,5,0,5,3.0,0.0,3.0
9207235,17,12,5,8,17,0,0,208,6.0,6.0,0.0,0.0,6.0,0.0,0.0,17,17,0,6.0,6.0,0.0
9909348,26,13,13,18,8,18,43,88,10.0,5.0,5.0,5.0,0.0,10.0,31.0,32,26,6,9.0,5.0,4.0
9805503,2,2,0,0,1,1,5,245,0.0,0.0,0.0,0.0,0.0,0.0,0.0,10,2,8,8.0,1.0,7.0
9906319,42,4,38,308,2,40,59,109,39.0,2.0,37.0,304.0,3.0,36.0,36.0,57,42,15,35.0,34.0,1.0
9701365,14,5,9,17,0,14,76,14,4.0,3.0,1.0,1.0,0.0,4.0,24.0,34,14,20,7.0,3.0,4.0
9310329,18,7,11,27,11,7,7,13,9.0,3.0,6.0,17.0,9.0,0.0,0.0,19,18,1,4.0,4.0,0.0
9609220,6,6,0,0,0,6,14,93,2.0,2.0,0.0,0.0,0.0,2.0,4.0,21,6,15,2.0,0.0,2.0
108182,10,5,5,10,1,9,72,50,6.0,3.0,3.0,6.0,0.0,6.0,37.0,57,10,47,16.0,2.0,14.0
112150,5,2,3,3,3,2,9,13,2.0,1.0,1.0,1.0,2.0,0.0,0.0,15,5,10,6.0,1.0,5.0
9905509,13,6,7,8,0,13,45,107,7.0,2.0,5.0,6.0,0.0,7.0,22.0,24,13,11,10.0,6.0,4.0
102137,9,6,3,4,6,3,7,23,0.0,0.0,0.0,0.0,0.0,0.0,0.0,29,9,20,10.0,0.0,10.0
9703372,11,5,6,7,0,11,59,36,8.0,4.0,4.0,4.0,0.0,8.0,37.0,27,11,16,2.0,2.0,0.0
9705319,10,2,8,18,0,10,24,8,5.0,1.0,4.0,8.0,0.0,5.0,8.0,21,10,11,5.0,5.0,0.0
9811274,2,2,0,0,0,2,13,6,0.0,0.0,0.0,0.0,0.0,0.0,0.0,26,2,24,13.0,1.0,12.0
9810458,2,1,1,1,0,2,9,646,0.0,0.0,0.0,0.0,0.0,0.0,0.0,10,2,8,2.0,0.0,2.0
9312229,7,2,5,6,6,1,1,6,3.0,3.0,0.0,0.0,3.0,0.0,0.0,8,7,1,2.0,2.0,0.0
9501415,3,1,2,3,3,0,0,1083,2.0,1.0,1.0,1.0,2.0,0.0,0.0,3,3,0,,,
9712524,6,2,4,8,0,6,9,277,6.0,2.0,4.0,8.0,0.0,6.0,8.0,9,6,3,9.0,6.0,3.0
9909423,19,5,14,37,2,17,93,49,10.0,2.0,8.0,21.0,1.0,9.0,50.0,44,19,25,14.0,5.0,9.0
9710316,24,9,15,76,3,21,58,8,20.0,6.0,14.0,74.0,0.0,20.0,53.0,32,24,8,23.0,18.0,5.0
9604329,8,4,4,4,3,5,5,129,2.0,1.0,1.0,1.0,2.0,0.0,0.0,12,8,4,2.0,2.0,0.0
9907202,10,1,9,20,0,10,29,6,1.0,1.0,0.0,0.0,0.0,1.0,12.0,40,10,30,9.0,7.0,2.0
9910399,14,3,11,31,3,11,66,24,7.0,2.0,5.0,15.0,0.0,7.0,40.0,46,14,32,10.0,8.0,2.0
9404274,17,7,10,16,16,1,1,53,4.0,4.0,0.0,0.0,4.0,0.0,0.0,18,17,1,4.0,4.0,0.0
9902337,15,7,8,21,2,13,34,51,3.0,2.0,1.0,1.0,0.0,3.0,12.0,37,15,22,10.0,1.0,9.0
9712469,32,13,19,38,1,31,173,57,21.0,8.0,13.0,26.0,0.0,21.0,122.0,57,32,25,18.0,9.0,9.0
9607484,6,4,2,2,3,3,33,53,3.0,2.0,1.0,1.0,0.0,3.0,33.0,26,6,20,19.0,3.0,16.0
9604439,8,7,1,1,6,2,2,95,1.0,1.0,0.0,0.0,0.0,1.0,1.0,11,8,3,3.0,2.0,1.0
110129,12,8,4,4,8,4,11,121,3.0,2.0,1.0,1.0,3.0,0.0,0.0,24,12,12,3.0,0.0,3.0
9804410,9,7,2,2,3,6,21,101,4.0,3.0,1.0,1.0,1.0,3.0,7.0,22,9,13,4.0,3.0,1.0
9808230,8,3,5,10,8,0,0,147,4.0,2.0,2.0,3.0,4.0,0.0,0.0,8,8,0,2.0,2.0,0.0
9703377,25,6,19,34,8,17,44,65,8.0,1.0,7.0,14.0,1.0,7.0,18.0,37,25,12,5.0,5.0,0.0
9909250,17,7,10,19,0,17,93,119,10.0,4.0,6.0,9.0,0.0,10.0,56.0,32,17,15,18.0,7.0,11.0
9512301,5,1,4,7,0,5,14,30,4.0,1.0,3.0,5.0,0.0,4.0,8.0,22,5,17,5.0,4.0,1.0
9907269,2,2,0,0,1,1,6,27,1.0,1.0,0.0,0.0,1.0,0.0,0.0,8,2,6,1.0,0.0,1.0
9509433,20,7,13,34,0,20,189,53,16.0,4.0,12.0,33.0,0.0,16.0,170.0,48,20,28,30.0,12.0,18.0
9711452,10,1,9,19,5,5,6,96,6.0,1.0,5.0,11.0,6.0,0.0,0.0,15,10,5,3.0,3.0,0.0
9506345,6,4,2,3,4,2,4,15,3.0,2.0,1.0,1.0,2.0,1.0,1.0,10,6,4,4.0,4.0,0.0
9812283,9,2,7,21,0,9,46,60,7.0,1.0,6.0,17.0,0.0,7.0,23.0,31,9,22,12.0,7.0,5.0
9906354,4,3,1,2,0,4,8,109,2.0,2.0,0.0,0.0,0.0,2.0,5.0,14,4,10,2.0,2.0,0.0
110034,18,8,10,27,2,16,69,16,13.0,5.0,8.0,25.0,0.0,13.0,47.0,33,18,15,13.0,7.0,6.0
111044,10,4,6,11,0,10,38,27,9.0,4.0,5.0,10.0,0.0,9.0,37.0,15,10,5,13.0,8.0,5.0
10227,13,3,10,15,0,13,77,9,2.0,1.0,1.0,1.0,0.0,2.0,13.0,43,13,30,7.0,5.0,2.0
9810517,19,2,17,74,0,19,148,68,18.0,2.0,16.0,72.0,0.0,18.0,128.0,38,19,19,26.0,16.0,10.0
9401221,10,6,4,5,3,7,7,329,3.0,3.0,0.0,0.0,0.0,3.0,3.0,11,10,1,3.0,2.0,1.0
9601230,18,3,15,41,1,17,45,95,13.0,1.0,12.0,35.0,0.0,13.0,22.0,39,18,21,12.0,10.0,2.0
206180,1,1,0,0,1,0,0,56,0.0,0.0,0.0,0.0,0.0,0.0,0.0,36,1,35,22.0,0.0,22.0
9902475,8,3,5,9,0,8,78,56,8.0,3.0,5.0,9.0,0.0,8.0,72.0,44,8,36,15.0,5.0,10.0
9305265,2,2,0,0,2,0,0,26,0.0,0.0,0.0,0.0,0.0,0.0,0.0,7,2,5,1.0,0.0,1.0
9606456,31,9,22,64,26,5,5,13,19.0,5.0,14.0,38.0,19.0,0.0,0.0,32,31,1,5.0,5.0,0.0
9212236,23,8,15,39,23,0,0,110,7.0,2.0,5.0,12.0,7.0,0.0,0.0,23,23,0,9.0,9.0,0.0
9404234,12,6,6,8,1,11,44,62,6.0,5.0,1.0,1.0,0.0,6.0,12.0,27,12,15,7.0,2.0,5.0
9610448,4,1,3,5,4,0,0,415,4.0,1.0,3.0,5.0,4.0,0.0,0.0,4,4,0,4.0,4.0,0.0
9705364,11,1,10,35,3,8,12,34,10.0,1.0,9.0,33.0,3.0,7.0,7.0,13,11,2,11.0,10.0,1.0
208043,6,5,1,1,0,6,79,15,2.0,2.0,0.0,0.0,0.0,2.0,37.0,90,6,84,48.0,1.0,47.0
9503314,2,2,0,0,1,1,5,60,0.0,0.0,0.0,0.0,0.0,0.0,0.0,9,2,7,1.0,0.0,1.0
9503321,2,2,0,0,2,0,0,757,1.0,1.0,0.0,0.0,1.0,0.0,0.0,6,2,4,2.0,1.0,1.0
211374,0,0,0,0,0,0,0,2,0.0,0.0,0.0,0.0,0.0,0.0,0.0,29,0,29,2.0,0.0,2.0
9909291,2,2,0,0,2,0,0,32,0.0,0.0,0.0,0.0,0.0,0.0,0.0,10,2,8,2.0,0.0,2.0
9804291,6,3,3,3,2,4,5,248,3.0,3.0,0.0,0.0,1.0,2.0,2.0,17,6,11,7.0,1.0,6.0
9704332,3,3,0,0,3,0,0,133,2.0,2.0,0.0,0.0,2.0,0.0,0.0,10,3,7,2.0,1.0,1.0
1051,0,0,0,0,0,0,0,8,0.0,0.0,0.0,0.0,0.0,0.0,0.0,23,0,23,1.0,0.0,1.0
9512262,9,6,3,4,7,2,2,45,3.0,2.0,1.0,1.0,3.0,0.0,0.0,12,9,3,2.0,2.0,0.0
107158,4,4,0,0,1,3,12,351,1.0,1.0,0.0,0.0,0.0,1.0,2.0,20,4,16,4.0,1.0,3.0
6295,5,2,3,9,0,5,84,49,4.0,1.0,3.0,6.0,0.0,4.0,55.0,31,5,26,23.0,4.0,19.0
9908203,6,3,3,4,0,6,14,29,2.0,1.0,1.0,1.0,0.0,2.0,10.0,14,6,8,7.0,2.0,5.0
9702264,5,5,0,0,5,0,0,299,2.0,2.0,0.0,0.0,2.0,0.0,0.0,8,5,3,1.0,1.0,0.0
9709372,13,5,8,18,2,11,36,78,9.0,3.0,6.0,12.0,0.0,9.0,30.0,27,13,14,12.0,9.0,3.0
204086,2,1,1,1,0,2,26,73,2.0,1.0,1.0,1.0,0.0,2.0,24.0,19,2,17,14.0,1.0,13.0
110395,1,1,0,0,0,1,1,73,,,,,,,,4,1,3,1.0,0.0,1.0
9703325,1,1,0,0,0,1,1,605,1.0,1.0,0.0,0.0,1.0,0.0,0.0,3,1,2,2.0,1.0,1.0
9079,3,1,2,2,3,0,0,970,,,,,,,,3,3,0,2.0,2.0,0.0
9806268,20,9,11,22,3,17,44,106,13.0,5.0,8.0,19.0,3.0,10.0,11.0,38,20,18,6.0,5.0,1.0
9708217,5,2,3,3,5,0,0,328,2.0,1.0,1.0,1.0,2.0,0.0,0.0,5,5,0,2.0,2.0,0.0
9401290,5,3,2,2,3,2,2,342,2.0,2.0,0.0,0.0,1.0,1.0,1.0,8,5,3,3.0,1.0,2.0
104228,9,1,8,14,0,9,117,46,8.0,1.0,7.0,13.0,0.0,8.0,85.0,45,9,36,19.0,8.0,11.0
9811446,5,5,0,0,2,3,9,283,1.0,1.0,0.0,0.0,1.0,0.0,0.0,9,5,4,1.0,1.0,0.0
202083,1,1,0,0,0,1,1,95,1.0,1.0,0.0,0.0,0.0,1.0,1.0,8,1,7,,,
9710290,8,3,5,7,0,8,11,9,3.0,1.0,2.0,2.0,3.0,0.0,0.0,10,8,2,1.0,1.0,0.0
9703413,1,1,0,0,0,1,3,116,1.0,1.0,0.0,0.0,0.0,1.0,3.0,10,1,9,1.0,0.0,1.0
9807395,7,4,3,4,7,0,0,13,1.0,1.0,0.0,0.0,1.0,0.0,0.0,8,7,1,2.0,2.0,0.0
9303306,22,6,16,50,22,0,0,77,16.0,2.0,14.0,45.0,16.0,0.0,0.0,22,22,0,13.0,13.0,0.0
9901267,10,7,3,4,7,3,9,57,3.0,2.0,1.0,1.0,1.0,2.0,6.0,19,10,9,5.0,0.0,5.0
103331,12,3,9,18,2,10,133,7,6.0,2.0,4.0,7.0,0.0,6.0,84.0,40,12,28,13.0,2.0,11.0
9403322,18,6,12,25,18,0,0,133,11.0,5.0,6.0,10.0,11.0,0.0,0.0,18,18,0,8.0,8.0,0.0
109103,4,1,3,3,0,4,31,4,3.0,1.0,2.0,2.0,0.0,3.0,20.0,28,4,24,16.0,1.0,15.0
9711321,7,6,1,1,7,0,0,64,4.0,4.0,0.0,0.0,4.0,0.0,0.0,7,7,0,2.0,2.0,0.0
9812465,8,3,5,8,0,8,26,23,2.0,1.0,1.0,1.0,0.0,2.0,4.0,19,8,11,4.0,2.0,2.0
9205242,3,2,1,1,3,0,0,449,2.0,1.0,1.0,1.0,2.0,0.0,0.0,3,3,0,2.0,2.0,0.0
108092,28,8,20,57,1,27,307,11,20.0,4.0,16.0,51.0,0.0,20.0,274.0,62,28,34,14.0,4.0,10.0
104308,2,1,1,1,0,2,19,26,1.0,1.0,0.0,0.0,0.0,1.0,8.0,15,2,13,12.0,2.0,10.0
9912364,7,3,4,5,0,7,43,9,2.0,1.0,1.0,1.0,0.0,2.0,3.0,23,7,16,7.0,3.0,4.0
9906339,10,6,4,5,0,10,101,8,7.0,6.0,1.0,1.0,0.0,7.0,12.0,46,10,36,8.0,7.0,1.0
203265,2,1,1,1,1,1,2,28,2.0,1.0,1.0,1.0,1.0,1.0,1.0,11,2,9,2.0,0.0,2.0
9507239,2,2,0,0,0,2,6,69,1.0,1.0,0.0,0.0,0.0,1.0,2.0,7,2,5,1.0,0.0,1.0
206038,12,2,10,22,0,12,125,0,11.0,1.0,10.0,22.0,0.0,11.0,74.0,31,12,19,14.0,8.0,6.0
9908331,1,1,0,0,1,0,0,197,1.0,1.0,0.0,0.0,1.0,0.0,0.0,3,1,2,1.0,1.0,0.0
9504281,7,7,0,0,6,1,1,217,3.0,3.0,0.0,0.0,3.0,0.0,0.0,8,7,1,2.0,2.0,0.0
9712248,10,5,5,9,2,8,12,65,6.0,3.0,3.0,6.0,0.0,6.0,6.0,15,10,5,2.0,0.0,2.0
10148,25,5,20,61,10,15,34,51,20.0,2.0,18.0,58.0,7.0,13.0,16.0,29,25,4,20.0,17.0,3.0
9212287,9,5,4,6,9,0,0,332,8.0,4.0,4.0,6.0,8.0,0.0,0.0,9,9,0,5.0,5.0,0.0
201080,15,4,11,29,1,14,36,119,11.0,3.0,8.0,25.0,0.0,11.0,29.0,21,15,6,15.0,11.0,4.0
209150,1,1,0,0,0,1,4,119,0.0,0.0,0.0,0.0,0.0,0.0,0.0,16,1,15,10.0,0.0,10.0
3136,17,5,12,39,2,15,48,45,12.0,1.0,11.0,37.0,1.0,11.0,17.0,25,17,8,12.0,10.0,2.0
9907481,6,4,2,3,3,3,5,41,3.0,1.0,2.0,2.0,2.0,1.0,1.0,11,6,5,4.0,3.0,1.0
203149,8,3,5,5,0,8,19,31,6.0,2.0,4.0,4.0,0.0,6.0,12.0,16,8,8,3.0,2.0,1.0
9402201,8,6,2,3,8,0,0,31,3.0,2.0,1.0,1.0,3.0,0.0,0.0,8,8,0,4.0,4.0,0.0
203161,5,3,2,3,1,4,61,8,4.0,2.0,2.0,3.0,0.0,4.0,51.0,37,5,32,18.0,3.0,15.0
9402345,1,1,0,0,1,0,0,596,0.0,0.0,0.0,0.0,0.0,0.0,0.0,2,1,1,1.0,0.0,1.0
208083,2,2,0,0,0,2,63,1,2.0,2.0,0.0,0.0,0.0,2.0,44.0,73,2,71,30.0,1.0,29.0
209044,2,2,0,0,1,1,4,49,1.0,1.0,0.0,0.0,0.0,1.0,2.0,10,2,8,3.0,1.0,2.0
9803292,4,3,1,1,2,2,2,31,1.0,1.0,0.0,0.0,1.0,0.0,0.0,9,4,5,2.0,2.0,0.0
2211,8,3,5,10,3,5,29,25,3.0,1.0,2.0,3.0,0.0,3.0,20.0,21,8,13,7.0,3.0,4.0
9811229,1,1,0,0,0,1,4,47,1.0,1.0,0.0,0.0,1.0,0.0,0.0,6,1,5,2.0,1.0,1.0
12250,4,1,3,6,0,4,27,30,2.0,1.0,1.0,1.0,0.0,2.0,17.0,24,4,20,15.0,1.0,14.0
9304236,2,2,0,0,2,0,0,237,1.0,1.0,0.0,0.0,1.0,0.0,0.0,2,2,0,1.0,1.0,0.0
9308301,2,2,0,0,2,0,0,196,,,,,,,,3,2,1,1.0,1.0,0.0
105205,9,3,6,6,0,9,110,11,5.0,1.0,4.0,4.0,0.0,5.0,90.0,47,9,38,33.0,4.0,29.0
9502244,4,4,0,0,3,1,1,268,2.0,2.0,0.0,0.0,2.0,0.0,0.0,5,4,1,1.0,1.0,0.0
205290,17,6,11,17,3,14,40,0,2.0,2.0,0.0,0.0,2.0,0.0,0.0,25,17,8,4.0,3.0,1.0
9903267,3,3,0,0,1,2,4,194,0.0,0.0,0.0,0.0,0.0,0.0,0.0,11,3,8,4.0,0.0,4.0
110237,13,5,8,12,1,12,68,3,3.0,2.0,1.0,1.0,0.0,3.0,40.0,41,13,28,15.0,6.0,9.0
9903233,2,2,0,0,0,2,3,267,2.0,2.0,0.0,0.0,0.0,2.0,2.0,9,2,7,1.0,0.0,1.0
9806458,4,4,0,0,2,2,4,650,1.0,1.0,0.0,0.0,1.0,0.0,0.0,8,4,4,1.0,1.0,0.0
9802275,2,1,1,1,0,2,17,12,2.0,1.0,1.0,1.0,0.0,2.0,17.0,17,2,15,,,
9901354,6,4,2,2,0,6,36,53,3.0,2.0,1.0,1.0,0.0,3.0,31.0,29,6,23,16.0,3.0,13.0
9510245,10,7,3,3,7,3,3,84,3.0,2.0,1.0,1.0,3.0,0.0,0.0,11,10,1,2.0,2.0,0.0
208063,2,2,0,0,1,1,8,4,1.0,1.0,0.0,0.0,0.0,1.0,5.0,22,2,20,11.0,1.0,10.0
9217,5,3,2,2,0,5,62,11,4.0,3.0,1.0,1.0,0.0,4.0,53.0,43,5,38,25.0,2.0,23.0
9408209,2,2,0,0,2,0,0,271,1.0,1.0,0.0,0.0,1.0,0.0,0.0,2,2,0,1.0,1.0,0.0
9912450,4,4,0,0,0,4,16,2,2.0,2.0,0.0,0.0,0.0,2.0,2.0,27,4,23,8.0,0.0,8.0
206009,4,4,0,0,0,4,25,12,1.0,1.0,0.0,0.0,0.0,1.0,7.0,26,4,22,11.0,1.0,10.0
9601379,11,3,8,17,7,4,4,268,10.0,2.0,8.0,16.0,6.0,4.0,4.0,13,11,2,8.0,7.0,1.0
9907506,8,2,6,16,1,7,18,103,7.0,1.0,6.0,16.0,0.0,7.0,18.0,12,8,4,11.0,7.0,4.0
9806220,3,2,1,1,0,3,5,72,2.0,2.0,0.0,0.0,0.0,2.0,2.0,13,3,10,6.0,1.0,5.0
102217,3,1,2,2,2,1,2,1239,1.0,1.0,0.0,0.0,1.0,0.0,0.0,7,3,4,1.0,0.0,1.0
207350,2,2,0,0,0,2,25,0,1.0,1.0,0.0,0.0,0.0,1.0,14.0,32,2,30,19.0,1.0,18.0
206308,9,3,6,16,1,8,134,0,7.0,1.0,6.0,16.0,0.0,7.0,55.0,55,9,46,16.0,7.0,9.0
205160,4,1,3,3,0,4,125,4,3.0,1.0,2.0,2.0,0.0,3.0,56.0,113,4,109,9.0,0.0,9.0
112108,31,20,11,26,0,31,315,9,23.0,14.0,9.0,23.0,0.0,23.0,278.0,101,31,70,37.0,5.0,32.0
9709221,9,5,4,8,2,7,28,54,6.0,2.0,4.0,8.0,1.0,5.0,17.0,23,9,14,11.0,6.0,5.0
9606229,12,6,6,17,1,11,45,17,6.0,3.0,3.0,5.0,6.0,0.0,0.0,20,12,8,6.0,6.0,0.0
9709444,5,2,3,6,0,5,7,289,5.0,2.0,3.0,6.0,0.0,5.0,6.0,10,5,5,7.0,5.0,2.0
9911308,4,4,0,0,0,4,10,29,3.0,3.0,0.0,0.0,0.0,3.0,8.0,12,4,8,2.0,2.0,0.0
9709247,4,3,1,1,0,4,18,6,1.0,1.0,0.0,0.0,0.0,1.0,1.0,26,4,22,3.0,1.0,2.0
3087,8,5,3,3,1,7,26,6,5.0,3.0,2.0,2.0,1.0,4.0,6.0,30,8,22,5.0,5.0,0.0
110324,7,5,2,3,0,7,84,27,6.0,4.0,2.0,3.0,0.0,6.0,65.0,44,7,37,16.0,2.0,14.0
9903530,3,3,0,0,0,3,15,47,1.0,1.0,0.0,0.0,0.0,1.0,5.0,21,3,18,8.0,1.0,7.0
9909529,5,4,1,1,0,5,31,11,3.0,2.0,1.0,1.0,0.0,3.0,18.0,27,5,22,2.0,2.0,0.0
111004,1,1,0,0,0,1,40,23,1.0,1.0,0.0,0.0,0.0,1.0,32.0,43,1,42,31.0,1.0,30.0
210263,8,1,7,25,8,0,0,103,8.0,1.0,7.0,25.0,8.0,0.0,0.0,8,8,0,8.0,8.0,0.0
9411328,6,4,2,2,1,5,15,40,5.0,3.0,2.0,2.0,0.0,5.0,15.0,10,6,4,3.0,2.0,1.0
205230,7,2,5,5,0,7,56,28,3.0,1.0,2.0,2.0,0.0,3.0,13.0,27,7,20,9.0,4.0,5.0
9804445,5,2,3,4,0,5,34,39,5.0,2.0,3.0,4.0,0.0,5.0,34.0,13,5,8,13.0,5.0,8.0
9311324,4,2,2,3,1,3,3,40,1.0,1.0,0.0,0.0,0.0,1.0,1.0,5,4,1,2.0,1.0,1.0
9712492,14,5,9,14,0,14,36,166,9.0,2.0,7.0,11.0,0.0,9.0,20.0,22,14,8,8.0,5.0,3.0
9903545,1,1,0,0,0,1,2,103,0.0,0.0,0.0,0.0,0.0,0.0,0.0,4,1,3,,,
209207,5,3,2,2,0,5,37,7,0.0,0.0,0.0,0.0,0.0,0.0,0.0,40,5,35,20.0,2.0,18.0
9013,2,1,1,1,0,2,17,43,2.0,1.0,1.0,1.0,0.0,2.0,17.0,15,2,13,14.0,2.0,12.0
9705327,17,4,13,58,0,17,85,29,17.0,4.0,13.0,58.0,0.0,17.0,71.0,34,17,17,19.0,15.0,4.0
9706466,1,1,0,0,1,0,0,74,0.0,0.0,0.0,0.0,0.0,0.0,0.0,4,1,3,,,
9205246,7,3,4,5,7,0,0,323,5.0,2.0,3.0,4.0,5.0,0.0,0.0,7,7,0,4.0,4.0,0.0
1035,6,1,5,9,0,6,28,16,1.0,1.0,0.0,0.0,0.0,1.0,4.0,21,6,15,9.0,5.0,4.0
9910318,1,1,0,0,0,1,3,14,0.0,0.0,0.0,0.0,0.0,0.0,0.0,34,1,33,4.0,0.0,4.0
9909349,2,2,0,0,0,2,6,92,0.0,0.0,0.0,0.0,0.0,0.0,0.0,8,2,6,2.0,0.0,2.0
9606301,4,4,0,0,1,3,4,13,1.0,1.0,0.0,0.0,1.0,0.0,0.0,11,4,7,1.0,1.0,0.0
9601327,5,4,1,1,1,4,13,15,1.0,1.0,0.0,0.0,0.0,1.0,4.0,31,5,26,1.0,1.0,0.0
9404301,2,2,0,0,0,2,2,394,1.0,1.0,0.0,0.0,0.0,1.0,1.0,4,2,2,2.0,1.0,1.0
9606313,7,6,1,1,2,5,8,156,4.0,4.0,0.0,0.0,0.0,4.0,7.0,10,7,3,6.0,3.0,3.0
9203208,2,1,1,1,2,0,0,223,2.0,1.0,1.0,1.0,2.0,0.0,0.0,2,2,0,,,
8062,1,1,0,0,0,1,4,8,,,,,,,,8,1,7,1.0,0.0,1.0
103174,13,2,11,35,1,12,52,80,10.0,2.0,8.0,23.0,0.0,10.0,46.0,29,13,16,18.0,11.0,7.0
105220,4,3,1,2,0,4,26,37,0.0,0.0,0.0,0.0,0.0,0.0,0.0,28,4,24,5.0,0.0,5.0
3042,27,8,19,44,6,21,42,11,6.0,1.0,5.0,12.0,5.0,1.0,1.0,34,27,7,5.0,1.0,4.0
9808223,4,1,3,5,0,4,7,44,3.0,1.0,2.0,2.0,1.0,2.0,2.0,8,4,4,6.0,3.0,3.0
9705204,6,2,4,9,0,6,28,103,6.0,2.0,4.0,9.0,0.0,6.0,28.0,13,6,7,11.0,6.0,5.0
9209288,5,3,2,3,5,0,0,206,3.0,1.0,2.0,3.0,3.0,0.0,0.0,5,5,0,3.0,3.0,0.0
9408349,1,1,0,0,1,0,0,208,0.0,0.0,0.0,0.0,0.0,0.0,0.0,15,1,14,5.0,0.0,5.0
9609438,2,2,0,0,0,2,5,14,1.0,1.0,0.0,0.0,0.0,1.0,1.0,5,2,3,,,
9807292,2,2,0,0,0,2,3,356,2.0,2.0,0.0,0.0,0.0,2.0,3.0,5,2,3,3.0,2.0,1.0
102292,3,3,0,0,0,3,22,24,1.0,1.0,0.0,0.0,0.0,1.0,11.0,40,3,37,14.0,0.0,14.0
101239,3,3,0,0,3,0,0,1794,2.0,2.0,0.0,0.0,2.0,0.0,0.0,7,3,4,2.0,0.0,2.0
111303,8,6,2,5,2,6,14,4,0.0,0.0,0.0,0.0,0.0,0.0,0.0,35,8,27,4.0,4.0,0.0
106267,8,2,6,11,0,8,120,4,8.0,2.0,6.0,11.0,0.0,8.0,112.0,42,8,34,10.0,3.0,7.0
9711398,17,1,16,41,7,10,12,125,14.0,1.0,13.0,37.0,5.0,9.0,11.0,19,17,2,11.0,10.0,1.0
6104,5,2,3,7,0,5,81,49,5.0,2.0,3.0,7.0,0.0,5.0,46.0,35,5,30,17.0,4.0,13.0
9809336,2,2,0,0,2,0,0,408,1.0,1.0,0.0,0.0,1.0,0.0,0.0,2,2,0,1.0,1.0,0.0
9409383,1,1,0,0,1,0,0,309,0.0,0.0,0.0,0.0,0.0,0.0,0.0,2,1,1,1.0,0.0,1.0
111187,3,1,2,2,0,3,14,64,1.0,1.0,0.0,0.0,0.0,1.0,6.0,16,3,13,3.0,1.0,2.0
9607445,2,2,0,0,0,2,2,79,0.0,0.0,0.0,0.0,0.0,0.0,0.0,5,2,3,2.0,0.0,2.0
207234,0,0,0,0,0,0,0,12,0.0,0.0,0.0,0.0,0.0,0.0,0.0,12,0,12,,,
9907322,11,4,7,26,4,7,41,187,8.0,2.0,6.0,25.0,2.0,6.0,19.0,23,11,12,13.0,8.0,5.0
5230,3,2,1,1,0,3,9,45,,,,,,,,8,3,5,4.0,2.0,2.0
9710422,9,3,6,10,1,8,21,29,6.0,2.0,4.0,6.0,6.0,0.0,0.0,15,9,6,10.0,5.0,5.0
9711478,6,4,2,6,1,5,9,59,5.0,3.0,2.0,5.0,0.0,5.0,9.0,10,6,4,8.0,5.0,3.0
9405292,2,2,0,0,2,0,0,1131,1.0,1.0,0.0,0.0,1.0,0.0,0.0,2,2,0,,,
9708367,10,4,6,11,1,9,23,133,9.0,4.0,5.0,8.0,1.0,8.0,19.0,16,10,6,11.0,7.0,4.0
9207246,8,1,7,15,8,0,0,228,7.0,1.0,6.0,11.0,7.0,0.0,0.0,8,8,0,7.0,7.0,0.0
3236,2,2,0,0,1,1,5,5,1.0,1.0,0.0,0.0,0.0,1.0,1.0,25,2,23,3.0,0.0,3.0
9904502,6,2,4,9,0,6,25,42,5.0,1.0,4.0,9.0,0.0,5.0,8.0,14,6,8,7.0,5.0,2.0
9610500,2,2,0,0,1,1,1,94,0.0,0.0,0.0,0.0,0.0,0.0,0.0,26,2,24,3.0,0.0,3.0
9905488,3,2,1,1,0,3,17,29,2.0,1.0,1.0,1.0,0.0,2.0,8.0,14,3,11,5.0,2.0,3.0
109280,2,2,0,0,0,2,14,34,1.0,1.0,0.0,0.0,0.0,1.0,13.0,21,2,19,9.0,0.0,9.0
12185,1,1,0,0,0,1,2,44,1.0,1.0,0.0,0.0,1.0,0.0,0.0,7,1,6,2.0,0.0,2.0
205125,6,4,2,4,0,6,43,52,5.0,3.0,2.0,4.0,0.0,5.0,41.0,21,6,15,19.0,5.0,14.0
207141,1,1,0,0,1,0,0,65,0.0,0.0,0.0,0.0,0.0,0.0,0.0,4,1,3,2.0,0.0,2.0
9507251,5,4,1,1,0,5,16,14,2.0,1.0,1.0,1.0,0.0,2.0,3.0,11,5,6,4.0,2.0,2.0
9612305,1,1,0,0,0,1,1,604,0.0,0.0,0.0,0.0,0.0,0.0,0.0,6,1,5,1.0,0.0,1.0
9901349,2,1,1,1,0,2,16,6,2.0,1.0,1.0,1.0,0.0,2.0,11.0,15,2,13,11.0,2.0,9.0
108004,2,2,0,0,0,2,5,1,1.0,1.0,0.0,0.0,0.0,1.0,2.0,21,2,19,3.0,1.0,2.0
9807203,1,1,0,0,1,0,0,125,0.0,0.0,0.0,0.0,0.0,0.0,0.0,2,1,1,1.0,0.0,1.0
211105,2,1,1,1,0,2,20,95,2.0,1.0,1.0,1.0,0.0,2.0,8.0,24,2,22,7.0,2.0,5.0
9506358,9,6,3,4,2,7,13,8,3.0,2.0,1.0,1.0,0.0,3.0,4.0,16,9,7,3.0,2.0,1.0
9705441,3,2,1,1,0,3,16,5,1.0,1.0,0.0,0.0,0.0,1.0,1.0,12,3,9,1.0,0.0,1.0
9604203,1,1,0,0,0,1,2,458,1.0,1.0,0.0,0.0,0.0,1.0,2.0,5,1,4,2.0,0.0,2.0
7332,6,2,4,6,0,6,27,40,6.0,2.0,4.0,6.0,0.0,6.0,27.0,14,6,8,6.0,2.0,4.0
9904426,2,2,0,0,2,0,0,42,0.0,0.0,0.0,0.0,0.0,0.0,0.0,5,2,3,1.0,1.0,0.0
9607424,6,3,3,4,2,4,4,285,5.0,2.0,3.0,4.0,1.0,4.0,4.0,7,6,1,6.0,5.0,1.0
9606358,4,4,0,0,2,2,2,111,1.0,1.0,0.0,0.0,0.0,1.0,1.0,6,4,2,2.0,2.0,0.0
9409352,1,1,0,0,0,1,3,1493,1.0,1.0,0.0,0.0,0.0,1.0,1.0,4,1,3,,,
210089,3,2,1,1,0,3,17,28,2.0,1.0,1.0,1.0,0.0,2.0,6.0,15,3,12,1.0,1.0,0.0
9909532,3,3,0,0,0,3,9,125,3.0,3.0,0.0,0.0,0.0,3.0,9.0,8,3,5,6.0,3.0,3.0
9803224,1,1,0,0,1,0,0,324,0.0,0.0,0.0,0.0,0.0,0.0,0.0,8,1,7,1.0,0.0,1.0
9305250,9,5,4,9,9,0,0,9,5.0,2.0,3.0,6.0,5.0,0.0,0.0,9,9,0,6.0,6.0,0.0
102248,3,1,2,3,0,3,8,20,3.0,1.0,2.0,3.0,0.0,3.0,7.0,20,3,17,5.0,0.0,5.0
9809584,0,0,0,0,0,0,0,70,0.0,0.0,0.0,0.0,0.0,0.0,0.0,9,0,9,,,
9610551,7,5,2,2,7,0,0,365,3.0,1.0,2.0,2.0,3.0,0.0,0.0,10,7,3,1.0,1.0,0.0
9506212,2,1,1,1,2,0,0,144,2.0,1.0,1.0,1.0,2.0,0.0,0.0,2,2,0,1.0,1.0,0.0
9710263,3,3,0,0,2,1,1,252,1.0,1.0,0.0,0.0,1.0,0.0,0.0,4,3,1,2.0,1.0,1.0
105171,1,1,0,0,1,0,0,245,0.0,0.0,0.0,0.0,0.0,0.0,0.0,9,1,8,1.0,0.0,1.0
9606205,2,2,0,0,1,1,1,29,0.0,0.0,0.0,0.0,0.0,0.0,0.0,9,2,7,2.0,0.0,2.0
9807472,22,4,18,100,3,19,80,16,20.0,3.0,17.0,95.0,3.0,17.0,78.0,37,22,15,17.0,16.0,1.0
209160,5,4,1,1,1,4,12,46,1.0,1.0,0.0,0.0,0.0,1.0,8.0,39,5,34,15.0,1.0,14.0
207264,2,2,0,0,0,2,10,11,1.0,1.0,0.0,0.0,0.0,1.0,2.0,25,2,23,2.0,2.0,0.0
205150,6,3,3,4,0,6,41,6,3.0,2.0,1.0,1.0,0.0,3.0,8.0,22,6,16,5.0,3.0,2.0
9612289,2,1,1,1,2,0,0,29,,,,,,,,3,2,1,,,
9709403,1,1,0,0,0,1,1,109,0.0,0.0,0.0,0.0,0.0,0.0,0.0,5,1,4,3.0,0.0,3.0
9708440,3,2,1,2,1,2,3,276,3.0,2.0,1.0,2.0,1.0,2.0,2.0,5,3,2,4.0,3.0,1.0
111128,0,0,0,0,0,0,0,138,0.0,0.0,0.0,0.0,0.0,0.0,0.0,7,0,7,3.0,0.0,3.0
9509269,23,11,12,25,17,6,8,110,8.0,4.0,4.0,5.0,8.0,0.0,0.0,28,23,5,4.0,4.0,0.0
108127,5,2,3,5,0,5,14,28,5.0,2.0,3.0,5.0,0.0,5.0,14.0,11,5,6,2.0,0.0,2.0
9807263,17,2,15,33,0,17,65,11,13.0,1.0,12.0,30.0,0.0,13.0,36.0,32,17,15,17.0,13.0,4.0
9801230,9,4,5,6,0,9,60,6,3.0,2.0,1.0,1.0,0.0,3.0,23.0,30,9,21,13.0,8.0,5.0
112205,9,6,3,4,5,4,7,31,4.0,3.0,1.0,1.0,2.0,2.0,2.0,18,9,9,1.0,1.0,0.0
9702387,5,3,2,2,4,1,1,58,1.0,1.0,0.0,0.0,1.0,0.0,0.0,6,5,1,1.0,1.0,0.0
9311317,1,1,0,0,1,0,0,1361,1.0,1.0,0.0,0.0,1.0,0.0,0.0,3,1,2,,,
9509381,1,1,0,0,0,1,1,208,1.0,1.0,0.0,0.0,1.0,0.0,0.0,7,1,6,3.0,1.0,2.0
9511309,4,2,2,4,0,4,12,53,0.0,0.0,0.0,0.0,0.0,0.0,0.0,11,4,7,3.0,2.0,1.0
9809575,6,4,2,3,5,1,1,85,2.0,2.0,0.0,0.0,2.0,0.0,0.0,10,6,4,1.0,1.0,0.0
3052,2,2,0,0,1,1,4,104,1.0,1.0,0.0,0.0,0.0,1.0,3.0,21,2,19,7.0,1.0,6.0
1305,0,0,0,0,0,0,0,120,0.0,0.0,0.0,0.0,0.0,0.0,0.0,4,0,4,1.0,0.0,1.0
9911464,5,3,2,2,0,5,31,10,4.0,2.0,2.0,2.0,1.0,3.0,4.0,18,5,13,13.0,3.0,10.0
9903547,3,3,0,0,0,3,9,20,0.0,0.0,0.0,0.0,0.0,0.0,0.0,11,3,8,5.0,1.0,4.0
10172,2,2,0,0,1,1,2,64,1.0,1.0,0.0,0.0,0.0,1.0,1.0,8,2,6,3.0,1.0,2.0
9908511,3,3,0,0,0,3,5,26,1.0,1.0,0.0,0.0,0.0,1.0,3.0,25,3,22,3.0,0.0,3.0
9808313,3,1,2,3,0,3,30,6,0.0,0.0,0.0,0.0,0.0,0.0,0.0,16,3,13,10.0,3.0,7.0
10298,1,1,0,0,0,1,6,54,0.0,0.0,0.0,0.0,0.0,0.0,0.0,10,1,9,,,
9612263,0,0,0,0,0,0,0,11,,,,,,,,6,0,6,,,
9601345,1,1,0,0,0,1,3,295,1.0,1.0,0.0,0.0,0.0,1.0,3.0,4,1,3,4.0,1.0,3.0
204238,0,0,0,0,0,0,0,32,,,,,,,,7,0,7,1.0,0.0,1.0
9701287,0,0,0,0,0,0,0,1988,0.0,0.0,0.0,0.0,0.0,0.0,0.0,1,0,1,1.0,0.0,1.0
9204223,1,1,0,0,1,0,0,237,1.0,1.0,0.0,0.0,1.0,0.0,0.0,1,1,0,,,
9301257,5,1,4,8,5,0,0,195,2.0,1.0,1.0,1.0,2.0,0.0,0.0,5,5,0,2.0,2.0,0.0
9905235,2,2,0,0,1,1,1,160,0.0,0.0,0.0,0.0,0.0,0.0,0.0,10,2,8,4.0,1.0,3.0
11005,2,2,0,0,0,2,7,7,2.0,2.0,0.0,0.0,0.0,2.0,6.0,16,2,14,5.0,0.0,5.0
205276,2,2,0,0,0,2,15,57,2.0,2.0,0.0,0.0,0.0,2.0,9.0,16,2,14,3.0,1.0,2.0
9408356,3,3,0,0,3,0,0,88,1.0,1.0,0.0,0.0,1.0,0.0,0.0,5,3,2,2.0,2.0,0.0
10347,1,1,0,0,0,1,2,21,0.0,0.0,0.0,0.0,0.0,0.0,0.0,10,1,9,2.0,0.0,2.0
8235,1,1,0,0,0,1,3,79,1.0,1.0,0.0,0.0,0.0,1.0,3.0,16,1,15,4.0,1.0,3.0
3098,1,1,0,0,0,1,9,11,1.0,1.0,0.0,0.0,0.0,1.0,5.0,26,1,25,10.0,1.0,9.0
9501300,2,1,1,1,0,2,2,363,0.0,0.0,0.0,0.0,0.0,0.0,0.0,8,2,6,3.0,2.0,1.0
9312238,4,4,0,0,1,3,3,35,2.0,2.0,0.0,0.0,0.0,2.0,2.0,9,4,5,2.0,1.0,1.0
5285,7,3,4,7,1,6,6,63,4.0,3.0,1.0,1.0,0.0,4.0,4.0,9,7,2,5.0,4.0,1.0
9411347,1,1,0,0,0,1,1,62,1.0,1.0,0.0,0.0,0.0,1.0,1.0,6,1,5,1.0,0.0,1.0
108262,8,2,6,13,5,3,6,181,6.0,2.0,4.0,6.0,4.0,2.0,5.0,15,8,7,9.0,8.0,1.0
10218,1,1,0,0,0,1,1,13,0.0,0.0,0.0,0.0,0.0,0.0,0.0,5,1,4,2.0,0.0,2.0
102142,0,0,0,0,0,0,0,298,0.0,0.0,0.0,0.0,0.0,0.0,0.0,1,0,1,,,
9912465,1,1,0,0,0,1,5,50,1.0,1.0,0.0,0.0,0.0,1.0,5.0,6,1,5,6.0,1.0,5.0
9909211,9,3,6,18,1,8,30,24,2.0,1.0,1.0,1.0,0.0,2.0,3.0,14,9,5,9.0,7.0,2.0
7116,4,2,2,3,0,4,15,112,3.0,1.0,2.0,3.0,0.0,3.0,8.0,20,4,16,6.0,3.0,3.0
204073,5,2,3,4,2,3,6,0,0.0,0.0,0.0,0.0,0.0,0.0,0.0,31,5,26,3.0,0.0,3.0
9701295,0,0,0,0,0,0,0,320,0.0,0.0,0.0,0.0,0.0,0.0,0.0,4,0,4,,,
9708406,0,0,0,0,0,0,0,1616,,,,,,,,1,0,1,1.0,0.0,1.0
9305292,1,1,0,0,1,0,0,1887,1.0,1.0,0.0,0.0,1.0,0.0,0.0,1,1,0,,,
9909568,2,2,0,0,0,2,12,89,2.0,2.0,0.0,0.0,1.0,1.0,6.0,14,2,12,2.0,2.0,0.0
110117,3,2,1,2,0,3,18,37,2.0,2.0,0.0,0.0,0.0,2.0,5.0,20,3,17,9.0,3.0,6.0
203164,1,1,0,0,0,1,3,50,1.0,1.0,0.0,0.0,0.0,1.0,3.0,12,1,11,2.0,0.0,2.0
9211331,4,4,0,0,4,0,0,407,2.0,2.0,0.0,0.0,2.0,0.0,0.0,6,4,2,2.0,2.0,0.0
9707287,0,0,0,0,0,0,0,5,0.0,0.0,0.0,0.0,0.0,0.0,0.0,16,0,16,9.0,0.0,9.0
5264,1,1,0,0,0,1,1,123,0.0,0.0,0.0,0.0,0.0,0.0,0.0,11,1,10,6.0,0.0,6.0
107288,2,2,0,0,2,0,0,88,2.0,2.0,0.0,0.0,2.0,0.0,0.0,10,2,8,4.0,2.0,2.0
204255,2,1,1,1,0,2,12,165,2.0,1.0,1.0,1.0,0.0,2.0,12.0,21,2,19,11.0,2.0,9.0
102053,5,4,1,1,2,3,23,113,4.0,3.0,1.0,1.0,1.0,3.0,21.0,34,5,29,20.0,3.0,17.0
111402,2,2,0,0,0,2,3,172,1.0,1.0,0.0,0.0,0.0,1.0,1.0,10,2,8,4.0,0.0,4.0
9505418,7,3,4,4,7,0,0,45,1.0,1.0,0.0,0.0,1.0,0.0,0.0,8,7,1,2.0,2.0,0.0
9801402,2,2,0,0,0,2,2,148,2.0,2.0,0.0,0.0,0.0,2.0,2.0,6,2,4,3.0,2.0,1.0
9808308,2,2,0,0,1,1,2,45,1.0,1.0,0.0,0.0,0.0,1.0,2.0,5,2,3,3.0,1.0,2.0
201246,1,1,0,0,0,1,5,53,1.0,1.0,0.0,0.0,0.0,1.0,5.0,11,1,10,1.0,0.0,1.0
2203,5,5,0,0,2,3,13,157,2.0,2.0,0.0,0.0,0.0,2.0,8.0,15,5,10,4.0,1.0,3.0
209010,9,1,8,11,0,9,51,25,5.0,1.0,4.0,5.0,0.0,5.0,31.0,20,9,11,11.0,4.0,7.0
9903466,3,3,0,0,3,0,0,362,2.0,2.0,0.0,0.0,2.0,0.0,0.0,3,3,0,1.0,1.0,0.0
9906392,4,4,0,0,2,2,26,12,1.0,1.0,0.0,0.0,0.0,1.0,17.0,41,4,37,7.0,1.0,6.0
2145,1,1,0,0,0,1,1,185,1.0,1.0,0.0,0.0,1.0,0.0,0.0,3,1,2,1.0,0.0,1.0
9405227,1,1,0,0,0,1,1,178,1.0,1.0,0.0,0.0,0.0,1.0,1.0,4,1,3,3.0,1.0,2.0
210195,2,1,1,1,0,2,16,38,2.0,1.0,1.0,1.0,0.0,2.0,16.0,26,2,24,22.0,1.0,21.0
212242,1,1,0,0,0,1,5,846,1.0,1.0,0.0,0.0,0.0,1.0,2.0,6,1,5,3.0,1.0,2.0
301040,5,4,1,1,0,5,33,37,4.0,3.0,1.0,1.0,0.0,4.0,32.0,23,5,18,15.0,4.0,11.0
207149,1,1,0,0,1,0,0,268,0.0,0.0,0.0,0.0,0.0,0.0,0.0,2,1,1,,,
9312231,1,1,0,0,1,0,0,134,,,,,,,,5,1,4,1.0,0.0,1.0
6315,1,1,0,0,0,1,14,7,1.0,1.0,0.0,0.0,0.0,1.0,6.0,26,1,25,6.0,0.0,6.0
212162,2,2,0,0,0,2,19,193,1.0,1.0,0.0,0.0,0.0,1.0,4.0,22,2,20,6.0,1.0,5.0
9908284,7,1,6,18,1,6,6,161,7.0,1.0,6.0,18.0,1.0,6.0,6.0,8,7,1,8.0,7.0,1.0
9608492,1,1,0,0,0,1,1,1203,,,,,,,,3,1,2,1.0,1.0,0.0
9812356,1,1,0,0,1,0,0,3,0.0,0.0,0.0,0.0,0.0,0.0,0.0,26,1,25,1.0,1.0,0.0
4162,1,1,0,0,0,1,9,82,1.0,1.0,0.0,0.0,0.0,1.0,9.0,14,1,13,10.0,1.0,9.0
105244,3,3,0,0,0,3,17,45,1.0,1.0,0.0,0.0,0.0,1.0,7.0,32,3,29,14.0,0.0,14.0
207009,2,1,1,1,0,2,8,2,2.0,1.0,1.0,1.0,0.0,2.0,2.0,16,2,14,4.0,0.0,4.0
203215,1,1,0,0,1,0,0,132,0.0,0.0,0.0,0.0,0.0,0.0,0.0,5,1,4,1.0,1.0,0.0
9291,4,1,3,4,4,0,0,353,4.0,1.0,3.0,4.0,4.0,0.0,0.0,4,4,0,4.0,4.0,0.0
204318,1,1,0,0,0,1,11,68,1.0,1.0,0.0,0.0,0.0,1.0,10.0,22,1,21,15.0,1.0,14.0
9903429,3,1,2,3,0,3,8,262,3.0,1.0,2.0,3.0,0.0,3.0,8.0,9,3,6,8.0,3.0,5.0
9807257,2,2,0,0,0,2,11,76,1.0,1.0,0.0,0.0,0.0,1.0,6.0,19,2,17,8.0,0.0,8.0
9712503,4,4,0,0,3,1,1,396,3.0,3.0,0.0,0.0,2.0,1.0,1.0,11,4,7,4.0,2.0,2.0
9808483,2,2,0,0,2,0,0,11,0.0,0.0,0.0,0.0,0.0,0.0,0.0,17,2,15,1.0,0.0,1.0
9706416,3,1,2,2,2,1,3,101,0.0,0.0,0.0,0.0,0.0,0.0,0.0,7,3,4,2.0,1.0,1.0
204069,5,3,2,3,0,5,44,37,3.0,2.0,1.0,1.0,0.0,3.0,14.0,36,5,31,12.0,3.0,9.0
3300,9,2,7,20,0,9,38,44,8.0,2.0,6.0,14.0,0.0,8.0,33.0,19,9,10,15.0,7.0,8.0
9708267,0,0,0,0,0,0,0,54,0.0,0.0,0.0,0.0,0.0,0.0,0.0,6,0,6,,,
205344,3,2,1,1,0,3,10,37,1.0,1.0,0.0,0.0,0.0,1.0,1.0,32,3,29,7.0,0.0,7.0
202096,1,1,0,0,0,1,5,55,0.0,0.0,0.0,0.0,0.0,0.0,0.0,18,1,17,3.0,1.0,2.0
9801237,3,1,2,3,0,3,3,749,3.0,1.0,2.0,3.0,3.0,0.0,0.0,11,3,8,3.0,3.0,0.0
9711508,1,1,0,0,0,1,8,115,1.0,1.0,0.0,0.0,0.0,1.0,8.0,10,1,9,7.0,1.0,6.0
101155,1,1,0,0,1,0,0,146,,,,,,,,1,1,0,,,
9911319,0,0,0,0,0,0,0,254,0.0,0.0,0.0,0.0,0.0,0.0,0.0,6,0,6,3.0,0.0,3.0
302203,0,0,0,0,0,0,0,202,0.0,0.0,0.0,0.0,0.0,0.0,0.0,9,0,9,3.0,0.0,3.0
9912522,0,0,0,0,0,0,0,1681,0.0,0.0,0.0,0.0,0.0,0.0,0.0,3,0,3,2.0,0.0,2.0
301100,0,0,0,0,0,0,0,628,0.0,0.0,0.0,0.0,0.0,0.0,0.0,1,0,1,1.0,0.0,1.0
205299,2,1,1,1,0,2,6,8,,,,,,,,5,2,3,,,
204307,5,1,4,7,0,5,56,2,4.0,1.0,3.0,6.0,0.0,4.0,23.0,43,5,38,12.0,4.0,8.0
9305253,2,2,0,0,2,0,0,175,1.0,1.0,0.0,0.0,1.0,0.0,0.0,2,2,0,1.0,1.0,0.0
112167,1,1,0,0,0,1,1,50,0.0,0.0,0.0,0.0,0.0,0.0,0.0,11,1,10,1.0,0.0,1.0
212381,0,0,0,0,0,0,0,166,0.0,0.0,0.0,0.0,0.0,0.0,0.0,10,0,10,7.0,0.0,7.0
102325,1,1,0,0,0,1,1,99,0.0,0.0,0.0,0.0,0.0,0.0,0.0,8,1,7,1.0,1.0,0.0
101095,1,1,0,0,0,1,3,45,1.0,1.0,0.0,0.0,0.0,1.0,3.0,29,1,28,14.0,0.0,14.0
9607302,2,2,0,0,0,2,3,181,0.0,0.0,0.0,0.0,0.0,0.0,0.0,11,2,9,5.0,0.0,5.0
9701274,1,1,0,0,0,1,3,244,1.0,1.0,0.0,0.0,0.0,1.0,3.0,4,1,3,4.0,1.0,3.0
202172,2,2,0,0,0,2,11,307,1.0,1.0,0.0,0.0,0.0,1.0,3.0,18,2,16,4.0,1.0,3.0
9805465,0,0,0,0,0,0,0,96,0.0,0.0,0.0,0.0,0.0,0.0,0.0,1,0,1,1.0,0.0,1.0
5053,1,1,0,0,0,1,2,1028,,,,,,,,5,1,4,2.0,0.0,2.0
9909205,4,3,1,1,2,2,2,70,2.0,1.0,1.0,1.0,0.0,2.0,2.0,6,4,2,3.0,2.0,1.0
9310241,7,6,1,1,7,0,0,233,4.0,4.0,0.0,0.0,4.0,0.0,0.0,7,7,0,3.0,3.0,0.0
210199,1,1,0,0,0,1,8,30,1.0,1.0,0.0,0.0,0.0,1.0,4.0,10,1,9,3.0,1.0,2.0
7285,3,3,0,0,2,1,1,406,2.0,2.0,0.0,0.0,2.0,0.0,0.0,5,3,2,3.0,2.0,1.0
111437,2,2,0,0,2,0,0,172,0.0,0.0,0.0,0.0,0.0,0.0,0.0,4,2,2,1.0,1.0,0.0
101345,3,2,1,1,1,2,3,89,2.0,1.0,1.0,1.0,0.0,2.0,3.0,7,3,4,4.0,2.0,2.0
107324,0,0,0,0,0,0,0,24,0.0,0.0,0.0,0.0,0.0,0.0,0.0,8,0,8,,,
9401225,4,4,0,0,4,0,0,186,1.0,1.0,0.0,0.0,1.0,0.0,0.0,4,4,0,1.0,1.0,0.0
107292,1,1,0,0,0,1,2,107,1.0,1.0,0.0,0.0,0.0,1.0,2.0,10,1,9,2.0,0.0,2.0
9702221,6,2,4,8,3,3,7,96,1.0,1.0,0.0,0.0,0.0,1.0,2.0,22,6,16,5.0,1.0,4.0
210218,0,0,0,0,0,0,0,121,0.0,0.0,0.0,0.0,0.0,0.0,0.0,18,0,18,6.0,0.0,6.0
109223,6,4,2,2,0,6,33,52,3.0,2.0,1.0,1.0,1.0,2.0,6.0,43,6,37,6.0,1.0,5.0
211101,1,1,0,0,0,1,9,0,0.0,0.0,0.0,0.0,0.0,0.0,0.0,16,1,15,2.0,0.0,2.0
207307,3,3,0,0,0,3,11,9,0.0,0.0,0.0,0.0,0.0,0.0,0.0,24,3,21,1.0,0.0,1.0
9509221,1,1,0,0,0,1,1,62,0.0,0.0,0.0,0.0,0.0,0.0,0.0,9,1,8,1.0,1.0,0.0
6151,0,0,0,0,0,0,0,123,0.0,0.0,0.0,0.0,0.0,0.0,0.0,4,0,4,2.0,0.0,2.0
9702241,2,2,0,0,1,1,1,77,0.0,0.0,0.0,0.0,0.0,0.0,0.0,8,2,6,1.0,1.0,0.0
101303,0,0,0,0,0,0,0,133,0.0,0.0,0.0,0.0,0.0,0.0,0.0,13,0,13,5.0,0.0,5.0
4070,2,1,1,1,0,2,15,73,2.0,1.0,1.0,1.0,0.0,2.0,15.0,17,2,15,1.0,1.0,0.0
205242,1,1,0,0,0,1,16,2,1.0,1.0,0.0,0.0,0.0,1.0,16.0,37,1,36,16.0,1.0,15.0
109033,2,2,0,0,1,1,3,156,1.0,1.0,0.0,0.0,0.0,1.0,3.0,8,2,6,5.0,1.0,4.0
9803307,2,2,0,0,2,0,0,1918,1.0,1.0,0.0,0.0,1.0,0.0,0.0,2,2,0,1.0,1.0,0.0
9810545,3,3,0,0,1,2,9,76,1.0,1.0,0.0,0.0,1.0,0.0,0.0,12,3,9,1.0,1.0,0.0
302155,0,0,0,0,0,0,0,10,0.0,0.0,0.0,0.0,0.0,0.0,0.0,92,0,92,12.0,0.0,12.0
9051,1,1,0,0,1,0,0,31,1.0,1.0,0.0,0.0,1.0,0.0,0.0,6,1,5,1.0,1.0,0.0
9907366,2,2,0,0,1,1,10,44,0.0,0.0,0.0,0.0,0.0,0.0,0.0,13,2,11,2.0,0.0,2.0
102072,2,2,0,0,0,2,15,43,2.0,2.0,0.0,0.0,0.0,2.0,15.0,37,2,35,11.0,2.0,9.0
207129,4,2,2,2,0,4,10,9,1.0,1.0,0.0,0.0,0.0,1.0,1.0,31,4,27,7.0,3.0,4.0
9606394,1,1,0,0,1,0,0,771,1.0,1.0,0.0,0.0,1.0,0.0,0.0,1,1,0,1.0,1.0,0.0
105179,5,3,2,2,0,5,20,31,2.0,1.0,1.0,1.0,0.0,2.0,8.0,16,5,11,8.0,3.0,5.0
9312340,1,1,0,0,1,0,0,237,1.0,1.0,0.0,0.0,1.0,0.0,0.0,2,1,1,1.0,0.0,1.0
9511316,1,1,0,0,1,0,0,139,1.0,1.0,0.0,0.0,1.0,0.0,0.0,1,1,0,1.0,1.0,0.0
204148,0,0,0,0,0,0,0,230,0.0,0.0,0.0,0.0,0.0,0.0,0.0,4,0,4,3.0,0.0,3.0
204036,1,1,0,0,0,1,2,8,,,,,,,,6,1,5,2.0,1.0,1.0
203107,3,1,2,2,1,2,4,215,3.0,1.0,2.0,2.0,1.0,2.0,4.0,5,3,2,4.0,2.0,2.0
9601259,3,2,1,1,2,1,2,71,2.0,1.0,1.0,1.0,1.0,1.0,2.0,7,3,4,4.0,2.0,2.0
12148,1,1,0,0,0,1,3,383,1.0,1.0,0.0,0.0,0.0,1.0,3.0,4,1,3,4.0,1.0,3.0
110248,4,2,2,2,1,3,19,23,3.0,1.0,2.0,2.0,0.0,3.0,10.0,16,4,12,2.0,1.0,1.0
9503397,0,0,0,0,0,0,0,378,0.0,0.0,0.0,0.0,0.0,0.0,0.0,6,0,6,4.0,0.0,4.0
5166,0,0,0,0,0,0,0,2096,,,,,,,,6,0,6,,,
9901282,0,0,0,0,0,0,0,78,0.0,0.0,0.0,0.0,0.0,0.0,0.0,25,0,25,8.0,0.0,8.0
9605435,1,1,0,0,0,1,1,507,1.0,1.0,0.0,0.0,0.0,1.0,1.0,2,1,1,2.0,1.0,1.0
9289,2,1,1,1,0,2,5,114,0.0,0.0,0.0,0.0,0.0,0.0,0.0,15,2,13,5.0,2.0,3.0
9501403,1,1,0,0,0,1,2,116,1.0,1.0,0.0,0.0,0.0,1.0,2.0,9,1,8,3.0,0.0,3.0
9708442,3,3,0,0,0,3,17,18,0.0,0.0,0.0,0.0,0.0,0.0,0.0,39,3,36,8.0,0.0,8.0
9807438,1,1,0,0,0,1,2,52,1.0,1.0,0.0,0.0,0.0,1.0,2.0,3,1,2,3.0,1.0,2.0
112179,0,0,0,0,0,0,0,32,0.0,0.0,0.0,0.0,0.0,0.0,0.0,11,0,11,,,
9810377,1,1,0,0,0,1,1,187,1.0,1.0,0.0,0.0,0.0,1.0,1.0,6,1,5,,,
9912400,1,1,0,0,1,0,0,286,1.0,1.0,0.0,0.0,1.0,0.0,0.0,4,1,3,1.0,1.0,0.0
6199,0,0,0,0,0,0,0,43,,,,,,,,6,0,6,,,
9809265,1,1,0,0,0,1,3,46,1.0,1.0,0.0,0.0,0.0,1.0,3.0,7,1,6,,,
205301,2,2,0,0,0,2,6,44,1.0,1.0,0.0,0.0,0.0,1.0,2.0,39,2,37,10.0,0.0,10.0
204155,2,1,1,1,0,2,14,2,0.0,0.0,0.0,0.0,0.0,0.0,0.0,21,2,19,3.0,2.0,1.0
9612271,0,0,0,0,0,0,0,679,0.0,0.0,0.0,0.0,0.0,0.0,0.0,4,0,4,1.0,0.0,1.0
9811321,5,3,2,3,0,5,35,137,4.0,2.0,2.0,3.0,0.0,4.0,34.0,19,5,14,16.0,3.0,13.0
301172,0,0,0,0,0,0,0,4,0.0,0.0,0.0,0.0,0.0,0.0,0.0,38,0,38,4.0,0.0,4.0
9503257,1,1,0,0,0,1,1,437,0.0,0.0,0.0,0.0,0.0,0.0,0.0,4,1,3,2.0,0.0,2.0
9603367,0,0,0,0,0,0,0,75,0.0,0.0,0.0,0.0,0.0,0.0,0.0,9,0,9,1.0,0.0,1.0
101290,0,0,0,0,0,0,0,166,0.0,0.0,0.0,0.0,0.0,0.0,0.0,4,0,4,3.0,0.0,3.0
9507209,0,0,0,0,0,0,0,317,0.0,0.0,0.0,0.0,0.0,0.0,0.0,8,0,8,1.0,0.0,1.0
205195,0,0,0,0,0,0,0,48,0.0,0.0,0.0,0.0,0.0,0.0,0.0,15,0,15,1.0,0.0,1.0
9702224,0,0,0,0,0,0,0,369,0.0,0.0,0.0,0.0,0.0,0.0,0.0,5,0,5,3.0,0.0,3.0
9907536,0,0,0,0,0,0,0,98,0.0,0.0,0.0,0.0,0.0,0.0,0.0,3,0,3,,,
9606366,2,1,1,1,0,2,2,382,2.0,1.0,1.0,1.0,1.0,1.0,1.0,5,2,3,3.0,2.0,1.0
1323,1,1,0,0,0,1,4,5,1.0,1.0,0.0,0.0,0.0,1.0,1.0,13,1,12,1.0,1.0,0.0
9711233,2,1,1,1,0,2,9,24,0.0,0.0,0.0,0.0,0.0,0.0,0.0,19,2,17,6.0,1.0,5.0
112321,1,1,0,0,0,1,10,12,0.0,0.0,0.0,0.0,0.0,0.0,0.0,21,1,20,4.0,1.0,3.0
212086,1,1,0,0,0,1,2,72,0.0,0.0,0.0,0.0,0.0,0.0,0.0,18,1,17,5.0,0.0,5.0
101256,1,1,0,0,0,1,1,85,0.0,0.0,0.0,0.0,0.0,0.0,0.0,16,1,15,5.0,0.0,5.0
9808235,0,0,0,0,0,0,0,277,0.0,0.0,0.0,0.0,0.0,0.0,0.0,4,0,4,4.0,0.0,4.0
9604213,0,0,0,0,0,0,0,116,0.0,0.0,0.0,0.0,0.0,0.0,0.0,2,0,2,,,
9606336,4,3,1,1,2,2,3,175,2.0,1.0,1.0,1.0,2.0,0.0,0.0,7,4,3,2.0,2.0,0.0
9810264,0,0,0,0,0,0,0,194,0.0,0.0,0.0,0.0,0.0,0.0,0.0,4,0,4,1.0,0.0,1.0
3099,3,3,0,0,2,1,2,314,1.0,1.0,0.0,0.0,0.0,1.0,1.0,5,3,2,1.0,1.0,0.0
9904241,1,1,0,0,0,1,1,72,0.0,0.0,0.0,0.0,0.0,0.0,0.0,4,1,3,1.0,0.0,1.0
9704261,1,1,0,0,0,1,1,320,1.0,1.0,0.0,0.0,0.0,1.0,1.0,9,1,8,2.0,1.0,1.0
9905483,0,0,0,0,0,0,0,288,0.0,0.0,0.0,0.0,0.0,0.0,0.0,7,0,7,3.0,0.0,3.0
105300,1,1,0,0,0,1,1,502,1.0,1.0,0.0,0.0,0.0,1.0,1.0,3,1,2,2.0,1.0,1.0
9709427,0,0,0,0,0,0,0,39,,,,,,,,2,0,2,1.0,0.0,1.0
9911423,2,1,1,1,0,2,2,145,2.0,1.0,1.0,1.0,0.0,2.0,2.0,4,2,2,3.0,2.0,1.0
9610309,1,1,0,0,0,1,4,35,0.0,0.0,0.0,0.0,0.0,0.0,0.0,36,1,35,6.0,1.0,5.0
205286,3,2,1,1,1,2,17,66,2.0,1.0,1.0,1.0,0.0,2.0,14.0,24,3,21,7.0,2.0,5.0
9702280,0,0,0,0,0,0,0,895,,,,,,,,1,0,1,,,
9609219,4,1,3,5,2,2,2,125,3.0,1.0,2.0,3.0,2.0,1.0,1.0,5,4,1,4.0,3.0,1.0
212091,0,0,0,0,0,0,0,30,0.0,0.0,0.0,0.0,0.0,0.0,0.0,38,0,38,6.0,0.0,6.0
9909363,2,2,0,0,0,2,6,30,1.0,1.0,0.0,0.0,0.0,1.0,2.0,33,2,31,18.0,0.0,18.0
9501306,0,0,0,0,0,0,0,207,0.0,0.0,0.0,0.0,0.0,0.0,0.0,11,0,11,2.0,0.0,2.0
112293,1,1,0,0,1,0,0,1480,,,,,,,,1,1,0,,,
9911439,1,1,0,0,0,1,1,5,0.0,0.0,0.0,0.0,0.0,0.0,0.0,11,1,10,3.0,0.0,3.0
209371,1,1,0,0,0,1,3,2,0.0,0.0,0.0,0.0,0.0,0.0,0.0,28,1,27,19.0,0.0,19.0
9501278,1,1,0,0,1,0,0,337,1.0,1.0,0.0,0.0,1.0,0.0,0.0,1,1,0,1.0,1.0,0.0
9806449,0,0,0,0,0,0,0,39,0.0,0.0,0.0,0.0,0.0,0.0,0.0,6,0,6,5.0,0.0,5.0
9311236,0,0,0,0,0,0,0,1008,,,,,,,,1,0,1,,,
9606436,2,1,1,1,0,2,2,48,2.0,1.0,1.0,1.0,2.0,0.0,0.0,6,2,4,2.0,2.0,0.0
205077,0,0,0,0,0,0,0,12,0.0,0.0,0.0,0.0,0.0,0.0,0.0,14,0,14,2.0,0.0,2.0
9608380,0,0,0,0,0,0,0,72,0.0,0.0,0.0,0.0,0.0,0.0,0.0,4,0,4,2.0,0.0,2.0
108218,1,1,0,0,0,1,1,356,1.0,1.0,0.0,0.0,0.0,1.0,1.0,6,1,5,4.0,1.0,3.0
108062,4,1,3,6,0,4,18,104,4.0,1.0,3.0,6.0,0.0,4.0,9.0,13,4,9,6.0,4.0,2.0
9805412,1,1,0,0,1,0,0,2035,1.0,1.0,0.0,0.0,1.0,0.0,0.0,4,1,3,,,
9701424,1,1,0,0,0,1,1,151,0.0,0.0,0.0,0.0,0.0,0.0,0.0,4,1,3,1.0,0.0,1.0
101252,0,0,0,0,0,0,0,146,0.0,0.0,0.0,0.0,0.0,0.0,0.0,3,0,3,1.0,0.0,1.0
9807450,0,0,0,0,0,0,0,118,0.0,0.0,0.0,0.0,0.0,0.0,0.0,7,0,7,4.0,0.0,4.0
12180,2,1,1,1,0,2,2,35,0.0,0.0,0.0,0.0,0.0,0.0,0.0,21,2,19,4.0,0.0,4.0
208160,1,1,0,0,0,1,21,9,1.0,1.0,0.0,0.0,0.0,1.0,21.0,44,1,43,34.0,1.0,33.0
212008,0,0,0,0,0,0,0,7,0.0,0.0,0.0,0.0,0.0,0.0,0.0,17,0,17,5.0,0.0,5.0
9805458,4,2,2,2,1,3,7,284,3.0,1.0,2.0,2.0,0.0,3.0,5.0,10,4,6,6.0,3.0,3.0
9902277,1,1,0,0,0,1,5,39,0.0,0.0,0.0,0.0,0.0,0.0,0.0,13,1,12,4.0,1.0,3.0
202261,6,4,2,3,1,5,11,89,6.0,4.0,2.0,3.0,6.0,0.0,0.0,15,6,9,4.0,4.0,0.0
209359,1,1,0,0,1,0,0,102,0.0,0.0,0.0,0.0,0.0,0.0,0.0,7,1,6,1.0,1.0,0.0
210032,3,3,0,0,0,3,25,24,2.0,2.0,0.0,0.0,0.0,2.0,18.0,32,3,29,8.0,2.0,6.0
6055,1,1,0,0,0,1,1,63,0.0,0.0,0.0,0.0,0.0,0.0,0.0,9,1,8,1.0,1.0,0.0
12117,0,0,0,0,0,0,0,31,0.0,0.0,0.0,0.0,0.0,0.0,0.0,4,0,4,1.0,0.0,1.0
9512283,0,0,0,0,0,0,0,1973,,,,,,,,3,0,3,1.0,0.0,1.0
211353,2,1,1,1,0,2,21,2,1.0,1.0,0.0,0.0,0.0,1.0,13.0,27,2,25,4.0,2.0,2.0
9507370,0,0,0,0,0,0,0,113,,,,,,,,2,0,2,,,
211183,0,0,0,0,0,0,0,698,0.0,0.0,0.0,0.0,0.0,0.0,0.0,1,0,1,1.0,0.0,1.0
9601221,4,2,2,3,4,0,0,340,4.0,2.0,2.0,3.0,4.0,0.0,0.0,5,4,1,3.0,3.0,0.0
109265,5,3,2,2,0,5,26,34,4.0,2.0,2.0,2.0,0.0,4.0,24.0,14,5,9,5.0,3.0,2.0
201203,0,0,0,0,0,0,0,175,0.0,0.0,0.0,0.0,0.0,0.0,0.0,6,0,6,1.0,0.0,1.0
9811354,1,1,0,0,0,1,2,173,1.0,1.0,0.0,0.0,0.0,1.0,2.0,16,1,15,1.0,0.0,1.0
111182,1,1,0,0,0,1,2,251,1.0,1.0,0.0,0.0,0.0,1.0,1.0,7,1,6,3.0,1.0,2.0
106008,0,0,0,0,0,0,0,116,0.0,0.0,0.0,0.0,0.0,0.0,0.0,13,0,13,9.0,0.0,9.0
3054,0,0,0,0,0,0,0,448,0.0,0.0,0.0,0.0,0.0,0.0,0.0,2,0,2,2.0,0.0,2.0
9705480,0,0,0,0,0,0,0,8,,,,,,,,4,0,4,,,
11256,1,1,0,0,1,0,0,545,1.0,1.0,0.0,0.0,1.0,0.0,0.0,8,1,7,2.0,0.0,2.0
207194,2,1,1,1,0,2,16,40,2.0,1.0,1.0,1.0,0.0,2.0,8.0,14,2,12,7.0,2.0,5.0
9905269,2,2,0,0,0,2,16,15,1.0,1.0,0.0,0.0,0.0,1.0,5.0,16,2,14,6.0,0.0,6.0
212365,0,0,0,0,0,0,0,103,0.0,0.0,0.0,0.0,0.0,0.0,0.0,19,0,19,4.0,0.0,4.0
9911396,1,1,0,0,0,1,1,662,1.0,1.0,0.0,0.0,1.0,0.0,0.0,7,1,6,6.0,0.0,6.0
205128,1,1,0,0,0,1,7,24,1.0,1.0,0.0,0.0,0.0,1.0,1.0,8,1,7,3.0,1.0,2.0
8096,1,1,0,0,1,0,0,31,0.0,0.0,0.0,0.0,0.0,0.0,0.0,6,1,5,,,
9909306,1,1,0,0,0,1,2,15,0.0,0.0,0.0,0.0,0.0,0.0,0.0,15,1,14,5.0,0.0,5.0
8092,0,0,0,0,0,0,0,7,0.0,0.0,0.0,0.0,0.0,0.0,0.0,17,0,17,,,
210261,1,1,0,0,0,1,9,4,1.0,1.0,0.0,0.0,0.0,1.0,8.0,15,1,14,5.0,1.0,4.0
9801267,0,0,0,0,0,0,0,2058,,,,,,,,3,0,3,1.0,0.0,1.0
9905384,0,0,0,0,0,0,0,108,0.0,0.0,0.0,0.0,0.0,0.0,0.0,4,0,4,,,
208098,1,1,0,0,0,1,2,31,1.0,1.0,0.0,0.0,1.0,0.0,0.0,4,1,3,1.0,1.0,0.0
9709346,0,0,0,0,0,0,0,2042,,,,,,,,1,0,1,,,
104167,0,0,0,0,0,0,0,1445,,,,,,,,5,0,5,,,
9409378,0,0,0,0,0,0,0,961,,,,,,,,1,0,1,,,
301234,1,1,0,0,0,1,17,3,1.0,1.0,0.0,0.0,0.0,1.0,12.0,34,1,33,9.0,0.0,9.0
9606224,1,1,0,0,0,1,1,588,1.0,1.0,0.0,0.0,0.0,1.0,1.0,3,1,2,2.0,1.0,1.0
111462,0,0,0,0,0,0,0,111,0.0,0.0,0.0,0.0,0.0,0.0,0.0,31,0,31,6.0,0.0,6.0
212319,0,0,0,0,0,0,0,25,0.0,0.0,0.0,0.0,0.0,0.0,0.0,41,0,41,17.0,0.0,17.0
9905547,0,0,0,0,0,0,0,26,0.0,0.0,0.0,0.0,0.0,0.0,0.0,61,0,61,9.0,0.0,9.0
1076,0,0,0,0,0,0,0,54,0.0,0.0,0.0,0.0,0.0,0.0,0.0,9,0,9,3.0,0.0,3.0
206187,0,0,0,0,0,0,0,430,0.0,0.0,0.0,0.0,0.0,0.0,0.0,3,0,3,3.0,0.0,3.0
111413,0,0,0,0,0,0,0,2036,,,,,,,,2,0,2,,,
10180,1,1,0,0,0,1,8,2,1.0,1.0,0.0,0.0,0.0,1.0,3.0,11,1,10,,,
9710536,0,0,0,0,0,0,0,1762,0.0,0.0,0.0,0.0,0.0,0.0,0.0,2,0,2,,,
9407300,0,0,0,0,0,0,0,183,0.0,0.0,0.0,0.0,0.0,0.0,0.0,9,0,9,2.0,0.0,2.0
211002,0,0,0,0,0,0,0,942,,,,,,,,1,0,1,,,
109220,2,2,0,0,0,2,4,8,1.0,1.0,0.0,0.0,1.0,0.0,0.0,6,2,4,,,
208100,0,0,0,0,0,0,0,32,0.0,0.0,0.0,0.0,0.0,0.0,0.0,37,0,37,4.0,0.0,4.0
9211253,0,0,0,0,0,0,0,1366,,,,,,,,1,0,1,,,
212262,0,0,0,0,0,0,0,58,0.0,0.0,0.0,0.0,0.0,0.0,0.0,2,0,2,,,
9509218,0,0,0,0,0,0,0,22,0.0,0.0,0.0,0.0,0.0,0.0,0.0,6,0,6,2.0,0.0,2.0
210110,1,1,0,0,0,1,3,128,1.0,1.0,0.0,0.0,0.0,1.0,1.0,7,1,6,1.0,0.0,1.0
9910304,1,1,0,0,1,0,0,1012,,,,,,,,2,1,1,1.0,1.0,0.0
210361,0,0,0,0,0,0,0,25,0.0,0.0,0.0,0.0,0.0,0.0,0.0,18,0,18,8.0,0.0,8.0
9612281,1,1,0,0,1,0,0,93,0.0,0.0,0.0,0.0,0.0,0.0,0.0,5,1,4,1.0,1.0,0.0
9904339,0,0,0,0,0,0,0,489,0.0,0.0,0.0,0.0,0.0,0.0,0.0,6,0,6,2.0,0.0,2.0
211367,1,1,0,0,0,1,3,20,0.0,0.0,0.0,0.0,0.0,0.0,0.0,10,1,9,5.0,1.0,4.0
9609228,1,1,0,0,0,1,1,153,1.0,1.0,0.0,0.0,0.0,1.0,1.0,4,1,3,2.0,1.0,1.0
9805479,1,1,0,0,1,0,0,574,1.0,1.0,0.0,0.0,1.0,0.0,0.0,2,1,1,2.0,1.0,1.0
9077,4,2,2,3,0,4,22,256,3.0,1.0,2.0,3.0,0.0,3.0,21.0,11,4,7,10.0,3.0,7.0
9911236,0,0,0,0,0,0,0,336,0.0,0.0,0.0,0.0,0.0,0.0,0.0,7,0,7,,,
207041,0,0,0,0,0,0,0,42,0.0,0.0,0.0,0.0,0.0,0.0,0.0,38,0,38,5.0,0.0,5.0
9611291,0,0,0,0,0,0,0,10,0.0,0.0,0.0,0.0,0.0,0.0,0.0,11,0,11,4.0,0.0,4.0
9276,1,1,0,0,0,1,1,101,0.0,0.0,0.0,0.0,0.0,0.0,0.0,12,1,11,1.0,1.0,0.0
212123,2,2,0,0,0,2,33,11,1.0,1.0,0.0,0.0,0.0,1.0,27.0,70,2,68,54.0,1.0,53.0
106300,1,1,0,0,1,0,0,305,1.0,1.0,0.0,0.0,1.0,0.0,0.0,5,1,4,1.0,1.0,0.0
108045,2,1,1,1,2,0,0,45,2.0,1.0,1.0,1.0,2.0,0.0,0.0,4,2,2,2.0,2.0,0.0
104032,1,1,0,0,0,1,5,51,0.0,0.0,0.0,0.0,0.0,0.0,0.0,11,1,10,7.0,1.0,6.0
9907284,0,0,0,0,0,0,0,58,0.0,0.0,0.0,0.0,0.0,0.0,0.0,16,0,16,5.0,0.0,5.0
9604356,0,0,0,0,0,0,0,369,0.0,0.0,0.0,0.0,0.0,0.0,0.0,5,0,5,1.0,0.0,1.0
302154,0,0,0,0,0,0,0,73,0.0,0.0,0.0,0.0,0.0,0.0,0.0,17,0,17,10.0,0.0,10.0
302177,0,0,0,0,0,0,0,7,0.0,0.0,0.0,0.0,0.0,0.0,0.0,39,0,39,7.0,0.0,7.0
9508331,0,0,0,0,0,0,0,534,0.0,0.0,0.0,0.0,0.0,0.0,0.0,5,0,5,1.0,0.0,1.0
9807401,0,0,0,0,0,0,0,404,0.0,0.0,0.0,0.0,0.0,0.0,0.0,2,0,2,2.0,0.0,2.0
207074,0,0,0,0,0,0,0,136,0.0,0.0,0.0,0.0,0.0,0.0,0.0,3,0,3,3.0,0.0,3.0
211217,0,0,0,0,0,0,0,349,0.0,0.0,0.0,0.0,0.0,0.0,0.0,3,0,3,,,
207279,0,0,0,0,0,0,0,902,,,,,,,,2,0,2,,,
9912258,0,0,0,0,0,0,0,16,0.0,0.0,0.0,0.0,0.0,0.0,0.0,15,0,15,3.0,0.0,3.0
212052,0,0,0,0,0,0,0,45,0.0,0.0,0.0,0.0,0.0,0.0,0.0,2,0,2,1.0,0.0,1.0
102202,0,0,0,0,0,0,0,372,0.0,0.0,0.0,0.0,0.0,0.0,0.0,5,0,5,3.0,0.0,3.0
111354,0,0,0,0,0,0,0,96,0.0,0.0,0.0,0.0,0.0,0.0,0.0,5,0,5,1.0,0.0,1.0
9301214,0,0,0,0,0,0,0,2089,0.0,0.0,0.0,0.0,0.0,0.0,0.0,1,0,1,,,
301075,0,0,0,0,0,0,0,2,0.0,0.0,0.0,0.0,0.0,0.0,0.0,18,0,18,3.0,0.0,3.0
9904222,2,2,0,0,2,0,0,213,2.0,2.0,0.0,0.0,2.0,0.0,0.0,2,2,0,1.0,1.0,0.0
9906474,0,0,0,0,0,0,0,318,0.0,0.0,0.0,0.0,0.0,0.0,0.0,6,0,6,1.0,0.0,1.0
111207,3,2,1,1,0,3,4,261,3.0,2.0,1.0,1.0,0.0,3.0,3.0,10,3,7,3.0,2.0,1.0
210406,1,1,0,0,0,1,3,16,0.0,0.0,0.0,0.0,0.0,0.0,0.0,32,1,31,10.0,0.0,10.0
9901301,1,1,0,0,0,1,3,276,1.0,1.0,0.0,0.0,0.0,1.0,3.0,6,1,5,5.0,1.0,4.0
207057,0,0,0,0,0,0,0,8,0.0,0.0,0.0,0.0,0.0,0.0,0.0,16,0,16,5.0,0.0,5.0
11315,0,0,0,0,0,0,0,31,0.0,0.0,0.0,0.0,0.0,0.0,0.0,9,0,9,1.0,0.0,1.0
9910380,0,0,0,0,0,0,0,142,0.0,0.0,0.0,0.0,0.0,0.0,0.0,3,0,3,2.0,0.0,2.0
301109,0,0,0,0,0,0,0,11,0.0,0.0,0.0,0.0,0.0,0.0,0.0,23,0,23,1.0,0.0,1.0
9807205,0,0,0,0,0,0,0,157,0.0,0.0,0.0,0.0,0.0,0.0,0.0,7,0,7,4.0,0.0,4.0
110372,0,0,0,0,0,0,0,85,0.0,0.0,0.0,0.0,0.0,0.0,0.0,12,0,12,7.0,0.0,7.0
207175,0,0,0,0,0,0,0,50,0.0,0.0,0.0,0.0,0.0,0.0,0.0,10,0,10,8.0,0.0,8.0
12182,0,0,0,0,0,0,0,5,0.0,0.0,0.0,0.0,0.0,0.0,0.0,7,0,7,1.0,0.0,1.0
106048,0,0,0,0,0,0,0,27,,,,,,,,6,0,6,,,
209162,0,0,0,0,0,0,0,28,0.0,0.0,0.0,0.0,0.0,0.0,0.0,6,0,6,1.0,0.0,1.0
9806498,0,0,0,0,0,0,0,111,0.0,0.0,0.0,0.0,0.0,0.0,0.0,1,0,1,1.0,0.0,1.0
9306283,0,0,0,0,0,0,0,243,0.0,0.0,0.0,0.0,0.0,0.0,0.0,2,0,2,,,
9808363,0,0,0,0,0,0,0,721,0.0,0.0,0.0,0.0,0.0,0.0,0.0,1,0,1,1.0,0.0,1.0
4163,1,1,0,0,0,1,2,775,1.0,1.0,0.0,0.0,1.0,0.0,0.0,4,1,3,1.0,1.0,0.0
203005,0,0,0,0,0,0,0,14,0.0,0.0,0.0,0.0,0.0,0.0,0.0,16,0,16,4.0,0.0,4.0
103302,0,0,0,0,0,0,0,259,0.0,0.0,0.0,0.0,0.0,0.0,0.0,1,0,1,1.0,0.0,1.0
9912480,0,0,0,0,0,0,0,131,0.0,0.0,0.0,0.0,0.0,0.0,0.0,6,0,6,2.0,0.0,2.0
110082,1,1,0,0,0,1,4,20,1.0,1.0,0.0,0.0,1.0,0.0,0.0,7,1,6,2.0,1.0,1.0
9908270,0,0,0,0,0,0,0,504,0.0,0.0,0.0,0.0,0.0,0.0,0.0,5,0,5,1.0,0.0,1.0
9710207,0,0,0,0,0,0,0,91,0.0,0.0,0.0,0.0,0.0,0.0,0.0,5,0,5,1.0,0.0,1.0
203139,0,0,0,0,0,0,0,247,0.0,0.0,0.0,0.0,0.0,0.0,0.0,3,0,3,1.0,0.0,1.0
210249,0,0,0,0,0,0,0,31,0.0,0.0,0.0,0.0,0.0,0.0,0.0,18,0,18,6.0,0.0,6.0
208135,0,0,0,0,0,0,0,168,0.0,0.0,0.0,0.0,0.0,0.0,0.0,3,0,3,2.0,0.0,2.0
9408377,1,1,0,0,1,0,0,1068,,,,,,,,1,1,0,1.0,1.0,0.0
211270,0,0,0,0,0,0,0,193,0.0,0.0,0.0,0.0,0.0,0.0,0.0,10,0,10,2.0,0.0,2.0
206176,0,0,0,0,0,0,0,239,0.0,0.0,0.0,0.0,0.0,0.0,0.0,20,0,20,1.0,0.0,1.0
9605453,0,0,0,0,0,0,0,25,0.0,0.0,0.0,0.0,0.0,0.0,0.0,6,0,6,3.0,0.0,3.0
112006,1,1,0,0,0,1,2,76,1.0,1.0,0.0,0.0,0.0,1.0,2.0,20,1,19,10.0,0.0,10.0
9809518,0,0,0,0,0,0,0,104,,,,,,,,3,0,3,,,
9907456,0,0,0,0,0,0,0,298,0.0,0.0,0.0,0.0,0.0,0.0,0.0,1,0,1,1.0,0.0,1.0
210264,0,0,0,0,0,0,0,106,0.0,0.0,0.0,0.0,0.0,0.0,0.0,1,0,1,,,
11073,0,0,0,0,0,0,0,15,0.0,0.0,0.0,0.0,0.0,0.0,0.0,5,0,5,4.0,0.0,4.0
211317,0,0,0,0,0,0,0,14,0.0,0.0,0.0,0.0,0.0,0.0,0.0,36,0,36,8.0,0.0,8.0
204143,0,0,0,0,0,0,0,1527,,,,,,,,2,0,2,,,
211184,0,0,0,0,0,0,0,261,0.0,0.0,0.0,0.0,0.0,0.0,0.0,3,0,3,3.0,0.0,3.0
210417,1,1,0,0,0,1,1,215,1.0,1.0,0.0,0.0,0.0,1.0,1.0,8,1,7,1.0,1.0,0.0
9409429,0,0,0,0,0,0,0,109,0.0,0.0,0.0,0.0,0.0,0.0,0.0,1,0,1,1.0,0.0,1.0
9311218,0,0,0,0,0,0,0,6,,,,,,,,6,0,6,,,
105299,1,1,0,0,1,0,0,19,0.0,0.0,0.0,0.0,0.0,0.0,0.0,40,1,39,17.0,0.0,17.0
9905385,0,0,0,0,0,0,0,19,,,,,,,,7,0,7,1.0,0.0,1.0
9611392,0,0,0,0,0,0,0,1290,,,,,,,,4,0,4,1.0,0.0,1.0
210268,0,0,0,0,0,0,0,23,0.0,0.0,0.0,0.0,0.0,0.0,0.0,12,0,12,1.0,0.0,1.0
9301251,2,2,0,0,2,0,0,578,2.0,2.0,0.0,0.0,2.0,0.0,0.0,2,2,0,2.0,2.0,0.0
207369,1,1,0,0,0,1,5,84,0.0,0.0,0.0,0.0,0.0,0.0,0.0,24,1,23,4.0,1.0,3.0
302019,0,0,0,0,0,0,0,594,0.0,0.0,0.0,0.0,0.0,0.0,0.0,5,0,5,2.0,0.0,2.0
9309279,0,0,0,0,0,0,0,1589,0.0,0.0,0.0,0.0,0.0,0.0,0.0,3,0,3,,,
209279,0,0,0,0,0,0,0,4,0.0,0.0,0.0,0.0,0.0,0.0,0.0,28,0,28,6.0,0.0,6.0
302093,0,0,0,0,0,0,0,0,0.0,0.0,0.0,0.0,0.0,0.0,0.0,38,0,38,18.0,0.0,18.0
9411228,0,0,0,0,0,0,0,1119,,,,,,,,1,0,1,,,
9610483,0,0,0,0,0,0,0,132,0.0,0.0,0.0,0.0,0.0,0.0,0.0,4,0,4,2.0,0.0,2.0
112164,0,0,0,0,0,0,0,58,0.0,0.0,0.0,0.0,0.0,0.0,0.0,24,0,24,5.0,0.0,5.0
302069,0,0,0,0,0,0,0,38,0.0,0.0,0.0,0.0,0.0,0.0,0.0,37,0,37,27.0,0.0,27.0
211121,0,0,0,0,0,0,0,226,0.0,0.0,0.0,0.0,0.0,0.0,0.0,25,0,25,4.0,0.0,4.0
104079,0,0,0,0,0,0,0,1174,0.0,0.0,0.0,0.0,0.0,0.0,0.0,1,0,1,,,
205164,0,0,0,0,0,0,0,58,0.0,0.0,0.0,0.0,0.0,0.0,0.0,6,0,6,2.0,0.0,2.0
12093,0,0,0,0,0,0,0,50,0.0,0.0,0.0,0.0,0.0,0.0,0.0,8,0,8,1.0,0.0,1.0
9904263,0,0,0,0,0,0,0,220,0.0,0.0,0.0,0.0,0.0,0.0,0.0,2,0,2,1.0,0.0,1.0
111008,0,0,0,0,0,0,0,23,0.0,0.0,0.0,0.0,0.0,0.0,0.0,20,0,20,5.0,0.0,5.0
110100,0,0,0,0,0,0,0,65,0.0,0.0,0.0,0.0,0.0,0.0,0.0,7,0,7,1.0,0.0,1.0
9405328,0,0,0,0,0,0,0,98,,,,,,,,2,0,2,,,
9712264,0,0,0,0,0,0,0,217,0.0,0.0,0.0,0.0,0.0,0.0,0.0,8,0,8,1.0,0.0,1.0
103325,1,1,0,0,0,1,5,347,1.0,1.0,0.0,0.0,0.0,1.0,5.0,9,1,8,7.0,1.0,6.0
112363,0,0,0,0,0,0,0,159,0.0,0.0,0.0,0.0,0.0,0.0,0.0,1,0,1,1.0,0.0,1.0
212310,0,0,0,0,0,0,0,89,0.0,0.0,0.0,0.0,0.0,0.0,0.0,5,0,5,3.0,0.0,3.0
110264,0,0,0,0,0,0,0,322,0.0,0.0,0.0,0.0,0.0,0.0,0.0,4,0,4,2.0,0.0,2.0
9314,1,1,0,0,1,0,0,84,0.0,0.0,0.0,0.0,0.0,0.0,0.0,2,1,1,1.0,1.0,0.0
205178,0,0,0,0,0,0,0,95,0.0,0.0,0.0,0.0,0.0,0.0,0.0,11,0,11,10.0,0.0,10.0
9405210,0,0,0,0,0,0,0,1018,0.0,0.0,0.0,0.0,0.0,0.0,0.0,2,0,2,,,
9505223,0,0,0,0,0,0,0,93,0.0,0.0,0.0,0.0,0.0,0.0,0.0,5,0,5,1.0,0.0,1.0
104118,0,0,0,0,0,0,0,8,,,,,,,,4,0,4,,,
6058,0,0,0,0,0,0,0,408,0.0,0.0,0.0,0.0,0.0,0.0,0.0,1,0,1,1.0,0.0,1.0
9706360,0,0,0,0,0,0,0,355,0.0,0.0,0.0,0.0,0.0,0.0,0.0,2,0,2,,,
9409213,0,0,0,0,0,0,0,1282,,,,,,,,1,0,1,,,
9409331,0,0,0,0,0,0,0,207,0.0,0.0,0.0,0.0,0.0,0.0,0.0,3,0,3,,,
211203,0,0,0,0,0,0,0,188,0.0,0.0,0.0,0.0,0.0,0.0,0.0,9,0,9,5.0,0.0,5.0
9703323,0,0,0,0,0,0,0,292,0.0,0.0,0.0,0.0,0.0,0.0,0.0,1,0,1,1.0,0.0,1.0
209163,0,0,0,0,0,0,0,23,0.0,0.0,0.0,0.0,0.0,0.0,0.0,8,0,8,5.0,0.0,5.0
9612392,0,0,0,0,0,0,0,50,0.0,0.0,0.0,0.0,0.0,0.0,0.0,7,0,7,,,
5107,0,0,0,0,0,0,0,1791,,,,,,,,1,0,1,,,
9304215,1,1,0,0,1,0,0,358,1.0,1.0,0.0,0.0,1.0,0.0,0.0,1,1,0,1.0,1.0,0.0
7090,0,0,0,0,0,0,0,13,0.0,0.0,0.0,0.0,0.0,0.0,0.0,7,0,7,5.0,0.0,5.0
9308319,0,0,0,0,0,0,0,2103,,,,,,,,1,0,1,,,
209311,0,0,0,0,0,0,0,156,0.0,0.0,0.0,0.0,0.0,0.0,0.0,4,0,4,1.0,0.0,1.0
9405269,0,0,0,0,0,0,0,112,0.0,0.0,0.0,0.0,0.0,0.0,0.0,17,0,17,4.0,0.0,4.0
209362,0,0,0,0,0,0,0,9,0.0,0.0,0.0,0.0,0.0,0.0,0.0,13,0,13,3.0,0.0,3.0
9806362,0,0,0,0,0,0,0,781,0.0,0.0,0.0,0.0,0.0,0.0,0.0,2,0,2,2.0,0.0,2.0
207262,0,0,0,0,0,0,0,42,,,,,,,,3,0,3,,,
1139,0,0,0,0,0,0,0,16,0.0,0.0,0.0,0.0,0.0,0.0,0.0,6,0,6,6.0,0.0,6.0
9801275,0,0,0,0,0,0,0,25,0.0,0.0,0.0,0.0,0.0,0.0,0.0,7,0,7,7.0,0.0,7.0
9802339,0,0,0,0,0,0,0,1538,,,,,,,,1,0,1,,,
210136,0,0,0,0,0,0,0,473,0.0,0.0,0.0,0.0,0.0,0.0,0.0,3,0,3,1.0,0.0,1.0
210365,1,1,0,0,0,1,1,346,0.0,0.0,0.0,0.0,0.0,0.0,0.0,10,1,9,3.0,0.0,3.0
9306303,0,0,0,0,0,0,0,341,0.0,0.0,0.0,0.0,0.0,0.0,0.0,1,0,1,,,
9908452,0,0,0,0,0,0,0,222,0.0,0.0,0.0,0.0,0.0,0.0,0.0,5,0,5,3.0,0.0,3.0
302275,0,0,0,0,0,0,0,25,0.0,0.0,0.0,0.0,0.0,0.0,0.0,17,0,17,3.0,0.0,3.0
9501357,118,21,97,350,34,84,228,13,21.0,7.0,14.0,39.0,3.0,18.0,35.0,165,118,47,13.0,11.0,2.0
9711261,31,12,19,37,17,14,26,1,10.0,1.0,9.0,19.0,10.0,0.0,0.0,44,31,13,3.0,3.0,0.0
8004,30,1,29,133,6,24,79,1,16.0,1.0,15.0,48.0,4.0,12.0,14.0,49,30,19,18.0,17.0,1.0
9705292,123,26,97,517,46,77,221,1,23.0,4.0,19.0,119.0,23.0,0.0,0.0,162,123,39,10.0,9.0,1.0
9211256,136,45,91,549,136,0,0,75,42.0,7.0,35.0,189.0,42.0,0.0,0.0,136,136,0,32.0,32.0,0.0
9403407,22,5,17,48,1,21,161,6,14.0,4.0,10.0,31.0,0.0,14.0,120.0,50,22,28,23.0,9.0,14.0
9506201,43,4,39,188,2,41,144,6,27.0,2.0,25.0,116.0,3.0,24.0,79.0,59,43,16,15.0,14.0,1.0
9704376,117,35,82,345,8,109,1060,1,27.0,3.0,24.0,101.0,0.0,27.0,319.0,311,117,194,35.0,0.0,35.0
9912288,7,6,1,1,4,3,6,296,2.0,2.0,0.0,0.0,1.0,1.0,2.0,12,7,5,3.0,3.0,0.0
12197,13,3,10,20,1,12,86,1,7.0,1.0,6.0,10.0,2.0,5.0,11.0,39,13,26,10.0,4.0,6.0
9805422,167,24,143,499,39,128,335,7,19.0,8.0,11.0,25.0,0.0,19.0,84.0,187,167,20,18.0,10.0,8.0
106315,182,56,126,332,85,97,351,4,22.0,8.0,14.0,41.0,0.0,22.0,113.0,255,182,73,19.0,13.0,6.0
9409315,38,3,35,81,18,20,41,26,15.0,1.0,14.0,39.0,9.0,6.0,16.0,45,38,7,7.0,6.0,1.0
9603205,43,3,40,205,16,27,47,4,17.0,2.0,15.0,54.0,17.0,0.0,0.0,48,43,5,16.0,16.0,0.0
9511337,26,5,21,76,21,5,5,48,15.0,2.0,13.0,47.0,15.0,0.0,0.0,27,26,1,13.0,13.0,0.0
9801375,84,15,69,289,26,58,193,43,33.0,2.0,31.0,164.0,1.0,32.0,127.0,96,84,12,25.0,16.0,9.0
3294,6,3,3,4,1,5,9,33,5.0,3.0,2.0,3.0,0.0,5.0,8.0,11,6,5,3.0,3.0,0.0
9405277,53,11,42,230,47,6,8,33,25.0,3.0,22.0,125.0,25.0,0.0,0.0,56,53,3,20.0,20.0,0.0
9607466,14,5,9,17,0,14,29,61,5.0,3.0,2.0,3.0,5.0,0.0,0.0,22,14,8,6.0,4.0,2.0
9706206,41,7,34,152,4,37,191,43,27.0,4.0,23.0,117.0,1.0,26.0,127.0,58,41,17,26.0,15.0,11.0
9805373,110,8,102,925,16,94,198,32,67.0,3.0,64.0,657.0,8.0,59.0,107.0,122,110,12,53.0,49.0,4.0
9903282,386,103,283,866,161,225,676,43,22.0,2.0,20.0,43.0,2.0,20.0,66.0,419,386,33,20.0,12.0,8.0
204316,26,13,13,21,0,26,360,19,10.0,2.0,8.0,12.0,0.0,10.0,179.0,251,26,225,46.0,4.0,42.0
10260,12,4,8,14,1,11,76,2,5.0,1.0,4.0,6.0,0.0,5.0,5.0,31,12,19,12.0,7.0,5.0
9303201,19,7,12,25,19,0,0,170,8.0,5.0,3.0,4.0,8.0,0.0,0.0,19,19,0,4.0,4.0,0.0
9607213,32,4,28,80,4,28,123,26,23.0,2.0,21.0,64.0,0.0,23.0,116.0,38,32,6,19.0,14.0,5.0
9810506,2,2,0,0,0,2,6,35,1.0,1.0,0.0,0.0,0.0,1.0,5.0,12,2,10,3.0,0.0,3.0
9807406,6,3,3,3,0,6,11,364,4.0,2.0,2.0,2.0,0.0,4.0,8.0,11,6,5,6.0,3.0,3.0
9602264,14,4,10,32,1,13,48,35,9.0,1.0,8.0,25.0,0.0,9.0,18.0,28,14,14,8.0,5.0,3.0
1002,118,22,96,533,14,104,849,4,57.0,7.0,50.0,313.0,1.0,56.0,629.0,144,118,26,54.0,34.0,20.0
9711308,69,15,54,145,22,47,193,23,16.0,4.0,12.0,28.0,1.0,15.0,77.0,83,69,14,16.0,14.0,2.0
9512313,16,5,11,18,3,13,44,4,10.0,1.0,9.0,15.0,0.0,10.0,31.0,25,16,9,11.0,7.0,4.0
103090,18,10,8,15,3,15,80,86,2.0,2.0,0.0,0.0,0.0,2.0,5.0,104,18,86,13.0,0.0,13.0
201243,5,4,1,1,3,2,13,26,0.0,0.0,0.0,0.0,0.0,0.0,0.0,37,5,32,4.0,0.0,4.0
9606306,1,1,0,0,1,0,0,511,1.0,1.0,0.0,0.0,1.0,0.0,0.0,3,1,2,2.0,0.0,2.0
9507269,17,3,14,42,3,14,32,63,13.0,3.0,10.0,32.0,3.0,10.0,21.0,22,17,5,15.0,12.0,3.0
9403353,10,7,3,3,8,2,7,149,6.0,4.0,2.0,2.0,4.0,2.0,6.0,15,10,5,4.0,2.0,2.0
9309298,54,18,36,80,25,29,48,25,19.0,12.0,7.0,12.0,3.0,16.0,27.0,57,54,3,10.0,9.0,1.0
9410311,80,8,72,340,54,26,29,61,39.0,1.0,38.0,167.0,39.0,0.0,0.0,83,80,3,28.0,28.0,0.0
9508390,26,9,17,63,12,14,14,102,13.0,2.0,11.0,44.0,4.0,9.0,9.0,27,26,1,13.0,12.0,1.0
9502417,80,9,71,288,31,49,104,99,24.0,1.0,23.0,77.0,4.0,20.0,47.0,88,80,8,20.0,17.0,3.0
9409330,9,3,6,15,2,7,7,207,6.0,2.0,4.0,9.0,0.0,6.0,6.0,11,9,2,1.0,1.0,0.0
9310320,205,24,181,997,27,178,395,3,43.0,4.0,39.0,135.0,6.0,37.0,48.0,215,205,10,27.0,26.0,1.0
9310314,31,5,26,90,23,8,12,0,16.0,2.0,14.0,51.0,16.0,0.0,0.0,34,31,3,5.0,5.0,0.0
9512300,29,7,22,45,16,13,22,144,13.0,3.0,10.0,24.0,6.0,7.0,13.0,33,29,4,8.0,5.0,3.0
9706281,58,3,55,412,0,58,215,0,43.0,4.0,39.0,310.0,0.0,43.0,150.0,68,58,10,40.0,35.0,5.0
9808367,31,14,17,37,23,8,19,0,6.0,2.0,4.0,5.0,6.0,0.0,0.0,35,31,4,2.0,2.0,0.0
9607251,66,14,52,217,10,56,151,0,23.0,4.0,19.0,62.0,7.0,16.0,34.0,80,66,14,12.0,9.0,3.0
9403201,52,7,45,142,40,12,12,3,20.0,3.0,17.0,67.0,20.0,0.0,0.0,53,52,1,9.0,9.0,0.0
9909304,39,6,33,89,2,37,152,3,13.0,1.0,12.0,30.0,4.0,9.0,25.0,63,39,24,15.0,12.0,3.0
9807552,50,5,45,173,2,48,239,3,26.0,1.0,25.0,88.0,0.0,26.0,144.0,83,50,33,9.0,6.0,3.0
9905202,23,4,19,55,0,23,188,3,2.0,2.0,0.0,0.0,0.0,2.0,10.0,64,23,41,19.0,10.0,9.0
9706230,34,12,22,73,3,31,110,0,10.0,6.0,4.0,9.0,0.0,10.0,26.0,54,34,20,9.0,3.0,6.0
9612243,32,12,20,56,10,22,31,0,3.0,3.0,0.0,0.0,2.0,1.0,1.0,40,32,8,3.0,3.0,0.0
9809252,12,3,9,24,1,11,20,0,10.0,2.0,8.0,21.0,0.0,10.0,18.0,14,12,2,3.0,2.0,1.0
9808489,14,6,8,24,8,6,15,3,1.0,1.0,0.0,0.0,0.0,1.0,2.0,28,14,14,11.0,0.0,11.0
9805262,79,7,72,383,47,32,72,0,20.0,4.0,16.0,64.0,8.0,12.0,37.0,83,79,4,24.0,24.0,0.0
9603292,5,5,0,0,0,5,14,0,,,,,,,,12,5,7,2.0,0.0,2.0
9807468,2,2,0,0,2,0,0,486,0.0,0.0,0.0,0.0,0.0,0.0,0.0,3,2,1,1.0,0.0,1.0
9602307,33,7,26,85,16,17,62,0,11.0,3.0,8.0,18.0,11.0,0.0,0.0,44,33,11,8.0,8.0,0.0
9808327,31,7,24,55,10,21,42,0,9.0,4.0,5.0,11.0,1.0,8.0,13.0,43,31,12,10.0,8.0,2.0
9902392,26,6,20,78,1,25,342,3,22.0,4.0,18.0,69.0,0.0,22.0,312.0,78,26,52,40.0,6.0,34.0
9604445,47,9,38,120,14,33,88,87,17.0,2.0,15.0,50.0,4.0,13.0,34.0,67,47,20,16.0,12.0,4.0
9301220,3,2,1,1,3,0,0,81,,,,,,,,3,3,0,,,
9605214,86,33,53,154,49,37,51,11,12.0,5.0,7.0,21.0,8.0,4.0,4.0,108,86,22,8.0,7.0,1.0
9204225,102,21,81,318,102,0,0,10,21.0,4.0,17.0,56.0,21.0,0.0,0.0,102,102,0,11.0,11.0,0.0
9611293,36,7,29,78,5,31,220,3,14.0,7.0,7.0,15.0,1.0,13.0,84.0,64,36,28,20.0,8.0,12.0
9503312,7,5,2,2,7,0,0,310,1.0,1.0,0.0,0.0,1.0,0.0,0.0,9,7,2,1.0,1.0,0.0
9607281,14,5,9,15,4,10,20,63,2.0,2.0,0.0,0.0,2.0,0.0,0.0,23,14,9,1.0,0.0,1.0
9308277,36,18,18,30,32,4,4,10,9.0,5.0,4.0,5.0,9.0,0.0,0.0,38,36,2,3.0,3.0,0.0
9709395,103,19,84,304,13,90,302,12,26.0,5.0,21.0,42.0,4.0,22.0,121.0,119,103,16,24.0,12.0,12.0
9510461,23,8,15,27,20,3,3,99,12.0,3.0,9.0,19.0,9.0,3.0,3.0,24,23,1,3.0,3.0,0.0
9411203,83,23,60,179,59,24,41,61,14.0,1.0,13.0,32.0,14.0,0.0,0.0,93,83,10,9.0,5.0,4.0
9605325,27,8,19,55,9,18,91,81,13.0,5.0,8.0,16.0,1.0,12.0,69.0,57,27,30,9.0,8.0,1.0
9405245,26,2,24,69,15,11,23,12,2.0,2.0,0.0,0.0,0.0,2.0,7.0,40,26,14,3.0,3.0,0.0
9703332,28,5,23,108,2,26,160,36,22.0,3.0,19.0,89.0,0.0,22.0,146.0,37,28,9,27.0,20.0,7.0
9607383,138,10,128,713,37,101,203,5,32.0,2.0,30.0,167.0,32.0,0.0,0.0,150,138,12,33.0,31.0,2.0
111073,1,1,0,0,1,0,0,313,0.0,0.0,0.0,0.0,0.0,0.0,0.0,5,1,4,4.0,0.0,4.0
102159,13,7,6,9,2,11,80,1,1.0,1.0,0.0,0.0,0.0,1.0,8.0,88,13,75,13.0,1.0,12.0
9908296,15,1,14,28,1,14,49,48,5.0,2.0,3.0,5.0,0.0,5.0,17.0,26,15,11,11.0,6.0,5.0
11317,7,3,4,4,0,7,73,1,2.0,2.0,0.0,0.0,0.0,2.0,15.0,41,7,34,9.0,3.0,6.0
102147,98,4,94,916,11,87,256,23,66.0,2.0,64.0,669.0,4.0,62.0,161.0,112,98,14,44.0,40.0,4.0
7208,42,10,32,111,0,42,774,34,32.0,7.0,25.0,89.0,0.0,32.0,707.0,114,42,72,66.0,22.0,44.0
9707521,60,4,56,233,3,57,394,1,30.0,1.0,29.0,136.0,1.0,29.0,170.0,84,60,24,27.0,17.0,10.0
9205233,52,17,35,97,52,0,0,32,13.0,3.0,10.0,27.0,13.0,0.0,0.0,52,52,0,3.0,3.0,0.0
9609434,133,13,120,824,5,128,824,5,71.0,7.0,64.0,543.0,0.0,71.0,508.0,171,133,38,54.0,42.0,12.0
9704307,23,11,12,29,1,22,226,5,11.0,3.0,8.0,19.0,0.0,11.0,168.0,59,23,36,32.0,10.0,22.0
9501287,89,8,81,544,58,31,49,1,55.0,5.0,50.0,367.0,44.0,11.0,11.0,99,89,10,9.0,9.0,0.0
9301273,22,8,14,29,22,0,0,93,6.0,3.0,3.0,3.0,6.0,0.0,0.0,22,22,0,3.0,3.0,0.0
9602211,32,5,27,63,25,7,8,32,13.0,2.0,11.0,24.0,6.0,7.0,7.0,35,32,3,1.0,1.0,0.0
9307262,33,10,23,56,33,0,0,13,6.0,3.0,3.0,5.0,6.0,0.0,0.0,33,33,0,5.0,5.0,0.0
5275,46,8,38,189,4,42,216,6,22.0,1.0,21.0,131.0,22.0,0.0,0.0,91,46,45,21.0,21.0,0.0
9507284,70,6,64,279,6,64,488,6,37.0,3.0,34.0,177.0,0.0,37.0,347.0,98,70,28,20.0,18.0,2.0
9706441,16,4,12,31,1,15,60,1,10.0,4.0,6.0,22.0,2.0,8.0,21.0,34,16,18,3.0,0.0,3.0
2116,29,6,23,89,2,27,157,34,22.0,3.0,19.0,77.0,0.0,22.0,144.0,44,29,15,27.0,15.0,12.0
9802409,110,19,91,342,18,92,241,83,30.0,5.0,25.0,82.0,0.0,30.0,77.0,122,110,12,24.0,19.0,5.0
9307322,72,4,68,421,26,46,125,69,50.0,2.0,48.0,327.0,18.0,32.0,89.0,78,72,6,30.0,26.0,4.0
9911369,26,5,21,65,4,22,77,74,15.0,2.0,13.0,40.0,2.0,13.0,53.0,42,26,16,24.0,13.0,11.0
9712531,12,2,10,31,0,12,82,1,11.0,2.0,9.0,27.0,0.0,11.0,72.0,23,12,11,2.0,2.0,0.0
9406428,24,6,18,90,4,20,29,86,18.0,2.0,16.0,76.0,3.0,15.0,15.0,28,24,4,16.0,15.0,1.0
9607297,16,3,13,25,2,14,15,31,9.0,1.0,8.0,18.0,9.0,0.0,0.0,20,16,4,8.0,8.0,0.0
9212206,43,8,35,124,43,0,0,187,9.0,3.0,6.0,20.0,9.0,0.0,0.0,43,43,0,7.0,7.0,0.0
9612480,47,5,42,130,2,45,162,7,18.0,3.0,15.0,39.0,0.0,18.0,65.0,65,47,18,19.0,12.0,7.0
9502374,5,5,0,0,1,4,11,179,3.0,3.0,0.0,0.0,2.0,1.0,1.0,14,5,9,2.0,1.0,1.0
9609503,15,3,12,20,2,13,37,7,4.0,2.0,2.0,4.0,1.0,3.0,15.0,33,15,18,9.0,3.0,6.0
9811353,102,4,98,617,19,83,238,2,53.0,2.0,51.0,404.0,0.0,53.0,178.0,112,102,10,31.0,26.0,5.0
9603307,37,9,28,184,4,33,159,12,27.0,3.0,24.0,161.0,5.0,22.0,32.0,93,37,56,15.0,1.0,14.0
9512360,1,1,0,0,0,1,1,60,0.0,0.0,0.0,0.0,0.0,0.0,0.0,10,1,9,2.0,0.0,2.0
9707409,124,2,122,1236,71,53,71,32,79.0,1.0,78.0,900.0,39.0,40.0,55.0,126,124,2,54.0,52.0,2.0
9806512,4,2,2,2,1,3,9,76,2.0,2.0,0.0,0.0,0.0,2.0,6.0,10,4,6,2.0,2.0,0.0
9706484,10,5,5,6,3,7,17,6,3.0,1.0,2.0,3.0,0.0,3.0,3.0,21,10,11,4.0,3.0,1.0
9512336,206,22,184,1267,52,154,731,8,91.0,4.0,87.0,747.0,5.0,86.0,486.0,224,206,18,52.0,44.0,8.0
9508237,26,8,18,37,22,4,9,5,1.0,1.0,0.0,0.0,0.0,1.0,2.0,36,26,10,5.0,5.0,0.0
9707467,17,4,13,22,7,10,36,62,6.0,2.0,4.0,6.0,5.0,1.0,2.0,31,17,14,3.0,2.0,1.0
9310208,28,10,18,42,28,0,0,24,8.0,2.0,6.0,11.0,8.0,0.0,0.0,28,28,0,4.0,4.0,0.0
9206242,140,17,123,987,140,0,0,56,93.0,7.0,86.0,720.0,93.0,0.0,0.0,140,140,0,43.0,43.0,0.0
9702201,35,8,27,85,20,15,29,11,12.0,3.0,9.0,15.0,6.0,6.0,6.0,44,35,9,7.0,6.0,1.0
9602284,13,9,4,4,0,13,25,16,5.0,5.0,0.0,0.0,4.0,1.0,1.0,24,13,11,4.0,4.0,0.0
9610450,12,7,5,6,7,5,9,16,3.0,2.0,1.0,1.0,1.0,2.0,5.0,15,12,3,5.0,2.0,3.0
9709454,6,6,0,0,0,6,16,30,2.0,2.0,0.0,0.0,0.0,2.0,5.0,18,6,12,5.0,2.0,3.0
9911516,15,4,11,30,0,15,50,108,13.0,3.0,10.0,29.0,0.0,13.0,42.0,23,15,8,17.0,11.0,6.0
9410258,23,5,18,79,12,11,13,151,17.0,1.0,16.0,74.0,6.0,11.0,11.0,25,23,2,17.0,16.0,1.0
9703360,8,4,4,10,1,7,25,151,6.0,3.0,3.0,7.0,0.0,6.0,17.0,17,8,9,10.0,6.0,4.0
9206246,42,8,34,144,42,0,0,4,10.0,1.0,9.0,22.0,10.0,0.0,0.0,42,42,0,8.0,8.0,0.0
9308353,6,3,3,3,6,0,0,86,3.0,2.0,1.0,1.0,3.0,0.0,0.0,6,6,0,1.0,1.0,0.0
9802426,20,9,11,29,6,14,32,59,14.0,6.0,8.0,26.0,0.0,14.0,32.0,25,20,5,14.0,11.0,3.0
9804215,24,9,15,30,3,21,115,6,9.0,4.0,5.0,11.0,0.0,9.0,64.0,39,24,15,11.0,3.0,8.0
9406236,16,6,10,14,9,7,10,29,3.0,1.0,2.0,3.0,3.0,0.0,0.0,18,16,2,3.0,3.0,0.0
9812252,29,16,13,16,5,24,102,8,3.0,3.0,0.0,0.0,0.0,3.0,32.0,137,29,108,27.0,1.0,26.0
9603287,8,3,5,8,0,8,11,85,7.0,3.0,4.0,7.0,0.0,7.0,8.0,14,8,6,6.0,5.0,1.0
9312257,15,9,6,8,2,13,13,6,2.0,2.0,0.0,0.0,2.0,0.0,0.0,17,15,2,6.0,6.0,0.0
9511216,6,4,2,3,0,6,19,96,6.0,4.0,2.0,3.0,0.0,6.0,19.0,12,6,6,10.0,4.0,6.0
9603366,90,22,68,219,14,76,125,14,40.0,9.0,31.0,92.0,7.0,33.0,53.0,96,90,6,9.0,8.0,1.0
9609423,22,9,13,24,13,9,9,157,11.0,2.0,9.0,17.0,7.0,4.0,4.0,23,22,1,6.0,6.0,0.0
9409434,48,5,43,183,33,15,18,38,18.0,1.0,17.0,71.0,18.0,0.0,0.0,51,48,3,14.0,14.0,0.0
9808344,10,5,5,9,1,9,60,22,5.0,4.0,1.0,1.0,0.0,5.0,26.0,24,10,14,11.0,4.0,7.0
9804357,18,7,11,19,3,15,53,45,9.0,3.0,6.0,8.0,0.0,9.0,33.0,28,18,10,12.0,6.0,6.0
9407313,7,2,5,9,7,0,0,38,1.0,1.0,0.0,0.0,1.0,0.0,0.0,7,7,0,1.0,1.0,0.0
7159,23,8,15,39,0,23,242,38,19.0,6.0,13.0,34.0,0.0,19.0,223.0,45,23,22,35.0,17.0,18.0
9612347,34,20,14,17,8,26,62,38,2.0,2.0,0.0,0.0,0.0,2.0,5.0,78,34,44,4.0,2.0,2.0
10234,7,1,6,7,0,7,63,38,7.0,1.0,6.0,7.0,0.0,7.0,63.0,19,7,12,17.0,7.0,10.0
9603290,20,5,15,46,6,14,31,88,13.0,2.0,11.0,32.0,4.0,9.0,17.0,30,20,10,12.0,10.0,2.0
9903292,47,12,35,84,9,38,102,20,7.0,1.0,6.0,11.0,3.0,4.0,4.0,54,47,7,14.0,11.0,3.0
9804425,36,4,32,79,2,34,163,21,23.0,2.0,21.0,54.0,0.0,23.0,135.0,47,36,11,24.0,13.0,11.0
9705347,72,9,63,359,2,70,254,21,57.0,5.0,52.0,324.0,0.0,57.0,221.0,80,72,8,38.0,30.0,8.0
9611213,43,8,35,129,14,29,60,66,16.0,2.0,14.0,44.0,5.0,11.0,12.0,54,43,11,11.0,10.0,1.0
9609400,22,7,15,37,18,4,4,66,6.0,3.0,3.0,5.0,6.0,0.0,0.0,24,22,2,4.0,3.0,1.0
9809480,60,20,40,95,34,26,30,66,7.0,1.0,6.0,17.0,7.0,0.0,0.0,64,60,4,4.0,3.0,1.0
9906280,13,6,7,13,0,13,50,135,4.0,2.0,2.0,3.0,0.0,4.0,11.0,28,13,15,5.0,4.0,1.0
9507428,6,2,4,6,6,0,0,140,4.0,1.0,3.0,5.0,4.0,0.0,0.0,6,6,0,4.0,4.0,0.0
9709429,10,8,2,3,10,0,0,8,0.0,0.0,0.0,0.0,0.0,0.0,0.0,22,10,12,2.0,0.0,2.0
9703420,79,9,70,318,4,75,225,54,47.0,2.0,45.0,200.0,2.0,45.0,117.0,92,79,13,26.0,21.0,5.0
108185,4,4,0,0,0,4,15,20,1.0,1.0,0.0,0.0,0.0,1.0,4.0,30,4,26,12.0,1.0,11.0
9209248,57,5,52,164,57,0,0,29,10.0,1.0,9.0,30.0,10.0,0.0,0.0,57,57,0,12.0,12.0,0.0
9212205,3,1,2,3,3,0,0,29,0.0,0.0,0.0,0.0,0.0,0.0,0.0,4,3,1,,,
9406386,91,9,82,682,32,59,86,17,71.0,4.0,67.0,601.0,24.0,47.0,69.0,93,91,2,47.0,46.0,1.0
9807219,18,10,8,17,1,17,46,20,5.0,4.0,1.0,2.0,3.0,2.0,2.0,24,18,6,3.0,2.0,1.0
9905521,6,2,4,9,0,6,41,20,5.0,1.0,4.0,9.0,0.0,5.0,40.0,15,6,9,2.0,1.0,1.0
103269,4,2,2,2,1,3,25,20,3.0,1.0,2.0,2.0,0.0,3.0,25.0,16,4,12,1.0,1.0,0.0
110107,1,1,0,0,0,1,8,20,1.0,1.0,0.0,0.0,0.0,1.0,8.0,27,1,26,24.0,0.0,24.0
9412309,20,5,15,35,14,6,15,26,5.0,1.0,4.0,6.0,5.0,0.0,0.0,28,20,8,3.0,2.0,1.0
9211296,9,6,3,3,9,0,0,515,3.0,3.0,0.0,0.0,3.0,0.0,0.0,9,9,0,3.0,3.0,0.0
9304319,36,11,25,69,30,6,6,85,11.0,4.0,7.0,17.0,11.0,0.0,0.0,37,36,1,9.0,9.0,0.0
9810442,205,15,190,1287,49,156,424,5,52.0,3.0,49.0,439.0,34.0,18.0,32.0,229,205,24,36.0,36.0,0.0
9403386,15,8,7,10,11,4,7,25,1.0,1.0,0.0,0.0,0.0,1.0,1.0,19,15,4,1.0,1.0,0.0
9804236,4,3,1,1,0,4,14,60,1.0,1.0,0.0,0.0,0.0,1.0,1.0,17,4,13,2.0,1.0,1.0
9803290,46,4,42,201,1,45,238,10,15.0,1.0,14.0,42.0,0.0,15.0,69.0,76,46,30,20.0,13.0,7.0
9707423,45,1,44,311,18,27,38,73,45.0,1.0,44.0,311.0,18.0,27.0,38.0,48,45,3,33.0,31.0,2.0
9705361,19,4,15,67,4,15,17,73,15.0,1.0,14.0,63.0,2.0,13.0,13.0,23,19,4,15.0,14.0,1.0
9709502,18,5,13,37,2,16,64,42,9.0,3.0,6.0,14.0,0.0,9.0,36.0,39,18,21,7.0,5.0,2.0
9506235,5,3,2,2,1,4,4,179,0.0,0.0,0.0,0.0,0.0,0.0,0.0,8,5,3,2.0,0.0,2.0
9311248,45,17,28,106,29,16,26,5,16.0,5.0,11.0,29.0,8.0,8.0,8.0,48,45,3,6.0,5.0,1.0
9403307,43,14,29,102,13,30,104,5,15.0,5.0,10.0,29.0,7.0,8.0,8.0,52,43,9,14.0,13.0,1.0
9504382,4,2,2,3,1,3,6,71,1.0,1.0,0.0,0.0,1.0,0.0,0.0,6,4,2,1.0,1.0,0.0
9601278,11,5,6,10,4,7,33,135,3.0,1.0,2.0,2.0,0.0,3.0,18.0,25,11,14,11.0,3.0,8.0
9511292,53,4,49,259,26,27,96,4,26.0,1.0,25.0,143.0,26.0,0.0,0.0,82,53,29,13.0,6.0,7.0
9903357,10,5,5,10,8,2,2,435,3.0,2.0,1.0,2.0,1.0,2.0,2.0,11,10,1,4.0,3.0,1.0
9906381,26,6,20,78,3,23,63,0,16.0,3.0,13.0,48.0,2.0,14.0,33.0,38,26,12,17.0,15.0,2.0
9710531,32,8,24,82,6,26,59,11,18.0,2.0,16.0,56.0,6.0,12.0,12.0,51,32,19,5.0,5.0,0.0
9806311,26,7,19,60,3,23,25,283,18.0,5.0,13.0,41.0,0.0,18.0,18.0,28,26,2,13.0,12.0,1.0
9404226,13,9,4,4,7,6,13,10,1.0,1.0,0.0,0.0,1.0,0.0,0.0,17,13,4,2.0,2.0,0.0
9604260,15,4,11,21,0,15,74,41,11.0,2.0,9.0,19.0,0.0,11.0,36.0,35,15,20,10.0,7.0,3.0
9303299,17,7,10,29,7,10,10,41,9.0,6.0,3.0,6.0,3.0,6.0,6.0,18,17,1,10.0,9.0,1.0
9805447,10,1,9,17,0,10,45,41,8.0,1.0,7.0,14.0,0.0,8.0,29.0,26,10,16,12.0,2.0,10.0
9904461,6,3,3,3,2,4,6,59,4.0,1.0,3.0,3.0,4.0,0.0,0.0,16,6,10,3.0,2.0,1.0
9408242,32,2,30,124,0,32,100,49,25.0,2.0,23.0,92.0,3.0,22.0,41.0,39,32,7,15.0,13.0,2.0
9510238,10,3,7,24,1,9,41,49,8.0,1.0,7.0,23.0,0.0,8.0,23.0,16,10,6,9.0,8.0,1.0
9705402,3,1,2,3,0,3,21,6,0.0,0.0,0.0,0.0,0.0,0.0,0.0,19,3,16,2.0,0.0,2.0
3320,17,4,13,39,2,15,38,23,5.0,1.0,4.0,6.0,0.0,5.0,10.0,25,17,8,9.0,8.0,1.0
201149,3,3,0,0,1,2,6,93,3.0,3.0,0.0,0.0,1.0,2.0,4.0,8,3,5,4.0,1.0,3.0
9507290,10,6,4,7,5,5,11,74,2.0,2.0,0.0,0.0,2.0,0.0,0.0,20,10,10,2.0,2.0,0.0
9411397,22,5,17,41,1,21,66,60,11.0,5.0,6.0,20.0,1.0,10.0,26.0,32,22,10,10.0,7.0,3.0
9609307,15,4,11,26,0,15,57,55,10.0,1.0,9.0,16.0,0.0,10.0,42.0,23,15,8,5.0,3.0,2.0
9901209,101,5,96,935,0,101,966,2,79.0,2.0,77.0,843.0,0.0,79.0,827.0,125,101,24,63.0,49.0,14.0
9707401,22,7,15,25,2,20,61,10,7.0,3.0,4.0,5.0,7.0,0.0,0.0,35,22,13,7.0,6.0,1.0
9708446,23,2,21,53,3,20,87,55,17.0,2.0,15.0,36.0,0.0,17.0,71.0,31,23,8,17.0,12.0,5.0
9907559,36,13,23,77,2,34,276,46,19.0,4.0,15.0,42.0,0.0,19.0,144.0,67,36,31,16.0,9.0,7.0
9607276,7,1,6,9,0,7,8,170,4.0,1.0,3.0,4.0,0.0,4.0,4.0,9,7,2,5.0,4.0,1.0
9703234,3,2,1,1,0,3,34,124,2.0,1.0,1.0,1.0,0.0,2.0,31.0,25,3,22,19.0,2.0,17.0
11359,21,2,19,69,0,21,146,18,11.0,1.0,10.0,27.0,0.0,11.0,63.0,54,21,33,14.0,7.0,7.0
9909497,21,4,17,66,0,21,132,18,15.0,1.0,14.0,41.0,0.0,15.0,90.0,61,21,40,11.0,0.0,11.0
9409254,116,20,96,431,110,6,6,27,41.0,10.0,31.0,109.0,41.0,0.0,0.0,117,116,1,18.0,18.0,0.0
9910275,22,10,12,20,2,20,169,5,1.0,1.0,0.0,0.0,0.0,1.0,5.0,110,22,88,11.0,5.0,6.0
9909228,33,8,25,116,2,31,113,18,23.0,4.0,19.0,93.0,0.0,23.0,88.0,63,33,30,23.0,15.0,8.0
9912443,6,3,3,6,6,0,0,13,0.0,0.0,0.0,0.0,0.0,0.0,0.0,15,6,9,2.0,1.0,1.0
9705479,25,15,10,12,14,11,20,5,0.0,0.0,0.0,0.0,0.0,0.0,0.0,59,25,34,8.0,0.0,8.0
9208215,21,13,8,16,21,0,0,15,5.0,2.0,3.0,4.0,5.0,0.0,0.0,21,21,0,3.0,3.0,0.0
9910465,27,3,24,66,0,27,77,32,17.0,2.0,15.0,35.0,0.0,17.0,50.0,36,27,9,4.0,3.0,1.0
9904367,11,3,8,23,2,9,41,158,7.0,1.0,6.0,20.0,1.0,6.0,31.0,26,11,15,15.0,7.0,8.0
106264,113,24,89,399,2,111,287,0,35.0,4.0,31.0,123.0,0.0,35.0,130.0,137,113,24,19.0,17.0,2.0
11054,56,14,42,174,4,52,168,0,19.0,5.0,14.0,54.0,3.0,16.0,67.0,76,56,20,5.0,5.0,0.0
9408300,10,4,6,7,10,0,0,132,4.0,4.0,0.0,0.0,4.0,0.0,0.0,11,10,1,3.0,2.0,1.0
9404220,25,9,16,49,20,5,8,94,14.0,2.0,12.0,39.0,11.0,3.0,5.0,28,25,3,11.0,9.0,2.0
9909456,70,9,61,196,12,58,176,11,19.0,5.0,14.0,41.0,0.0,19.0,69.0,81,70,11,12.0,12.0,0.0
9602296,4,2,2,3,4,0,0,118,3.0,1.0,2.0,3.0,3.0,0.0,0.0,4,4,0,1.0,1.0,0.0
9506452,103,8,95,710,9,94,494,8,64.0,3.0,61.0,516.0,1.0,63.0,291.0,121,103,18,42.0,36.0,6.0
9801304,15,4,11,15,0,15,63,16,12.0,3.0,9.0,12.0,0.0,12.0,42.0,31,15,16,15.0,10.0,5.0
9909271,8,3,5,8,1,7,21,43,3.0,3.0,0.0,0.0,0.0,3.0,9.0,11,8,3,6.0,3.0,3.0
9711328,10,5,5,11,0,10,69,4,7.0,2.0,5.0,9.0,0.0,7.0,38.0,48,10,38,15.0,7.0,8.0
9606310,40,7,33,104,0,40,198,94,22.0,2.0,20.0,78.0,0.0,22.0,124.0,67,40,27,28.0,19.0,9.0
9811373,5,2,3,3,0,5,44,114,4.0,2.0,2.0,2.0,0.0,4.0,28.0,18,5,13,14.0,3.0,11.0
9706518,8,3,5,9,1,7,8,129,4.0,2.0,2.0,3.0,0.0,4.0,4.0,11,8,3,2.0,2.0,0.0
103330,3,2,1,1,2,1,4,44,0.0,0.0,0.0,0.0,0.0,0.0,0.0,8,3,5,1.0,0.0,1.0
9505410,21,4,17,45,3,18,32,39,10.0,1.0,9.0,21.0,2.0,8.0,12.0,25,21,4,11.0,8.0,3.0
9901299,68,6,62,368,3,65,334,2,39.0,1.0,38.0,225.0,39.0,0.0,0.0,82,68,14,33.0,31.0,2.0
9905474,97,16,81,376,0,97,832,2,48.0,8.0,40.0,139.0,0.0,48.0,540.0,115,97,18,27.0,13.0,14.0
9909240,4,1,3,4,0,4,28,2,4.0,1.0,3.0,4.0,0.0,4.0,28.0,16,4,12,3.0,2.0,1.0
9504355,11,6,5,7,6,5,5,138,7.0,4.0,3.0,4.0,2.0,5.0,5.0,12,11,1,5.0,4.0,1.0
9605302,28,12,16,37,4,24,77,11,14.0,7.0,7.0,12.0,0.0,14.0,43.0,34,28,6,9.0,6.0,3.0
3261,49,4,45,423,0,49,248,19,40.0,2.0,38.0,388.0,0.0,40.0,219.0,58,49,9,44.0,37.0,7.0
9809213,6,2,4,7,3,3,8,210,1.0,1.0,0.0,0.0,0.0,1.0,2.0,11,6,5,5.0,3.0,2.0
204023,2,1,1,1,0,2,13,19,0.0,0.0,0.0,0.0,0.0,0.0,0.0,26,2,24,4.0,0.0,4.0
12058,20,1,19,47,6,14,27,43,10.0,1.0,9.0,11.0,5.0,5.0,7.0,25,20,5,8.0,8.0,0.0
202271,6,3,3,6,0,6,115,19,6.0,3.0,3.0,6.0,0.0,6.0,112.0,53,6,47,27.0,5.0,22.0
9901277,25,11,14,28,1,24,121,19,3.0,3.0,0.0,0.0,0.0,3.0,20.0,44,25,19,23.0,5.0,18.0
203154,13,1,12,36,0,13,182,28,13.0,1.0,12.0,36.0,0.0,13.0,152.0,33,13,20,26.0,13.0,13.0
8153,2,1,1,1,0,2,7,28,,,,,,,,8,2,6,3.0,1.0,2.0
9908299,22,2,20,62,0,22,173,2,16.0,1.0,15.0,33.0,0.0,16.0,125.0,43,22,21,6.0,6.0,0.0
9706410,34,3,31,164,0,34,203,9,27.0,2.0,25.0,138.0,0.0,27.0,160.0,44,34,10,31.0,22.0,9.0
9511417,29,3,26,68,25,4,5,91,14.0,1.0,13.0,31.0,14.0,0.0,0.0,33,29,4,7.0,7.0,0.0
9611368,13,7,6,17,6,7,8,288,4.0,2.0,2.0,2.0,0.0,4.0,5.0,15,13,2,5.0,3.0,2.0
9062,16,10,6,6,2,14,39,2,4.0,2.0,2.0,2.0,0.0,4.0,8.0,27,16,11,7.0,3.0,4.0
106336,23,6,17,60,0,23,186,2,10.0,4.0,6.0,7.0,0.0,10.0,100.0,57,23,34,15.0,11.0,4.0
5105,5,2,3,5,0,5,77,21,4.0,1.0,3.0,5.0,0.0,4.0,72.0,47,5,42,35.0,4.0,31.0
9510342,42,3,39,118,22,20,26,5,13.0,1.0,12.0,38.0,13.0,0.0,0.0,47,42,5,15.0,15.0,0.0
107133,5,3,2,2,0,5,45,12,1.0,1.0,0.0,0.0,0.0,1.0,13.0,43,5,38,6.0,3.0,3.0
9612458,9,3,6,7,1,8,24,90,6.0,1.0,5.0,6.0,0.0,6.0,19.0,16,9,7,5.0,3.0,2.0
9405380,14,6,8,22,14,0,0,30,8.0,1.0,7.0,16.0,8.0,0.0,0.0,15,14,1,6.0,6.0,0.0
4083,10,1,9,16,3,7,31,28,10.0,1.0,9.0,16.0,3.0,7.0,27.0,21,10,11,13.0,5.0,8.0
9505253,3,3,0,0,2,1,1,99,,,,,,,,9,3,6,2.0,0.0,2.0
9309214,16,7,9,13,7,9,13,164,1.0,1.0,0.0,0.0,0.0,1.0,1.0,21,16,5,2.0,1.0,1.0
4249,5,3,2,2,0,5,10,107,1.0,1.0,0.0,0.0,1.0,0.0,0.0,8,5,3,1.0,1.0,0.0
9705282,18,10,8,14,1,17,75,4,7.0,2.0,5.0,10.0,2.0,5.0,17.0,57,18,39,8.0,3.0,5.0
9907213,5,5,0,0,3,2,4,48,1.0,1.0,0.0,0.0,1.0,0.0,0.0,18,5,13,2.0,1.0,1.0
205134,9,3,6,10,0,9,24,1,0.0,0.0,0.0,0.0,0.0,0.0,0.0,18,9,9,1.0,0.0,1.0
4262,18,5,13,27,1,17,168,7,6.0,2.0,4.0,7.0,0.0,6.0,47.0,69,18,51,16.0,4.0,12.0
12222,15,5,10,20,0,15,54,301,8.0,3.0,5.0,11.0,0.0,8.0,24.0,25,15,10,14.0,9.0,5.0
9804412,11,3,8,13,2,9,13,58,4.0,1.0,3.0,3.0,1.0,3.0,3.0,13,11,2,1.0,1.0,0.0
1321,7,3,4,5,3,4,8,1,0.0,0.0,0.0,0.0,0.0,0.0,0.0,18,7,11,3.0,0.0,3.0
9710228,11,6,5,9,11,0,0,79,4.0,1.0,3.0,5.0,4.0,0.0,0.0,11,11,0,3.0,3.0,0.0
9305283,10,5,5,8,10,0,0,68,6.0,5.0,1.0,3.0,6.0,0.0,0.0,10,10,0,6.0,6.0,0.0
9801233,17,7,10,21,1,16,74,9,9.0,4.0,5.0,9.0,0.0,9.0,46.0,29,17,12,2.0,2.0,0.0
9803364,12,5,7,16,3,9,30,11,5.0,2.0,3.0,6.0,1.0,4.0,8.0,21,12,9,9.0,5.0,4.0
9503465,21,10,11,20,11,10,23,17,6.0,3.0,3.0,5.0,6.0,0.0,0.0,32,21,11,5.0,5.0,0.0
9301204,14,6,8,20,14,0,0,17,4.0,2.0,2.0,3.0,4.0,0.0,0.0,14,14,0,3.0,3.0,0.0
9603247,36,6,30,132,4,32,84,48,21.0,1.0,20.0,89.0,1.0,20.0,34.0,46,36,10,21.0,19.0,2.0
9605393,3,2,1,1,3,0,0,320,1.0,1.0,0.0,0.0,1.0,0.0,0.0,6,3,3,1.0,1.0,0.0
9905406,14,4,10,20,0,14,34,56,10.0,3.0,7.0,14.0,0.0,10.0,29.0,22,14,8,6.0,5.0,1.0
106158,1,1,0,0,0,1,1,425,0.0,0.0,0.0,0.0,0.0,0.0,0.0,9,1,8,3.0,0.0,3.0
9509324,23,2,21,66,22,1,1,154,17.0,2.0,15.0,41.0,17.0,0.0,0.0,24,23,1,12.0,12.0,0.0
9609247,13,3,10,15,6,7,19,13,7.0,2.0,5.0,8.0,4.0,3.0,5.0,20,13,7,9.0,7.0,2.0
9206214,35,13,22,141,35,0,0,15,23.0,5.0,18.0,121.0,23.0,0.0,0.0,35,35,0,10.0,10.0,0.0
10253,10,3,7,14,0,10,166,4,6.0,2.0,4.0,8.0,0.0,6.0,107.0,62,10,52,29.0,6.0,23.0
12116,11,5,6,17,1,10,64,29,9.0,3.0,6.0,17.0,0.0,9.0,52.0,33,11,22,17.0,9.0,8.0
9712498,1,1,0,0,0,1,2,1,0.0,0.0,0.0,0.0,0.0,0.0,0.0,9,1,8,3.0,0.0,3.0
9408235,2,1,1,1,2,0,0,1634,0.0,0.0,0.0,0.0,0.0,0.0,0.0,5,2,3,1.0,0.0,1.0
9502380,0,0,0,0,0,0,0,492,0.0,0.0,0.0,0.0,0.0,0.0,0.0,7,0,7,1.0,0.0,1.0
9805288,17,9,8,15,5,12,19,28,6.0,2.0,4.0,5.0,2.0,4.0,6.0,23,17,6,8.0,6.0,2.0
9604295,31,4,27,155,8,23,32,54,24.0,3.0,21.0,134.0,4.0,20.0,20.0,34,31,3,23.0,22.0,1.0
9706229,24,9,15,37,3,21,72,14,7.0,3.0,4.0,9.0,0.0,7.0,28.0,36,24,12,4.0,4.0,0.0
9912371,2,2,0,0,0,2,6,45,0.0,0.0,0.0,0.0,0.0,0.0,0.0,11,2,9,2.0,0.0,2.0
9910238,53,6,47,283,0,53,601,24,48.0,6.0,42.0,258.0,0.0,48.0,527.0,84,53,31,38.0,21.0,17.0
7197,20,5,15,47,0,20,229,24,20.0,5.0,15.0,47.0,0.0,20.0,212.0,46,20,26,26.0,11.0,15.0
9710529,45,14,31,58,16,29,30,64,17.0,8.0,9.0,17.0,5.0,12.0,13.0,49,45,4,7.0,6.0,1.0
9702274,53,13,40,102,46,7,8,64,27.0,5.0,22.0,59.0,22.0,5.0,5.0,59,53,6,9.0,9.0,0.0
5128,1,1,0,0,0,1,1,214,1.0,1.0,0.0,0.0,0.0,1.0,1.0,2,1,1,1.0,1.0,0.0
6287,2,2,0,0,0,2,4,138,0.0,0.0,0.0,0.0,0.0,0.0,0.0,15,2,13,3.0,0.0,3.0
9911286,18,6,12,22,2,16,40,286,7.0,5.0,2.0,3.0,1.0,6.0,6.0,28,18,10,7.0,5.0,2.0
9407204,41,8,33,121,16,25,39,14,13.0,4.0,9.0,19.0,13.0,0.0,0.0,46,41,5,5.0,5.0,0.0
9604264,20,5,15,28,7,13,41,14,5.0,3.0,2.0,3.0,4.0,1.0,1.0,31,20,11,3.0,1.0,2.0
9507434,17,4,13,36,5,12,22,41,8.0,2.0,6.0,11.0,8.0,0.0,0.0,23,17,6,4.0,3.0,1.0
9901442,51,6,45,143,1,50,196,27,37.0,5.0,32.0,110.0,0.0,37.0,153.0,68,51,17,18.0,14.0,4.0
9810453,10,5,5,10,0,10,26,73,9.0,4.0,5.0,10.0,0.0,9.0,24.0,17,10,7,3.0,1.0,2.0
9401206,72,20,52,284,31,41,80,13,32.0,5.0,27.0,175.0,15.0,17.0,23.0,80,72,8,24.0,23.0,1.0
9804370,1,1,0,0,0,1,3,76,1.0,1.0,0.0,0.0,0.0,1.0,3.0,4,1,3,4.0,1.0,3.0
9805475,2,2,0,0,0,2,2,118,2.0,2.0,0.0,0.0,0.0,2.0,2.0,4,2,2,1.0,0.0,1.0
9707254,23,2,21,95,0,23,204,9,20.0,1.0,19.0,87.0,0.0,20.0,185.0,40,23,17,33.0,18.0,15.0
9607325,1,1,0,0,1,0,0,1141,,,,,,,,1,1,0,,,
9312315,32,11,21,58,32,0,0,7,17.0,5.0,12.0,35.0,17.0,0.0,0.0,32,32,0,11.0,11.0,0.0
9511375,7,4,3,3,2,5,23,16,4.0,3.0,1.0,1.0,0.0,4.0,10.0,17,7,10,2.0,2.0,0.0
9511434,30,13,17,34,7,23,52,105,12.0,4.0,8.0,15.0,1.0,11.0,19.0,40,30,10,12.0,8.0,4.0
9705297,1,1,0,0,1,0,0,194,0.0,0.0,0.0,0.0,0.0,0.0,0.0,4,1,3,3.0,0.0,3.0
9709236,4,3,1,1,0,4,23,194,2.0,2.0,0.0,0.0,0.0,2.0,4.0,13,4,9,6.0,3.0,3.0
9609417,3,1,2,2,1,2,2,13,,,,,,,,4,3,1,,,
9610355,5,3,2,4,0,5,15,18,2.0,1.0,1.0,1.0,2.0,0.0,0.0,12,5,7,,,
9503450,2,2,0,0,2,0,0,1894,,,,,,,,2,2,0,1.0,1.0,0.0
9711392,17,10,7,12,4,13,42,97,8.0,4.0,4.0,6.0,0.0,8.0,30.0,28,17,11,16.0,8.0,8.0
9311219,9,2,7,14,5,4,4,108,6.0,1.0,5.0,10.0,3.0,3.0,3.0,13,9,4,2.0,0.0,2.0
9502387,3,2,1,1,1,2,5,90,0.0,0.0,0.0,0.0,0.0,0.0,0.0,17,3,14,2.0,0.0,2.0
9608273,4,4,0,0,1,3,6,10,1.0,1.0,0.0,0.0,0.0,1.0,2.0,17,4,13,,,
104246,5,3,2,2,1,4,19,16,1.0,1.0,0.0,0.0,0.0,1.0,10.0,23,5,18,12.0,1.0,11.0
9301259,55,10,45,278,55,0,0,33,37.0,3.0,34.0,230.0,37.0,0.0,0.0,55,55,0,27.0,27.0,0.0
108073,35,13,22,57,2,33,245,0,7.0,2.0,5.0,10.0,0.0,7.0,99.0,88,35,53,40.0,3.0,37.0
105261,10,6,4,5,1,9,84,3,3.0,2.0,1.0,1.0,0.0,3.0,30.0,132,10,122,31.0,0.0,31.0
9704283,14,3,11,29,6,8,15,120,12.0,2.0,10.0,28.0,4.0,8.0,15.0,17,14,3,12.0,10.0,2.0
9809491,4,1,3,5,0,4,13,0,0.0,0.0,0.0,0.0,0.0,0.0,0.0,13,4,9,2.0,2.0,0.0
9507231,7,4,3,5,2,5,7,345,1.0,1.0,0.0,0.0,0.0,1.0,1.0,10,7,3,2.0,2.0,0.0
9905282,19,7,12,24,3,16,38,31,5.0,2.0,3.0,4.0,0.0,5.0,17.0,34,19,15,8.0,3.0,5.0
9610522,20,6,14,29,20,0,0,299,12.0,5.0,7.0,13.0,12.0,0.0,0.0,20,20,0,10.0,10.0,0.0
9812447,4,4,0,0,0,4,12,46,2.0,2.0,0.0,0.0,0.0,2.0,8.0,33,4,29,3.0,1.0,2.0
9082,3,1,2,2,1,2,10,1,2.0,1.0,1.0,1.0,0.0,2.0,5.0,18,3,15,8.0,2.0,6.0
5182,2,2,0,0,0,2,5,128,0.0,0.0,0.0,0.0,0.0,0.0,0.0,13,2,11,4.0,0.0,4.0
4127,20,4,16,57,0,20,167,5,14.0,1.0,13.0,42.0,0.0,14.0,124.0,37,20,17,23.0,11.0,12.0
9805220,1,1,0,0,0,1,2,213,1.0,1.0,0.0,0.0,0.0,1.0,2.0,3,1,2,2.0,1.0,1.0
9602247,1,1,0,0,1,0,0,129,0.0,0.0,0.0,0.0,0.0,0.0,0.0,4,1,3,,,
5186,7,2,5,10,0,7,31,18,4.0,2.0,2.0,3.0,0.0,4.0,13.0,24,7,17,12.0,4.0,8.0
9503451,1,1,0,0,1,0,0,15,0.0,0.0,0.0,0.0,0.0,0.0,0.0,14,1,13,2.0,0.0,2.0
9309215,8,3,5,11,8,0,0,60,1.0,1.0,0.0,0.0,1.0,0.0,0.0,8,8,0,1.0,1.0,0.0
9512290,11,7,4,7,2,9,23,123,8.0,4.0,4.0,7.0,1.0,7.0,15.0,16,11,5,7.0,5.0,2.0
9411380,3,2,1,1,3,0,0,90,2.0,1.0,1.0,1.0,2.0,0.0,0.0,4,3,1,1.0,0.0,1.0
9312280,5,3,2,3,5,0,0,103,0.0,0.0,0.0,0.0,0.0,0.0,0.0,7,5,2,3.0,3.0,0.0
9710339,19,4,15,95,2,17,63,49,17.0,3.0,14.0,92.0,3.0,14.0,43.0,32,19,13,20.0,16.0,4.0
9803268,3,2,1,1,0,3,6,111,3.0,2.0,1.0,1.0,0.0,3.0,3.0,6,3,3,4.0,3.0,1.0
9302320,3,1,2,3,3,0,0,641,1.0,1.0,0.0,0.0,1.0,0.0,0.0,3,3,0,2.0,2.0,0.0
9205207,4,2,2,2,4,0,0,225,2.0,2.0,0.0,0.0,2.0,0.0,0.0,4,4,0,2.0,2.0,0.0
9603322,14,7,7,17,7,7,7,160,6.0,5.0,1.0,1.0,3.0,3.0,3.0,15,14,1,6.0,5.0,1.0
9701359,2,2,0,0,0,2,5,41,1.0,1.0,0.0,0.0,0.0,1.0,1.0,7,2,5,2.0,1.0,1.0
9610327,5,2,3,3,5,0,0,87,4.0,1.0,3.0,3.0,4.0,0.0,0.0,6,5,1,,,
9507244,10,2,8,17,0,10,59,3,4.0,2.0,2.0,2.0,0.0,4.0,28.0,22,10,12,3.0,2.0,1.0
105005,32,8,24,58,4,28,147,23,10.0,3.0,7.0,13.0,0.0,10.0,88.0,64,32,32,21.0,8.0,13.0
9608225,2,2,0,0,1,1,3,23,0.0,0.0,0.0,0.0,0.0,0.0,0.0,6,2,4,1.0,0.0,1.0
9209261,30,11,19,36,30,0,0,169,11.0,2.0,9.0,17.0,11.0,0.0,0.0,30,30,0,8.0,8.0,0.0
4201,5,2,3,5,1,4,36,25,2.0,1.0,1.0,1.0,0.0,2.0,14.0,22,5,17,8.0,2.0,6.0
9908460,3,2,1,1,0,3,11,22,2.0,1.0,1.0,1.0,0.0,2.0,4.0,16,3,13,1.0,0.0,1.0
9304245,21,6,15,38,18,3,3,112,13.0,4.0,9.0,22.0,13.0,0.0,0.0,22,21,1,9.0,9.0,0.0
301079,0,0,0,0,0,0,0,36,0.0,0.0,0.0,0.0,0.0,0.0,0.0,45,0,45,2.0,0.0,2.0
9807350,27,2,25,97,5,22,48,7,14.0,1.0,13.0,40.0,14.0,0.0,0.0,45,27,18,16.0,15.0,1.0
9307218,13,4,9,13,13,0,0,1,1.0,1.0,0.0,0.0,1.0,0.0,0.0,13,13,0,1.0,1.0,0.0
9704280,23,5,18,70,0,23,212,36,21.0,3.0,18.0,69.0,0.0,21.0,205.0,39,23,16,30.0,19.0,11.0
202058,49,21,28,49,4,45,350,0,2.0,1.0,1.0,1.0,0.0,2.0,59.0,268,49,219,38.0,2.0,36.0
6018,2,1,1,1,0,2,8,218,2.0,1.0,1.0,1.0,0.0,2.0,6.0,13,2,11,8.0,2.0,6.0
201174,6,4,2,3,1,5,18,67,4.0,4.0,0.0,0.0,0.0,4.0,17.0,18,6,12,2.0,1.0,1.0
9709300,6,4,2,2,3,3,4,67,2.0,2.0,0.0,0.0,2.0,0.0,0.0,9,6,3,1.0,1.0,0.0
9404296,14,7,7,12,5,9,35,6,7.0,4.0,3.0,7.0,0.0,7.0,26.0,43,14,29,5.0,0.0,5.0
10233,2,2,0,0,0,2,5,373,1.0,1.0,0.0,0.0,0.0,1.0,2.0,5,2,3,2.0,1.0,1.0
9811434,5,4,1,1,0,5,28,30,4.0,3.0,1.0,1.0,0.0,4.0,20.0,43,5,38,17.0,3.0,14.0
9509281,3,3,0,0,1,2,4,345,3.0,3.0,0.0,0.0,1.0,2.0,4.0,6,3,3,4.0,2.0,2.0
9510414,1,1,0,0,0,1,1,168,0.0,0.0,0.0,0.0,0.0,0.0,0.0,7,1,6,3.0,0.0,3.0
9205222,5,2,3,3,5,0,0,342,2.0,1.0,1.0,1.0,2.0,0.0,0.0,5,5,0,3.0,3.0,0.0
9710275,5,3,2,3,2,3,11,1,2.0,2.0,0.0,0.0,0.0,2.0,4.0,17,5,12,6.0,3.0,3.0
9901327,12,3,9,23,1,11,13,145,8.0,2.0,6.0,17.0,1.0,7.0,7.0,14,12,2,9.0,8.0,1.0
9703313,37,7,30,152,12,25,31,83,22.0,2.0,20.0,93.0,4.0,18.0,22.0,41,37,4,19.0,18.0,1.0
9710280,12,2,10,28,4,8,9,98,12.0,2.0,10.0,28.0,4.0,8.0,8.0,14,12,2,9.0,8.0,1.0
9803289,14,5,9,19,14,0,0,154,13.0,4.0,9.0,19.0,13.0,0.0,0.0,15,14,1,10.0,10.0,0.0
9701247,14,6,8,16,5,9,13,44,9.0,4.0,5.0,10.0,2.0,7.0,8.0,17,14,3,7.0,5.0,2.0
9401238,16,8,8,14,5,11,11,265,8.0,3.0,5.0,8.0,0.0,8.0,8.0,17,16,1,8.0,7.0,1.0
9810402,6,2,4,6,2,4,4,79,0.0,0.0,0.0,0.0,0.0,0.0,0.0,7,6,1,3.0,2.0,1.0
5127,4,2,2,3,0,4,47,49,1.0,1.0,0.0,0.0,0.0,1.0,13.0,44,4,40,18.0,1.0,17.0
9712438,20,4,16,32,2,18,74,13,15.0,3.0,12.0,25.0,1.0,14.0,54.0,34,20,14,2.0,2.0,0.0
9703455,19,2,17,53,2,17,90,67,15.0,2.0,13.0,42.0,0.0,15.0,75.0,31,19,12,20.0,13.0,7.0
9906285,5,3,2,2,1,4,7,83,2.0,1.0,1.0,1.0,2.0,0.0,0.0,14,5,9,2.0,2.0,0.0
9406307,1,1,0,0,0,1,2,1306,1.0,1.0,0.0,0.0,0.0,1.0,1.0,3,1,2,,,
104162,14,2,12,33,0,14,205,8,13.0,2.0,11.0,30.0,0.0,13.0,185.0,47,14,33,36.0,9.0,27.0
9804317,3,2,1,1,3,0,0,80,3.0,2.0,1.0,1.0,3.0,0.0,0.0,3,3,0,,,
10177,17,6,11,31,5,12,60,22,8.0,3.0,5.0,12.0,0.0,8.0,38.0,36,17,19,14.0,10.0,4.0
9801292,9,3,6,11,6,3,4,45,5.0,2.0,3.0,4.0,5.0,0.0,0.0,12,9,3,3.0,3.0,0.0
105071,45,10,35,125,5,40,193,0,27.0,5.0,22.0,84.0,0.0,27.0,149.0,59,45,14,23.0,12.0,11.0
110071,6,5,1,1,0,6,23,0,4.0,3.0,1.0,1.0,0.0,4.0,13.0,21,6,15,3.0,2.0,1.0
9211221,12,10,2,2,12,0,0,189,7.0,7.0,0.0,0.0,7.0,0.0,0.0,12,12,0,4.0,4.0,0.0
9502408,17,6,11,16,17,0,0,59,10.0,4.0,6.0,10.0,10.0,0.0,0.0,17,17,0,6.0,6.0,0.0
9810204,4,3,1,1,2,2,13,10,0.0,0.0,0.0,0.0,0.0,0.0,0.0,31,4,27,5.0,1.0,4.0
206052,0,0,0,0,0,0,0,19,0.0,0.0,0.0,0.0,0.0,0.0,0.0,13,0,13,1.0,0.0,1.0
9311359,3,2,1,1,3,0,0,234,0.0,0.0,0.0,0.0,0.0,0.0,0.0,14,3,11,3.0,0.0,3.0
12017,39,9,30,142,0,39,354,0,29.0,5.0,24.0,119.0,0.0,29.0,264.0,107,39,68,40.0,15.0,25.0
9612227,16,6,10,20,1,15,43,63,9.0,5.0,4.0,9.0,1.0,8.0,27.0,28,16,12,11.0,5.0,6.0
5276,17,5,12,24,1,16,215,12,13.0,3.0,10.0,20.0,0.0,13.0,170.0,58,17,41,18.0,5.0,13.0
9807324,25,15,10,13,9,16,43,9,4.0,4.0,0.0,0.0,0.0,4.0,9.0,31,25,6,4.0,4.0,0.0
9904304,7,2,5,7,0,7,20,25,3.0,1.0,2.0,3.0,0.0,3.0,7.0,18,7,11,6.0,3.0,3.0
9912511,7,3,4,7,0,7,30,2,0.0,0.0,0.0,0.0,0.0,0.0,0.0,28,7,21,2.0,0.0,2.0
9609359,3,1,2,2,0,3,10,10,2.0,1.0,1.0,1.0,1.0,1.0,4.0,15,3,12,5.0,0.0,5.0
9407260,20,5,15,50,20,0,0,152,16.0,4.0,12.0,43.0,16.0,0.0,0.0,22,20,2,13.0,13.0,0.0
103050,19,3,16,63,0,19,63,23,15.0,1.0,14.0,57.0,0.0,15.0,32.0,37,19,18,9.0,8.0,1.0
9307241,93,11,82,643,86,7,17,53,69.0,3.0,66.0,583.0,69.0,0.0,0.0,97,93,4,49.0,49.0,0.0
9810227,3,2,1,1,0,3,9,227,1.0,1.0,0.0,0.0,0.0,1.0,4.0,10,3,7,5.0,1.0,4.0
103100,5,1,4,6,0,5,35,56,5.0,1.0,4.0,6.0,0.0,5.0,35.0,15,5,10,12.0,3.0,9.0
9311263,5,3,2,2,5,0,0,330,2.0,2.0,0.0,0.0,2.0,0.0,0.0,5,5,0,2.0,2.0,0.0
9401255,39,13,26,84,10,29,29,6,17.0,6.0,11.0,29.0,0.0,17.0,17.0,40,39,1,11.0,11.0,0.0
9704329,8,4,4,7,0,8,20,5,4.0,1.0,3.0,5.0,0.0,4.0,12.0,12,8,4,8.0,5.0,3.0
7161,2,2,0,0,2,0,0,0,0.0,0.0,0.0,0.0,0.0,0.0,0.0,50,2,48,2.0,0.0,2.0
9401329,8,6,2,3,8,0,0,318,1.0,1.0,0.0,0.0,1.0,0.0,0.0,9,8,1,2.0,2.0,0.0
9803215,4,4,0,0,0,4,14,15,1.0,1.0,0.0,0.0,0.0,1.0,8.0,35,4,31,3.0,1.0,2.0
9803426,14,4,10,30,0,14,64,33,11.0,3.0,8.0,26.0,0.0,11.0,47.0,26,14,12,14.0,10.0,4.0
2012,1,1,0,0,0,1,3,15,0.0,0.0,0.0,0.0,0.0,0.0,0.0,5,1,4,3.0,0.0,3.0
9209270,4,2,2,3,4,0,0,176,4.0,2.0,2.0,3.0,4.0,0.0,0.0,4,4,0,,,
9704436,17,4,13,35,0,17,48,25,11.0,1.0,10.0,27.0,2.0,9.0,12.0,28,17,11,12.0,10.0,2.0
9308211,2,1,1,1,1,1,1,81,,,,,,,,3,2,1,,,
9908466,9,1,8,12,0,9,31,27,7.0,1.0,6.0,8.0,0.0,7.0,23.0,18,9,9,9.0,3.0,6.0
9805324,11,6,5,9,3,8,9,101,3.0,2.0,1.0,2.0,0.0,3.0,3.0,14,11,3,3.0,3.0,0.0
209131,11,6,5,5,5,6,28,0,2.0,1.0,1.0,1.0,0.0,2.0,14.0,38,11,27,16.0,1.0,15.0
110001,14,3,11,25,0,14,125,46,13.0,3.0,10.0,23.0,0.0,13.0,114.0,43,14,29,30.0,12.0,18.0
10088,9,4,5,8,0,9,51,3,0.0,0.0,0.0,0.0,0.0,0.0,0.0,32,9,23,5.0,3.0,2.0
9411340,15,6,9,13,12,3,3,238,4.0,2.0,2.0,2.0,4.0,0.0,0.0,16,15,1,3.0,3.0,0.0
202003,20,3,17,59,0,20,162,0,2.0,1.0,1.0,1.0,0.0,2.0,39.0,59,20,39,22.0,2.0,20.0
9905461,9,2,7,11,0,9,56,0,5.0,1.0,4.0,6.0,0.0,5.0,24.0,26,9,17,10.0,4.0,6.0
12379,24,7,17,47,8,16,27,2,6.0,2.0,4.0,8.0,6.0,0.0,0.0,29,24,5,2.0,2.0,0.0
7009,11,4,7,11,6,5,14,60,1.0,1.0,0.0,0.0,0.0,1.0,4.0,26,11,15,4.0,3.0,1.0
11393,22,5,17,67,3,19,78,47,18.0,2.0,16.0,64.0,1.0,17.0,67.0,39,22,17,26.0,16.0,10.0
9510209,5,2,3,6,2,3,5,47,4.0,2.0,2.0,5.0,3.0,1.0,1.0,11,5,6,1.0,0.0,1.0
104104,13,6,7,13,0,13,42,3,5.0,3.0,2.0,3.0,0.0,5.0,8.0,33,13,20,7.0,5.0,2.0
9711342,6,1,5,9,0,6,31,5,3.0,1.0,2.0,3.0,0.0,3.0,10.0,16,6,10,8.0,5.0,3.0
9812389,5,5,0,0,2,3,7,243,1.0,1.0,0.0,0.0,0.0,1.0,2.0,14,5,9,3.0,1.0,2.0
9404361,10,4,6,8,10,0,0,228,8.0,3.0,5.0,7.0,8.0,0.0,0.0,10,10,0,4.0,4.0,0.0
9911283,16,7,9,15,8,8,27,24,10.0,2.0,8.0,14.0,4.0,6.0,10.0,36,16,20,5.0,4.0,1.0
9308201,8,5,3,3,2,6,23,35,4.0,3.0,1.0,1.0,1.0,3.0,13.0,16,8,8,9.0,3.0,6.0
9809224,6,3,3,3,0,6,24,100,2.0,1.0,1.0,1.0,0.0,2.0,12.0,17,6,11,10.0,1.0,9.0
9812242,2,2,0,0,1,1,1,2079,1.0,1.0,0.0,0.0,1.0,0.0,0.0,5,2,3,1.0,0.0,1.0
9812474,4,2,2,5,3,1,1,76,1.0,1.0,0.0,0.0,0.0,1.0,1.0,6,4,2,3.0,2.0,1.0
104108,24,3,21,74,0,24,388,11,22.0,3.0,19.0,69.0,0.0,22.0,360.0,60,24,36,47.0,20.0,27.0
9709226,5,2,3,4,1,4,5,16,0.0,0.0,0.0,0.0,0.0,0.0,0.0,22,5,17,2.0,0.0,2.0
9706244,3,1,2,3,0,3,6,13,3.0,1.0,2.0,3.0,1.0,2.0,2.0,7,3,4,2.0,1.0,1.0
9803220,0,0,0,0,0,0,0,159,0.0,0.0,0.0,0.0,0.0,0.0,0.0,4,0,4,,,
9712504,19,8,11,26,2,17,64,59,9.0,5.0,4.0,11.0,0.0,9.0,45.0,34,19,15,15.0,6.0,9.0
9310268,3,3,0,0,3,0,0,223,1.0,1.0,0.0,0.0,1.0,0.0,0.0,3,3,0,,,
11019,1,1,0,0,0,1,15,15,1.0,1.0,0.0,0.0,0.0,1.0,15.0,24,1,23,4.0,0.0,4.0
9511360,12,3,9,17,2,10,10,17,2.0,2.0,0.0,0.0,2.0,0.0,0.0,14,12,2,2.0,2.0,0.0
105250,4,3,1,1,1,3,14,2,1.0,1.0,0.0,0.0,0.0,1.0,2.0,15,4,11,5.0,0.0,5.0
9802364,13,7,6,13,8,5,7,121,5.0,1.0,4.0,8.0,5.0,0.0,0.0,22,13,9,5.0,5.0,0.0
110262,13,4,9,20,3,10,16,239,11.0,3.0,8.0,18.0,2.0,9.0,9.0,17,13,4,10.0,9.0,1.0
9407391,6,6,0,0,3,3,4,159,1.0,1.0,0.0,0.0,0.0,1.0,1.0,10,6,4,2.0,1.0,1.0
9610207,2,1,1,1,0,2,10,8,1.0,1.0,0.0,0.0,0.0,1.0,1.0,8,2,6,2.0,1.0,1.0
9512259,11,8,3,3,1,10,14,222,7.0,4.0,3.0,3.0,1.0,6.0,6.0,16,11,5,7.0,6.0,1.0
9411213,3,2,1,1,0,3,8,208,1.0,1.0,0.0,0.0,0.0,1.0,3.0,6,3,3,4.0,1.0,3.0
8083,6,4,2,3,1,5,10,88,5.0,3.0,2.0,3.0,1.0,4.0,8.0,12,6,6,5.0,3.0,2.0
9901204,6,5,1,2,1,5,14,128,1.0,1.0,0.0,0.0,0.0,1.0,1.0,15,6,9,5.0,0.0,5.0
9907389,26,3,23,127,1,25,75,109,23.0,2.0,21.0,122.0,0.0,23.0,66.0,33,26,7,25.0,22.0,3.0
9709363,24,5,19,33,4,20,125,14,18.0,2.0,16.0,29.0,1.0,17.0,57.0,42,24,18,19.0,12.0,7.0
9312307,2,2,0,0,0,2,3,13,,,,,,,,4,2,2,,,
9704337,9,2,7,10,4,5,11,157,8.0,1.0,7.0,10.0,5.0,3.0,3.0,23,9,14,5.0,5.0,0.0
109035,8,2,6,13,4,4,12,50,3.0,2.0,1.0,1.0,2.0,1.0,4.0,13,8,5,9.0,5.0,4.0
9901363,4,4,0,0,3,1,2,231,1.0,1.0,0.0,0.0,1.0,0.0,0.0,10,4,6,3.0,1.0,2.0
9902339,14,4,10,34,4,10,29,0,8.0,1.0,7.0,24.0,1.0,7.0,14.0,33,14,19,12.0,9.0,3.0
7180,11,8,3,4,0,11,44,102,4.0,3.0,1.0,2.0,0.0,4.0,15.0,82,11,71,17.0,0.0,17.0
9805472,5,2,3,4,0,5,71,36,4.0,2.0,2.0,3.0,0.0,4.0,51.0,38,5,33,26.0,3.0,23.0
9806462,36,9,27,74,5,31,117,8,10.0,3.0,7.0,21.0,1.0,9.0,32.0,64,36,28,12.0,2.0,10.0
9702384,17,3,14,32,2,15,28,85,12.0,1.0,11.0,28.0,3.0,9.0,9.0,21,17,4,8.0,7.0,1.0
9612367,7,4,3,5,3,4,5,30,0.0,0.0,0.0,0.0,0.0,0.0,0.0,25,7,18,12.0,0.0,12.0
9410320,6,2,4,6,1,5,7,54,2.0,1.0,1.0,1.0,1.0,1.0,1.0,8,6,2,2.0,2.0,0.0
9511251,1,1,0,0,1,0,0,436,0.0,0.0,0.0,0.0,0.0,0.0,0.0,15,1,14,2.0,0.0,2.0
9805231,7,1,6,8,0,7,18,277,6.0,1.0,5.0,7.0,0.0,6.0,15.0,11,7,4,10.0,6.0,4.0
9412234,3,3,0,0,3,0,0,553,1.0,1.0,0.0,0.0,1.0,0.0,0.0,5,3,2,2.0,1.0,1.0
9711251,26,5,21,79,1,25,87,8,18.0,3.0,15.0,56.0,0.0,18.0,66.0,35,26,9,20.0,14.0,6.0
9803329,5,4,1,1,0,5,12,129,1.0,1.0,0.0,0.0,0.0,1.0,1.0,22,5,17,3.0,1.0,2.0
9711268,12,7,5,8,2,10,47,6,5.0,2.0,3.0,5.0,0.0,5.0,8.0,44,12,32,8.0,4.0,4.0
12026,7,7,0,0,0,7,80,24,3.0,3.0,0.0,0.0,0.0,3.0,39.0,77,7,70,22.0,2.0,20.0
9807224,21,4,17,34,20,1,1,174,7.0,1.0,6.0,6.0,6.0,1.0,1.0,22,21,1,9.0,9.0,0.0
9908243,9,6,3,4,4,5,8,51,4.0,4.0,0.0,0.0,2.0,2.0,2.0,14,9,5,6.0,4.0,2.0
9802316,5,2,3,5,2,3,5,106,3.0,1.0,2.0,3.0,2.0,1.0,1.0,12,5,7,3.0,3.0,0.0
9612422,3,2,1,1,0,3,22,53,3.0,2.0,1.0,1.0,0.0,3.0,22.0,14,3,11,13.0,3.0,10.0
9610467,16,2,14,42,6,10,26,25,10.0,1.0,9.0,21.0,2.0,8.0,19.0,25,16,9,13.0,9.0,4.0
203029,8,4,4,5,2,6,16,121,1.0,1.0,0.0,0.0,0.0,1.0,5.0,26,8,18,8.0,5.0,3.0
9211246,1,1,0,0,1,0,0,1309,,,,,,,,1,1,0,,,
9402323,1,1,0,0,1,0,0,276,1.0,1.0,0.0,0.0,1.0,0.0,0.0,3,1,2,1.0,1.0,0.0
9308374,27,2,25,108,27,0,0,113,21.0,1.0,20.0,86.0,21.0,0.0,0.0,27,27,0,18.0,18.0,0.0
109200,4,2,2,3,0,4,16,0,3.0,1.0,2.0,2.0,0.0,3.0,10.0,12,4,8,3.0,1.0,2.0
9512346,4,2,2,3,3,1,1,41,0.0,0.0,0.0,0.0,0.0,0.0,0.0,6,4,2,1.0,0.0,1.0
9508239,26,12,14,58,3,23,53,27,15.0,5.0,10.0,38.0,0.0,15.0,33.0,33,26,7,3.0,3.0,0.0
9803349,25,11,14,34,3,22,164,53,16.0,6.0,10.0,25.0,1.0,15.0,150.0,53,25,28,34.0,11.0,23.0
9712526,8,5,3,3,8,0,0,40,4.0,3.0,1.0,1.0,4.0,0.0,0.0,10,8,2,4.0,4.0,0.0
9612208,7,3,4,5,1,6,11,103,4.0,2.0,2.0,2.0,1.0,3.0,8.0,14,7,7,5.0,2.0,3.0
9905212,18,3,15,23,5,13,36,99,7.0,1.0,6.0,9.0,1.0,6.0,13.0,26,18,8,10.0,7.0,3.0
9803424,9,2,7,13,1,8,78,17,7.0,1.0,6.0,12.0,0.0,7.0,74.0,23,9,14,19.0,5.0,14.0
112062,3,3,0,0,0,3,5,62,0.0,0.0,0.0,0.0,0.0,0.0,0.0,16,3,13,2.0,0.0,2.0
111054,1,1,0,0,1,0,0,68,0.0,0.0,0.0,0.0,0.0,0.0,0.0,13,1,12,9.0,0.0,9.0
108077,9,3,6,8,0,9,65,9,7.0,3.0,4.0,6.0,0.0,7.0,57.0,26,9,17,5.0,5.0,0.0
108187,5,4,1,1,0,5,29,83,4.0,3.0,1.0,1.0,0.0,4.0,22.0,16,5,11,10.0,4.0,6.0
9509383,8,4,4,7,3,5,5,143,4.0,2.0,2.0,2.0,0.0,4.0,4.0,11,8,3,6.0,5.0,1.0
3174,7,4,3,3,0,7,59,12,5.0,3.0,2.0,2.0,0.0,5.0,38.0,36,7,29,1.0,1.0,0.0
7306,5,3,2,3,0,5,65,56,5.0,3.0,2.0,3.0,0.0,5.0,55.0,39,5,34,23.0,5.0,18.0
9304294,15,7,8,20,1,14,17,56,12.0,5.0,7.0,18.0,0.0,12.0,15.0,17,15,2,4.0,4.0,0.0
9305311,3,2,1,1,3,0,0,914,,,,,,,,3,3,0,,,
9609459,5,2,3,5,3,2,6,152,0.0,0.0,0.0,0.0,0.0,0.0,0.0,10,5,5,2.0,0.0,2.0
9209272,11,3,8,15,11,0,0,124,4.0,2.0,2.0,3.0,4.0,0.0,0.0,14,11,3,4.0,4.0,0.0
9503261,1,1,0,0,0,1,1,19,0.0,0.0,0.0,0.0,0.0,0.0,0.0,12,1,11,7.0,0.0,7.0
9611201,2,2,0,0,0,2,4,415,2.0,2.0,0.0,0.0,0.0,2.0,4.0,9,2,7,4.0,2.0,2.0
9401326,4,4,0,0,3,1,1,417,1.0,1.0,0.0,0.0,1.0,0.0,0.0,5,4,1,2.0,2.0,0.0
105108,7,3,4,5,0,7,52,92,2.0,1.0,1.0,1.0,0.0,2.0,10.0,32,7,25,16.0,4.0,12.0
9505214,1,1,0,0,1,0,0,81,0.0,0.0,0.0,0.0,0.0,0.0,0.0,11,1,10,4.0,0.0,4.0
9804240,8,7,1,2,3,5,13,47,6.0,5.0,1.0,2.0,1.0,5.0,12.0,19,8,11,4.0,3.0,1.0
111471,5,3,2,2,0,5,17,2,2.0,2.0,0.0,0.0,2.0,0.0,0.0,11,5,6,3.0,3.0,0.0
9312233,4,3,1,1,4,0,0,48,1.0,1.0,0.0,0.0,1.0,0.0,0.0,8,4,4,2.0,2.0,0.0
9804334,1,1,0,0,0,1,1,159,0.0,0.0,0.0,0.0,0.0,0.0,0.0,3,1,2,1.0,0.0,1.0
9907340,10,6,4,4,9,1,1,20,4.0,2.0,2.0,2.0,4.0,0.0,0.0,17,10,7,2.0,2.0,0.0
9404287,7,3,4,6,7,0,0,150,5.0,1.0,4.0,6.0,5.0,0.0,0.0,7,7,0,4.0,4.0,0.0
9808352,3,3,0,0,3,0,0,45,1.0,1.0,0.0,0.0,1.0,0.0,0.0,3,3,0,1.0,1.0,0.0
109146,7,2,5,7,0,7,39,16,5.0,1.0,4.0,6.0,0.0,5.0,19.0,18,7,11,9.0,4.0,5.0
7352,4,2,2,4,0,4,11,49,3.0,1.0,2.0,3.0,0.0,3.0,8.0,7,4,3,1.0,0.0,1.0
9908455,11,6,5,9,1,10,31,251,8.0,4.0,4.0,6.0,1.0,7.0,18.0,20,11,9,11.0,7.0,4.0
9406324,8,4,4,6,0,8,12,35,3.0,3.0,0.0,0.0,1.0,2.0,3.0,11,8,3,3.0,2.0,1.0
9803246,8,3,5,9,0,8,25,78,8.0,3.0,5.0,9.0,0.0,8.0,23.0,14,8,6,7.0,4.0,3.0
3312,13,4,9,29,0,13,68,2,6.0,1.0,5.0,15.0,6.0,0.0,0.0,32,13,19,6.0,6.0,0.0
111233,8,5,3,6,0,8,38,73,5.0,3.0,2.0,4.0,0.0,5.0,25.0,15,8,7,8.0,3.0,5.0
11033,0,0,0,0,0,0,0,20,0.0,0.0,0.0,0.0,0.0,0.0,0.0,8,0,8,2.0,0.0,2.0
9080,3,2,1,2,3,0,0,1034,,,,,,,,3,3,0,1.0,1.0,0.0
9708388,10,4,6,17,5,5,5,135,3.0,2.0,1.0,2.0,3.0,0.0,0.0,14,10,4,2.0,2.0,0.0
9901416,12,5,7,14,5,7,14,47,6.0,1.0,5.0,9.0,2.0,4.0,5.0,20,12,8,4.0,2.0,2.0
9708269,1,1,0,0,0,1,2,342,0.0,0.0,0.0,0.0,0.0,0.0,0.0,8,1,7,3.0,0.0,3.0
105319,2,2,0,0,0,2,5,82,0.0,0.0,0.0,0.0,0.0,0.0,0.0,9,2,7,1.0,0.0,1.0
9812441,6,4,2,4,1,5,22,82,3.0,2.0,1.0,2.0,0.0,3.0,14.0,14,6,8,10.0,3.0,7.0
202084,2,2,0,0,0,2,10,95,2.0,2.0,0.0,0.0,0.0,2.0,9.0,9,2,7,3.0,1.0,2.0
9712508,17,2,15,38,0,17,101,9,14.0,2.0,12.0,31.0,0.0,14.0,80.0,29,17,12,3.0,2.0,1.0
9510225,1,1,0,0,1,0,0,116,,,,,,,,2,1,1,,,
9807453,13,5,8,14,3,10,16,13,5.0,2.0,3.0,6.0,1.0,4.0,4.0,16,13,3,7.0,4.0,3.0
9706404,4,2,2,4,1,3,3,49,3.0,1.0,2.0,3.0,0.0,3.0,3.0,8,4,4,3.0,3.0,0.0
9509309,4,4,0,0,2,2,4,47,0.0,0.0,0.0,0.0,0.0,0.0,0.0,7,4,3,1.0,1.0,0.0
9905412,11,2,9,18,2,9,35,7,8.0,2.0,6.0,8.0,2.0,6.0,8.0,32,11,21,7.0,6.0,1.0
9811453,10,8,2,3,10,0,0,180,4.0,2.0,2.0,3.0,4.0,0.0,0.0,10,10,0,4.0,4.0,0.0
109269,1,1,0,0,0,1,4,33,0.0,0.0,0.0,0.0,0.0,0.0,0.0,18,1,17,9.0,0.0,9.0
10317,1,1,0,0,1,0,0,11,0.0,0.0,0.0,0.0,0.0,0.0,0.0,18,1,17,,,
5013,6,1,5,11,0,6,31,7,6.0,1.0,5.0,11.0,0.0,6.0,19.0,33,6,27,7.0,2.0,5.0
5199,2,2,0,0,0,2,4,92,1.0,1.0,0.0,0.0,0.0,1.0,2.0,8,2,6,6.0,2.0,4.0
9903527,13,6,7,13,6,7,14,77,6.0,3.0,3.0,6.0,6.0,0.0,0.0,19,13,6,3.0,3.0,0.0
9512411,3,3,0,0,2,1,1,231,0.0,0.0,0.0,0.0,0.0,0.0,0.0,14,3,11,3.0,0.0,3.0
9909524,4,4,0,0,2,2,10,14,1.0,1.0,0.0,0.0,0.0,1.0,4.0,18,4,14,7.0,1.0,6.0
9612288,2,2,0,0,2,0,0,244,2.0,2.0,0.0,0.0,2.0,0.0,0.0,2,2,0,1.0,1.0,0.0
8121,4,4,0,0,1,3,3,28,3.0,3.0,0.0,0.0,0.0,3.0,3.0,5,4,1,1.0,1.0,0.0
9710317,19,9,10,18,0,19,66,31,17.0,7.0,10.0,18.0,0.0,17.0,62.0,26,19,7,11.0,5.0,6.0
207080,18,9,9,20,3,15,140,0,13.0,5.0,8.0,16.0,0.0,13.0,108.0,41,18,23,13.0,8.0,5.0
9807460,8,5,3,3,3,5,11,65,3.0,1.0,2.0,2.0,0.0,3.0,5.0,18,8,10,2.0,1.0,1.0
9608252,5,4,1,1,3,2,3,79,1.0,1.0,0.0,0.0,1.0,0.0,0.0,7,5,2,1.0,1.0,0.0
9802274,3,1,2,3,0,3,3,65,1.0,1.0,0.0,0.0,0.0,1.0,1.0,4,3,1,2.0,1.0,1.0
107126,1,1,0,0,0,1,1,31,0.0,0.0,0.0,0.0,0.0,0.0,0.0,16,1,15,3.0,0.0,3.0
9212310,7,3,4,4,7,0,0,332,7.0,3.0,4.0,4.0,7.0,0.0,0.0,7,7,0,6.0,6.0,0.0
207348,15,5,10,28,0,15,144,0,6.0,2.0,4.0,10.0,0.0,6.0,57.0,38,15,23,17.0,6.0,11.0
204335,8,4,4,5,0,8,52,46,5.0,2.0,3.0,4.0,0.0,5.0,31.0,47,8,39,19.0,4.0,15.0
8109,2,2,0,0,1,1,2,279,0.0,0.0,0.0,0.0,0.0,0.0,0.0,7,2,5,1.0,0.0,1.0
9812338,3,3,0,0,0,3,14,3,2.0,2.0,0.0,0.0,0.0,2.0,7.0,18,3,15,4.0,1.0,3.0
204215,1,1,0,0,0,1,3,31,0.0,0.0,0.0,0.0,0.0,0.0,0.0,11,1,10,2.0,1.0,1.0
9704392,5,2,3,3,4,1,2,22,1.0,1.0,0.0,0.0,0.0,1.0,1.0,9,5,4,1.0,1.0,0.0
9906492,6,2,4,6,0,6,15,43,2.0,1.0,1.0,1.0,0.0,2.0,7.0,24,6,18,3.0,3.0,0.0
9707396,0,0,0,0,0,0,0,329,0.0,0.0,0.0,0.0,0.0,0.0,0.0,7,0,7,4.0,0.0,4.0
208087,12,2,10,28,0,12,91,1,8.0,2.0,6.0,19.0,0.0,8.0,32.0,33,12,21,15.0,8.0,7.0
209045,1,1,0,0,1,0,0,79,1.0,1.0,0.0,0.0,1.0,0.0,0.0,10,1,9,2.0,0.0,2.0
9902400,4,2,2,3,2,2,3,59,4.0,2.0,2.0,3.0,4.0,0.0,0.0,17,4,13,3.0,3.0,0.0
6314,5,2,3,5,0,5,44,25,1.0,1.0,0.0,0.0,0.0,1.0,8.0,26,5,21,8.0,1.0,7.0
203080,1,1,0,0,0,1,8,37,1.0,1.0,0.0,0.0,0.0,1.0,3.0,21,1,20,7.0,1.0,6.0
9609321,15,4,11,28,4,11,16,30,7.0,6.0,1.0,1.0,3.0,4.0,7.0,17,15,2,8.0,8.0,0.0
9801338,0,0,0,0,0,0,0,88,0.0,0.0,0.0,0.0,0.0,0.0,0.0,10,0,10,1.0,0.0,1.0
9702304,4,1,3,5,0,4,10,10,3.0,1.0,2.0,3.0,0.0,3.0,9.0,8,4,4,7.0,3.0,4.0
106248,8,3,5,8,0,8,157,11,6.0,2.0,4.0,7.0,0.0,6.0,133.0,61,8,53,31.0,4.0,27.0
9503241,18,5,13,26,4,14,40,113,12.0,2.0,10.0,17.0,2.0,10.0,18.0,29,18,11,13.0,11.0,2.0
205347,7,4,3,4,0,7,45,2,0.0,0.0,0.0,0.0,0.0,0.0,0.0,46,7,39,2.0,1.0,1.0
9907388,2,2,0,0,1,1,5,217,0.0,0.0,0.0,0.0,0.0,0.0,0.0,10,2,8,3.0,1.0,2.0
107089,4,3,1,1,3,1,2,4,0.0,0.0,0.0,0.0,0.0,0.0,0.0,28,4,24,3.0,0.0,3.0
9506330,2,2,0,0,2,0,0,267,1.0,1.0,0.0,0.0,1.0,0.0,0.0,2,2,0,1.0,1.0,0.0
207044,6,4,2,2,0,6,33,38,3.0,3.0,0.0,0.0,0.0,3.0,7.0,16,6,10,5.0,3.0,2.0
9902396,1,1,0,0,0,1,10,0,1.0,1.0,0.0,0.0,0.0,1.0,9.0,22,1,21,4.0,1.0,3.0
9607216,3,1,2,2,0,3,17,79,3.0,1.0,2.0,2.0,0.0,3.0,17.0,14,3,11,7.0,1.0,6.0
9608301,4,4,0,0,4,0,0,213,2.0,2.0,0.0,0.0,2.0,0.0,0.0,4,4,0,1.0,1.0,0.0
211040,4,3,1,2,0,4,22,95,3.0,2.0,1.0,2.0,1.0,2.0,2.0,18,4,14,4.0,1.0,3.0
9907241,12,5,7,12,0,12,58,11,8.0,4.0,4.0,7.0,1.0,7.0,34.0,23,12,11,15.0,8.0,7.0
9507390,1,1,0,0,1,0,0,40,0.0,0.0,0.0,0.0,0.0,0.0,0.0,19,1,18,7.0,0.0,7.0
9610330,2,2,0,0,1,1,1,155,0.0,0.0,0.0,0.0,0.0,0.0,0.0,7,2,5,1.0,0.0,1.0
111198,2,1,1,1,0,2,35,12,2.0,1.0,1.0,1.0,0.0,2.0,34.0,174,2,172,45.0,0.0,45.0
9151,8,2,6,8,2,6,11,268,6.0,2.0,4.0,5.0,0.0,6.0,11.0,11,8,3,8.0,5.0,3.0
11283,7,4,3,3,1,6,20,21,4.0,3.0,1.0,1.0,1.0,3.0,8.0,22,7,15,5.0,1.0,4.0
9806221,6,3,3,6,1,5,5,72,4.0,2.0,2.0,4.0,1.0,3.0,3.0,13,6,7,7.0,3.0,4.0
8165,6,4,2,2,2,4,12,12,2.0,1.0,1.0,1.0,0.0,2.0,9.0,22,6,16,3.0,1.0,2.0
9809558,3,2,1,1,0,3,3,82,0.0,0.0,0.0,0.0,0.0,0.0,0.0,7,3,4,2.0,2.0,0.0
112101,10,1,9,40,0,10,56,0,9.0,1.0,8.0,31.0,0.0,9.0,42.0,19,10,9,17.0,10.0,7.0
205212,3,2,1,1,0,3,21,32,1.0,1.0,0.0,0.0,0.0,1.0,4.0,38,3,35,2.0,1.0,1.0
5043,12,6,6,11,6,6,14,101,2.0,2.0,0.0,0.0,0.0,2.0,7.0,24,12,12,6.0,6.0,0.0
9806535,15,6,9,25,2,13,15,9,13.0,4.0,9.0,25.0,2.0,11.0,11.0,18,15,3,1.0,0.0,1.0
9311314,1,1,0,0,1,0,0,1372,,,,,,,,1,1,0,,,
9807225,5,5,0,0,3,2,7,49,2.0,2.0,0.0,0.0,0.0,2.0,5.0,11,5,6,2.0,0.0,2.0
9706299,0,0,0,0,0,0,0,51,0.0,0.0,0.0,0.0,0.0,0.0,0.0,7,0,7,1.0,0.0,1.0
9408249,3,3,0,0,2,1,1,476,2.0,2.0,0.0,0.0,1.0,1.0,1.0,4,3,1,2.0,1.0,1.0
9810478,2,2,0,0,0,2,7,85,1.0,1.0,0.0,0.0,0.0,1.0,2.0,23,2,21,9.0,0.0,9.0
102171,4,3,1,1,4,0,0,113,2.0,2.0,0.0,0.0,2.0,0.0,0.0,4,4,0,2.0,2.0,0.0
207108,12,6,6,9,0,12,275,1,6.0,4.0,2.0,4.0,0.0,6.0,131.0,290,12,278,47.0,3.0,44.0
9906546,9,5,4,5,1,8,44,11,1.0,1.0,0.0,0.0,0.0,1.0,7.0,33,9,24,12.0,2.0,10.0
111154,3,2,1,1,0,3,11,55,0.0,0.0,0.0,0.0,0.0,0.0,0.0,15,3,12,4.0,1.0,3.0
9411425,13,3,10,35,13,0,0,103,11.0,3.0,8.0,32.0,11.0,0.0,0.0,13,13,0,9.0,9.0,0.0
9411329,3,2,1,1,0,3,9,40,3.0,2.0,1.0,1.0,0.0,3.0,9.0,7,3,4,3.0,2.0,1.0
205265,1,1,0,0,0,1,17,28,1.0,1.0,0.0,0.0,0.0,1.0,13.0,27,1,26,13.0,1.0,12.0
9905365,2,2,0,0,0,2,11,39,2.0,2.0,0.0,0.0,0.0,2.0,11.0,20,2,18,13.0,1.0,12.0
9610202,4,2,2,4,0,4,31,40,3.0,1.0,2.0,3.0,0.0,3.0,24.0,18,4,14,11.0,3.0,8.0
9810469,1,1,0,0,0,1,2,117,0.0,0.0,0.0,0.0,0.0,0.0,0.0,7,1,6,1.0,0.0,1.0
9511236,4,3,1,1,1,3,12,176,3.0,2.0,1.0,1.0,0.0,3.0,11.0,17,4,13,10.0,2.0,8.0
201049,4,4,0,0,0,4,17,7,1.0,1.0,0.0,0.0,0.0,1.0,5.0,24,4,20,7.0,0.0,7.0
9905480,8,1,7,17,0,8,58,43,8.0,1.0,7.0,17.0,0.0,8.0,58.0,20,8,12,18.0,6.0,12.0
6271,5,1,4,10,0,5,89,49,5.0,1.0,4.0,10.0,0.0,5.0,70.0,31,5,26,23.0,5.0,18.0
1003,6,3,3,3,0,6,16,6,5.0,2.0,3.0,3.0,0.0,5.0,10.0,24,6,18,8.0,5.0,3.0
9506232,2,2,0,0,0,2,3,323,1.0,1.0,0.0,0.0,0.0,1.0,2.0,4,2,2,3.0,1.0,2.0
101253,1,1,0,0,0,1,2,33,1.0,1.0,0.0,0.0,0.0,1.0,2.0,10,1,9,5.0,1.0,4.0
9605421,1,1,0,0,1,0,0,307,0.0,0.0,0.0,0.0,0.0,0.0,0.0,2,1,1,1.0,0.0,1.0
9903548,1,1,0,0,0,1,1,1644,1.0,1.0,0.0,0.0,1.0,0.0,0.0,4,1,3,1.0,0.0,1.0
9612246,2,2,0,0,1,1,1,322,0.0,0.0,0.0,0.0,0.0,0.0,0.0,5,2,3,2.0,0.0,2.0
208230,0,0,0,0,0,0,0,48,0.0,0.0,0.0,0.0,0.0,0.0,0.0,29,0,29,17.0,0.0,17.0
3034,4,4,0,0,2,2,2,283,0.0,0.0,0.0,0.0,0.0,0.0,0.0,12,4,8,2.0,1.0,1.0
9805433,5,1,4,6,1,4,4,20,5.0,1.0,4.0,6.0,2.0,3.0,3.0,9,5,4,6.0,5.0,1.0
9605329,1,1,0,0,0,1,5,223,1.0,1.0,0.0,0.0,0.0,1.0,3.0,10,1,9,6.0,1.0,5.0
9909324,9,3,6,11,0,9,62,8,9.0,3.0,6.0,11.0,0.0,9.0,62.0,21,9,12,17.0,8.0,9.0
104237,5,1,4,8,5,0,0,80,4.0,1.0,3.0,4.0,4.0,0.0,0.0,10,5,5,1.0,0.0,1.0
9404303,15,4,11,17,15,0,0,188,8.0,1.0,7.0,12.0,8.0,0.0,0.0,15,15,0,6.0,6.0,0.0
8280,8,3,5,7,0,8,134,11,6.0,2.0,4.0,6.0,0.0,6.0,105.0,37,8,29,24.0,5.0,19.0
9811314,3,3,0,0,1,2,4,336,2.0,2.0,0.0,0.0,0.0,2.0,4.0,5,3,2,1.0,1.0,0.0
9807233,3,2,1,1,0,3,13,42,1.0,1.0,0.0,0.0,0.0,1.0,7.0,16,3,13,2.0,0.0,2.0
9308256,3,2,1,2,1,2,2,206,3.0,2.0,1.0,2.0,1.0,2.0,2.0,4,3,1,4.0,3.0,1.0
9211327,1,1,0,0,1,0,0,1266,1.0,1.0,0.0,0.0,1.0,0.0,0.0,1,1,0,1.0,1.0,0.0
9711228,2,2,0,0,0,2,3,105,0.0,0.0,0.0,0.0,0.0,0.0,0.0,13,2,11,5.0,0.0,5.0
9803381,2,2,0,0,0,2,4,356,2.0,2.0,0.0,0.0,0.0,2.0,4.0,4,2,2,2.0,1.0,1.0
9701415,16,7,9,13,1,15,40,6,5.0,2.0,3.0,3.0,4.0,1.0,1.0,22,16,6,9.0,7.0,2.0
105061,13,8,5,12,0,13,108,4,6.0,3.0,3.0,8.0,0.0,6.0,67.0,47,13,34,20.0,6.0,14.0
9607287,3,2,1,1,0,3,6,60,1.0,1.0,0.0,0.0,0.0,1.0,3.0,10,3,7,3.0,0.0,3.0
208076,8,3,5,5,0,8,47,23,0.0,0.0,0.0,0.0,0.0,0.0,0.0,61,8,53,28.0,0.0,28.0
9805507,5,2,3,6,5,0,0,125,4.0,1.0,3.0,6.0,4.0,0.0,0.0,5,5,0,,,
109250,5,3,2,3,1,4,7,17,0.0,0.0,0.0,0.0,0.0,0.0,0.0,17,5,12,3.0,0.0,3.0
9712427,3,2,1,1,1,2,4,55,0.0,0.0,0.0,0.0,0.0,0.0,0.0,14,3,11,1.0,0.0,1.0
9711355,7,5,2,3,1,6,12,44,2.0,1.0,1.0,1.0,0.0,2.0,2.0,11,7,4,3.0,2.0,1.0
201123,2,2,0,0,0,2,4,64,1.0,1.0,0.0,0.0,0.0,1.0,1.0,5,2,3,2.0,1.0,1.0
9908399,7,6,1,1,2,5,30,58,3.0,3.0,0.0,0.0,0.0,3.0,24.0,35,7,28,14.0,2.0,12.0
102113,6,4,2,2,0,6,38,12,3.0,2.0,1.0,1.0,0.0,3.0,16.0,22,6,16,13.0,3.0,10.0
6019,2,1,1,1,0,2,2,294,1.0,1.0,0.0,0.0,1.0,0.0,0.0,3,2,1,2.0,2.0,0.0
9511214,2,1,1,1,2,0,0,45,2.0,1.0,1.0,1.0,2.0,0.0,0.0,2,2,0,,,
9808238,3,2,1,1,1,2,3,1,0.0,0.0,0.0,0.0,0.0,0.0,0.0,22,3,19,1.0,0.0,1.0
9910321,2,1,1,1,0,2,2,59,2.0,1.0,1.0,1.0,0.0,2.0,2.0,3,2,1,1.0,1.0,0.0
9353,2,2,0,0,1,1,3,157,0.0,0.0,0.0,0.0,0.0,0.0,0.0,17,2,15,4.0,0.0,4.0
9801346,9,4,5,12,1,8,11,33,4.0,2.0,2.0,3.0,2.0,2.0,2.0,16,9,7,2.0,1.0,1.0
204178,0,0,0,0,0,0,0,52,0.0,0.0,0.0,0.0,0.0,0.0,0.0,7,0,7,4.0,0.0,4.0
9809421,4,1,3,4,0,4,13,346,2.0,1.0,1.0,1.0,0.0,2.0,4.0,13,4,9,7.0,2.0,5.0
6253,3,3,0,0,0,3,26,10,0.0,0.0,0.0,0.0,0.0,0.0,0.0,51,3,48,12.0,0.0,12.0
9608426,2,1,1,1,0,2,5,16,2.0,1.0,1.0,1.0,0.0,2.0,4.0,7,2,5,5.0,2.0,3.0
9707507,7,3,4,6,0,7,8,53,4.0,3.0,1.0,1.0,0.0,4.0,4.0,13,7,6,4.0,3.0,1.0
110023,5,2,3,4,1,4,41,34,2.0,1.0,1.0,1.0,0.0,2.0,32.0,33,5,28,3.0,1.0,2.0
12187,1,1,0,0,0,1,2,80,1.0,1.0,0.0,0.0,1.0,0.0,0.0,4,1,3,2.0,1.0,1.0
9219,3,1,2,3,0,3,17,52,3.0,1.0,2.0,3.0,0.0,3.0,17.0,16,3,13,13.0,3.0,10.0
8206,2,1,1,1,1,1,1,285,0.0,0.0,0.0,0.0,0.0,0.0,0.0,7,2,5,2.0,2.0,0.0
9502339,5,5,0,0,1,4,8,303,1.0,1.0,0.0,0.0,0.0,1.0,1.0,10,5,5,2.0,1.0,1.0
9709476,3,3,0,0,0,3,5,140,1.0,1.0,0.0,0.0,0.0,1.0,2.0,10,3,7,4.0,1.0,3.0
9502207,6,4,2,3,1,5,20,6,2.0,1.0,1.0,1.0,0.0,2.0,2.0,12,6,6,2.0,2.0,0.0
11228,4,4,0,0,2,2,4,74,2.0,2.0,0.0,0.0,2.0,0.0,0.0,8,4,4,2.0,0.0,2.0
9710398,9,6,3,4,5,4,9,247,5.0,3.0,2.0,3.0,1.0,4.0,7.0,15,9,6,5.0,3.0,2.0
9910528,1,1,0,0,1,0,0,190,0.0,0.0,0.0,0.0,0.0,0.0,0.0,6,1,5,2.0,0.0,2.0
9701237,3,2,1,1,1,2,2,439,2.0,1.0,1.0,1.0,2.0,0.0,0.0,11,3,8,4.0,0.0,4.0
9603329,4,4,0,0,3,1,5,61,0.0,0.0,0.0,0.0,0.0,0.0,0.0,10,4,6,2.0,1.0,1.0
9708347,1,1,0,0,1,0,0,1,0.0,0.0,0.0,0.0,0.0,0.0,0.0,10,1,9,,,
9061,3,3,0,0,0,3,6,40,0.0,0.0,0.0,0.0,0.0,0.0,0.0,7,3,4,2.0,0.0,2.0
204121,0,0,0,0,0,0,0,56,0.0,0.0,0.0,0.0,0.0,0.0,0.0,16,0,16,1.0,0.0,1.0
9907483,3,1,2,3,1,2,2,285,3.0,1.0,2.0,3.0,1.0,2.0,2.0,5,3,2,4.0,3.0,1.0
9812457,1,1,0,0,0,1,1,76,0.0,0.0,0.0,0.0,0.0,0.0,0.0,26,1,25,2.0,0.0,2.0
9610365,2,1,1,1,0,2,5,16,2.0,1.0,1.0,1.0,2.0,0.0,0.0,11,2,9,2.0,2.0,0.0
211153,1,1,0,0,1,0,0,28,1.0,1.0,0.0,0.0,1.0,0.0,0.0,14,1,13,4.0,0.0,4.0
9808471,10,7,3,3,3,7,20,125,4.0,2.0,2.0,2.0,1.0,3.0,9.0,17,10,7,5.0,4.0,1.0
8132,4,3,1,2,0,4,14,2,4.0,3.0,1.0,2.0,4.0,0.0,0.0,11,4,7,2.0,1.0,1.0
9905332,1,1,0,0,0,1,2,129,0.0,0.0,0.0,0.0,0.0,0.0,0.0,8,1,7,2.0,0.0,2.0
8150,14,3,11,29,3,11,49,20,9.0,1.0,8.0,24.0,4.0,5.0,5.0,31,14,17,7.0,6.0,1.0
9606363,1,1,0,0,0,1,1,43,0.0,0.0,0.0,0.0,0.0,0.0,0.0,7,1,6,2.0,0.0,2.0
204118,2,1,1,1,0,2,3,0,2.0,1.0,1.0,1.0,1.0,1.0,1.0,4,2,2,3.0,2.0,1.0
9702256,9,3,6,14,2,7,9,144,9.0,3.0,6.0,14.0,2.0,7.0,9.0,12,9,3,9.0,8.0,1.0
9510438,4,2,2,2,0,4,4,106,2.0,2.0,0.0,0.0,2.0,0.0,0.0,5,4,1,3.0,3.0,0.0
9908510,2,2,0,0,0,2,14,9,1.0,1.0,0.0,0.0,0.0,1.0,8.0,15,2,13,11.0,1.0,10.0
9608208,3,3,0,0,2,1,1,325,1.0,1.0,0.0,0.0,0.0,1.0,1.0,5,3,2,2.0,1.0,1.0
9810454,12,1,11,27,0,12,28,16,9.0,1.0,8.0,23.0,0.0,9.0,16.0,18,12,6,8.0,7.0,1.0
209256,3,2,1,1,0,3,52,21,3.0,2.0,1.0,1.0,0.0,3.0,34.0,78,3,75,10.0,1.0,9.0
10045,1,1,0,0,1,0,0,8,0.0,0.0,0.0,0.0,0.0,0.0,0.0,10,1,9,7.0,0.0,7.0
202174,6,1,5,12,0,6,18,62,6.0,1.0,5.0,12.0,0.0,6.0,18.0,12,6,6,10.0,6.0,4.0
9702203,2,2,0,0,0,2,6,545,1.0,1.0,0.0,0.0,0.0,1.0,1.0,7,2,5,2.0,1.0,1.0
9711515,4,4,0,0,3,1,3,102,1.0,1.0,0.0,0.0,1.0,0.0,0.0,9,4,5,1.0,1.0,0.0
9709279,1,1,0,0,1,0,0,276,0.0,0.0,0.0,0.0,0.0,0.0,0.0,9,1,8,3.0,0.0,3.0
110152,1,1,0,0,0,1,1,138,1.0,1.0,0.0,0.0,1.0,0.0,0.0,6,1,5,2.0,1.0,1.0
9711252,7,3,4,6,0,7,12,110,4.0,2.0,2.0,3.0,0.0,4.0,4.0,11,7,4,4.0,3.0,1.0
202111,6,2,4,4,0,6,39,28,4.0,2.0,2.0,2.0,0.0,4.0,24.0,23,6,17,11.0,3.0,8.0
9809283,2,2,0,0,1,1,1,72,2.0,2.0,0.0,0.0,2.0,0.0,0.0,4,2,2,3.0,2.0,1.0
9611395,3,2,1,1,3,0,0,61,0.0,0.0,0.0,0.0,0.0,0.0,0.0,15,3,12,9.0,0.0,9.0
9902301,5,2,3,3,1,4,8,31,4.0,2.0,2.0,2.0,0.0,4.0,6.0,9,5,4,3.0,2.0,1.0
9704248,8,6,2,2,8,0,0,36,2.0,2.0,0.0,0.0,2.0,0.0,0.0,13,8,5,3.0,2.0,1.0
9310232,2,2,0,0,0,2,2,1532,,,,,,,,4,2,2,1.0,1.0,0.0
9311251,0,0,0,0,0,0,0,10,0.0,0.0,0.0,0.0,0.0,0.0,0.0,8,0,8,1.0,0.0,1.0
9606350,2,1,1,1,1,1,2,53,2.0,1.0,1.0,1.0,2.0,0.0,0.0,6,2,4,,,
9908226,6,1,5,5,6,0,0,65,5.0,1.0,4.0,4.0,5.0,0.0,0.0,6,6,0,3.0,3.0,0.0
9906361,3,2,1,1,0,3,9,104,2.0,1.0,1.0,1.0,0.0,2.0,5.0,17,3,14,6.0,2.0,4.0
9510337,1,1,0,0,1,0,0,29,0.0,0.0,0.0,0.0,0.0,0.0,0.0,8,1,7,5.0,0.0,5.0
108244,10,4,6,8,1,9,122,12,4.0,2.0,2.0,3.0,0.0,4.0,39.0,93,10,83,17.0,2.0,15.0
9907312,2,2,0,0,0,2,5,20,1.0,1.0,0.0,0.0,1.0,0.0,0.0,6,2,4,1.0,1.0,0.0
102189,3,2,1,1,1,2,4,88,2.0,1.0,1.0,1.0,0.0,2.0,4.0,7,3,4,3.0,0.0,3.0
9907344,2,2,0,0,0,2,9,12,0.0,0.0,0.0,0.0,0.0,0.0,0.0,13,2,11,10.0,1.0,9.0
211195,1,1,0,0,0,1,2,7,1.0,1.0,0.0,0.0,0.0,1.0,2.0,12,1,11,3.0,1.0,2.0
201309,4,1,3,3,0,4,7,46,1.0,1.0,0.0,0.0,1.0,0.0,0.0,7,4,3,3.0,2.0,1.0
110133,1,1,0,0,0,1,26,29,0.0,0.0,0.0,0.0,0.0,0.0,0.0,27,1,26,4.0,0.0,4.0
9210224,2,2,0,0,2,0,0,295,2.0,2.0,0.0,0.0,2.0,0.0,0.0,2,2,0,1.0,1.0,0.0
8248,1,1,0,0,0,1,1,32,0.0,0.0,0.0,0.0,0.0,0.0,0.0,33,1,32,3.0,1.0,2.0
9506394,3,3,0,0,0,3,6,78,3.0,3.0,0.0,0.0,1.0,2.0,2.0,6,3,3,3.0,2.0,1.0
109109,1,1,0,0,0,1,6,33,1.0,1.0,0.0,0.0,0.0,1.0,3.0,21,1,20,9.0,1.0,8.0
9312331,1,1,0,0,1,0,0,234,0.0,0.0,0.0,0.0,0.0,0.0,0.0,4,1,3,2.0,0.0,2.0
9907547,7,3,4,9,0,7,44,102,7.0,3.0,4.0,9.0,0.0,7.0,38.0,21,7,14,12.0,6.0,6.0
8166,1,1,0,0,0,1,6,10,0.0,0.0,0.0,0.0,0.0,0.0,0.0,30,1,29,8.0,0.0,8.0
9711299,7,6,1,1,7,0,0,59,3.0,2.0,1.0,1.0,3.0,0.0,0.0,7,7,0,3.0,3.0,0.0
9605203,3,3,0,0,0,3,7,330,1.0,1.0,0.0,0.0,1.0,0.0,0.0,11,3,8,4.0,1.0,3.0
106127,5,4,1,1,0,5,25,21,2.0,2.0,0.0,0.0,0.0,2.0,2.0,27,5,22,8.0,2.0,6.0
9709412,5,3,2,2,0,5,28,79,3.0,1.0,2.0,2.0,0.0,3.0,16.0,33,5,28,10.0,3.0,7.0
9709418,3,3,0,0,0,3,17,38,1.0,1.0,0.0,0.0,0.0,1.0,3.0,20,3,17,5.0,1.0,4.0
2023,5,3,2,3,1,4,20,78,3.0,1.0,2.0,3.0,0.0,3.0,16.0,34,5,29,7.0,1.0,6.0
9604354,1,1,0,0,1,0,0,60,1.0,1.0,0.0,0.0,1.0,0.0,0.0,10,1,9,2.0,1.0,1.0
6277,8,3,5,5,2,6,26,63,4.0,3.0,1.0,1.0,0.0,4.0,16.0,17,8,9,10.0,4.0,6.0
9604246,1,1,0,0,1,0,0,2137,,,,,,,,2,1,1,,,
9607341,4,3,1,2,0,4,6,181,4.0,3.0,1.0,2.0,0.0,4.0,6.0,6,4,2,5.0,3.0,2.0
9509211,6,5,1,1,2,4,7,291,3.0,3.0,0.0,0.0,1.0,2.0,4.0,9,6,3,4.0,2.0,2.0
9710396,1,1,0,0,1,0,0,298,1.0,1.0,0.0,0.0,1.0,0.0,0.0,7,1,6,2.0,0.0,2.0
9910402,1,1,0,0,0,1,3,0,0.0,0.0,0.0,0.0,0.0,0.0,0.0,8,1,7,2.0,1.0,1.0
9909440,3,2,1,2,0,3,24,24,3.0,2.0,1.0,2.0,0.0,3.0,18.0,12,3,9,,,
107217,0,0,0,0,0,0,0,1352,0.0,0.0,0.0,0.0,0.0,0.0,0.0,1,0,1,1.0,0.0,1.0
204144,6,3,3,7,0,6,11,107,6.0,3.0,3.0,7.0,0.0,6.0,11.0,9,6,3,8.0,6.0,2.0
207302,1,1,0,0,0,1,3,48,0.0,0.0,0.0,0.0,0.0,0.0,0.0,67,1,66,7.0,0.0,7.0
9609211,1,1,0,0,1,0,0,12,0.0,0.0,0.0,0.0,0.0,0.0,0.0,8,1,7,1.0,1.0,0.0
302004,0,0,0,0,0,0,0,33,0.0,0.0,0.0,0.0,0.0,0.0,0.0,22,0,22,1.0,0.0,1.0
9910260,4,4,0,0,0,4,13,13,0.0,0.0,0.0,0.0,0.0,0.0,0.0,9,4,5,2.0,0.0,2.0
203033,3,2,1,1,0,3,22,37,1.0,1.0,0.0,0.0,0.0,1.0,6.0,27,3,24,7.0,1.0,6.0
9710305,4,2,2,3,2,2,3,91,3.0,1.0,2.0,3.0,2.0,1.0,2.0,7,4,3,5.0,3.0,2.0
9902453,5,2,3,3,0,5,25,107,5.0,2.0,3.0,3.0,0.0,5.0,20.0,40,5,35,9.0,5.0,4.0
9507456,6,5,1,1,6,0,0,247,2.0,2.0,0.0,0.0,2.0,0.0,0.0,6,6,0,2.0,2.0,0.0
11003,4,2,2,2,0,4,39,40,4.0,2.0,2.0,2.0,0.0,4.0,38.0,22,4,18,7.0,1.0,6.0
209274,0,0,0,0,0,0,0,1,0.0,0.0,0.0,0.0,0.0,0.0,0.0,18,0,18,5.0,0.0,5.0
204332,4,3,1,1,0,4,25,165,4.0,3.0,1.0,1.0,0.0,4.0,25.0,16,4,12,14.0,4.0,10.0
107185,4,3,1,1,0,4,19,113,4.0,3.0,1.0,1.0,1.0,3.0,13.0,17,4,13,10.0,3.0,7.0
9812416,1,1,0,0,0,1,4,11,0.0,0.0,0.0,0.0,0.0,0.0,0.0,12,1,11,2.0,0.0,2.0
8146,1,1,0,0,0,1,2,45,1.0,1.0,0.0,0.0,0.0,1.0,1.0,3,1,2,1.0,0.0,1.0
9803486,8,8,0,0,8,0,0,148,5.0,5.0,0.0,0.0,5.0,0.0,0.0,8,8,0,3.0,3.0,0.0
107176,7,5,2,2,2,5,36,260,3.0,3.0,0.0,0.0,0.0,3.0,15.0,27,7,20,9.0,3.0,6.0
111338,3,3,0,0,0,3,32,53,2.0,2.0,0.0,0.0,0.0,2.0,31.0,43,3,40,35.0,1.0,34.0
9903362,3,2,1,1,2,1,1,26,2.0,1.0,1.0,1.0,2.0,0.0,0.0,11,3,8,2.0,2.0,0.0
211041,1,1,0,0,0,1,7,25,1.0,1.0,0.0,0.0,0.0,1.0,7.0,13,1,12,10.0,1.0,9.0
9904246,4,2,2,2,0,4,41,90,3.0,1.0,2.0,2.0,0.0,3.0,24.0,21,4,17,11.0,3.0,8.0
9703282,0,0,0,0,0,0,0,224,0.0,0.0,0.0,0.0,0.0,0.0,0.0,2,0,2,2.0,0.0,2.0
9701265,1,1,0,0,1,0,0,663,1.0,1.0,0.0,0.0,1.0,0.0,0.0,2,1,1,1.0,1.0,0.0
9210210,3,1,2,2,3,0,0,178,3.0,1.0,2.0,2.0,3.0,0.0,0.0,3,3,0,3.0,3.0,0.0
210331,4,3,1,1,0,4,20,38,4.0,3.0,1.0,1.0,0.0,4.0,20.0,12,4,8,4.0,2.0,2.0
6099,3,2,1,1,0,3,13,3,0.0,0.0,0.0,0.0,0.0,0.0,0.0,29,3,26,8.0,0.0,8.0
209057,0,0,0,0,0,0,0,107,0.0,0.0,0.0,0.0,0.0,0.0,0.0,16,0,16,7.0,0.0,7.0
207358,4,3,1,2,0,4,11,53,3.0,2.0,1.0,2.0,0.0,3.0,8.0,16,4,12,3.0,0.0,3.0
301265,0,0,0,0,0,0,0,23,0.0,0.0,0.0,0.0,0.0,0.0,0.0,13,0,13,8.0,0.0,8.0
9906528,4,2,2,2,0,4,8,798,1.0,1.0,0.0,0.0,0.0,1.0,1.0,11,4,7,5.0,3.0,2.0
206105,1,1,0,0,0,1,9,7,1.0,1.0,0.0,0.0,0.0,1.0,5.0,23,1,22,8.0,1.0,7.0
9908475,6,2,4,10,0,6,26,161,5.0,2.0,3.0,9.0,0.0,5.0,25.0,13,6,7,11.0,5.0,6.0
212101,0,0,0,0,0,0,0,106,0.0,0.0,0.0,0.0,0.0,0.0,0.0,7,0,7,6.0,0.0,6.0
9711393,4,2,2,3,1,3,4,1050,3.0,2.0,1.0,1.0,0.0,3.0,4.0,6,4,2,5.0,3.0,2.0
10054,2,1,1,1,0,2,37,82,2.0,1.0,1.0,1.0,0.0,2.0,27.0,40,2,38,20.0,1.0,19.0
111015,4,2,2,2,0,4,21,51,4.0,2.0,2.0,2.0,0.0,4.0,14.0,11,4,7,7.0,4.0,3.0
209126,1,1,0,0,0,1,2,37,1.0,1.0,0.0,0.0,0.0,1.0,2.0,7,1,6,1.0,1.0,0.0
9407325,5,5,0,0,5,0,0,132,3.0,3.0,0.0,0.0,3.0,0.0,0.0,6,5,1,2.0,2.0,0.0
103051,5,3,2,2,2,3,3,353,5.0,3.0,2.0,2.0,2.0,3.0,3.0,6,5,1,4.0,3.0,1.0
9907556,5,2,3,4,0,5,46,68,5.0,2.0,3.0,4.0,0.0,5.0,25.0,25,5,20,10.0,4.0,6.0
9905499,8,3,5,9,1,7,14,262,6.0,1.0,5.0,9.0,0.0,6.0,12.0,17,8,9,10.0,6.0,4.0
9509214,2,1,1,1,0,2,6,76,2.0,1.0,1.0,1.0,0.0,2.0,6.0,6,2,4,5.0,2.0,3.0
9610422,0,0,0,0,0,0,0,130,0.0,0.0,0.0,0.0,0.0,0.0,0.0,4,0,4,,,
1283,0,0,0,0,0,0,0,114,0.0,0.0,0.0,0.0,0.0,0.0,0.0,9,0,9,2.0,0.0,2.0
106327,2,1,1,1,0,2,29,32,2.0,1.0,1.0,1.0,0.0,2.0,21.0,32,2,30,20.0,1.0,19.0
205327,5,5,0,0,0,5,38,2,2.0,2.0,0.0,0.0,0.0,2.0,17.0,36,5,31,14.0,2.0,12.0
9905444,6,1,5,10,0,6,17,44,6.0,1.0,5.0,10.0,0.0,6.0,17.0,11,6,5,10.0,6.0,4.0
9709218,0,0,0,0,0,0,0,148,,,,,,,,1,0,1,,,
9708238,3,2,1,1,3,0,0,268,2.0,1.0,1.0,1.0,2.0,0.0,0.0,3,3,0,2.0,2.0,0.0
302162,0,0,0,0,0,0,0,126,0.0,0.0,0.0,0.0,0.0,0.0,0.0,3,0,3,1.0,0.0,1.0
9812274,6,1,5,12,0,6,11,85,5.0,1.0,4.0,10.0,0.0,5.0,6.0,13,6,7,8.0,6.0,2.0
211320,0,0,0,0,0,0,0,101,0.0,0.0,0.0,0.0,0.0,0.0,0.0,4,0,4,1.0,0.0,1.0
108254,1,1,0,0,1,0,0,146,,,,,,,,1,1,0,,,
9906211,8,4,4,6,1,7,14,254,8.0,4.0,4.0,6.0,1.0,7.0,10.0,11,8,3,7.0,5.0,2.0
112242,5,2,3,4,0,5,29,202,5.0,2.0,3.0,4.0,0.0,5.0,18.0,28,5,23,9.0,4.0,5.0
111461,0,0,0,0,0,0,0,76,0.0,0.0,0.0,0.0,0.0,0.0,0.0,14,0,14,8.0,0.0,8.0
212130,1,1,0,0,1,0,0,628,1.0,1.0,0.0,0.0,1.0,0.0,0.0,7,1,6,2.0,1.0,1.0
207055,5,5,0,0,1,4,52,33,3.0,3.0,0.0,0.0,0.0,3.0,37.0,74,5,69,26.0,1.0,25.0
208102,2,2,0,0,0,2,6,2,1.0,1.0,0.0,0.0,0.0,1.0,2.0,33,2,31,2.0,0.0,2.0
9909319,0,0,0,0,0,0,0,1966,0.0,0.0,0.0,0.0,0.0,0.0,0.0,2,0,2,1.0,0.0,1.0
9905333,2,2,0,0,2,0,0,448,1.0,1.0,0.0,0.0,1.0,0.0,0.0,5,2,3,1.0,1.0,0.0
101267,3,1,2,3,1,2,13,166,2.0,1.0,1.0,1.0,0.0,2.0,11.0,13,3,10,7.0,2.0,5.0
9801296,0,0,0,0,0,0,0,15,,,,,,,,10,0,10,2.0,0.0,2.0
103332,3,3,0,0,0,3,27,45,3.0,3.0,0.0,0.0,0.0,3.0,27.0,17,3,14,17.0,3.0,14.0
9607327,1,1,0,0,1,0,0,94,,,,,,,,1,1,0,,,
9405286,1,1,0,0,0,1,1,96,0.0,0.0,0.0,0.0,0.0,0.0,0.0,8,1,7,,,
112330,1,1,0,0,0,1,1,65,0.0,0.0,0.0,0.0,0.0,0.0,0.0,6,1,5,,,
9701382,0,0,0,0,0,0,0,231,0.0,0.0,0.0,0.0,0.0,0.0,0.0,5,0,5,,,
9908325,2,2,0,0,0,2,6,0,1.0,1.0,0.0,0.0,0.0,1.0,2.0,10,2,8,2.0,1.0,1.0
9607274,3,2,1,1,1,2,2,70,2.0,1.0,1.0,1.0,0.0,2.0,2.0,5,3,2,3.0,2.0,1.0
104129,8,3,5,9,0,8,98,2,8.0,3.0,5.0,9.0,0.0,8.0,64.0,35,8,27,21.0,5.0,16.0
206070,7,4,3,3,0,7,58,30,5.0,3.0,2.0,2.0,0.0,5.0,20.0,54,7,47,10.0,1.0,9.0
9804325,1,1,0,0,0,1,4,10,1.0,1.0,0.0,0.0,0.0,1.0,2.0,26,1,25,1.0,0.0,1.0
112017,1,1,0,0,1,0,0,172,1.0,1.0,0.0,0.0,1.0,0.0,0.0,2,1,1,1.0,1.0,0.0
9308354,0,0,0,0,0,0,0,1452,,,,,,,,2,0,2,,,
103313,4,4,0,0,0,4,14,24,2.0,2.0,0.0,0.0,0.0,2.0,2.0,34,4,30,6.0,0.0,6.0
109073,0,0,0,0,0,0,0,477,0.0,0.0,0.0,0.0,0.0,0.0,0.0,7,0,7,1.0,0.0,1.0
9901212,0,0,0,0,0,0,0,203,0.0,0.0,0.0,0.0,0.0,0.0,0.0,4,0,4,,,
9801232,4,1,3,5,4,0,0,96,3.0,1.0,2.0,3.0,3.0,0.0,0.0,5,4,1,1.0,1.0,0.0
111222,1,1,0,0,0,1,11,5,1.0,1.0,0.0,0.0,0.0,1.0,4.0,24,1,23,13.0,1.0,12.0
9611441,3,2,1,1,2,1,3,236,2.0,1.0,1.0,1.0,1.0,1.0,2.0,7,3,4,4.0,2.0,2.0
9907324,0,0,0,0,0,0,0,77,0.0,0.0,0.0,0.0,0.0,0.0,0.0,6,0,6,1.0,0.0,1.0
9710246,3,3,0,0,0,3,10,10,1.0,1.0,0.0,0.0,0.0,1.0,2.0,16,3,13,3.0,1.0,2.0
101202,0,0,0,0,0,0,0,21,0.0,0.0,0.0,0.0,0.0,0.0,0.0,39,0,39,11.0,0.0,11.0
205268,0,0,0,0,0,0,0,37,0.0,0.0,0.0,0.0,0.0,0.0,0.0,6,0,6,1.0,0.0,1.0
208129,1,1,0,0,0,1,12,37,0.0,0.0,0.0,0.0,0.0,0.0,0.0,58,1,57,25.0,0.0,25.0
9512322,2,1,1,1,0,2,7,133,2.0,1.0,1.0,1.0,0.0,2.0,4.0,11,2,9,3.0,2.0,1.0
9910207,3,2,1,1,0,3,4,674,1.0,1.0,0.0,0.0,1.0,0.0,0.0,6,3,3,2.0,2.0,0.0
9809240,1,1,0,0,1,0,0,86,0.0,0.0,0.0,0.0,0.0,0.0,0.0,17,1,16,1.0,0.0,1.0
111056,1,1,0,0,1,0,0,50,0.0,0.0,0.0,0.0,0.0,0.0,0.0,9,1,8,,,
9712226,0,0,0,0,0,0,0,61,0.0,0.0,0.0,0.0,0.0,0.0,0.0,7,0,7,2.0,0.0,2.0
9259,1,1,0,0,0,1,3,52,1.0,1.0,0.0,0.0,0.0,1.0,3.0,4,1,3,3.0,1.0,2.0
205088,4,4,0,0,1,3,35,37,2.0,2.0,0.0,0.0,0.0,2.0,22.0,27,4,23,15.0,2.0,13.0
9501211,0,0,0,0,0,0,0,835,,,,,,,,3,0,3,,,
9807382,6,5,1,1,0,6,13,76,6.0,5.0,1.0,1.0,1.0,5.0,9.0,9,6,3,7.0,5.0,2.0
11198,2,1,1,1,1,1,1,21,0.0,0.0,0.0,0.0,0.0,0.0,0.0,11,2,9,1.0,1.0,0.0
212351,4,4,0,0,0,4,6,9,2.0,2.0,0.0,0.0,0.0,2.0,2.0,15,4,11,7.0,3.0,4.0
9511406,3,3,0,0,0,3,3,232,3.0,3.0,0.0,0.0,0.0,3.0,3.0,6,3,3,5.0,3.0,2.0
206250,0,0,0,0,0,0,0,18,0.0,0.0,0.0,0.0,0.0,0.0,0.0,10,0,10,1.0,0.0,1.0
9405387,2,1,1,1,2,0,0,237,2.0,1.0,1.0,1.0,2.0,0.0,0.0,2,2,0,2.0,2.0,0.0
110384,0,0,0,0,0,0,0,8,,,,,,,,5,0,5,,,
203073,1,1,0,0,0,1,3,230,1.0,1.0,0.0,0.0,0.0,1.0,2.0,7,1,6,3.0,1.0,2.0
209016,2,2,0,0,1,1,3,71,0.0,0.0,0.0,0.0,0.0,0.0,0.0,12,2,10,1.0,0.0,1.0
9503469,1,1,0,0,1,0,0,116,1.0,1.0,0.0,0.0,1.0,0.0,0.0,2,1,1,1.0,1.0,0.0
9711407,0,0,0,0,0,0,0,4,,,,,,,,9,0,9,1.0,0.0,1.0
9906439,3,1,2,2,0,3,8,383,3.0,1.0,2.0,2.0,0.0,3.0,8.0,7,3,4,6.0,3.0,3.0
205317,0,0,0,0,0,0,0,18,0.0,0.0,0.0,0.0,0.0,0.0,0.0,13,0,13,1.0,0.0,1.0
9312330,1,1,0,0,0,1,2,378,1.0,1.0,0.0,0.0,0.0,1.0,1.0,3,1,2,2.0,1.0,1.0
9706521,0,0,0,0,0,0,0,249,0.0,0.0,0.0,0.0,0.0,0.0,0.0,1,0,1,1.0,0.0,1.0
9711269,2,2,0,0,0,2,11,6,0.0,0.0,0.0,0.0,0.0,0.0,0.0,25,2,23,10.0,1.0,9.0
9404345,3,2,1,1,3,0,0,507,3.0,2.0,1.0,1.0,3.0,0.0,0.0,3,3,0,3.0,3.0,0.0
103296,2,2,0,0,2,0,0,47,0.0,0.0,0.0,0.0,0.0,0.0,0.0,12,2,10,1.0,1.0,0.0
9705332,0,0,0,0,0,0,0,603,0.0,0.0,0.0,0.0,0.0,0.0,0.0,1,0,1,1.0,0.0,1.0
8337,3,3,0,0,2,1,2,197,1.0,1.0,0.0,0.0,0.0,1.0,2.0,8,3,5,2.0,0.0,2.0
9612242,1,1,0,0,0,1,1,52,0.0,0.0,0.0,0.0,0.0,0.0,0.0,4,1,3,2.0,1.0,1.0
7220,5,3,2,2,0,5,43,12,2.0,2.0,0.0,0.0,0.0,2.0,8.0,49,5,44,7.0,2.0,5.0
104023,1,1,0,0,0,1,7,40,0.0,0.0,0.0,0.0,0.0,0.0,0.0,41,1,40,17.0,0.0,17.0
111328,4,3,1,1,0,4,31,42,2.0,2.0,0.0,0.0,0.0,2.0,14.0,35,4,31,17.0,2.0,15.0
9912222,1,1,0,0,0,1,1,347,1.0,1.0,0.0,0.0,0.0,1.0,1.0,3,1,2,2.0,1.0,1.0
7019,0,0,0,0,0,0,0,72,,,,,,,,1,0,1,,,
110292,1,1,0,0,0,1,16,44,0.0,0.0,0.0,0.0,0.0,0.0,0.0,69,1,68,14.0,1.0,13.0
208264,3,1,2,2,2,1,1,568,3.0,1.0,2.0,2.0,3.0,0.0,0.0,4,3,1,2.0,2.0,0.0
9603418,1,1,0,0,1,0,0,679,0.0,0.0,0.0,0.0,0.0,0.0,0.0,10,1,9,1.0,1.0,0.0
9912273,2,2,0,0,1,1,2,137,1.0,1.0,0.0,0.0,0.0,1.0,1.0,18,2,16,7.0,0.0,7.0
7200,1,1,0,0,0,1,1,12,1.0,1.0,0.0,0.0,1.0,0.0,0.0,8,1,7,1.0,1.0,0.0
9804278,1,1,0,0,0,1,1,803,1.0,1.0,0.0,0.0,0.0,1.0,1.0,4,1,3,2.0,1.0,1.0
9403332,3,3,0,0,1,2,7,250,2.0,2.0,0.0,0.0,0.0,2.0,5.0,8,3,5,5.0,2.0,3.0
103085,0,0,0,0,0,0,0,157,0.0,0.0,0.0,0.0,0.0,0.0,0.0,12,0,12,4.0,0.0,4.0
9901425,0,0,0,0,0,0,0,14,0.0,0.0,0.0,0.0,0.0,0.0,0.0,16,0,16,7.0,0.0,7.0
3269,4,3,1,2,3,1,1,463,4.0,3.0,1.0,2.0,3.0,1.0,1.0,8,4,4,4.0,3.0,1.0
9302321,2,2,0,0,2,0,0,369,2.0,2.0,0.0,0.0,2.0,0.0,0.0,3,2,1,1.0,1.0,0.0
9803234,0,0,0,0,0,0,0,72,,,,,,,,2,0,2,1.0,0.0,1.0
9412399,4,2,2,2,4,0,0,382,2.0,1.0,1.0,1.0,2.0,0.0,0.0,4,4,0,2.0,2.0,0.0
9906511,0,0,0,0,0,0,0,1277,,,,,,,,2,0,2,,,
9808403,3,2,1,1,2,1,1,151,0.0,0.0,0.0,0.0,0.0,0.0,0.0,6,3,3,2.0,2.0,0.0
111014,2,1,1,1,0,2,24,12,1.0,1.0,0.0,0.0,0.0,1.0,6.0,20,2,18,4.0,2.0,2.0
208127,0,0,0,0,0,0,0,1354,,,,,,,,3,0,3,,,
9402216,2,2,0,0,2,0,0,680,1.0,1.0,0.0,0.0,1.0,0.0,0.0,2,2,0,1.0,1.0,0.0
9508371,0,0,0,0,0,0,0,332,0.0,0.0,0.0,0.0,0.0,0.0,0.0,3,0,3,,,
9312230,3,2,1,1,3,0,0,298,2.0,1.0,1.0,1.0,2.0,0.0,0.0,3,3,0,2.0,2.0,0.0
9809394,1,1,0,0,0,1,4,175,1.0,1.0,0.0,0.0,0.0,1.0,4.0,10,1,9,8.0,1.0,7.0
102107,0,0,0,0,0,0,0,76,0.0,0.0,0.0,0.0,0.0,0.0,0.0,10,0,10,9.0,0.0,9.0
9607248,7,2,5,10,7,0,0,314,7.0,2.0,5.0,10.0,7.0,0.0,0.0,9,7,2,6.0,6.0,0.0
9601207,0,0,0,0,0,0,0,682,0.0,0.0,0.0,0.0,0.0,0.0,0.0,1,0,1,1.0,0.0,1.0
8036,1,1,0,0,0,1,1,52,0.0,0.0,0.0,0.0,0.0,0.0,0.0,12,1,11,2.0,0.0,2.0
212033,1,1,0,0,0,1,6,13,0.0,0.0,0.0,0.0,0.0,0.0,0.0,25,1,24,8.0,0.0,8.0
105251,2,1,1,1,1,1,1,502,2.0,1.0,1.0,1.0,1.0,1.0,1.0,3,2,1,3.0,2.0,1.0
9512353,1,1,0,0,1,0,0,911,,,,,,,,2,1,1,,,
9912393,4,2,2,3,0,4,16,145,4.0,2.0,2.0,3.0,0.0,4.0,13.0,10,4,6,8.0,4.0,4.0
6100,0,0,0,0,0,0,0,1021,,,,,,,,1,0,1,,,
206222,2,2,0,0,0,2,8,66,1.0,1.0,0.0,0.0,0.0,1.0,1.0,13,2,11,3.0,2.0,1.0
9903219,0,0,0,0,0,0,0,359,0.0,0.0,0.0,0.0,0.0,0.0,0.0,8,0,8,1.0,0.0,1.0
9705456,7,2,5,6,5,2,2,125,5.0,1.0,4.0,5.0,5.0,0.0,0.0,8,7,1,5.0,5.0,0.0
301194,0,0,0,0,0,0,0,38,0.0,0.0,0.0,0.0,0.0,0.0,0.0,7,0,7,5.0,0.0,5.0
9510328,0,0,0,0,0,0,0,342,0.0,0.0,0.0,0.0,0.0,0.0,0.0,1,0,1,1.0,0.0,1.0
9909223,0,0,0,0,0,0,0,1904,,,,,,,,3,0,3,,,
9808490,0,0,0,0,0,0,0,8,0.0,0.0,0.0,0.0,0.0,0.0,0.0,7,0,7,5.0,0.0,5.0
105002,0,0,0,0,0,0,0,1678,,,,,,,,6,0,6,,,
211023,5,2,3,4,0,5,38,2,4.0,1.0,3.0,4.0,0.0,4.0,31.0,25,5,20,21.0,4.0,17.0
9610554,0,0,0,0,0,0,0,11,0.0,0.0,0.0,0.0,0.0,0.0,0.0,12,0,12,4.0,0.0,4.0
9609424,0,0,0,0,0,0,0,1927,0.0,0.0,0.0,0.0,0.0,0.0,0.0,1,0,1,,,
103026,0,0,0,0,0,0,0,0,,,,,,,,9,0,9,,,
9307289,2,2,0,0,2,0,0,790,1.0,1.0,0.0,0.0,1.0,0.0,0.0,2,2,0,2.0,2.0,0.0
9805202,0,0,0,0,0,0,0,1172,,,,,,,,3,0,3,2.0,0.0,2.0
110090,1,1,0,0,0,1,1,254,1.0,1.0,0.0,0.0,0.0,1.0,1.0,2,1,1,2.0,1.0,1.0
302159,0,0,0,0,0,0,0,128,0.0,0.0,0.0,0.0,0.0,0.0,0.0,5,0,5,1.0,0.0,1.0
111322,3,1,2,3,0,3,12,104,3.0,1.0,2.0,3.0,0.0,3.0,9.0,8,3,5,6.0,3.0,3.0
6052,0,0,0,0,0,0,0,2,,,,,,,,7,0,7,,,
206189,1,1,0,0,0,1,2,155,1.0,1.0,0.0,0.0,0.0,1.0,2.0,6,1,5,3.0,1.0,2.0
1319,3,3,0,0,3,0,0,377,2.0,2.0,0.0,0.0,2.0,0.0,0.0,11,3,8,1.0,1.0,0.0
9603319,0,0,0,0,0,0,0,30,0.0,0.0,0.0,0.0,0.0,0.0,0.0,7,0,7,2.0,0.0,2.0
9911205,0,0,0,0,0,0,0,200,0.0,0.0,0.0,0.0,0.0,0.0,0.0,13,0,13,2.0,0.0,2.0
9501328,0,0,0,0,0,0,0,87,0.0,0.0,0.0,0.0,0.0,0.0,0.0,6,0,6,1.0,0.0,1.0
9606228,0,0,0,0,0,0,0,315,0.0,0.0,0.0,0.0,0.0,0.0,0.0,4,0,4,,,
9904327,2,2,0,0,0,2,4,284,2.0,2.0,0.0,0.0,0.0,2.0,4.0,13,2,11,10.0,2.0,8.0
9909283,1,1,0,0,1,0,0,44,1.0,1.0,0.0,0.0,1.0,0.0,0.0,4,1,3,1.0,1.0,0.0
104139,2,2,0,0,0,2,2,38,1.0,1.0,0.0,0.0,1.0,0.0,0.0,17,2,15,3.0,0.0,3.0
9409368,0,0,0,0,0,0,0,1281,,,,,,,,1,0,1,,,
108052,0,0,0,0,0,0,0,310,0.0,0.0,0.0,0.0,0.0,0.0,0.0,1,0,1,,,
110343,1,1,0,0,0,1,3,1362,,,,,,,,6,1,5,,,
9910443,1,1,0,0,0,1,1,31,1.0,1.0,0.0,0.0,1.0,0.0,0.0,4,1,3,1.0,1.0,0.0
9812312,1,1,0,0,1,0,0,1026,0.0,0.0,0.0,0.0,0.0,0.0,0.0,4,1,3,1.0,1.0,0.0
9808282,0,0,0,0,0,0,0,291,0.0,0.0,0.0,0.0,0.0,0.0,0.0,3,0,3,1.0,0.0,1.0
103055,1,1,0,0,0,1,7,2,1.0,1.0,0.0,0.0,0.0,1.0,4.0,24,1,23,2.0,1.0,1.0
211129,1,1,0,0,1,0,0,698,1.0,1.0,0.0,0.0,1.0,0.0,0.0,1,1,0,1.0,1.0,0.0
212083,1,1,0,0,0,1,4,24,0.0,0.0,0.0,0.0,0.0,0.0,0.0,22,1,21,7.0,1.0,6.0
204068,1,1,0,0,0,1,45,34,1.0,1.0,0.0,0.0,0.0,1.0,37.0,82,1,81,29.0,1.0,28.0
104229,1,1,0,0,1,0,0,175,1.0,1.0,0.0,0.0,1.0,0.0,0.0,2,1,1,1.0,1.0,0.0
7098,3,2,1,1,0,3,10,90,3.0,2.0,1.0,1.0,0.0,3.0,10.0,14,3,11,5.0,3.0,2.0
9808365,0,0,0,0,0,0,0,272,0.0,0.0,0.0,0.0,0.0,0.0,0.0,7,0,7,3.0,0.0,3.0
10236,0,0,0,0,0,0,0,262,0.0,0.0,0.0,0.0,0.0,0.0,0.0,6,0,6,6.0,0.0,6.0
9705342,0,0,0,0,0,0,0,174,0.0,0.0,0.0,0.0,0.0,0.0,0.0,5,0,5,2.0,0.0,2.0
207011,0,0,0,0,0,0,0,472,0.0,0.0,0.0,0.0,0.0,0.0,0.0,2,0,2,2.0,0.0,2.0
9506296,0,0,0,0,0,0,0,10,,,,,,,,6,0,6,,,
207195,1,1,0,0,0,1,8,40,1.0,1.0,0.0,0.0,0.0,1.0,5.0,11,1,10,7.0,1.0,6.0
8011,0,0,0,0,0,0,0,15,0.0,0.0,0.0,0.0,0.0,0.0,0.0,41,0,41,4.0,0.0,4.0
202168,2,2,0,0,1,1,7,103,1.0,1.0,0.0,0.0,0.0,1.0,4.0,15,2,13,4.0,0.0,4.0
210099,1,1,0,0,0,1,1,187,1.0,1.0,0.0,0.0,0.0,1.0,1.0,3,1,2,2.0,1.0,1.0
212241,0,0,0,0,0,0,0,282,0.0,0.0,0.0,0.0,0.0,0.0,0.0,9,0,9,5.0,0.0,5.0
102110,1,1,0,0,1,0,0,44,0.0,0.0,0.0,0.0,0.0,0.0,0.0,6,1,5,2.0,0.0,2.0
301108,0,0,0,0,0,0,0,116,0.0,0.0,0.0,0.0,0.0,0.0,0.0,15,0,15,2.0,0.0,2.0
9512276,0,0,0,0,0,0,0,1273,,,,,,,,1,0,1,,,
104002,3,1,2,2,0,3,20,2,2.0,1.0,1.0,1.0,0.0,2.0,4.0,22,3,19,8.0,2.0,6.0
210161,3,2,1,1,0,3,39,24,2.0,2.0,0.0,0.0,0.0,2.0,29.0,42,3,39,29.0,1.0,28.0
9610465,0,0,0,0,0,0,0,484,0.0,0.0,0.0,0.0,0.0,0.0,0.0,3,0,3,1.0,0.0,1.0
212088,0,0,0,0,0,0,0,57,0.0,0.0,0.0,0.0,0.0,0.0,0.0,9,0,9,1.0,0.0,1.0
9608455,0,0,0,0,0,0,0,203,0.0,0.0,0.0,0.0,0.0,0.0,0.0,1,0,1,,,
9706308,1,1,0,0,0,1,1,284,1.0,1.0,0.0,0.0,0.0,1.0,1.0,4,1,3,4.0,1.0,3.0
9709268,0,0,0,0,0,0,0,148,0.0,0.0,0.0,0.0,0.0,0.0,0.0,4,0,4,4.0,0.0,4.0
212169,2,2,0,0,0,2,9,2,1.0,1.0,0.0,0.0,0.0,1.0,3.0,51,2,49,16.0,0.0,16.0
9812462,0,0,0,0,0,0,0,122,0.0,0.0,0.0,0.0,0.0,0.0,0.0,7,0,7,1.0,0.0,1.0
2140,1,1,0,0,0,1,2,111,0.0,0.0,0.0,0.0,0.0,0.0,0.0,3,1,2,1.0,0.0,1.0
302130,0,0,0,0,0,0,0,76,0.0,0.0,0.0,0.0,0.0,0.0,0.0,20,0,20,6.0,0.0,6.0
9506219,2,2,0,0,2,0,0,363,0.0,0.0,0.0,0.0,0.0,0.0,0.0,5,2,3,1.0,0.0,1.0
106164,0,0,0,0,0,0,0,21,,,,,,,,6,0,6,,,
9903269,1,1,0,0,1,0,0,311,0.0,0.0,0.0,0.0,0.0,0.0,0.0,2,1,1,1.0,0.0,1.0
9910258,0,0,0,0,0,0,0,1633,,,,,,,,3,0,3,,,
211032,0,0,0,0,0,0,0,20,0.0,0.0,0.0,0.0,0.0,0.0,0.0,4,0,4,,,
101356,0,0,0,0,0,0,0,120,0.0,0.0,0.0,0.0,0.0,0.0,0.0,9,0,9,7.0,0.0,7.0
207105,0,0,0,0,0,0,0,249,0.0,0.0,0.0,0.0,0.0,0.0,0.0,7,0,7,2.0,0.0,2.0
9310328,0,0,0,0,0,0,0,1960,,,,,,,,1,0,1,1.0,0.0,1.0
101028,0,0,0,0,0,0,0,309,0.0,0.0,0.0,0.0,0.0,0.0,0.0,2,0,2,1.0,0.0,1.0
301016,0,0,0,0,0,0,0,0,,,,,,,,8,0,8,1.0,0.0,1.0
211060,0,0,0,0,0,0,0,27,0.0,0.0,0.0,0.0,0.0,0.0,0.0,16,0,16,4.0,0.0,4.0
111239,0,0,0,0,0,0,0,392,0.0,0.0,0.0,0.0,0.0,0.0,0.0,4,0,4,1.0,0.0,1.0
6193,0,0,0,0,0,0,0,66,,,,,,,,4,0,4,,,
101265,1,1,0,0,0,1,7,30,1.0,1.0,0.0,0.0,0.0,1.0,3.0,11,1,10,4.0,1.0,3.0
9811319,0,0,0,0,0,0,0,275,0.0,0.0,0.0,0.0,0.0,0.0,0.0,6,0,6,4.0,0.0,4.0
205304,1,1,0,0,0,1,2,71,0.0,0.0,0.0,0.0,0.0,0.0,0.0,10,1,9,8.0,0.0,8.0
9609305,1,1,0,0,0,1,4,29,1.0,1.0,0.0,0.0,0.0,1.0,4.0,7,1,6,5.0,1.0,4.0
9320,0,0,0,0,0,0,0,80,0.0,0.0,0.0,0.0,0.0,0.0,0.0,7,0,7,3.0,0.0,3.0
110130,1,1,0,0,0,1,1,20,0.0,0.0,0.0,0.0,0.0,0.0,0.0,19,1,18,6.0,0.0,6.0
9606401,1,1,0,0,1,0,0,153,1.0,1.0,0.0,0.0,1.0,0.0,0.0,1,1,0,,,
9604368,1,1,0,0,1,0,0,574,1.0,1.0,0.0,0.0,1.0,0.0,0.0,1,1,0,1.0,1.0,0.0
107267,2,1,1,1,0,2,17,256,2.0,1.0,1.0,1.0,0.0,2.0,16.0,12,2,10,10.0,2.0,8.0
210444,0,0,0,0,0,0,0,95,0.0,0.0,0.0,0.0,0.0,0.0,0.0,10,0,10,3.0,0.0,3.0
9707202,5,1,4,9,3,2,8,316,5.0,1.0,4.0,9.0,3.0,2.0,2.0,9,5,4,6.0,5.0,1.0
9711237,2,1,1,1,0,2,8,17,0.0,0.0,0.0,0.0,0.0,0.0,0.0,23,2,21,2.0,0.0,2.0
9602228,0,0,0,0,0,0,0,544,0.0,0.0,0.0,0.0,0.0,0.0,0.0,8,0,8,1.0,0.0,1.0
206279,3,2,1,1,0,3,86,11,3.0,2.0,1.0,1.0,0.0,3.0,85.0,46,3,43,41.0,3.0,38.0
206146,0,0,0,0,0,0,0,203,0.0,0.0,0.0,0.0,0.0,0.0,0.0,8,0,8,1.0,0.0,1.0
9509301,0,0,0,0,0,0,0,250,0.0,0.0,0.0,0.0,0.0,0.0,0.0,5,0,5,1.0,0.0,1.0
9901269,0,0,0,0,0,0,0,70,0.0,0.0,0.0,0.0,0.0,0.0,0.0,6,0,6,,,
211090,0,0,0,0,0,0,0,14,0.0,0.0,0.0,0.0,0.0,0.0,0.0,11,0,11,2.0,0.0,2.0
9910463,0,0,0,0,0,0,0,87,0.0,0.0,0.0,0.0,0.0,0.0,0.0,9,0,9,3.0,0.0,3.0
9701258,0,0,0,0,0,0,0,229,0.0,0.0,0.0,0.0,0.0,0.0,0.0,3,0,3,2.0,0.0,2.0
301078,1,1,0,0,0,1,5,121,1.0,1.0,0.0,0.0,0.0,1.0,2.0,14,1,13,4.0,0.0,4.0
103116,0,0,0,0,0,0,0,5,,,,,,,,9,0,9,1.0,0.0,1.0
9806446,0,0,0,0,0,0,0,341,0.0,0.0,0.0,0.0,0.0,0.0,0.0,4,0,4,2.0,0.0,2.0
212111,0,0,0,0,0,0,0,1706,,,,,,,,6,0,6,1.0,0.0,1.0
9708309,1,1,0,0,0,1,1,1526,1.0,1.0,0.0,0.0,1.0,0.0,0.0,2,1,1,1.0,1.0,0.0
105219,0,0,0,0,0,0,0,2123,,,,,,,,1,0,1,,,
9903243,1,1,0,0,0,1,3,111,1.0,1.0,0.0,0.0,0.0,1.0,3.0,4,1,3,1.0,1.0,0.0
2069,0,0,0,0,0,0,0,36,0.0,0.0,0.0,0.0,0.0,0.0,0.0,9,0,9,2.0,0.0,2.0
11284,0,0,0,0,0,0,0,130,0.0,0.0,0.0,0.0,0.0,0.0,0.0,8,0,8,6.0,0.0,6.0
111238,0,0,0,0,0,0,0,159,0.0,0.0,0.0,0.0,0.0,0.0,0.0,7,0,7,1.0,0.0,1.0
302082,0,0,0,0,0,0,0,0,0.0,0.0,0.0,0.0,0.0,0.0,0.0,45,0,45,19.0,0.0,19.0
9403309,0,0,0,0,0,0,0,1747,,,,,,,,1,0,1,,,
9406297,0,0,0,0,0,0,0,478,0.0,0.0,0.0,0.0,0.0,0.0,0.0,3,0,3,1.0,0.0,1.0
9705427,0,0,0,0,0,0,0,897,,,,,,,,3,0,3,,,
7042,0,0,0,0,0,0,0,14,0.0,0.0,0.0,0.0,0.0,0.0,0.0,21,0,21,4.0,0.0,4.0
9611211,0,0,0,0,0,0,0,470,0.0,0.0,0.0,0.0,0.0,0.0,0.0,5,0,5,2.0,0.0,2.0
9505292,0,0,0,0,0,0,0,325,0.0,0.0,0.0,0.0,0.0,0.0,0.0,3,0,3,2.0,0.0,2.0
9810395,0,0,0,0,0,0,0,89,0.0,0.0,0.0,0.0,0.0,0.0,0.0,5,0,5,,,
9510292,0,0,0,0,0,0,0,18,0.0,0.0,0.0,0.0,0.0,0.0,0.0,6,0,6,1.0,0.0,1.0
2159,0,0,0,0,0,0,0,3,0.0,0.0,0.0,0.0,0.0,0.0,0.0,10,0,10,1.0,0.0,1.0
302156,0,0,0,0,0,0,0,1,0.0,0.0,0.0,0.0,0.0,0.0,0.0,21,0,21,7.0,0.0,7.0
109144,0,0,0,0,0,0,0,155,0.0,0.0,0.0,0.0,0.0,0.0,0.0,6,0,6,5.0,0.0,5.0
9809515,0,0,0,0,0,0,0,7,0.0,0.0,0.0,0.0,0.0,0.0,0.0,7,0,7,1.0,0.0,1.0
204256,1,1,0,0,0,1,6,50,1.0,1.0,0.0,0.0,0.0,1.0,5.0,16,1,15,13.0,1.0,12.0
301025,0,0,0,0,0,0,0,220,0.0,0.0,0.0,0.0,0.0,0.0,0.0,5,0,5,3.0,0.0,3.0
212179,0,0,0,0,0,0,0,38,0.0,0.0,0.0,0.0,0.0,0.0,0.0,17,0,17,6.0,0.0,6.0
211417,0,0,0,0,0,0,0,23,0.0,0.0,0.0,0.0,0.0,0.0,0.0,11,0,11,2.0,0.0,2.0
209026,1,1,0,0,0,1,10,21,1.0,1.0,0.0,0.0,0.0,1.0,6.0,13,1,12,7.0,1.0,6.0
9801404,0,0,0,0,0,0,0,205,0.0,0.0,0.0,0.0,0.0,0.0,0.0,1,0,1,1.0,0.0,1.0
9404260,1,1,0,0,1,0,0,721,1.0,1.0,0.0,0.0,1.0,0.0,0.0,1,1,0,1.0,1.0,0.0
302022,0,0,0,0,0,0,0,17,0.0,0.0,0.0,0.0,0.0,0.0,0.0,26,0,26,3.0,0.0,3.0
9705472,0,0,0,0,0,0,0,176,,,,,,,,1,0,1,,,
9812533,0,0,0,0,0,0,0,379,0.0,0.0,0.0,0.0,0.0,0.0,0.0,9,0,9,5.0,0.0,5.0
103071,0,0,0,0,0,0,0,128,0.0,0.0,0.0,0.0,0.0,0.0,0.0,17,0,17,5.0,0.0,5.0
9711443,0,0,0,0,0,0,0,1730,,,,,,,,3,0,3,1.0,0.0,1.0
211010,0,0,0,0,0,0,0,1,0.0,0.0,0.0,0.0,0.0,0.0,0.0,94,0,94,27.0,0.0,27.0
209114,1,1,0,0,0,1,7,27,1.0,1.0,0.0,0.0,0.0,1.0,7.0,38,1,37,14.0,0.0,14.0
103323,1,1,0,0,0,1,1,247,1.0,1.0,0.0,0.0,0.0,1.0,1.0,2,1,1,1.0,1.0,0.0
209323,1,1,0,0,0,1,7,31,1.0,1.0,0.0,0.0,0.0,1.0,3.0,22,1,21,4.0,1.0,3.0
301039,0,0,0,0,0,0,0,26,0.0,0.0,0.0,0.0,0.0,0.0,0.0,26,0,26,3.0,0.0,3.0
9604285,0,0,0,0,0,0,0,1873,0.0,0.0,0.0,0.0,0.0,0.0,0.0,9,0,9,1.0,0.0,1.0
9405409,0,0,0,0,0,0,0,149,,,,,,,,1,0,1,1.0,0.0,1.0
9611459,0,0,0,0,0,0,0,56,0.0,0.0,0.0,0.0,0.0,0.0,0.0,7,0,7,,,
302220,0,0,0,0,0,0,0,31,0.0,0.0,0.0,0.0,0.0,0.0,0.0,9,0,9,1.0,0.0,1.0
6048,1,1,0,0,0,1,2,383,0.0,0.0,0.0,0.0,0.0,0.0,0.0,3,1,2,,,
9505400,0,0,0,0,0,0,0,75,0.0,0.0,0.0,0.0,0.0,0.0,0.0,12,0,12,1.0,0.0,1.0
9808472,0,0,0,0,0,0,0,152,0.0,0.0,0.0,0.0,0.0,0.0,0.0,7,0,7,4.0,0.0,4.0
2014,0,0,0,0,0,0,0,9,0.0,0.0,0.0,0.0,0.0,0.0,0.0,35,0,35,10.0,0.0,10.0
102104,0,0,0,0,0,0,0,90,0.0,0.0,0.0,0.0,0.0,0.0,0.0,8,0,8,4.0,0.0,4.0
3265,0,0,0,0,0,0,0,2068,0.0,0.0,0.0,0.0,0.0,0.0,0.0,7,0,7,1.0,0.0,1.0
212215,0,0,0,0,0,0,0,80,0.0,0.0,0.0,0.0,0.0,0.0,0.0,7,0,7,3.0,0.0,3.0
9609396,0,0,0,0,0,0,0,176,0.0,0.0,0.0,0.0,0.0,0.0,0.0,11,0,11,10.0,0.0,10.0
9812330,0,0,0,0,0,0,0,200,0.0,0.0,0.0,0.0,0.0,0.0,0.0,9,0,9,4.0,0.0,4.0
9510411,0,0,0,0,0,0,0,99,0.0,0.0,0.0,0.0,0.0,0.0,0.0,7,0,7,2.0,0.0,2.0
209356,0,0,0,0,0,0,0,40,0.0,0.0,0.0,0.0,0.0,0.0,0.0,13,0,13,7.0,0.0,7.0
9804225,0,0,0,0,0,0,0,158,0.0,0.0,0.0,0.0,0.0,0.0,0.0,13,0,13,8.0,0.0,8.0
5296,0,0,0,0,0,0,0,919,,,,,,,,1,0,1,,,
109209,0,0,0,0,0,0,0,305,0.0,0.0,0.0,0.0,0.0,0.0,0.0,11,0,11,2.0,0.0,2.0
9409365,0,0,0,0,0,0,0,281,0.0,0.0,0.0,0.0,0.0,0.0,0.0,1,0,1,1.0,0.0,1.0
210270,0,0,0,0,0,0,0,10,0.0,0.0,0.0,0.0,0.0,0.0,0.0,23,0,23,5.0,0.0,5.0
9808473,0,0,0,0,0,0,0,228,0.0,0.0,0.0,0.0,0.0,0.0,0.0,6,0,6,5.0,0.0,5.0
11010,1,1,0,0,1,0,0,594,1.0,1.0,0.0,0.0,1.0,0.0,0.0,2,1,1,1.0,1.0,0.0
9604325,0,0,0,0,0,0,0,61,,,,,,,,6,0,6,,,
9609390,0,0,0,0,0,0,0,78,0.0,0.0,0.0,0.0,0.0,0.0,0.0,6,0,6,2.0,0.0,2.0
211354,1,1,0,0,0,1,4,0,1.0,1.0,0.0,0.0,0.0,1.0,4.0,27,1,26,9.0,1.0,8.0
9410299,0,0,0,0,0,0,0,17,0.0,0.0,0.0,0.0,0.0,0.0,0.0,7,0,7,1.0,0.0,1.0
207212,0,0,0,0,0,0,0,74,0.0,0.0,0.0,0.0,0.0,0.0,0.0,14,0,14,11.0,0.0,11.0
9508217,0,0,0,0,0,0,0,1064,0.0,0.0,0.0,0.0,0.0,0.0,0.0,2,0,2,,,
9710269,0,0,0,0,0,0,0,474,0.0,0.0,0.0,0.0,0.0,0.0,0.0,3,0,3,2.0,0.0,2.0
103093,0,0,0,0,0,0,0,22,0.0,0.0,0.0,0.0,0.0,0.0,0.0,19,0,19,2.0,0.0,2.0
9707230,0,0,0,0,0,0,0,100,0.0,0.0,0.0,0.0,0.0,0.0,0.0,12,0,12,7.0,0.0,7.0
209086,0,0,0,0,0,0,0,465,0.0,0.0,0.0,0.0,0.0,0.0,0.0,3,0,3,3.0,0.0,3.0
302273,0,0,0,0,0,0,0,29,0.0,0.0,0.0,0.0,0.0,0.0,0.0,11,0,11,3.0,0.0,3.0
9904358,0,0,0,0,0,0,0,1099,0.0,0.0,0.0,0.0,0.0,0.0,0.0,3,0,3,,,
9511247,0,0,0,0,0,0,0,198,0.0,0.0,0.0,0.0,0.0,0.0,0.0,2,0,2,1.0,0.0,1.0
9310357,0,0,0,0,0,0,0,108,,,,,,,,1,0,1,,,
302028,0,0,0,0,0,0,0,27,0.0,0.0,0.0,0.0,0.0,0.0,0.0,9,0,9,,,
9501203,0,0,0,0,0,0,0,270,0.0,0.0,0.0,0.0,0.0,0.0,0.0,3,0,3,1.0,0.0,1.0
9811511,0,0,0,0,0,0,0,139,0.0,0.0,0.0,0.0,0.0,0.0,0.0,2,0,2,1.0,0.0,1.0
12106,0,0,0,0,0,0,0,76,0.0,0.0,0.0,0.0,0.0,0.0,0.0,5,0,5,5.0,0.0,5.0
111259,0,0,0,0,0,0,0,44,0.0,0.0,0.0,0.0,0.0,0.0,0.0,7,0,7,,,
201037,0,0,0,0,0,0,0,651,0.0,0.0,0.0,0.0,0.0,0.0,0.0,1,0,1,1.0,0.0,1.0
9507392,0,0,0,0,0,0,0,737,0.0,0.0,0.0,0.0,0.0,0.0,0.0,1,0,1,1.0,0.0,1.0
110406,0,0,0,0,0,0,0,51,0.0,0.0,0.0,0.0,0.0,0.0,0.0,5,0,5,3.0,0.0,3.0
9806448,0,0,0,0,0,0,0,7,0.0,0.0,0.0,0.0,0.0,0.0,0.0,15,0,15,,,
301271,0,0,0,0,0,0,0,2,0.0,0.0,0.0,0.0,0.0,0.0,0.0,26,0,26,4.0,0.0,4.0
12201,0,0,0,0,0,0,0,1998,,,,,,,,2,0,2,,,
9702234,0,0,0,0,0,0,0,15,0.0,0.0,0.0,0.0,0.0,0.0,0.0,10,0,10,3.0,0.0,3.0
9310249,0,0,0,0,0,0,0,476,0.0,0.0,0.0,0.0,0.0,0.0,0.0,1,0,1,1.0,0.0,1.0
101255,0,0,0,0,0,0,0,264,0.0,0.0,0.0,0.0,0.0,0.0,0.0,3,0,3,1.0,0.0,1.0
9606450,0,0,0,0,0,0,0,44,,,,,,,,2,0,2,1.0,0.0,1.0
211202,0,0,0,0,0,0,0,259,0.0,0.0,0.0,0.0,0.0,0.0,0.0,2,0,2,1.0,0.0,1.0
9712326,0,0,0,0,0,0,0,370,0.0,0.0,0.0,0.0,0.0,0.0,0.0,4,0,4,1.0,0.0,1.0
301188,0,0,0,0,0,0,0,338,0.0,0.0,0.0,0.0,0.0,0.0,0.0,8,0,8,3.0,0.0,3.0
9909343,0,0,0,0,0,0,0,11,0.0,0.0,0.0,0.0,0.0,0.0,0.0,5,0,5,1.0,0.0,1.0
209282,0,0,0,0,0,0,0,60,0.0,0.0,0.0,0.0,0.0,0.0,0.0,11,0,11,4.0,0.0,4.0
9801367,0,0,0,0,0,0,0,137,0.0,0.0,0.0,0.0,0.0,0.0,0.0,5,0,5,,,
301053,0,0,0,0,0,0,0,54,0.0,0.0,0.0,0.0,0.0,0.0,0.0,27,0,27,6.0,0.0,6.0
211192,0,0,0,0,0,0,0,4,0.0,0.0,0.0,0.0,0.0,0.0,0.0,17,0,17,4.0,0.0,4.0
9706324,0,0,0,0,0,0,0,130,,,,,,,,3,0,3,1.0,0.0,1.0
9804406,0,0,0,0,0,0,0,57,0.0,0.0,0.0,0.0,0.0,0.0,0.0,5,0,5,4.0,0.0,4.0
10320,1,1,0,0,0,1,9,105,1.0,1.0,0.0,0.0,0.0,1.0,7.0,14,1,13,9.0,1.0,8.0
9311268,0,0,0,0,0,0,0,1541,,,,,,,,1,0,1,,,
9911469,0,0,0,0,0,0,0,200,0.0,0.0,0.0,0.0,0.0,0.0,0.0,9,0,9,3.0,0.0,3.0
302043,0,0,0,0,0,0,0,9,0.0,0.0,0.0,0.0,0.0,0.0,0.0,11,0,11,4.0,0.0,4.0
9907546,0,0,0,0,0,0,0,47,0.0,0.0,0.0,0.0,0.0,0.0,0.0,10,0,10,5.0,0.0,5.0
1294,0,0,0,0,0,0,0,22,,,,,,,,6,0,6,,,
9908234,0,0,0,0,0,0,0,6,0.0,0.0,0.0,0.0,0.0,0.0,0.0,9,0,9,8.0,0.0,8.0
6008,0,0,0,0,0,0,0,8,,,,,,,,6,0,6,,,
111036,0,0,0,0,0,0,0,746,0.0,0.0,0.0,0.0,0.0,0.0,0.0,1,0,1,1.0,0.0,1.0
9304224,0,0,0,0,0,0,0,304,,,,,,,,3,0,3,1.0,0.0,1.0
9311333,0,0,0,0,0,0,0,15,0.0,0.0,0.0,0.0,0.0,0.0,0.0,6,0,6,1.0,0.0,1.0
9501384,179,44,135,636,85,94,188,13,58.0,3.0,55.0,292.0,19.0,39.0,68.0,201,179,22,28.0,25.0,3.0
9712252,16,5,11,25,8,8,18,212,5.0,2.0,3.0,5.0,1.0,4.0,4.0,23,16,7,3.0,2.0,1.0
8009,34,2,32,155,5,29,140,1,17.0,2.0,15.0,52.0,4.0,13.0,31.0,56,34,22,21.0,18.0,3.0
9707251,138,14,124,800,23,115,525,1,50.0,5.0,45.0,282.0,1.0,49.0,194.0,174,138,36,29.0,23.0,6.0
9211260,121,42,79,446,121,0,0,75,39.0,7.0,32.0,165.0,39.0,0.0,0.0,121,121,0,29.0,29.0,0.0
9405207,102,16,86,468,26,76,208,6,58.0,9.0,49.0,284.0,4.0,54.0,166.0,111,102,9,32.0,25.0,7.0
9506374,114,9,105,1024,18,96,374,7,67.0,1.0,66.0,674.0,7.0,60.0,152.0,126,114,12,45.0,42.0,3.0
9709288,42,3,39,194,6,36,122,1,25.0,2.0,23.0,100.0,0.0,25.0,93.0,52,42,10,8.0,4.0,4.0
9512356,46,6,40,246,1,45,229,34,35.0,4.0,31.0,211.0,0.0,35.0,161.0,61,46,15,36.0,28.0,8.0
12289,27,6,21,62,6,21,86,2,14.0,5.0,9.0,27.0,6.0,8.0,9.0,37,27,10,17.0,13.0,4.0
9807223,17,8,9,12,0,17,72,29,7.0,3.0,4.0,6.0,0.0,7.0,29.0,38,17,21,12.0,2.0,10.0
106344,3,3,0,0,1,2,9,33,1.0,1.0,0.0,0.0,0.0,1.0,6.0,27,3,24,4.0,0.0,4.0
9409460,14,8,6,8,4,10,29,157,4.0,1.0,3.0,4.0,0.0,4.0,8.0,19,14,5,7.0,4.0,3.0
9609331,219,25,194,1383,16,203,768,4,80.0,5.0,75.0,711.0,1.0,79.0,387.0,233,219,14,58.0,50.0,8.0
9512292,30,7,23,63,5,25,29,33,17.0,3.0,14.0,38.0,0.0,17.0,18.0,34,30,4,11.0,10.0,1.0
9808468,46,6,40,176,8,38,125,4,24.0,3.0,21.0,88.0,2.0,22.0,62.0,59,46,13,19.0,12.0,7.0
6032,36,18,18,28,6,30,121,33,12.0,3.0,9.0,13.0,0.0,12.0,50.0,194,36,158,23.0,5.0,18.0
9406315,244,79,165,458,185,59,69,16,24.0,4.0,20.0,48.0,11.0,13.0,16.0,251,244,7,11.0,10.0,1.0
9608269,21,7,14,32,1,20,56,26,13.0,2.0,11.0,25.0,1.0,12.0,28.0,31,21,10,5.0,2.0,3.0
9706218,14,6,8,12,1,13,53,61,4.0,3.0,1.0,1.0,1.0,3.0,10.0,27,14,13,7.0,2.0,5.0
9805470,150,23,127,735,39,111,429,23,38.0,5.0,33.0,162.0,2.0,36.0,172.0,164,150,14,34.0,25.0,9.0
9903394,16,6,10,24,4,12,34,33,11.0,3.0,8.0,20.0,4.0,7.0,12.0,31,16,15,7.0,5.0,2.0
205126,9,9,0,0,9,0,0,616,4.0,4.0,0.0,0.0,4.0,0.0,0.0,10,9,1,2.0,2.0,0.0
11112,8,2,6,9,0,8,44,26,6.0,1.0,5.0,6.0,0.0,6.0,34.0,22,8,14,11.0,5.0,6.0
9304265,37,11,26,74,19,18,23,29,13.0,3.0,10.0,32.0,3.0,10.0,13.0,42,37,5,8.0,8.0,0.0
9607328,3,2,1,1,1,2,11,26,0.0,0.0,0.0,0.0,0.0,0.0,0.0,10,3,7,3.0,0.0,3.0
9811216,8,5,3,3,1,7,34,26,4.0,2.0,2.0,2.0,0.0,4.0,22.0,35,8,27,7.0,1.0,6.0
9808433,39,10,29,82,9,30,56,4,15.0,2.0,13.0,28.0,7.0,8.0,8.0,47,39,8,14.0,13.0,1.0
9706542,24,10,14,24,3,21,80,35,3.0,1.0,2.0,3.0,0.0,3.0,19.0,53,24,29,7.0,3.0,4.0
9323,1,1,0,0,0,1,2,36,0.0,0.0,0.0,0.0,0.0,0.0,0.0,7,1,6,1.0,0.0,1.0
9803277,161,12,149,1227,15,146,556,4,84.0,4.0,80.0,788.0,4.0,80.0,356.0,173,161,12,60.0,54.0,6.0
9603227,49,10,39,73,3,46,121,4,25.0,7.0,18.0,34.0,0.0,25.0,74.0,61,49,12,17.0,11.0,6.0
104047,24,4,20,66,0,24,253,4,20.0,3.0,17.0,54.0,0.0,20.0,213.0,58,24,34,31.0,14.0,17.0
202001,9,8,1,1,4,5,24,30,0.0,0.0,0.0,0.0,0.0,0.0,0.0,76,9,67,7.0,0.0,7.0
9407311,48,10,38,114,26,22,41,41,11.0,5.0,6.0,16.0,0.0,11.0,28.0,52,48,4,13.0,10.0,3.0
9304266,20,7,13,36,20,0,0,63,9.0,1.0,8.0,23.0,9.0,0.0,0.0,20,20,0,8.0,8.0,0.0
9502276,6,2,4,6,4,2,2,149,4.0,1.0,3.0,3.0,2.0,2.0,2.0,7,6,1,4.0,4.0,0.0
9309326,34,11,23,66,16,18,18,25,13.0,1.0,12.0,41.0,3.0,10.0,10.0,35,34,1,10.0,9.0,1.0
9411377,79,14,65,270,79,0,0,23,19.0,3.0,16.0,46.0,19.0,0.0,0.0,79,79,0,16.0,16.0,0.0
9801208,86,29,57,239,86,0,0,102,26.0,3.0,23.0,129.0,26.0,0.0,0.0,86,86,0,22.0,22.0,0.0
9502418,65,11,54,252,9,56,167,3,15.0,1.0,14.0,35.0,0.0,15.0,47.0,86,65,21,19.0,15.0,4.0
9503392,11,5,6,10,5,6,13,55,2.0,1.0,1.0,1.0,1.0,1.0,2.0,22,11,11,2.0,1.0,1.0
9311214,141,34,107,427,107,34,42,0,29.0,7.0,22.0,121.0,29.0,0.0,0.0,145,141,4,15.0,14.0,1.0
9311306,64,16,48,179,26,38,46,0,21.0,6.0,15.0,68.0,8.0,13.0,13.0,67,64,3,9.0,8.0,1.0
9604289,14,7,7,10,4,10,13,117,5.0,1.0,4.0,5.0,4.0,1.0,1.0,20,14,6,5.0,5.0,0.0
9707203,16,3,13,44,0,16,49,0,12.0,1.0,11.0,38.0,0.0,12.0,32.0,28,16,12,17.0,12.0,5.0
9808451,36,8,28,93,0,36,326,0,22.0,4.0,18.0,65.0,0.0,22.0,136.0,68,36,32,27.0,19.0,8.0
9505402,39,4,35,220,9,30,134,3,28.0,1.0,27.0,178.0,15.0,13.0,22.0,63,39,24,8.0,2.0,6.0
9404354,28,8,20,55,22,6,7,3,4.0,3.0,1.0,1.0,4.0,0.0,0.0,30,28,2,10.0,10.0,0.0
9909425,50,2,48,303,3,47,280,0,39.0,2.0,37.0,252.0,0.0,39.0,215.0,64,50,14,38.0,30.0,8.0
9808232,47,4,43,207,3,44,319,12,27.0,2.0,25.0,121.0,0.0,27.0,182.0,83,47,36,14.0,11.0,3.0
9905340,8,3,5,10,7,1,3,3,1.0,1.0,0.0,0.0,0.0,1.0,2.0,20,8,12,5.0,5.0,0.0
9803309,26,7,19,58,5,21,51,0,9.0,1.0,8.0,27.0,1.0,8.0,19.0,33,26,7,10.0,8.0,2.0
9703240,80,13,67,274,80,0,0,119,29.0,2.0,27.0,101.0,29.0,0.0,0.0,80,80,0,25.0,25.0,0.0
9211320,51,13,38,200,51,0,0,0,7.0,2.0,5.0,10.0,7.0,0.0,0.0,51,51,0,8.0,8.0,0.0
9809307,49,6,43,120,38,11,11,3,19.0,4.0,15.0,32.0,16.0,3.0,3.0,52,49,3,7.0,6.0,1.0
9809509,18,10,8,11,17,1,1,377,4.0,2.0,2.0,3.0,4.0,0.0,0.0,21,18,3,2.0,2.0,0.0
9606221,1,1,0,0,0,1,3,1739,0.0,0.0,0.0,0.0,0.0,0.0,0.0,6,1,5,1.0,0.0,1.0
9509306,3,2,1,1,3,0,0,164,0.0,0.0,0.0,0.0,0.0,0.0,0.0,33,3,30,12.0,0.0,12.0
9603430,37,7,30,198,10,27,27,82,34.0,6.0,28.0,186.0,9.0,25.0,25.0,38,37,1,26.0,25.0,1.0
9809315,35,5,30,138,0,35,266,50,26.0,1.0,25.0,121.0,0.0,26.0,168.0,73,35,38,30.0,21.0,9.0
9903203,13,3,10,31,0,13,150,3,10.0,1.0,9.0,28.0,0.0,10.0,94.0,78,13,65,23.0,2.0,21.0
9611422,21,9,12,25,9,12,42,87,7.0,2.0,5.0,9.0,0.0,7.0,27.0,32,21,11,12.0,6.0,6.0
9608420,4,4,0,0,2,2,7,81,3.0,3.0,0.0,0.0,1.0,2.0,6.0,29,4,25,5.0,0.0,5.0
9211325,15,5,10,22,6,9,9,75,5.0,2.0,3.0,3.0,1.0,4.0,4.0,16,15,1,5.0,4.0,1.0
9208243,34,20,14,35,34,0,0,10,5.0,3.0,2.0,4.0,5.0,0.0,0.0,34,34,0,6.0,6.0,0.0
9803308,30,7,23,40,3,27,132,12,6.0,2.0,4.0,4.0,0.0,6.0,19.0,63,30,33,13.0,3.0,10.0
9706242,52,7,45,255,5,47,184,50,37.0,4.0,33.0,217.0,0.0,37.0,116.0,74,52,22,28.0,25.0,3.0
9607451,11,2,9,28,0,11,47,71,10.0,2.0,8.0,26.0,0.0,10.0,44.0,23,11,12,19.0,8.0,11.0
9507348,39,5,34,78,10,29,59,0,14.0,4.0,10.0,17.0,6.0,8.0,14.0,45,39,6,11.0,8.0,3.0
9411247,12,7,5,6,5,7,14,10,2.0,1.0,1.0,1.0,0.0,2.0,7.0,34,12,22,3.0,3.0,0.0
9512368,10,4,6,11,10,0,0,73,4.0,3.0,1.0,1.0,4.0,0.0,0.0,10,10,0,4.0,4.0,0.0
9304295,129,32,97,463,49,80,117,10,56.0,12.0,44.0,221.0,16.0,40.0,40.0,138,129,9,18.0,17.0,1.0
9711448,11,8,3,8,6,5,7,36,0.0,0.0,0.0,0.0,0.0,0.0,0.0,30,11,19,5.0,0.0,5.0
9410283,53,11,42,168,8,45,97,12,17.0,7.0,10.0,30.0,5.0,12.0,21.0,61,53,8,15.0,14.0,1.0
9703347,18,4,14,43,1,17,93,12,10.0,2.0,8.0,19.0,0.0,10.0,62.0,30,18,12,17.0,8.0,9.0
9611273,52,7,45,176,1,51,241,5,15.0,1.0,14.0,29.0,1.0,14.0,35.0,72,52,20,16.0,12.0,4.0
111262,1,1,0,0,0,1,10,34,0.0,0.0,0.0,0.0,0.0,0.0,0.0,78,1,77,38.0,0.0,38.0
103040,11,8,3,4,3,8,19,1,3.0,2.0,1.0,2.0,3.0,0.0,0.0,25,11,14,2.0,2.0,0.0
9910237,41,6,35,195,2,39,259,34,31.0,2.0,29.0,179.0,1.0,30.0,236.0,61,41,20,42.0,28.0,14.0
12212,15,7,8,11,0,15,108,1,8.0,5.0,3.0,4.0,0.0,8.0,63.0,42,15,27,16.0,5.0,11.0
102157,106,7,99,985,1,105,579,23,69.0,4.0,65.0,683.0,0.0,69.0,322.0,130,106,24,55.0,46.0,9.0
7313,52,11,41,127,1,51,557,34,16.0,4.0,12.0,30.0,0.0,16.0,281.0,145,52,93,44.0,12.0,32.0
9711246,90,3,87,888,3,87,526,1,76.0,2.0,74.0,800.0,0.0,76.0,484.0,116,90,26,56.0,50.0,6.0
9303296,22,7,15,25,22,0,0,5,6.0,2.0,4.0,6.0,6.0,0.0,0.0,23,22,1,5.0,5.0,0.0
9609444,94,9,85,509,4,90,575,5,53.0,6.0,47.0,347.0,0.0,53.0,428.0,113,94,19,51.0,37.0,14.0
9704382,13,1,12,27,0,13,53,5,8.0,1.0,7.0,13.0,0.0,8.0,39.0,19,13,6,3.0,3.0,0.0
9507329,40,5,35,112,4,36,156,1,26.0,5.0,21.0,73.0,2.0,24.0,93.0,53,40,13,21.0,16.0,5.0
9303204,29,3,26,141,29,0,0,33,24.0,3.0,21.0,114.0,24.0,0.0,0.0,29,29,0,17.0,17.0,0.0
9604211,10,6,4,5,6,4,11,55,1.0,1.0,0.0,0.0,1.0,0.0,0.0,14,10,4,3.0,1.0,2.0
9503277,7,5,2,3,2,5,13,34,4.0,2.0,2.0,3.0,1.0,3.0,10.0,15,7,8,3.0,3.0,0.0
7054,7,3,4,7,0,7,112,6,5.0,1.0,4.0,7.0,0.0,5.0,80.0,42,7,35,19.0,5.0,14.0
9508211,39,7,32,106,9,30,90,6,15.0,2.0,13.0,37.0,5.0,10.0,15.0,47,39,8,13.0,11.0,2.0
9711203,5,3,2,2,2,3,4,293,1.0,1.0,0.0,0.0,0.0,1.0,1.0,10,5,5,3.0,0.0,3.0
9504252,8,4,4,4,4,4,8,100,3.0,2.0,1.0,1.0,1.0,2.0,4.0,13,8,5,3.0,1.0,2.0
9802412,21,5,16,31,3,18,83,29,10.0,7.0,3.0,6.0,0.0,10.0,57.0,31,21,10,15.0,7.0,8.0
9508346,33,12,21,48,1,32,140,69,15.0,7.0,8.0,20.0,0.0,15.0,80.0,50,33,17,17.0,7.0,10.0
9507282,184,15,169,960,119,65,126,5,38.0,4.0,34.0,151.0,38.0,0.0,0.0,193,184,9,29.0,29.0,0.0
9809302,1,1,0,0,0,1,20,1,1.0,1.0,0.0,0.0,0.0,1.0,18.0,26,1,25,1.0,0.0,1.0
9601384,46,7,39,157,5,41,77,86,27.0,3.0,24.0,106.0,0.0,27.0,44.0,52,46,6,17.0,15.0,2.0
9810386,34,17,17,31,11,23,32,31,10.0,5.0,5.0,8.0,1.0,9.0,12.0,39,34,5,6.0,6.0,0.0
9404357,102,14,88,456,74,28,36,40,54.0,8.0,46.0,220.0,41.0,13.0,20.0,107,102,5,31.0,31.0,0.0
9707222,9,4,5,13,0,9,21,7,7.0,3.0,4.0,12.0,0.0,7.0,16.0,17,9,8,5.0,5.0,0.0
9502378,44,5,39,174,14,30,82,7,19.0,1.0,18.0,80.0,8.0,11.0,18.0,57,44,13,18.0,16.0,2.0
9706247,21,8,13,34,0,21,97,7,13.0,4.0,9.0,22.0,0.0,13.0,43.0,41,21,20,14.0,6.0,8.0
9811378,60,2,58,409,0,60,516,2,46.0,1.0,45.0,365.0,0.0,46.0,458.0,79,60,19,41.0,29.0,12.0
9603443,9,4,5,5,3,6,11,91,0.0,0.0,0.0,0.0,0.0,0.0,0.0,20,9,11,4.0,0.0,4.0
9306296,30,14,16,52,15,15,18,15,5.0,3.0,2.0,2.0,5.0,0.0,0.0,32,30,2,3.0,3.0,0.0
6290,3,2,1,1,1,2,5,76,3.0,2.0,1.0,1.0,1.0,2.0,2.0,15,3,12,5.0,3.0,2.0
9809530,10,7,3,3,0,10,28,98,8.0,6.0,2.0,2.0,0.0,8.0,24.0,22,10,12,8.0,1.0,7.0
9903205,3,3,0,0,1,2,3,76,2.0,2.0,0.0,0.0,1.0,1.0,1.0,6,3,3,1.0,0.0,1.0
9706285,49,10,39,178,7,42,170,19,22.0,3.0,19.0,78.0,1.0,21.0,39.0,68,49,19,27.0,20.0,7.0
9604244,22,5,17,64,4,18,53,12,18.0,3.0,15.0,57.0,0.0,18.0,47.0,33,22,11,17.0,14.0,3.0
9502317,57,6,51,226,4,53,148,61,31.0,1.0,30.0,100.0,1.0,30.0,67.0,67,57,10,24.0,21.0,3.0
9701294,72,6,66,507,14,58,104,24,40.0,2.0,38.0,361.0,19.0,21.0,21.0,77,72,5,30.0,29.0,1.0
9808233,7,5,2,4,4,3,12,127,0.0,0.0,0.0,0.0,0.0,0.0,0.0,34,7,27,9.0,0.0,9.0
9310252,39,7,32,146,39,0,0,16,28.0,3.0,25.0,122.0,28.0,0.0,0.0,39,39,0,7.0,7.0,0.0
9606293,5,5,0,0,1,4,15,16,2.0,2.0,0.0,0.0,0.0,2.0,9.0,14,5,9,2.0,0.0,2.0
9703445,65,23,42,116,24,41,112,16,19.0,3.0,16.0,48.0,9.0,10.0,18.0,87,65,22,15.0,4.0,11.0
9710375,11,10,1,1,1,10,35,30,2.0,2.0,0.0,0.0,0.0,2.0,5.0,28,11,17,5.0,2.0,3.0
9912407,24,5,19,56,2,22,118,12,2.0,1.0,1.0,1.0,0.0,2.0,3.0,51,24,27,6.0,6.0,0.0
9702276,73,15,58,247,24,49,175,24,23.0,3.0,20.0,114.0,3.0,20.0,49.0,96,73,23,9.0,7.0,2.0
9810259,16,4,12,21,1,15,65,24,5.0,1.0,4.0,6.0,0.0,5.0,21.0,26,16,10,6.0,3.0,3.0
9302248,43,16,27,62,32,11,11,47,9.0,7.0,2.0,2.0,9.0,0.0,0.0,45,43,2,6.0,6.0,0.0
9310217,5,3,2,4,3,2,3,86,1.0,1.0,0.0,0.0,1.0,0.0,0.0,9,5,4,4.0,3.0,1.0
9505219,78,17,61,220,78,0,0,59,20.0,3.0,17.0,79.0,20.0,0.0,0.0,78,78,0,12.0,12.0,0.0
9903226,42,9,33,84,4,38,171,6,14.0,6.0,8.0,17.0,0.0,14.0,86.0,67,42,25,9.0,7.0,2.0
9412269,15,7,8,16,14,1,1,186,9.0,2.0,7.0,15.0,9.0,0.0,0.0,16,15,1,8.0,8.0,0.0
9902315,17,4,13,38,2,15,95,6,4.0,2.0,2.0,2.0,0.0,4.0,10.0,36,17,19,6.0,6.0,0.0
9605349,32,6,26,70,5,27,59,79,18.0,2.0,16.0,46.0,0.0,18.0,36.0,38,32,6,13.0,11.0,2.0
9406251,11,4,7,21,11,0,0,6,2.0,1.0,1.0,1.0,2.0,0.0,0.0,13,11,2,8.0,8.0,0.0
9908416,2,1,1,1,0,2,6,96,2.0,1.0,1.0,1.0,0.0,2.0,5.0,15,2,13,10.0,1.0,9.0
9612250,23,10,13,22,4,19,98,68,8.0,3.0,5.0,11.0,4.0,4.0,9.0,41,23,18,8.0,7.0,1.0
9611344,10,4,6,15,10,0,0,348,7.0,3.0,4.0,7.0,7.0,0.0,0.0,10,10,0,6.0,6.0,0.0
9410218,16,2,14,39,14,2,2,38,6.0,1.0,5.0,7.0,6.0,0.0,0.0,17,16,1,6.0,6.0,0.0
9903478,42,2,40,152,1,41,307,22,33.0,2.0,31.0,122.0,0.0,33.0,240.0,69,42,27,36.0,22.0,14.0
9804384,20,8,12,16,3,17,44,45,6.0,3.0,3.0,3.0,0.0,6.0,23.0,33,20,13,3.0,3.0,0.0
9910309,44,7,37,139,2,42,282,38,34.0,3.0,31.0,126.0,0.0,34.0,232.0,63,44,19,35.0,24.0,11.0
9161,6,5,1,1,0,6,34,22,1.0,1.0,0.0,0.0,0.0,1.0,20.0,35,6,29,24.0,1.0,23.0
9701393,46,4,42,212,4,42,164,22,31.0,2.0,29.0,150.0,0.0,31.0,126.0,56,46,10,25.0,18.0,7.0
10294,6,5,1,1,0,6,65,38,6.0,5.0,1.0,1.0,0.0,6.0,64.0,27,6,21,20.0,6.0,14.0
9604300,5,2,3,3,0,5,14,40,4.0,1.0,3.0,3.0,0.0,4.0,12.0,12,5,7,1.0,0.0,1.0
9212210,29,12,17,34,11,18,24,64,11.0,3.0,8.0,21.0,2.0,9.0,9.0,32,29,3,11.0,10.0,1.0
9808404,44,3,41,283,0,44,244,21,40.0,1.0,39.0,272.0,0.0,40.0,232.0,63,44,19,44.0,29.0,15.0
9805209,29,11,18,38,3,26,152,21,16.0,5.0,11.0,25.0,0.0,16.0,116.0,45,29,16,22.0,8.0,14.0
9803393,40,5,35,171,12,28,52,66,24.0,5.0,19.0,94.0,8.0,16.0,20.0,46,40,6,18.0,16.0,2.0
9610433,33,9,24,51,3,30,78,19,10.0,2.0,8.0,10.0,2.0,8.0,13.0,41,33,8,11.0,8.0,3.0
9809544,18,2,16,33,2,16,41,66,9.0,3.0,6.0,13.0,1.0,8.0,8.0,26,18,8,4.0,4.0,0.0
9906422,6,4,2,3,1,5,57,4,0.0,0.0,0.0,0.0,0.0,0.0,0.0,109,6,103,8.0,0.0,8.0
9512281,27,6,21,78,19,8,9,140,9.0,2.0,7.0,17.0,4.0,5.0,6.0,29,27,2,9.0,8.0,1.0
9801285,2,2,0,0,0,2,4,760,1.0,1.0,0.0,0.0,1.0,0.0,0.0,7,2,5,2.0,1.0,1.0
9705273,6,4,2,2,4,2,2,144,1.0,1.0,0.0,0.0,1.0,0.0,0.0,9,6,3,2.0,2.0,0.0
109135,9,2,7,18,0,9,116,20,9.0,2.0,7.0,18.0,0.0,9.0,116.0,42,9,33,29.0,4.0,25.0
9209256,27,8,19,92,27,0,0,124,18.0,4.0,14.0,81.0,18.0,0.0,0.0,27,27,0,15.0,15.0,0.0
9212295,15,8,7,11,5,10,26,29,12.0,5.0,7.0,11.0,2.0,10.0,26.0,20,15,5,2.0,1.0,1.0
9408373,29,5,24,93,25,4,6,7,9.0,1.0,8.0,23.0,9.0,0.0,0.0,31,29,2,10.0,10.0,0.0
9910347,22,4,18,65,0,22,483,20,22.0,4.0,18.0,65.0,0.0,22.0,467.0,63,22,41,47.0,16.0,31.0
9908290,10,2,8,31,0,10,107,20,9.0,1.0,8.0,29.0,0.0,9.0,106.0,26,10,16,21.0,9.0,12.0
105009,26,6,20,49,1,25,237,20,20.0,3.0,17.0,43.0,0.0,20.0,217.0,55,26,29,35.0,9.0,26.0
105150,34,3,31,109,0,34,323,20,31.0,3.0,28.0,102.0,0.0,31.0,313.0,64,34,30,35.0,10.0,25.0
109036,6,5,1,2,0,6,18,30,1.0,1.0,0.0,0.0,1.0,0.0,0.0,26,6,20,8.0,2.0,6.0
9306214,29,8,21,83,18,11,21,6,15.0,2.0,13.0,56.0,8.0,7.0,14.0,33,29,4,17.0,15.0,2.0
9407303,37,15,22,55,34,3,6,7,8.0,2.0,6.0,17.0,8.0,0.0,0.0,41,37,4,4.0,4.0,0.0
9812397,113,16,97,357,25,88,570,2,33.0,5.0,28.0,112.0,0.0,33.0,392.0,146,113,33,26.0,13.0,13.0
9411209,4,1,3,4,4,0,0,1906,1.0,1.0,0.0,0.0,1.0,0.0,0.0,4,4,0,1.0,1.0,0.0
9807522,41,8,33,111,2,39,191,2,22.0,2.0,20.0,80.0,0.0,22.0,122.0,49,41,8,4.0,4.0,0.0
9605351,29,7,22,41,6,23,69,61,2.0,2.0,0.0,0.0,0.0,2.0,12.0,46,29,17,3.0,3.0,0.0
9708226,19,3,16,42,0,19,128,99,10.0,2.0,8.0,25.0,0.0,10.0,41.0,38,19,19,16.0,12.0,4.0
9707450,18,12,6,10,5,13,62,5,3.0,2.0,1.0,1.0,0.0,3.0,25.0,42,18,24,16.0,1.0,15.0
9710259,10,4,6,13,2,8,34,42,6.0,1.0,5.0,10.0,0.0,6.0,9.0,31,10,21,8.0,5.0,3.0
9211332,7,6,1,1,7,0,0,179,5.0,4.0,1.0,1.0,5.0,0.0,0.0,7,7,0,3.0,3.0,0.0
9503425,32,18,14,18,12,20,71,35,6.0,3.0,3.0,3.0,3.0,3.0,11.0,64,32,32,4.0,2.0,2.0
9404212,32,8,24,83,15,17,27,5,20.0,5.0,15.0,54.0,8.0,12.0,12.0,35,32,3,13.0,12.0,1.0
9509216,28,5,23,73,27,1,1,109,13.0,2.0,11.0,36.0,13.0,0.0,0.0,30,28,2,12.0,12.0,0.0
9602418,11,3,8,23,1,10,14,44,9.0,2.0,7.0,18.0,0.0,9.0,11.0,16,11,5,7.0,6.0,1.0
9511319,13,2,11,25,6,7,8,4,4.0,1.0,3.0,3.0,0.0,4.0,4.0,16,13,3,1.0,1.0,0.0
9905266,11,4,7,12,1,10,76,4,4.0,1.0,3.0,3.0,0.0,4.0,9.0,35,11,24,5.0,4.0,1.0
9906509,18,14,4,5,11,7,14,3,6.0,6.0,0.0,0.0,6.0,0.0,0.0,32,18,14,4.0,4.0,0.0
9712517,41,3,38,129,4,37,102,11,23.0,2.0,21.0,82.0,1.0,22.0,48.0,52,41,11,8.0,5.0,3.0
9901219,14,3,11,17,1,13,36,0,7.0,5.0,2.0,2.0,1.0,6.0,9.0,28,14,14,9.0,3.0,6.0
9805317,8,5,3,4,5,3,11,5,0.0,0.0,0.0,0.0,0.0,0.0,0.0,30,8,22,11.0,0.0,11.0
9604266,23,5,18,61,0,23,89,41,17.0,3.0,14.0,47.0,0.0,17.0,45.0,39,23,16,17.0,14.0,3.0
9308251,4,3,1,1,2,2,4,41,0.0,0.0,0.0,0.0,0.0,0.0,0.0,7,4,3,1.0,1.0,0.0
9805494,46,19,27,59,17,29,83,41,9.0,3.0,6.0,9.0,1.0,8.0,22.0,149,46,103,18.0,2.0,16.0
9412248,12,11,1,1,12,0,0,322,6.0,6.0,0.0,0.0,6.0,0.0,0.0,12,12,0,4.0,4.0,0.0
9501296,15,5,10,27,1,14,47,49,11.0,3.0,8.0,23.0,4.0,7.0,20.0,25,15,10,11.0,8.0,3.0
9412258,2,1,1,1,2,0,0,25,0.0,0.0,0.0,0.0,0.0,0.0,0.0,11,2,9,3.0,0.0,3.0
9705447,10,6,4,6,1,9,27,78,5.0,3.0,2.0,3.0,0.0,5.0,11.0,18,10,8,7.0,4.0,3.0
8078,23,11,12,21,5,18,86,23,6.0,5.0,1.0,1.0,1.0,5.0,23.0,36,23,13,12.0,5.0,7.0
203049,5,4,1,1,1,4,24,13,1.0,1.0,0.0,0.0,0.0,1.0,14.0,34,5,29,16.0,1.0,15.0
9508362,28,8,20,52,3,25,56,74,14.0,4.0,10.0,23.0,0.0,14.0,29.0,32,28,4,15.0,12.0,3.0
9503306,20,9,11,15,8,12,28,60,4.0,3.0,1.0,1.0,0.0,4.0,6.0,25,20,5,3.0,3.0,0.0
9711348,58,2,56,309,1,57,227,55,41.0,2.0,39.0,208.0,1.0,40.0,166.0,67,58,9,33.0,28.0,5.0
9902263,64,2,62,652,0,64,472,2,58.0,2.0,56.0,629.0,0.0,58.0,445.0,73,64,9,52.0,43.0,9.0
9801425,7,5,2,2,0,7,51,61,2.0,2.0,0.0,0.0,0.0,2.0,17.0,51,7,44,13.0,2.0,11.0
9712249,34,10,24,42,1,33,209,12,11.0,4.0,7.0,9.0,0.0,11.0,65.0,82,34,48,23.0,6.0,17.0
9910392,14,2,12,28,1,13,60,3,6.0,1.0,5.0,8.0,0.0,6.0,40.0,28,14,14,15.0,3.0,12.0
1062,13,7,6,9,1,12,120,17,7.0,3.0,4.0,6.0,0.0,7.0,97.0,56,13,43,27.0,4.0,23.0
9304204,15,7,8,17,15,0,0,116,7.0,2.0,5.0,8.0,7.0,0.0,0.0,15,15,0,5.0,5.0,0.0
12020,39,6,33,88,0,39,277,18,21.0,3.0,18.0,45.0,0.0,21.0,165.0,76,39,37,17.0,9.0,8.0
2126,18,14,4,5,1,17,61,18,5.0,4.0,1.0,1.0,1.0,4.0,10.0,75,18,57,10.0,3.0,7.0
9411444,25,4,21,68,2,23,36,27,17.0,4.0,13.0,49.0,0.0,17.0,27.0,27,25,2,15.0,14.0,1.0
9911293,116,2,114,471,12,104,551,5,22.0,1.0,21.0,134.0,15.0,7.0,7.0,173,116,57,18.0,18.0,0.0
9909333,33,5,28,119,0,33,264,32,19.0,3.0,16.0,70.0,0.0,19.0,184.0,52,33,19,29.0,17.0,12.0
3251,34,11,23,49,4,30,158,3,9.0,6.0,3.0,3.0,0.0,9.0,71.0,66,34,32,11.0,11.0,0.0
9712340,1,1,0,0,0,1,1,36,0.0,0.0,0.0,0.0,0.0,0.0,0.0,28,1,27,21.0,0.0,21.0
9208255,11,3,8,19,11,0,0,18,5.0,2.0,3.0,6.0,5.0,0.0,0.0,11,11,0,2.0,2.0,0.0
9910553,51,9,42,187,0,51,700,32,32.0,4.0,28.0,131.0,0.0,32.0,552.0,109,51,58,54.0,20.0,34.0
9906527,44,10,34,84,5,39,103,18,1.0,1.0,0.0,0.0,0.0,1.0,3.0,59,44,15,4.0,1.0,3.0
107310,14,3,11,31,1,13,30,0,12.0,2.0,10.0,30.0,1.0,11.0,23.0,19,14,5,4.0,4.0,0.0
102252,27,2,25,78,1,26,194,0,12.0,1.0,11.0,33.0,0.0,12.0,117.0,55,27,28,23.0,6.0,17.0
9410305,3,2,1,1,3,0,0,132,1.0,1.0,0.0,0.0,1.0,0.0,0.0,3,3,0,1.0,1.0,0.0
9405419,11,7,4,4,3,8,38,10,5.0,3.0,2.0,2.0,0.0,5.0,16.0,21,11,10,8.0,3.0,5.0
9707308,7,4,3,6,0,7,16,51,4.0,2.0,2.0,3.0,0.0,4.0,11.0,13,7,6,9.0,3.0,6.0
9603279,30,9,21,73,30,0,0,118,18.0,3.0,15.0,53.0,18.0,0.0,0.0,30,30,0,15.0,15.0,0.0
9507307,46,13,33,146,3,43,86,16,25.0,8.0,17.0,52.0,0.0,25.0,56.0,50,46,4,19.0,17.0,2.0
9803387,18,4,14,24,6,12,29,140,6.0,1.0,5.0,9.0,6.0,0.0,0.0,25,18,7,6.0,6.0,0.0
9909305,21,8,13,30,2,19,74,8,12.0,4.0,8.0,22.0,1.0,11.0,57.0,40,21,19,19.0,7.0,12.0
9801229,23,7,16,59,8,15,23,4,8.0,1.0,7.0,23.0,1.0,7.0,7.0,30,23,7,10.0,9.0,1.0
9609447,28,9,19,59,2,26,129,94,13.0,3.0,10.0,38.0,0.0,13.0,90.0,43,28,15,23.0,13.0,10.0
9901293,6,1,5,7,1,5,11,210,2.0,1.0,1.0,1.0,1.0,1.0,1.0,14,6,8,3.0,1.0,2.0
9811253,90,22,68,257,0,90,580,9,32.0,6.0,26.0,76.0,1.0,31.0,60.0,126,90,36,21.0,18.0,3.0
9304289,14,3,11,23,14,0,0,39,9.0,2.0,7.0,14.0,9.0,0.0,0.0,15,14,1,5.0,5.0,0.0
9607370,31,13,18,58,7,24,52,44,8.0,3.0,5.0,8.0,0.0,8.0,25.0,41,31,10,12.0,9.0,3.0
9907272,36,2,34,152,0,36,226,2,23.0,2.0,21.0,87.0,0.0,23.0,40.0,52,36,16,25.0,21.0,4.0
9904262,45,5,40,216,0,45,797,2,39.0,3.0,36.0,202.0,0.0,39.0,728.0,92,45,47,46.0,21.0,25.0
9910277,15,5,10,15,0,15,108,2,7.0,3.0,4.0,4.0,0.0,7.0,77.0,56,15,41,19.0,4.0,15.0
9508319,16,2,14,26,16,0,0,258,7.0,1.0,6.0,13.0,7.0,0.0,0.0,16,16,0,7.0,7.0,0.0
9705470,17,4,13,57,0,17,43,16,13.0,2.0,11.0,38.0,0.0,13.0,26.0,26,17,9,15.0,13.0,2.0
4013,33,7,26,155,8,25,122,19,23.0,1.0,22.0,139.0,1.0,22.0,111.0,47,33,14,27.0,20.0,7.0
9812250,5,2,3,3,4,1,1,19,,,,,,,,6,5,1,,,
204025,22,13,9,10,2,20,72,39,4.0,3.0,1.0,1.0,0.0,4.0,18.0,36,22,14,8.0,3.0,5.0
12129,2,1,1,1,0,2,5,19,0.0,0.0,0.0,0.0,0.0,0.0,0.0,11,2,9,2.0,0.0,2.0
203064,6,2,4,4,0,6,21,19,0.0,0.0,0.0,0.0,0.0,0.0,0.0,24,6,18,6.0,1.0,5.0
11133,5,2,3,4,1,4,5,43,4.0,1.0,3.0,3.0,2.0,2.0,3.0,8,5,3,1.0,1.0,0.0
204218,13,5,8,15,0,13,199,28,13.0,5.0,8.0,15.0,0.0,13.0,159.0,41,13,28,26.0,12.0,14.0
102065,21,6,15,53,2,19,104,28,13.0,4.0,9.0,34.0,2.0,11.0,23.0,37,21,16,9.0,5.0,4.0
9909373,16,6,10,22,0,16,138,2,4.0,3.0,1.0,1.0,0.0,4.0,46.0,47,16,31,7.0,1.0,6.0
9711405,14,5,9,22,1,13,47,9,9.0,2.0,7.0,18.0,0.0,9.0,32.0,21,14,7,1.0,1.0,0.0
9512390,6,2,4,5,1,5,10,91,1.0,1.0,0.0,0.0,0.0,1.0,3.0,10,6,4,5.0,2.0,3.0
9612312,14,11,3,3,10,4,4,148,4.0,3.0,1.0,1.0,1.0,3.0,3.0,16,14,2,5.0,3.0,2.0
10192,21,6,15,30,0,21,169,2,17.0,4.0,13.0,28.0,0.0,17.0,80.0,39,21,18,23.0,15.0,8.0
111435,9,7,2,3,0,9,52,2,0.0,0.0,0.0,0.0,0.0,0.0,0.0,19,9,10,7.0,4.0,3.0
5146,13,7,6,10,0,13,102,2,10.0,5.0,5.0,9.0,0.0,10.0,54.0,29,13,16,16.0,6.0,10.0
9607362,28,7,21,73,2,26,81,5,13.0,2.0,11.0,35.0,1.0,12.0,12.0,42,28,14,17.0,16.0,1.0
110283,15,4,11,21,1,14,202,3,8.0,2.0,6.0,8.0,0.0,8.0,75.0,59,15,44,23.0,9.0,14.0
9805336,4,4,0,0,0,4,55,60,0.0,0.0,0.0,0.0,0.0,0.0,0.0,47,4,43,15.0,0.0,15.0
9209219,7,5,2,2,7,0,0,105,2.0,2.0,0.0,0.0,2.0,0.0,0.0,7,7,0,3.0,3.0,0.0
9912240,9,1,8,11,0,9,31,28,6.0,1.0,5.0,7.0,0.0,6.0,13.0,31,9,22,9.0,4.0,5.0
9506443,1,1,0,0,1,0,0,159,0.0,0.0,0.0,0.0,0.0,0.0,0.0,9,1,8,3.0,0.0,3.0
9405382,7,5,2,4,1,6,25,164,5.0,4.0,1.0,2.0,0.0,5.0,15.0,13,7,6,9.0,6.0,3.0
101091,37,7,30,144,1,36,162,0,17.0,2.0,15.0,56.0,0.0,17.0,58.0,69,37,32,18.0,13.0,5.0
9710424,6,6,0,0,4,2,2,86,,,,,,,,7,6,1,,,
9705397,8,6,2,3,2,6,25,74,4.0,3.0,1.0,2.0,0.0,4.0,12.0,23,8,15,7.0,3.0,4.0
201094,3,3,0,0,1,2,3,1,0.0,0.0,0.0,0.0,0.0,0.0,0.0,32,3,29,3.0,0.0,3.0
5188,2,1,1,1,0,2,16,34,0.0,0.0,0.0,0.0,0.0,0.0,0.0,17,2,15,2.0,0.0,2.0
101034,9,5,4,8,1,8,78,5,5.0,2.0,3.0,4.0,0.0,5.0,55.0,31,9,22,17.0,4.0,13.0
9808360,25,13,12,29,1,24,165,17,12.0,6.0,6.0,20.0,0.0,12.0,130.0,47,25,22,19.0,6.0,13.0
9412346,12,4,8,18,1,11,47,75,2.0,2.0,0.0,0.0,0.0,2.0,13.0,26,12,14,9.0,1.0,8.0
9711450,42,8,34,85,32,10,19,79,18.0,2.0,16.0,38.0,13.0,5.0,7.0,47,42,5,17.0,17.0,0.0
9305293,22,3,19,39,12,10,10,196,12.0,1.0,11.0,17.0,4.0,8.0,8.0,23,22,1,7.0,6.0,1.0
9801260,81,6,75,446,1,80,488,9,53.0,3.0,50.0,311.0,0.0,53.0,367.0,96,81,15,42.0,28.0,14.0
9807204,3,2,1,1,1,2,6,8,0.0,0.0,0.0,0.0,0.0,0.0,0.0,6,3,3,1.0,0.0,1.0
9505329,175,13,162,1208,7,168,525,17,132.0,8.0,124.0,1033.0,1.0,131.0,455.0,186,175,11,63.0,57.0,6.0
9503346,19,8,11,26,0,19,81,17,15.0,5.0,10.0,25.0,0.0,15.0,56.0,27,19,8,14.0,9.0,5.0
9606271,12,6,6,11,6,6,7,33,6.0,4.0,2.0,4.0,5.0,1.0,1.0,15,12,3,7.0,6.0,1.0
9605433,4,2,2,2,2,2,6,211,2.0,1.0,1.0,1.0,1.0,1.0,1.0,11,4,7,4.0,2.0,2.0
9810235,11,7,4,6,2,9,82,24,6.0,3.0,3.0,5.0,0.0,6.0,52.0,28,11,17,2.0,1.0,1.0
5004,12,5,7,12,2,10,30,104,5.0,3.0,2.0,4.0,1.0,4.0,16.0,20,12,8,8.0,4.0,4.0
9510258,18,7,11,25,3,15,20,154,11.0,3.0,8.0,14.0,1.0,10.0,10.0,21,18,3,7.0,6.0,1.0
9609265,9,8,1,3,0,9,35,13,5.0,4.0,1.0,3.0,0.0,5.0,9.0,28,9,19,9.0,6.0,3.0
9208202,6,5,1,1,6,0,0,533,3.0,3.0,0.0,0.0,3.0,0.0,0.0,6,6,0,2.0,2.0,0.0
105053,15,3,12,31,0,15,93,4,8.0,2.0,6.0,13.0,1.0,7.0,22.0,38,15,23,3.0,3.0,0.0
9612387,11,3,8,18,1,10,48,7,8.0,2.0,6.0,15.0,0.0,8.0,45.0,22,11,11,5.0,4.0,1.0
9801201,10,8,2,2,4,6,48,1,2.0,2.0,0.0,0.0,0.0,2.0,30.0,83,10,73,16.0,0.0,16.0
9502329,47,10,37,233,38,9,11,29,32.0,4.0,28.0,211.0,32.0,0.0,0.0,56,47,9,28.0,28.0,0.0
9304278,2,2,0,0,2,0,0,492,2.0,2.0,0.0,0.0,2.0,0.0,0.0,2,2,0,2.0,2.0,0.0
9809410,11,2,9,27,10,1,1,50,4.0,1.0,3.0,5.0,4.0,0.0,0.0,12,11,1,4.0,4.0,0.0
9604441,85,23,62,327,25,60,156,54,34.0,2.0,32.0,174.0,9.0,25.0,40.0,133,85,48,24.0,22.0,2.0
9805509,19,4,15,43,2,17,36,54,13.0,1.0,12.0,33.0,13.0,0.0,0.0,24,19,5,11.0,11.0,0.0
9312260,7,7,0,0,7,0,0,220,2.0,2.0,0.0,0.0,2.0,0.0,0.0,7,7,0,1.0,1.0,0.0
9910424,6,6,0,0,0,6,81,24,5.0,5.0,0.0,0.0,0.0,5.0,62.0,46,6,40,26.0,1.0,25.0
11254,24,8,16,45,2,22,187,24,15.0,3.0,12.0,39.0,0.0,15.0,161.0,46,24,22,27.0,10.0,17.0
9712352,11,5,6,8,11,0,0,224,8.0,5.0,3.0,3.0,8.0,0.0,0.0,11,11,0,6.0,6.0,0.0
9706256,1,1,0,0,1,0,0,1350,,,,,,,,1,1,0,1.0,1.0,0.0
9812404,10,5,5,5,7,3,5,214,7.0,2.0,5.0,5.0,6.0,1.0,1.0,13,10,3,4.0,2.0,2.0
101059,2,2,0,0,0,2,18,9,1.0,1.0,0.0,0.0,0.0,1.0,2.0,21,2,19,3.0,0.0,3.0
9511217,32,5,27,86,15,17,17,14,15.0,2.0,13.0,32.0,15.0,0.0,0.0,36,32,4,9.0,9.0,0.0
9502271,14,5,9,16,6,8,13,14,7.0,3.0,4.0,7.0,0.0,7.0,10.0,19,14,5,6.0,6.0,0.0
9611326,9,4,5,6,2,7,26,14,1.0,1.0,0.0,0.0,0.0,1.0,5.0,28,9,19,7.0,5.0,2.0
9509279,40,13,27,72,40,0,0,14,9.0,3.0,6.0,13.0,9.0,0.0,0.0,41,40,1,8.0,8.0,0.0
9902250,21,9,12,28,8,13,31,27,11.0,5.0,6.0,10.0,5.0,6.0,6.0,26,21,5,11.0,7.0,4.0
9908446,11,4,7,16,1,10,59,73,10.0,3.0,7.0,16.0,0.0,10.0,59.0,21,11,10,18.0,8.0,10.0
9404353,7,4,3,6,7,0,0,34,1.0,1.0,0.0,0.0,1.0,0.0,0.0,8,7,1,1.0,1.0,0.0
9311301,13,7,6,11,13,0,0,132,4.0,2.0,2.0,2.0,4.0,0.0,0.0,13,13,0,2.0,2.0,0.0
9807258,24,10,14,28,2,22,70,51,8.0,4.0,4.0,5.0,0.0,8.0,28.0,42,24,18,13.0,3.0,10.0
9805380,61,5,56,228,18,43,169,9,26.0,5.0,21.0,58.0,0.0,26.0,103.0,76,61,15,21.0,21.0,0.0
9702418,18,7,11,33,1,17,65,16,5.0,1.0,4.0,5.0,1.0,4.0,17.0,32,18,14,5.0,5.0,0.0
9811396,5,2,3,3,1,4,13,162,3.0,1.0,2.0,2.0,0.0,3.0,5.0,13,5,8,6.0,3.0,3.0
9512223,2,1,1,1,0,2,2,16,2.0,1.0,1.0,1.0,0.0,2.0,2.0,20,2,18,2.0,2.0,0.0
9512316,6,3,3,3,6,0,0,11,,,,,,,,6,6,0,1.0,1.0,0.0
9705466,6,4,2,2,0,6,20,57,2.0,2.0,0.0,0.0,0.0,2.0,3.0,18,6,12,4.0,2.0,2.0
9709425,7,3,4,4,0,7,15,44,5.0,1.0,4.0,4.0,1.0,4.0,7.0,12,7,5,4.0,4.0,0.0
9610269,27,4,23,96,3,24,116,13,18.0,2.0,16.0,74.0,0.0,18.0,80.0,39,27,12,24.0,17.0,7.0
9309219,39,9,30,100,39,0,0,18,18.0,2.0,16.0,51.0,18.0,0.0,0.0,39,39,0,8.0,8.0,0.0
9511457,4,2,2,3,0,4,7,97,0.0,0.0,0.0,0.0,0.0,0.0,0.0,6,4,2,2.0,0.0,2.0
9605266,57,2,55,383,4,53,202,15,43.0,1.0,42.0,327.0,1.0,42.0,172.0,68,57,11,39.0,31.0,8.0
9311296,13,7,6,9,10,3,4,15,6.0,4.0,2.0,2.0,6.0,0.0,0.0,15,13,2,5.0,5.0,0.0
9503296,28,6,22,69,2,26,69,15,15.0,2.0,13.0,42.0,1.0,14.0,37.0,36,28,8,9.0,8.0,1.0
9705248,13,5,8,17,0,13,75,15,5.0,3.0,2.0,3.0,0.0,5.0,25.0,25,13,12,2.0,1.0,1.0
9912312,21,9,12,17,11,10,19,226,4.0,1.0,3.0,5.0,4.0,0.0,0.0,25,21,4,4.0,4.0,0.0
9604301,31,7,24,98,5,26,96,33,22.0,2.0,20.0,88.0,2.0,20.0,75.0,40,31,9,24.0,19.0,5.0
108112,25,10,15,35,8,17,54,3,1.0,1.0,0.0,0.0,0.0,1.0,4.0,45,25,20,6.0,6.0,0.0
9809459,6,5,1,1,6,0,0,168,1.0,1.0,0.0,0.0,1.0,0.0,0.0,6,6,0,1.0,1.0,0.0
9705227,1,1,0,0,1,0,0,120,,,,,,,,1,1,0,,,
9904349,11,1,10,22,1,10,20,0,0.0,0.0,0.0,0.0,0.0,0.0,0.0,16,11,5,1.0,0.0,1.0
9508323,17,9,8,10,14,3,3,52,7.0,2.0,5.0,6.0,7.0,0.0,0.0,18,17,1,2.0,2.0,0.0
9905324,3,1,2,2,0,3,22,52,2.0,1.0,1.0,1.0,0.0,2.0,12.0,16,3,13,9.0,2.0,7.0
9308279,14,3,11,19,14,0,0,112,6.0,2.0,4.0,6.0,6.0,0.0,0.0,14,14,0,6.0,6.0,0.0
9708329,14,2,12,18,14,0,0,2,4.0,2.0,2.0,3.0,4.0,0.0,0.0,15,14,1,2.0,2.0,0.0
9606422,13,8,5,10,3,10,27,74,3.0,2.0,1.0,2.0,0.0,3.0,8.0,28,13,15,8.0,4.0,4.0
9810553,29,2,27,67,29,0,0,128,20.0,1.0,19.0,57.0,20.0,0.0,0.0,29,29,0,14.0,14.0,0.0
5211,6,5,1,2,0,6,28,5,2.0,2.0,0.0,0.0,0.0,2.0,3.0,18,6,12,2.0,0.0,2.0
9603316,6,5,1,1,4,2,3,174,3.0,3.0,0.0,0.0,3.0,0.0,0.0,10,6,4,2.0,1.0,1.0
9703252,5,2,3,4,1,4,13,145,3.0,2.0,1.0,1.0,0.0,3.0,3.0,15,5,10,2.0,2.0,0.0
5203,7,3,4,6,6,1,1,305,0.0,0.0,0.0,0.0,0.0,0.0,0.0,10,7,3,4.0,4.0,0.0
9610262,12,2,10,30,2,10,26,137,11.0,1.0,10.0,30.0,1.0,10.0,24.0,22,12,10,14.0,11.0,3.0
9604392,9,2,7,14,1,8,25,4,2.0,1.0,1.0,1.0,0.0,2.0,6.0,17,9,8,6.0,2.0,4.0
9603413,5,1,4,5,2,3,4,123,3.0,1.0,2.0,3.0,3.0,0.0,0.0,10,5,5,2.0,0.0,2.0
5224,6,3,3,5,1,5,24,21,4.0,1.0,3.0,5.0,0.0,4.0,13.0,25,6,19,10.0,0.0,10.0
9406379,7,4,3,3,6,1,2,103,2.0,1.0,1.0,1.0,2.0,0.0,0.0,9,7,2,3.0,3.0,0.0
9803433,29,9,20,120,2,27,203,49,16.0,5.0,11.0,54.0,0.0,16.0,112.0,55,29,26,27.0,11.0,16.0
9711430,4,4,0,0,0,4,4,111,3.0,3.0,0.0,0.0,3.0,0.0,0.0,5,4,1,3.0,3.0,0.0
9910555,2,1,1,1,0,2,2,641,0.0,0.0,0.0,0.0,0.0,0.0,0.0,3,2,1,2.0,1.0,1.0
9209260,11,6,5,10,11,0,0,225,8.0,4.0,4.0,8.0,8.0,0.0,0.0,11,11,0,3.0,3.0,0.0
9603341,25,8,17,28,4,21,47,30,10.0,2.0,8.0,13.0,10.0,0.0,0.0,40,25,15,3.0,1.0,2.0
9605303,4,1,3,5,0,4,16,30,3.0,1.0,2.0,3.0,0.0,3.0,13.0,12,4,8,4.0,3.0,1.0
9702313,1,1,0,0,1,0,0,1656,0.0,0.0,0.0,0.0,0.0,0.0,0.0,2,1,1,1.0,0.0,1.0
9609486,9,3,6,18,0,9,57,3,1.0,1.0,0.0,0.0,0.0,1.0,9.0,35,9,26,4.0,2.0,2.0
2151,19,8,11,31,4,15,77,42,8.0,2.0,6.0,18.0,1.0,7.0,33.0,40,19,21,18.0,7.0,11.0
9196,3,1,2,2,0,3,22,55,2.0,1.0,1.0,1.0,0.0,2.0,15.0,15,3,12,,,
9501318,42,6,36,150,18,24,40,13,24.0,2.0,22.0,102.0,9.0,15.0,19.0,47,42,5,19.0,18.0,1.0
103126,17,7,10,28,1,16,71,23,7.0,3.0,4.0,13.0,0.0,7.0,46.0,30,17,13,11.0,6.0,5.0
9701276,5,4,1,1,1,4,8,21,1.0,1.0,0.0,0.0,0.0,1.0,5.0,36,5,31,5.0,0.0,5.0
9304234,17,3,14,27,17,0,0,112,9.0,2.0,7.0,14.0,9.0,0.0,0.0,17,17,0,7.0,7.0,0.0
6196,5,4,1,1,2,3,7,36,2.0,1.0,1.0,1.0,0.0,2.0,4.0,9,5,4,5.0,2.0,3.0
9204226,13,3,10,34,13,0,0,36,9.0,2.0,7.0,17.0,9.0,0.0,0.0,13,13,0,9.0,9.0,0.0
9407378,7,4,3,4,6,1,2,74,1.0,1.0,0.0,0.0,1.0,0.0,0.0,10,7,3,1.0,1.0,0.0
9705399,18,2,16,65,0,18,310,36,16.0,2.0,14.0,53.0,0.0,16.0,303.0,49,18,31,41.0,15.0,26.0
204141,3,3,0,0,0,3,10,26,1.0,1.0,0.0,0.0,0.0,1.0,2.0,15,3,12,2.0,1.0,1.0
105034,3,2,1,1,0,3,16,218,3.0,2.0,1.0,1.0,0.0,3.0,15.0,16,3,13,13.0,3.0,10.0
202265,3,2,1,1,0,3,24,89,3.0,2.0,1.0,1.0,0.0,3.0,18.0,20,3,17,12.0,3.0,9.0
9709430,4,3,1,1,0,4,22,67,3.0,2.0,1.0,1.0,0.0,3.0,19.0,16,4,12,4.0,0.0,4.0
9412239,6,3,3,3,0,6,13,98,1.0,1.0,0.0,0.0,0.0,1.0,4.0,17,6,11,6.0,1.0,5.0
11366,9,6,3,4,1,8,24,86,2.0,2.0,0.0,0.0,0.0,2.0,6.0,20,9,11,3.0,2.0,1.0
5074,1,1,0,0,0,1,7,30,1.0,1.0,0.0,0.0,0.0,1.0,7.0,9,1,8,,,
9312269,8,4,4,7,5,3,12,345,4.0,1.0,3.0,5.0,4.0,0.0,0.0,13,8,5,4.0,4.0,0.0
9405325,38,15,23,105,37,1,1,94,16.0,4.0,12.0,54.0,16.0,0.0,0.0,39,38,1,8.0,8.0,0.0
101281,3,3,0,0,0,3,14,21,0.0,0.0,0.0,0.0,0.0,0.0,0.0,23,3,20,2.0,0.0,2.0
9906396,8,3,5,7,0,8,26,1,3.0,2.0,1.0,1.0,1.0,2.0,3.0,20,8,12,5.0,4.0,1.0
9903543,22,9,13,25,2,20,155,1,4.0,2.0,2.0,2.0,0.0,4.0,62.0,78,22,56,21.0,1.0,20.0
9802448,11,5,6,6,6,5,12,67,1.0,1.0,0.0,0.0,0.0,1.0,1.0,23,11,12,3.0,0.0,3.0
9609239,3,3,0,0,0,3,9,57,3.0,3.0,0.0,0.0,0.0,3.0,6.0,11,3,8,5.0,2.0,3.0
9803301,29,4,25,71,13,16,24,125,22.0,1.0,21.0,64.0,9.0,13.0,20.0,31,29,2,18.0,16.0,2.0
9705384,7,3,4,4,0,7,14,19,5.0,2.0,3.0,3.0,0.0,5.0,7.0,12,7,5,1.0,1.0,0.0
9708432,4,4,0,0,0,4,5,432,3.0,3.0,0.0,0.0,0.0,3.0,3.0,10,4,6,4.0,3.0,1.0
9810421,4,2,2,2,0,4,13,6,0.0,0.0,0.0,0.0,0.0,0.0,0.0,21,4,17,4.0,1.0,3.0
8156,12,8,4,7,2,10,170,24,10.0,6.0,4.0,7.0,0.0,10.0,129.0,43,12,31,20.0,6.0,14.0
9902463,6,3,3,5,1,5,6,13,0.0,0.0,0.0,0.0,0.0,0.0,0.0,10,6,4,1.0,0.0,1.0
9029,9,6,3,5,3,6,12,25,3.0,1.0,2.0,3.0,0.0,3.0,3.0,20,9,11,2.0,2.0,0.0
9708221,3,2,1,1,1,2,4,10,0.0,0.0,0.0,0.0,0.0,0.0,0.0,97,3,94,13.0,0.0,13.0
9503334,17,3,14,33,2,15,24,90,15.0,2.0,13.0,32.0,0.0,15.0,24.0,20,17,3,13.0,12.0,1.0
9902305,4,1,3,6,3,1,1,8,0.0,0.0,0.0,0.0,0.0,0.0,0.0,6,4,2,2.0,1.0,1.0
9305270,2,1,1,1,2,0,0,2127,,,,,,,,2,2,0,,,
103044,16,4,12,36,1,15,61,22,13.0,2.0,11.0,35.0,0.0,13.0,43.0,31,16,15,17.0,12.0,5.0
9802378,19,5,14,42,14,5,8,88,8.0,2.0,6.0,21.0,8.0,0.0,0.0,30,19,11,4.0,4.0,0.0
106086,6,2,4,4,0,6,17,0,6.0,2.0,4.0,4.0,0.0,6.0,17.0,11,6,5,2.0,2.0,0.0
110105,11,2,9,24,0,11,63,0,10.0,1.0,9.0,23.0,0.0,10.0,57.0,27,11,16,17.0,10.0,7.0
9506347,14,2,12,26,9,5,11,200,13.0,1.0,12.0,26.0,8.0,5.0,5.0,17,14,3,12.0,11.0,1.0
9608330,8,3,5,6,2,6,13,62,3.0,2.0,1.0,1.0,0.0,3.0,10.0,23,8,15,8.0,3.0,5.0
9902465,2,1,1,1,0,2,22,3,2.0,1.0,1.0,1.0,0.0,2.0,22.0,19,2,17,6.0,0.0,6.0
106075,7,6,1,1,0,7,19,66,3.0,2.0,1.0,1.0,0.0,3.0,13.0,16,7,9,9.0,3.0,6.0
9509357,3,2,1,1,2,1,1,217,0.0,0.0,0.0,0.0,0.0,0.0,0.0,5,3,2,1.0,0.0,1.0
102046,19,4,15,54,0,19,199,0,17.0,3.0,14.0,51.0,0.0,17.0,173.0,42,19,23,31.0,15.0,16.0
9612340,6,5,1,3,2,4,11,63,3.0,2.0,1.0,2.0,1.0,2.0,7.0,13,6,7,7.0,2.0,5.0
7041,13,3,10,21,0,13,234,12,9.0,2.0,7.0,17.0,0.0,9.0,176.0,71,13,58,23.0,6.0,17.0
9808201,7,3,4,4,0,7,27,14,0.0,0.0,0.0,0.0,0.0,0.0,0.0,28,7,21,4.0,1.0,3.0
9907431,13,5,8,17,0,13,57,25,5.0,3.0,2.0,4.0,0.0,5.0,29.0,34,13,21,18.0,4.0,14.0
9912524,9,3,6,24,0,9,122,3,8.0,3.0,5.0,19.0,0.0,8.0,109.0,54,9,45,9.0,7.0,2.0
9512426,5,3,2,4,0,5,20,10,3.0,2.0,1.0,2.0,0.0,3.0,11.0,11,5,6,1.0,1.0,0.0
9409384,12,2,10,28,12,0,0,152,11.0,2.0,9.0,25.0,11.0,0.0,0.0,12,12,0,10.0,10.0,0.0
103069,7,3,4,12,0,7,106,23,7.0,3.0,4.0,12.0,0.0,7.0,106.0,29,7,22,18.0,6.0,12.0
9307242,74,10,64,496,74,0,0,53,58.0,4.0,54.0,470.0,58.0,0.0,0.0,74,74,0,42.0,42.0,0.0
9608297,19,3,16,44,1,18,65,7,12.0,2.0,10.0,31.0,0.0,12.0,32.0,30,19,11,14.0,10.0,4.0
103244,6,1,5,8,0,6,23,56,6.0,1.0,5.0,8.0,0.0,6.0,18.0,16,6,10,3.0,3.0,0.0
9606201,14,5,9,16,6,8,11,33,5.0,3.0,2.0,3.0,2.0,3.0,3.0,18,14,4,3.0,3.0,0.0
9507364,4,4,0,0,1,3,11,6,3.0,3.0,0.0,0.0,0.0,3.0,11.0,14,4,10,1.0,1.0,0.0
9705411,15,7,8,21,1,14,67,5,6.0,3.0,3.0,4.0,1.0,5.0,12.0,37,15,22,11.0,8.0,3.0
9910466,10,5,5,6,0,10,141,2,7.0,4.0,3.0,4.0,0.0,7.0,113.0,50,10,40,34.0,4.0,30.0
9901241,8,3,5,9,1,7,77,3,6.0,2.0,4.0,7.0,0.0,6.0,68.0,41,8,33,22.0,2.0,20.0
9906312,7,3,4,8,1,6,19,55,6.0,2.0,4.0,8.0,0.0,6.0,19.0,11,7,4,1.0,1.0,0.0
9805274,19,3,16,35,3,16,71,12,8.0,2.0,6.0,15.0,7.0,1.0,1.0,51,19,32,6.0,6.0,0.0
9501227,4,2,2,3,4,0,0,60,1.0,1.0,0.0,0.0,1.0,0.0,0.0,7,4,3,1.0,1.0,0.0
9209287,9,4,5,11,9,0,0,176,9.0,4.0,5.0,11.0,9.0,0.0,0.0,9,9,0,9.0,9.0,0.0
9709458,2,1,1,1,0,2,4,363,0.0,0.0,0.0,0.0,0.0,0.0,0.0,11,2,9,3.0,0.0,3.0
9306254,13,5,8,11,13,0,0,35,5.0,3.0,2.0,2.0,5.0,0.0,0.0,13,13,0,3.0,3.0,0.0
9811327,1,1,0,0,1,0,0,1735,0.0,0.0,0.0,0.0,0.0,0.0,0.0,3,1,2,1.0,1.0,0.0
9801341,10,5,5,8,1,9,64,130,5.0,3.0,2.0,2.0,0.0,5.0,24.0,32,10,22,10.0,3.0,7.0
210007,6,5,1,1,3,3,24,129,2.0,2.0,0.0,0.0,0.0,2.0,11.0,41,6,35,10.0,2.0,8.0
201052,11,1,10,23,0,11,76,46,9.0,1.0,8.0,21.0,0.0,9.0,51.0,46,11,35,23.0,7.0,16.0
10178,35,7,28,100,21,14,21,119,15.0,1.0,14.0,51.0,15.0,0.0,0.0,43,35,8,13.0,13.0,0.0
9510373,10,8,2,5,3,7,11,238,3.0,3.0,0.0,0.0,3.0,0.0,0.0,18,10,8,4.0,1.0,3.0
202006,13,4,9,22,0,13,77,107,11.0,3.0,8.0,18.0,0.0,11.0,38.0,44,13,31,13.0,9.0,4.0
9912268,10,8,2,2,0,10,45,0,4.0,3.0,1.0,1.0,0.0,4.0,16.0,36,10,26,8.0,3.0,5.0
107190,20,3,17,97,0,20,203,37,19.0,3.0,16.0,94.0,0.0,19.0,141.0,50,20,30,26.0,18.0,8.0
7206,7,1,6,10,0,7,48,60,1.0,1.0,0.0,0.0,0.0,1.0,7.0,29,7,22,8.0,1.0,7.0
103007,5,1,4,6,1,4,47,47,4.0,1.0,3.0,5.0,0.0,4.0,39.0,27,5,22,21.0,4.0,17.0
9912551,13,8,5,6,1,12,55,57,5.0,4.0,1.0,1.0,0.0,5.0,19.0,34,13,21,3.0,2.0,1.0
105212,23,9,14,37,0,23,59,3,16.0,3.0,13.0,30.0,0.0,16.0,42.0,46,23,23,5.0,5.0,0.0
9906202,7,4,3,3,0,7,18,58,2.0,1.0,1.0,1.0,0.0,2.0,4.0,12,7,5,3.0,3.0,0.0
9907438,4,4,0,0,2,2,6,48,1.0,1.0,0.0,0.0,0.0,1.0,4.0,14,4,10,5.0,1.0,4.0
6192,11,4,7,20,1,10,31,65,10.0,4.0,6.0,19.0,1.0,9.0,22.0,18,11,7,4.0,4.0,0.0
9401280,0,0,0,0,0,0,0,203,0.0,0.0,0.0,0.0,0.0,0.0,0.0,1,0,1,,,
9411268,6,2,4,8,2,4,5,35,1.0,1.0,0.0,0.0,0.0,1.0,2.0,12,6,6,3.0,3.0,0.0
9501333,12,4,8,25,1,11,28,100,10.0,2.0,8.0,25.0,0.0,10.0,27.0,15,12,3,13.0,10.0,3.0
9812300,3,2,1,1,3,0,0,158,1.0,1.0,0.0,0.0,1.0,0.0,0.0,6,3,3,2.0,2.0,0.0
204060,3,3,0,0,0,3,23,54,3.0,3.0,0.0,0.0,0.0,3.0,15.0,24,3,21,10.0,2.0,8.0
105334,16,2,14,34,0,16,231,11,13.0,2.0,11.0,30.0,0.0,13.0,183.0,45,16,29,30.0,11.0,19.0
9408280,3,3,0,0,2,1,1,92,0.0,0.0,0.0,0.0,0.0,0.0,0.0,5,3,2,1.0,1.0,0.0
9411300,8,7,1,2,3,5,15,13,4.0,3.0,1.0,2.0,1.0,3.0,6.0,18,8,10,2.0,2.0,0.0
9505209,10,3,7,13,10,0,0,410,5.0,2.0,3.0,6.0,5.0,0.0,0.0,10,10,0,6.0,6.0,0.0
9508264,17,4,13,33,5,12,13,84,10.0,1.0,9.0,22.0,2.0,8.0,8.0,19,17,2,10.0,9.0,1.0
9403392,3,3,0,0,3,0,0,149,1.0,1.0,0.0,0.0,1.0,0.0,0.0,3,3,0,1.0,1.0,0.0
12077,3,1,2,2,0,3,19,15,3.0,1.0,2.0,2.0,0.0,3.0,19.0,13,3,10,7.0,2.0,5.0
9512248,31,4,27,86,1,30,83,17,11.0,3.0,8.0,25.0,2.0,9.0,18.0,39,31,8,17.0,14.0,3.0
8116,6,3,3,4,1,5,15,2,3.0,1.0,2.0,3.0,1.0,2.0,3.0,15,6,9,4.0,2.0,2.0
9911535,19,7,12,22,9,10,40,121,11.0,4.0,7.0,16.0,4.0,7.0,18.0,27,19,8,8.0,4.0,4.0
9604446,7,4,3,6,0,7,11,101,7.0,4.0,3.0,6.0,0.0,7.0,9.0,13,7,6,5.0,4.0,1.0
9407395,11,5,6,19,3,8,8,50,8.0,3.0,5.0,11.0,2.0,6.0,6.0,12,11,1,4.0,3.0,1.0
9707318,5,3,2,2,0,5,41,6,1.0,1.0,0.0,0.0,0.0,1.0,4.0,23,5,18,7.0,2.0,5.0
9710458,3,3,0,0,2,1,1,117,0.0,0.0,0.0,0.0,0.0,0.0,0.0,6,3,3,1.0,0.0,1.0
9610266,6,5,1,1,1,5,23,6,1.0,1.0,0.0,0.0,0.0,1.0,15.0,37,6,31,18.0,1.0,17.0
9612336,9,5,4,5,9,0,0,88,2.0,1.0,1.0,1.0,2.0,0.0,0.0,9,9,0,2.0,2.0,0.0
9905346,19,6,13,19,0,19,57,128,18.0,5.0,13.0,19.0,2.0,16.0,47.0,25,19,6,15.0,11.0,4.0
9910338,52,5,47,424,24,28,41,109,47.0,4.0,43.0,418.0,19.0,28.0,41.0,65,52,13,42.0,40.0,2.0
9906276,8,3,5,11,1,7,31,14,4.0,2.0,2.0,3.0,0.0,4.0,14.0,20,8,12,5.0,4.0,1.0
9401245,14,7,7,15,9,5,9,116,5.0,2.0,3.0,5.0,5.0,0.0,0.0,17,14,3,6.0,6.0,0.0
9801274,1,1,0,0,0,1,2,93,0.0,0.0,0.0,0.0,0.0,0.0,0.0,5,1,4,1.0,0.0,1.0
9703315,17,2,15,44,13,4,7,50,11.0,1.0,10.0,26.0,11.0,0.0,0.0,19,17,2,4.0,4.0,0.0
9304201,1,1,0,0,1,0,0,1665,1.0,1.0,0.0,0.0,1.0,0.0,0.0,1,1,0,1.0,1.0,0.0
210083,3,2,1,1,0,3,21,19,2.0,1.0,1.0,1.0,0.0,2.0,4.0,36,3,33,8.0,2.0,6.0
9702262,9,3,6,12,2,7,9,160,6.0,2.0,4.0,6.0,2.0,4.0,5.0,12,9,3,6.0,5.0,1.0
205129,0,0,0,0,0,0,0,37,0.0,0.0,0.0,0.0,0.0,0.0,0.0,7,0,7,3.0,0.0,3.0
9912336,19,4,15,45,2,17,92,71,13.0,1.0,12.0,32.0,0.0,13.0,69.0,34,19,15,21.0,9.0,12.0
9311331,4,2,2,3,1,3,9,6,1.0,1.0,0.0,0.0,1.0,0.0,0.0,8,4,4,2.0,1.0,1.0
9810295,6,6,0,0,1,5,12,54,3.0,3.0,0.0,0.0,1.0,2.0,4.0,12,6,6,6.0,3.0,3.0
9609262,9,1,8,18,1,8,21,34,0.0,0.0,0.0,0.0,0.0,0.0,0.0,17,9,8,5.0,4.0,1.0
109069,1,1,0,0,0,1,1,77,0.0,0.0,0.0,0.0,0.0,0.0,0.0,15,1,14,6.0,0.0,6.0
9811302,4,2,2,2,0,4,6,277,4.0,2.0,2.0,2.0,0.0,4.0,6.0,6,4,2,6.0,4.0,2.0
9810325,3,2,1,1,1,2,7,1,0.0,0.0,0.0,0.0,0.0,0.0,0.0,14,3,11,5.0,0.0,5.0
9802282,8,4,4,7,1,7,29,8,7.0,3.0,4.0,7.0,0.0,7.0,29.0,18,8,10,14.0,7.0,7.0
9806232,37,6,31,142,0,37,310,9,35.0,6.0,29.0,133.0,0.0,35.0,290.0,61,37,24,44.0,24.0,20.0
9511362,16,11,5,7,3,13,31,29,4.0,4.0,0.0,0.0,0.0,4.0,14.0,21,16,5,3.0,2.0,1.0
9607427,6,4,2,2,1,5,6,14,1.0,1.0,0.0,0.0,0.0,1.0,1.0,10,6,4,2.0,1.0,1.0
9807261,23,7,16,49,7,16,49,161,13.0,4.0,9.0,27.0,2.0,11.0,30.0,30,23,7,13.0,10.0,3.0
9908274,3,3,0,0,0,3,14,51,1.0,1.0,0.0,0.0,0.0,1.0,2.0,12,3,9,3.0,1.0,2.0
9806353,7,3,4,7,0,7,11,209,5.0,2.0,3.0,6.0,0.0,5.0,9.0,10,7,3,3.0,2.0,1.0
9510448,4,1,3,4,0,4,10,78,1.0,1.0,0.0,0.0,0.0,1.0,1.0,10,4,6,3.0,1.0,2.0
9703251,6,4,2,2,3,3,5,95,1.0,1.0,0.0,0.0,1.0,0.0,0.0,10,6,4,1.0,1.0,0.0
207114,6,4,2,2,1,5,19,24,1.0,1.0,0.0,0.0,0.0,1.0,3.0,29,6,23,9.0,2.0,7.0
9401260,3,2,1,1,0,3,3,1949,,,,,,,,4,3,1,,,
9211232,6,5,1,1,6,0,0,276,3.0,2.0,1.0,1.0,3.0,0.0,0.0,6,6,0,2.0,2.0,0.0
9401203,11,2,9,13,11,0,0,65,3.0,1.0,2.0,2.0,3.0,0.0,0.0,11,11,0,2.0,2.0,0.0
112355,0,0,0,0,0,0,0,222,0.0,0.0,0.0,0.0,0.0,0.0,0.0,3,0,3,3.0,0.0,3.0
9601313,14,6,8,18,2,12,38,133,10.0,3.0,7.0,15.0,2.0,8.0,17.0,31,14,17,10.0,5.0,5.0
9806369,6,4,2,3,6,0,0,27,1.0,1.0,0.0,0.0,1.0,0.0,0.0,7,6,1,1.0,1.0,0.0
9406406,12,3,9,18,3,9,62,53,8.0,1.0,7.0,16.0,0.0,8.0,57.0,23,12,11,15.0,7.0,8.0
9802306,8,4,4,5,1,7,14,96,3.0,3.0,0.0,0.0,1.0,2.0,3.0,13,8,5,4.0,2.0,2.0
9404230,4,4,0,0,1,3,4,75,1.0,1.0,0.0,0.0,0.0,1.0,1.0,10,4,6,3.0,2.0,1.0
9905446,5,3,2,2,0,5,13,18,3.0,2.0,1.0,1.0,1.0,2.0,5.0,16,5,11,4.0,0.0,4.0
9807293,9,6,3,4,0,9,43,25,3.0,1.0,2.0,2.0,0.0,3.0,15.0,23,9,14,2.0,2.0,0.0
112114,8,4,4,4,3,5,26,16,3.0,1.0,2.0,2.0,0.0,3.0,16.0,29,8,21,8.0,1.0,7.0
111186,2,2,0,0,1,1,3,27,1.0,1.0,0.0,0.0,1.0,0.0,0.0,20,2,18,11.0,0.0,11.0
9501270,2,1,1,1,0,2,2,27,1.0,1.0,0.0,0.0,1.0,0.0,0.0,5,2,3,2.0,1.0,1.0
9907373,11,3,8,22,1,10,24,83,8.0,2.0,6.0,18.0,3.0,5.0,5.0,16,11,5,12.0,9.0,3.0
9808246,4,2,2,3,0,4,6,143,4.0,2.0,2.0,3.0,0.0,4.0,6.0,8,4,4,1.0,0.0,1.0
9905364,2,2,0,0,1,1,1,826,,,,,,,,4,2,2,,,
12178,6,3,3,3,0,6,45,56,4.0,4.0,0.0,0.0,0.0,4.0,40.0,36,6,30,17.0,2.0,15.0
9310230,10,1,9,31,0,10,20,56,4.0,1.0,3.0,4.0,0.0,4.0,8.0,13,10,3,5.0,5.0,0.0
9310290,3,1,2,3,2,1,1,649,0.0,0.0,0.0,0.0,0.0,0.0,0.0,4,3,1,1.0,0.0,1.0
9711365,13,6,7,12,1,12,85,13,7.0,2.0,5.0,10.0,0.0,7.0,63.0,52,13,39,16.0,4.0,12.0
9309301,3,3,0,0,1,2,6,124,2.0,2.0,0.0,0.0,0.0,2.0,5.0,8,3,5,1.0,0.0,1.0
9910429,0,0,0,0,0,0,0,39,0.0,0.0,0.0,0.0,0.0,0.0,0.0,13,0,13,2.0,0.0,2.0
9405263,2,2,0,0,2,0,0,289,2.0,2.0,0.0,0.0,2.0,0.0,0.0,2,2,0,1.0,1.0,0.0
9601344,11,6,5,9,10,1,1,285,8.0,4.0,4.0,8.0,8.0,0.0,0.0,13,11,2,6.0,6.0,0.0
201261,8,4,4,7,1,7,34,15,2.0,1.0,1.0,1.0,0.0,2.0,15.0,31,8,23,4.0,2.0,2.0
8331,1,1,0,0,0,1,5,87,1.0,1.0,0.0,0.0,0.0,1.0,5.0,16,1,15,2.0,1.0,1.0
9807393,6,1,5,9,0,6,102,1,5.0,1.0,4.0,6.0,0.0,5.0,69.0,41,6,35,18.0,1.0,17.0
208027,3,3,0,0,1,2,32,2,1.0,1.0,0.0,0.0,0.0,1.0,12.0,34,3,31,4.0,3.0,1.0
9404336,8,6,2,3,8,0,0,531,3.0,3.0,0.0,0.0,3.0,0.0,0.0,8,8,0,2.0,2.0,0.0
9805395,5,1,4,6,0,5,17,142,5.0,1.0,4.0,6.0,0.0,5.0,17.0,9,5,4,9.0,5.0,4.0
9705405,11,5,6,11,3,8,26,41,4.0,2.0,2.0,3.0,0.0,4.0,18.0,19,11,8,4.0,4.0,0.0
9712505,2,2,0,0,0,2,11,16,0.0,0.0,0.0,0.0,0.0,0.0,0.0,82,2,80,9.0,0.0,9.0
9905562,4,4,0,0,1,3,10,57,2.0,2.0,0.0,0.0,0.0,2.0,9.0,14,4,10,9.0,1.0,8.0
9810546,16,5,11,37,1,15,57,16,2.0,2.0,0.0,0.0,0.0,2.0,11.0,54,16,38,9.0,9.0,0.0
8017,3,2,1,1,0,3,7,307,2.0,1.0,1.0,1.0,0.0,2.0,4.0,13,3,10,5.0,2.0,3.0
9909337,13,1,12,51,1,12,151,49,11.0,1.0,10.0,38.0,1.0,10.0,102.0,34,13,21,23.0,10.0,13.0
9809566,15,5,10,19,4,11,17,267,5.0,1.0,4.0,9.0,4.0,1.0,1.0,27,15,12,6.0,5.0,1.0
9807519,7,1,6,12,0,7,33,78,7.0,1.0,6.0,12.0,0.0,7.0,31.0,16,7,9,10.0,5.0,5.0
102174,8,3,5,11,0,8,92,2,4.0,1.0,3.0,6.0,0.0,4.0,54.0,27,8,19,10.0,4.0,6.0
111348,4,3,1,2,0,4,32,73,4.0,3.0,1.0,2.0,0.0,4.0,32.0,17,4,13,17.0,4.0,13.0
9807422,9,4,5,10,0,9,15,20,7.0,2.0,5.0,10.0,7.0,0.0,0.0,12,9,3,8.0,7.0,1.0
9081,6,3,3,6,3,3,3,13,1.0,1.0,0.0,0.0,1.0,0.0,0.0,7,6,1,2.0,2.0,0.0
9806350,18,5,13,46,0,18,113,16,16.0,3.0,13.0,46.0,0.0,16.0,98.0,39,18,21,10.0,8.0,2.0
9308225,2,2,0,0,1,1,1,276,0.0,0.0,0.0,0.0,0.0,0.0,0.0,3,2,1,2.0,1.0,1.0
9709375,1,1,0,0,0,1,1,10,0.0,0.0,0.0,0.0,0.0,0.0,0.0,16,1,15,9.0,0.0,9.0
107215,4,2,2,2,0,4,16,46,1.0,1.0,0.0,0.0,0.0,1.0,1.0,11,4,7,3.0,2.0,1.0
9901236,1,1,0,0,0,1,2,46,0.0,0.0,0.0,0.0,0.0,0.0,0.0,13,1,12,1.0,0.0,1.0
9806451,8,1,7,10,5,3,7,333,5.0,1.0,4.0,5.0,2.0,3.0,7.0,13,8,5,7.0,2.0,5.0
9802346,4,1,3,4,1,3,4,287,3.0,1.0,2.0,2.0,2.0,1.0,1.0,7,4,3,1.0,1.0,0.0
9612482,1,1,0,0,0,1,3,265,1.0,1.0,0.0,0.0,0.0,1.0,3.0,8,1,7,6.0,1.0,5.0
9808280,8,3,5,10,0,8,62,13,7.0,3.0,4.0,8.0,0.0,7.0,48.0,24,8,16,17.0,7.0,10.0
9407330,3,3,0,0,3,0,0,611,1.0,1.0,0.0,0.0,1.0,0.0,0.0,3,3,0,1.0,1.0,0.0
9604360,11,3,8,12,5,6,10,47,4.0,1.0,3.0,4.0,1.0,3.0,3.0,13,11,2,3.0,3.0,0.0
9401273,3,1,2,2,0,3,6,335,3.0,1.0,2.0,2.0,0.0,3.0,4.0,7,3,4,5.0,3.0,2.0
9605355,1,1,0,0,0,1,6,3,0.0,0.0,0.0,0.0,0.0,0.0,0.0,11,1,10,9.0,0.0,9.0
9810278,2,2,0,0,0,2,5,22,2.0,2.0,0.0,0.0,0.0,2.0,4.0,13,2,11,4.0,0.0,4.0
102118,1,1,0,0,0,1,3,11,0.0,0.0,0.0,0.0,0.0,0.0,0.0,24,1,23,8.0,0.0,8.0
10305,7,2,5,13,1,6,25,209,6.0,1.0,5.0,13.0,0.0,6.0,18.0,15,7,8,11.0,6.0,5.0
9305245,8,5,3,4,8,0,0,217,4.0,4.0,0.0,0.0,4.0,0.0,0.0,8,8,0,3.0,3.0,0.0
2241,11,7,4,9,1,10,33,45,7.0,3.0,4.0,9.0,0.0,7.0,11.0,24,11,13,5.0,2.0,3.0
9804238,5,4,1,1,2,3,3,14,2.0,2.0,0.0,0.0,0.0,2.0,2.0,17,5,12,2.0,1.0,1.0
9506322,7,4,3,4,1,6,8,8,2.0,2.0,0.0,0.0,0.0,2.0,2.0,13,7,6,3.0,3.0,0.0
9810247,1,1,0,0,0,1,1,46,0.0,0.0,0.0,0.0,0.0,0.0,0.0,32,1,31,14.0,0.0,14.0
110245,1,1,0,0,0,1,1,28,1.0,1.0,0.0,0.0,0.0,1.0,1.0,8,1,7,2.0,0.0,2.0
9311299,5,5,0,0,3,2,7,53,2.0,2.0,0.0,0.0,0.0,2.0,7.0,10,5,5,1.0,1.0,0.0
109174,10,5,5,9,1,9,73,9,6.0,2.0,4.0,5.0,0.0,6.0,54.0,37,10,27,9.0,5.0,4.0
9905527,1,1,0,0,0,1,1,197,1.0,1.0,0.0,0.0,0.0,1.0,1.0,8,1,7,2.0,0.0,2.0
9611418,5,3,2,2,4,1,1,13,0.0,0.0,0.0,0.0,0.0,0.0,0.0,12,5,7,3.0,0.0,3.0
9803377,8,4,4,6,2,6,11,65,2.0,2.0,0.0,0.0,0.0,2.0,2.0,11,8,3,4.0,2.0,2.0
112354,2,1,1,1,0,2,6,51,2.0,1.0,1.0,1.0,0.0,2.0,2.0,5,2,3,5.0,2.0,3.0
9303227,7,4,3,3,1,6,9,332,6.0,4.0,2.0,2.0,0.0,6.0,9.0,9,7,2,5.0,3.0,2.0
208193,3,2,1,2,0,3,31,0,3.0,2.0,1.0,2.0,0.0,3.0,23.0,23,3,20,7.0,2.0,5.0
206110,21,5,16,40,0,21,228,55,5.0,2.0,3.0,6.0,0.0,5.0,58.0,72,21,51,35.0,4.0,31.0
104256,12,5,7,15,1,11,59,45,4.0,2.0,2.0,5.0,0.0,4.0,27.0,37,12,25,11.0,4.0,7.0
9227,6,2,4,5,1,5,9,354,4.0,2.0,2.0,2.0,4.0,0.0,0.0,13,6,7,3.0,3.0,0.0
206104,3,3,0,0,1,2,3,59,1.0,1.0,0.0,0.0,1.0,0.0,0.0,11,3,8,2.0,1.0,1.0
9803478,4,3,1,1,3,1,1,294,2.0,2.0,0.0,0.0,2.0,0.0,0.0,5,4,1,2.0,1.0,1.0
6060,7,3,4,4,0,7,38,17,4.0,2.0,2.0,2.0,0.0,4.0,32.0,27,7,20,3.0,0.0,3.0
9704421,3,1,2,3,0,3,31,7,3.0,1.0,2.0,3.0,0.0,3.0,15.0,19,3,16,10.0,3.0,7.0
208091,13,4,9,27,0,13,71,1,9.0,2.0,7.0,21.0,0.0,9.0,29.0,59,13,46,14.0,9.0,5.0
209080,2,1,1,1,0,2,10,1,1.0,1.0,0.0,0.0,0.0,1.0,9.0,40,2,38,3.0,0.0,3.0
9907570,7,4,3,9,2,5,6,59,1.0,1.0,0.0,0.0,0.0,1.0,2.0,13,7,6,5.0,5.0,0.0
7091,31,6,25,76,5,26,201,25,12.0,2.0,10.0,35.0,0.0,12.0,98.0,62,31,31,26.0,11.0,15.0
109272,8,4,4,4,0,8,21,37,4.0,2.0,2.0,2.0,0.0,4.0,4.0,23,8,15,5.0,4.0,1.0
9907235,6,1,5,9,5,1,1,35,4.0,1.0,3.0,5.0,4.0,0.0,0.0,8,6,2,4.0,4.0,0.0
9404337,10,5,5,5,10,0,0,271,6.0,4.0,2.0,2.0,6.0,0.0,0.0,10,10,0,4.0,4.0,0.0
9609313,3,3,0,0,1,2,3,1725,,,,,,,,5,3,2,,,
107142,19,5,14,53,3,16,191,11,11.0,2.0,9.0,36.0,0.0,11.0,182.0,49,19,30,31.0,10.0,21.0
9504363,13,4,9,15,6,7,8,54,7.0,5.0,2.0,2.0,6.0,1.0,1.0,15,13,2,4.0,4.0,0.0
206118,1,1,0,0,0,1,5,3,0.0,0.0,0.0,0.0,0.0,0.0,0.0,12,1,11,3.0,0.0,3.0
103094,5,3,2,3,1,4,12,273,1.0,1.0,0.0,0.0,0.0,1.0,1.0,13,5,8,4.0,3.0,1.0
204350,5,3,2,2,2,3,25,10,2.0,2.0,0.0,0.0,0.0,2.0,19.0,36,5,31,11.0,1.0,10.0
9702345,11,2,9,17,6,5,6,267,9.0,2.0,7.0,14.0,9.0,0.0,0.0,30,11,19,5.0,5.0,0.0
107118,10,2,8,18,0,10,62,38,4.0,2.0,2.0,2.0,0.0,4.0,42.0,31,10,21,21.0,4.0,17.0
9901220,9,6,3,5,0,9,87,0,2.0,1.0,1.0,1.0,0.0,2.0,21.0,47,9,38,5.0,3.0,2.0
9503473,26,7,19,48,24,2,3,59,12.0,1.0,11.0,31.0,12.0,0.0,0.0,29,26,3,9.0,9.0,0.0
9901367,4,4,0,0,4,0,0,59,2.0,2.0,0.0,0.0,2.0,0.0,0.0,5,4,1,2.0,2.0,0.0
205015,2,2,0,0,0,2,11,5,1.0,1.0,0.0,0.0,0.0,1.0,6.0,16,2,14,3.0,1.0,2.0
9911331,4,2,2,3,1,3,6,11,0.0,0.0,0.0,0.0,0.0,0.0,0.0,9,4,5,5.0,3.0,2.0
105274,0,0,0,0,0,0,0,2,,,,,,,,8,0,8,,,
9512397,1,1,0,0,1,0,0,155,1.0,1.0,0.0,0.0,1.0,0.0,0.0,2,1,1,1.0,1.0,0.0
207184,8,5,3,4,0,8,53,12,3.0,3.0,0.0,0.0,0.0,3.0,33.0,53,8,45,16.0,1.0,15.0
104203,6,5,1,2,1,5,7,53,3.0,2.0,1.0,1.0,1.0,2.0,2.0,12,6,6,4.0,3.0,1.0
9508301,5,2,3,6,5,0,0,103,4.0,1.0,3.0,6.0,4.0,0.0,0.0,5,5,0,4.0,4.0,0.0
9808231,4,2,2,3,0,4,8,72,3.0,1.0,2.0,2.0,0.0,3.0,5.0,16,4,12,8.0,3.0,5.0
12170,3,3,0,0,1,2,7,195,2.0,2.0,0.0,0.0,0.0,2.0,4.0,11,3,8,5.0,2.0,3.0
209147,3,2,1,1,1,2,5,0,1.0,1.0,0.0,0.0,1.0,0.0,0.0,7,3,4,1.0,0.0,1.0
9807371,17,1,16,93,0,17,30,0,15.0,1.0,14.0,80.0,1.0,14.0,14.0,22,17,5,17.0,15.0,2.0
205227,8,7,1,3,2,6,64,32,4.0,3.0,1.0,2.0,0.0,4.0,38.0,26,8,18,3.0,3.0,0.0
12160,2,2,0,0,1,1,3,147,1.0,1.0,0.0,0.0,0.0,1.0,2.0,5,2,3,1.0,1.0,0.0
9909534,3,3,0,0,0,3,29,9,3.0,3.0,0.0,0.0,0.0,3.0,29.0,22,3,19,1.0,0.0,1.0
6102,1,1,0,0,0,1,1,258,1.0,1.0,0.0,0.0,1.0,0.0,0.0,2,1,1,1.0,1.0,0.0
9303262,3,2,1,1,3,0,0,289,2.0,1.0,1.0,1.0,2.0,0.0,0.0,3,3,0,2.0,2.0,0.0
9507274,3,2,1,1,3,0,0,88,2.0,2.0,0.0,0.0,2.0,0.0,0.0,7,3,4,2.0,1.0,1.0
9510211,3,3,0,0,3,0,0,131,2.0,2.0,0.0,0.0,2.0,0.0,0.0,5,3,2,2.0,2.0,0.0
12358,2,2,0,0,0,2,5,65,1.0,1.0,0.0,0.0,1.0,0.0,0.0,7,2,5,2.0,0.0,2.0
9610402,14,2,12,27,0,14,52,113,12.0,2.0,10.0,24.0,0.0,12.0,43.0,22,14,8,15.0,10.0,5.0
2122,1,1,0,0,0,1,8,1,,,,,,,,11,1,10,,,
9711236,16,2,14,25,1,15,76,115,14.0,2.0,12.0,22.0,1.0,13.0,60.0,32,16,16,12.0,6.0,6.0
111294,4,4,0,0,0,4,24,18,0.0,0.0,0.0,0.0,0.0,0.0,0.0,33,4,29,13.0,0.0,13.0
9906441,9,3,6,13,0,9,35,108,8.0,3.0,5.0,10.0,0.0,8.0,30.0,18,9,9,14.0,7.0,7.0
9501210,5,4,1,2,0,5,14,40,5.0,4.0,1.0,2.0,0.0,5.0,14.0,9,5,4,4.0,3.0,1.0
206217,8,5,3,4,8,0,0,70,3.0,2.0,1.0,1.0,3.0,0.0,0.0,9,8,1,2.0,2.0,0.0
9710227,6,3,3,3,0,6,24,17,3.0,1.0,2.0,2.0,3.0,0.0,0.0,22,6,16,5.0,2.0,3.0
9612476,1,1,0,0,0,1,1,383,0.0,0.0,0.0,0.0,0.0,0.0,0.0,3,1,2,,,
5083,4,2,2,2,0,4,12,197,4.0,2.0,2.0,2.0,0.0,4.0,12.0,10,4,6,9.0,4.0,5.0
9210270,5,4,1,2,5,0,0,758,3.0,3.0,0.0,0.0,3.0,0.0,0.0,5,5,0,3.0,3.0,0.0
201244,2,2,0,0,1,1,8,1,1.0,1.0,0.0,0.0,0.0,1.0,4.0,27,2,25,2.0,1.0,1.0
9910240,4,2,2,3,0,4,40,43,4.0,2.0,2.0,3.0,0.0,4.0,40.0,17,4,13,15.0,3.0,12.0
9908321,9,1,8,20,5,4,4,49,8.0,1.0,7.0,19.0,4.0,4.0,4.0,15,9,6,8.0,8.0,0.0
9502347,1,1,0,0,1,0,0,452,0.0,0.0,0.0,0.0,0.0,0.0,0.0,5,1,4,1.0,0.0,1.0
1160,3,1,2,2,1,2,6,50,2.0,1.0,1.0,1.0,0.0,2.0,6.0,7,3,4,5.0,2.0,3.0
5306,6,4,2,2,0,6,42,35,5.0,4.0,1.0,1.0,0.0,5.0,21.0,34,6,28,5.0,3.0,2.0
9807239,4,2,2,2,0,4,6,595,4.0,2.0,2.0,2.0,3.0,1.0,1.0,8,4,4,2.0,1.0,1.0
9710525,2,2,0,0,0,2,7,27,,,,,,,,8,2,6,4.0,1.0,3.0
9707228,6,6,0,0,0,6,21,203,3.0,3.0,0.0,0.0,0.0,3.0,3.0,19,6,13,8.0,1.0,7.0
10090,3,3,0,0,1,2,4,48,0.0,0.0,0.0,0.0,0.0,0.0,0.0,8,3,5,4.0,0.0,4.0
9506272,4,3,1,1,4,0,0,406,1.0,1.0,0.0,0.0,1.0,0.0,0.0,4,4,0,2.0,2.0,0.0
9807408,17,7,10,28,10,7,12,20,11.0,3.0,8.0,20.0,7.0,4.0,4.0,22,17,5,9.0,8.0,1.0
9411400,2,2,0,0,0,2,3,15,1.0,1.0,0.0,0.0,1.0,0.0,0.0,5,2,3,1.0,1.0,0.0
9909396,2,2,0,0,0,2,5,8,1.0,1.0,0.0,0.0,1.0,0.0,0.0,10,2,8,2.0,1.0,1.0
9811418,0,0,0,0,0,0,0,14,0.0,0.0,0.0,0.0,0.0,0.0,0.0,5,0,5,,,
9608290,1,1,0,0,1,0,0,367,0.0,0.0,0.0,0.0,0.0,0.0,0.0,2,1,1,1.0,0.0,1.0
7240,12,4,8,21,2,10,32,16,6.0,4.0,2.0,4.0,0.0,6.0,22.0,21,12,9,4.0,2.0,2.0
9811315,5,5,0,0,0,5,10,336,4.0,4.0,0.0,0.0,0.0,4.0,9.0,8,5,3,2.0,1.0,1.0
9901370,4,2,2,2,0,4,5,103,3.0,1.0,2.0,2.0,0.0,3.0,4.0,8,4,4,4.0,3.0,1.0
9403337,4,2,2,3,3,1,1,200,1.0,1.0,0.0,0.0,0.0,1.0,1.0,6,4,2,2.0,1.0,1.0
6218,1,1,0,0,1,0,0,59,0.0,0.0,0.0,0.0,0.0,0.0,0.0,8,1,7,7.0,0.0,7.0
9707470,4,2,2,2,2,2,17,41,0.0,0.0,0.0,0.0,0.0,0.0,0.0,20,4,16,4.0,1.0,3.0
9706451,2,2,0,0,1,1,2,483,0.0,0.0,0.0,0.0,0.0,0.0,0.0,7,2,5,1.0,0.0,1.0
8007,6,4,2,3,0,6,54,24,5.0,3.0,2.0,3.0,0.0,5.0,51.0,39,6,33,11.0,1.0,10.0
9903213,1,1,0,0,0,1,3,1321,0.0,0.0,0.0,0.0,0.0,0.0,0.0,4,1,3,,,
212068,1,1,0,0,0,1,10,25,0.0,0.0,0.0,0.0,0.0,0.0,0.0,28,1,27,17.0,0.0,17.0
210448,2,2,0,0,0,2,16,4,1.0,1.0,0.0,0.0,0.0,1.0,11.0,24,2,22,9.0,0.0,9.0
9807335,13,4,9,15,1,12,47,125,11.0,2.0,9.0,15.0,0.0,11.0,36.0,25,13,12,13.0,8.0,5.0
110180,2,1,1,1,0,2,53,49,2.0,1.0,1.0,1.0,0.0,2.0,43.0,34,2,32,24.0,2.0,22.0
9611282,5,2,3,5,0,5,14,55,5.0,2.0,3.0,5.0,0.0,5.0,13.0,10,5,5,7.0,5.0,2.0
9905434,1,1,0,0,0,1,3,14,,,,,,,,8,1,7,1.0,1.0,0.0
202008,5,4,1,1,2,3,6,259,2.0,2.0,0.0,0.0,0.0,2.0,2.0,10,5,5,2.0,2.0,0.0
9910364,1,1,0,0,0,1,9,13,1.0,1.0,0.0,0.0,0.0,1.0,5.0,20,1,19,7.0,1.0,6.0
205205,4,2,2,3,0,4,23,12,2.0,1.0,1.0,1.0,0.0,2.0,13.0,27,4,23,13.0,2.0,11.0
104115,11,8,3,3,1,10,66,4,1.0,1.0,0.0,0.0,0.0,1.0,4.0,67,11,56,7.0,2.0,5.0
9909544,3,3,0,0,2,1,3,224,1.0,1.0,0.0,0.0,1.0,0.0,0.0,9,3,6,2.0,2.0,0.0
9612276,2,1,1,1,0,2,6,29,2.0,1.0,1.0,1.0,0.0,2.0,4.0,16,2,14,4.0,2.0,2.0
9911500,0,0,0,0,0,0,0,98,0.0,0.0,0.0,0.0,0.0,0.0,0.0,11,0,11,2.0,0.0,2.0
9901344,5,3,2,2,0,5,26,157,3.0,3.0,0.0,0.0,0.0,3.0,9.0,22,5,17,7.0,3.0,4.0
4178,1,1,0,0,0,1,1,203,1.0,1.0,0.0,0.0,0.0,1.0,1.0,3,1,2,3.0,1.0,2.0
104223,1,1,0,0,1,0,0,110,,,,,,,,2,1,1,,,
9911491,7,1,6,10,0,7,51,10,5.0,1.0,4.0,6.0,0.0,5.0,26.0,23,7,16,11.0,5.0,6.0
9406403,1,1,0,0,0,1,1,1926,,,,,,,,10,1,9,1.0,0.0,1.0
9610516,3,1,2,2,1,2,2,306,1.0,1.0,0.0,0.0,1.0,0.0,0.0,8,3,5,1.0,1.0,0.0
9711201,20,5,15,60,0,20,78,53,17.0,3.0,14.0,57.0,0.0,17.0,72.0,26,20,6,21.0,15.0,6.0
110313,4,3,1,1,0,4,18,58,0.0,0.0,0.0,0.0,0.0,0.0,0.0,23,4,19,14.0,0.0,14.0
9402233,1,1,0,0,0,1,1,1269,0.0,0.0,0.0,0.0,0.0,0.0,0.0,4,1,3,1.0,0.0,1.0
102332,12,4,8,24,2,10,36,52,9.0,3.0,6.0,22.0,0.0,9.0,35.0,17,12,5,12.0,7.0,5.0
10099,4,3,1,1,3,1,1,285,4.0,3.0,1.0,1.0,4.0,0.0,0.0,7,4,3,2.0,2.0,0.0
9606425,5,3,2,2,2,3,5,160,2.0,1.0,1.0,1.0,0.0,2.0,2.0,8,5,3,3.0,2.0,1.0
9803230,1,1,0,0,0,1,13,27,1.0,1.0,0.0,0.0,0.0,1.0,13.0,15,1,14,2.0,0.0,2.0
9701358,6,3,3,5,0,6,41,6,6.0,3.0,3.0,5.0,0.0,6.0,19.0,27,6,21,11.0,4.0,7.0
9808329,6,3,3,6,0,6,10,1,0.0,0.0,0.0,0.0,0.0,0.0,0.0,21,6,15,1.0,1.0,0.0
9701333,4,3,1,3,4,0,0,247,4.0,3.0,1.0,3.0,4.0,0.0,0.0,4,4,0,3.0,3.0,0.0
107080,4,3,1,1,0,4,28,69,2.0,1.0,1.0,1.0,0.0,2.0,10.0,34,4,30,10.0,2.0,8.0
9502314,3,3,0,0,2,1,3,439,2.0,2.0,0.0,0.0,1.0,1.0,1.0,7,3,4,2.0,1.0,1.0
212019,0,0,0,0,0,0,0,34,0.0,0.0,0.0,0.0,0.0,0.0,0.0,6,0,6,,,
9701224,2,2,0,0,0,2,3,179,0.0,0.0,0.0,0.0,0.0,0.0,0.0,16,2,14,2.0,0.0,2.0
9905473,3,3,0,0,0,3,6,40,3.0,3.0,0.0,0.0,0.0,3.0,6.0,11,3,8,3.0,0.0,3.0
11201,4,4,0,0,0,4,27,56,4.0,4.0,0.0,0.0,0.0,4.0,27.0,18,4,14,14.0,1.0,13.0
9402317,3,3,0,0,3,0,0,231,2.0,2.0,0.0,0.0,2.0,0.0,0.0,3,3,0,2.0,2.0,0.0
302268,0,0,0,0,0,0,0,126,0.0,0.0,0.0,0.0,0.0,0.0,0.0,5,0,5,4.0,0.0,4.0
9609319,4,2,2,2,4,0,0,756,1.0,1.0,0.0,0.0,1.0,0.0,0.0,5,4,1,2.0,2.0,0.0
211305,4,3,1,1,1,3,9,28,3.0,2.0,1.0,1.0,1.0,2.0,5.0,15,4,11,4.0,0.0,4.0
9904377,3,1,2,2,1,2,7,125,2.0,1.0,1.0,1.0,0.0,2.0,6.0,7,3,4,5.0,2.0,3.0
102182,1,1,0,0,0,1,4,2,1.0,1.0,0.0,0.0,0.0,1.0,1.0,18,1,17,6.0,0.0,6.0
9701215,18,1,17,38,14,4,11,9,11.0,1.0,10.0,25.0,11.0,0.0,0.0,23,18,5,11.0,11.0,0.0
102044,1,1,0,0,0,1,6,20,1.0,1.0,0.0,0.0,0.0,1.0,3.0,21,1,20,5.0,1.0,4.0
9807304,0,0,0,0,0,0,0,184,0.0,0.0,0.0,0.0,0.0,0.0,0.0,2,0,2,1.0,0.0,1.0
2248,2,2,0,0,1,1,2,3,0.0,0.0,0.0,0.0,0.0,0.0,0.0,18,2,16,6.0,0.0,6.0
9710321,1,1,0,0,0,1,2,144,1.0,1.0,0.0,0.0,0.0,1.0,2.0,3,1,2,1.0,0.0,1.0
9805322,2,2,0,0,0,2,3,1824,1.0,1.0,0.0,0.0,1.0,0.0,0.0,4,2,2,1.0,1.0,0.0
109165,0,0,0,0,0,0,0,180,0.0,0.0,0.0,0.0,0.0,0.0,0.0,6,0,6,4.0,0.0,4.0
9608222,18,10,8,14,7,11,31,99,4.0,3.0,1.0,1.0,0.0,4.0,10.0,23,18,5,5.0,4.0,1.0
9812456,15,2,13,58,0,15,103,16,14.0,2.0,12.0,55.0,0.0,14.0,97.0,36,15,21,17.0,14.0,3.0
210021,6,2,4,5,0,6,56,46,3.0,1.0,2.0,3.0,0.0,3.0,42.0,52,6,46,17.0,2.0,15.0
10228,8,3,5,13,1,7,18,64,6.0,2.0,4.0,12.0,1.0,5.0,13.0,13,8,5,8.0,6.0,2.0
204348,7,1,6,13,0,7,28,62,7.0,1.0,6.0,13.0,0.0,7.0,28.0,15,7,8,12.0,7.0,5.0
203074,1,1,0,0,0,1,2,11,0.0,0.0,0.0,0.0,0.0,0.0,0.0,47,1,46,8.0,0.0,8.0
107221,2,2,0,0,2,0,0,159,1.0,1.0,0.0,0.0,1.0,0.0,0.0,2,2,0,1.0,1.0,0.0
9703421,2,2,0,0,1,1,5,15,1.0,1.0,0.0,0.0,1.0,0.0,0.0,7,2,5,1.0,1.0,0.0
9603232,6,5,1,1,6,0,0,474,4.0,3.0,1.0,1.0,4.0,0.0,0.0,6,6,0,2.0,2.0,0.0
9505204,4,1,3,4,1,3,9,113,4.0,1.0,3.0,4.0,1.0,3.0,9.0,8,4,4,7.0,4.0,3.0
205218,4,4,0,0,0,4,13,109,0.0,0.0,0.0,0.0,0.0,0.0,0.0,21,4,17,7.0,1.0,6.0
9709421,1,1,0,0,0,1,5,72,1.0,1.0,0.0,0.0,0.0,1.0,4.0,9,1,8,7.0,0.0,7.0
204296,0,0,0,0,0,0,0,28,0.0,0.0,0.0,0.0,0.0,0.0,0.0,32,0,32,18.0,0.0,18.0
9905236,6,4,2,3,1,5,12,31,2.0,1.0,1.0,1.0,2.0,0.0,0.0,14,6,8,3.0,3.0,0.0
9704409,2,2,0,0,2,0,0,908,,,,,,,,4,2,2,,,
9508361,0,0,0,0,0,0,0,98,0.0,0.0,0.0,0.0,0.0,0.0,0.0,7,0,7,2.0,0.0,2.0
9506288,4,2,2,2,0,4,14,1,0.0,0.0,0.0,0.0,0.0,0.0,0.0,15,4,11,1.0,0.0,1.0
210305,1,1,0,0,0,1,10,9,1.0,1.0,0.0,0.0,0.0,1.0,9.0,22,1,21,6.0,1.0,5.0
111091,1,1,0,0,0,1,1,79,0.0,0.0,0.0,0.0,0.0,0.0,0.0,6,1,5,,,
9120,1,1,0,0,1,0,0,2116,,,,,,,,4,1,3,,,
3103,4,4,0,0,4,0,0,121,1.0,1.0,0.0,0.0,1.0,0.0,0.0,11,4,7,1.0,1.0,0.0
4108,1,1,0,0,0,1,11,12,1.0,1.0,0.0,0.0,0.0,1.0,9.0,26,1,25,,,
9908228,4,3,1,1,1,3,14,21,3.0,2.0,1.0,1.0,0.0,3.0,12.0,19,4,15,2.0,0.0,2.0
4045,3,3,0,0,2,1,1,762,0.0,0.0,0.0,0.0,0.0,0.0,0.0,5,3,2,1.0,0.0,1.0
201029,0,0,0,0,0,0,0,112,0.0,0.0,0.0,0.0,0.0,0.0,0.0,3,0,3,2.0,0.0,2.0
105279,8,3,5,6,0,8,34,7,6.0,2.0,4.0,5.0,0.0,6.0,19.0,24,8,16,11.0,2.0,9.0
203173,1,1,0,0,1,0,0,74,0.0,0.0,0.0,0.0,0.0,0.0,0.0,11,1,10,4.0,0.0,4.0
9305298,1,1,0,0,1,0,0,29,1.0,1.0,0.0,0.0,1.0,0.0,0.0,10,1,9,1.0,0.0,1.0
9303212,4,4,0,0,4,0,0,240,3.0,3.0,0.0,0.0,3.0,0.0,0.0,4,4,0,1.0,1.0,0.0
9809354,4,2,2,3,1,3,4,7,3.0,1.0,2.0,3.0,3.0,0.0,0.0,11,4,7,2.0,2.0,0.0
9506341,2,2,0,0,2,0,0,250,1.0,1.0,0.0,0.0,1.0,0.0,0.0,2,2,0,1.0,1.0,0.0
9803369,6,5,1,1,1,5,27,33,1.0,1.0,0.0,0.0,0.0,1.0,6.0,30,6,24,11.0,1.0,10.0
9904427,2,2,0,0,0,2,2,1,0.0,0.0,0.0,0.0,0.0,0.0,0.0,28,2,26,2.0,1.0,1.0
9508307,1,1,0,0,1,0,0,250,0.0,0.0,0.0,0.0,0.0,0.0,0.0,3,1,2,2.0,1.0,1.0
112149,1,1,0,0,0,1,6,7,1.0,1.0,0.0,0.0,0.0,1.0,6.0,16,1,15,8.0,1.0,7.0
9812430,3,3,0,0,1,2,13,84,2.0,2.0,0.0,0.0,0.0,2.0,11.0,16,3,13,9.0,2.0,7.0
9407312,2,1,1,1,0,2,3,330,1.0,1.0,0.0,0.0,0.0,1.0,1.0,6,2,4,3.0,2.0,1.0
111200,3,3,0,0,0,3,12,21,0.0,0.0,0.0,0.0,0.0,0.0,0.0,10,3,7,6.0,1.0,5.0
9711207,4,3,1,1,0,4,4,85,2.0,2.0,0.0,0.0,2.0,0.0,0.0,17,4,13,4.0,0.0,4.0
6212,4,4,0,0,0,4,21,54,4.0,4.0,0.0,0.0,0.0,4.0,10.0,20,4,16,9.0,4.0,5.0
2125,2,2,0,0,2,0,0,73,0.0,0.0,0.0,0.0,0.0,0.0,0.0,15,2,13,10.0,0.0,10.0
9412297,3,3,0,0,2,1,2,10,2.0,2.0,0.0,0.0,2.0,0.0,0.0,9,3,6,2.0,2.0,0.0
6339,4,4,0,0,1,3,21,0,1.0,1.0,0.0,0.0,1.0,0.0,0.0,27,4,23,2.0,1.0,1.0
9804438,6,4,2,4,6,0,0,464,4.0,2.0,2.0,4.0,4.0,0.0,0.0,7,6,1,4.0,4.0,0.0
104161,4,2,2,3,0,4,7,181,2.0,1.0,1.0,1.0,0.0,2.0,4.0,11,4,7,4.0,3.0,1.0
9704381,3,3,0,0,2,1,1,291,2.0,2.0,0.0,0.0,2.0,0.0,0.0,5,3,2,2.0,2.0,0.0
9506439,3,2,1,1,2,1,2,298,3.0,2.0,1.0,1.0,3.0,0.0,0.0,6,3,3,3.0,3.0,0.0
9503447,2,2,0,0,1,1,1,56,,,,,,,,3,2,1,1.0,0.0,1.0
9609426,4,4,0,0,2,2,3,266,2.0,2.0,0.0,0.0,0.0,2.0,3.0,7,4,3,4.0,2.0,2.0
6066,2,2,0,0,1,1,1,171,2.0,2.0,0.0,0.0,2.0,0.0,0.0,3,2,1,2.0,2.0,0.0
206125,1,1,0,0,0,1,4,89,0.0,0.0,0.0,0.0,0.0,0.0,0.0,11,1,10,5.0,0.0,5.0
111236,5,4,1,2,0,5,21,48,3.0,3.0,0.0,0.0,0.0,3.0,8.0,14,5,9,10.0,3.0,7.0
211219,0,0,0,0,0,0,0,105,0.0,0.0,0.0,0.0,0.0,0.0,0.0,16,0,16,6.0,0.0,6.0
104096,7,1,6,8,2,5,20,33,5.0,1.0,4.0,6.0,1.0,4.0,11.0,16,7,9,7.0,3.0,4.0
9806520,2,2,0,0,0,2,13,87,1.0,1.0,0.0,0.0,0.0,1.0,10.0,19,2,17,12.0,1.0,11.0
108072,2,2,0,0,0,2,17,37,1.0,1.0,0.0,0.0,0.0,1.0,7.0,16,2,14,7.0,1.0,6.0
9710404,2,1,1,1,0,2,4,91,2.0,1.0,1.0,1.0,0.0,2.0,4.0,7,2,5,6.0,2.0,4.0
9504209,4,3,1,1,3,1,1,225,2.0,1.0,1.0,1.0,1.0,1.0,1.0,5,4,1,3.0,2.0,1.0
9511368,1,1,0,0,1,0,0,93,0.0,0.0,0.0,0.0,0.0,0.0,0.0,10,1,9,1.0,0.0,1.0
105013,1,1,0,0,0,1,7,40,1.0,1.0,0.0,0.0,0.0,1.0,7.0,15,1,14,4.0,0.0,4.0
9801455,0,0,0,0,0,0,0,191,0.0,0.0,0.0,0.0,0.0,0.0,0.0,1,0,1,,,
205040,9,5,4,5,1,8,43,165,8.0,4.0,4.0,5.0,0.0,8.0,43.0,23,9,14,17.0,6.0,11.0
210189,1,1,0,0,0,1,7,113,1.0,1.0,0.0,0.0,0.0,1.0,2.0,18,1,17,8.0,0.0,8.0
9905496,2,2,0,0,0,2,10,16,0.0,0.0,0.0,0.0,0.0,0.0,0.0,24,2,22,3.0,1.0,2.0
9811292,1,1,0,0,0,1,1,51,0.0,0.0,0.0,0.0,0.0,0.0,0.0,13,1,12,4.0,0.0,4.0
9703409,6,6,0,0,5,1,2,148,3.0,3.0,0.0,0.0,3.0,0.0,0.0,8,6,2,2.0,1.0,1.0
204058,4,3,1,1,0,4,37,27,2.0,1.0,1.0,1.0,0.0,2.0,15.0,38,4,34,15.0,2.0,13.0
5144,10,3,7,14,0,10,80,53,10.0,3.0,7.0,14.0,0.0,10.0,74.0,21,10,11,18.0,9.0,9.0
7195,1,1,0,0,0,1,3,12,0.0,0.0,0.0,0.0,0.0,0.0,0.0,8,1,7,1.0,1.0,0.0
102284,2,1,1,1,1,1,3,30,0.0,0.0,0.0,0.0,0.0,0.0,0.0,16,2,14,4.0,1.0,3.0
9606476,4,2,2,2,0,4,9,15,1.0,1.0,0.0,0.0,0.0,1.0,3.0,29,4,25,6.0,0.0,6.0
9806297,0,0,0,0,0,0,0,57,0.0,0.0,0.0,0.0,0.0,0.0,0.0,6,0,6,3.0,0.0,3.0
7296,0,0,0,0,0,0,0,84,0.0,0.0,0.0,0.0,0.0,0.0,0.0,8,0,8,6.0,0.0,6.0
9301250,1,1,0,0,0,1,1,178,1.0,1.0,0.0,0.0,0.0,1.0,1.0,2,1,1,2.0,1.0,1.0
212283,2,1,1,1,0,2,12,38,2.0,1.0,1.0,1.0,0.0,2.0,10.0,11,2,9,2.0,1.0,1.0
4037,1,1,0,0,0,1,1,3,0.0,0.0,0.0,0.0,0.0,0.0,0.0,16,1,15,2.0,1.0,1.0
112010,1,1,0,0,0,1,1,12,0.0,0.0,0.0,0.0,0.0,0.0,0.0,21,1,20,2.0,0.0,2.0
105060,1,1,0,0,1,0,0,195,0.0,0.0,0.0,0.0,0.0,0.0,0.0,7,1,6,2.0,0.0,2.0
206094,2,2,0,0,2,0,0,8,0.0,0.0,0.0,0.0,0.0,0.0,0.0,16,2,14,7.0,0.0,7.0
209267,0,0,0,0,0,0,0,283,0.0,0.0,0.0,0.0,0.0,0.0,0.0,10,0,10,7.0,0.0,7.0
103154,4,1,3,6,0,4,36,7,3.0,1.0,2.0,3.0,0.0,3.0,25.0,45,4,41,8.0,1.0,7.0
9805243,4,2,2,2,0,4,7,52,0.0,0.0,0.0,0.0,0.0,0.0,0.0,12,4,8,2.0,2.0,0.0
111025,2,2,0,0,0,2,5,106,2.0,2.0,0.0,0.0,0.0,2.0,5.0,6,2,4,5.0,1.0,4.0
9712422,4,4,0,0,2,2,2,359,1.0,1.0,0.0,0.0,0.0,1.0,1.0,12,4,8,,,
103109,1,1,0,0,0,1,3,82,1.0,1.0,0.0,0.0,0.0,1.0,3.0,4,1,3,,,
111271,5,3,2,3,0,5,20,51,5.0,3.0,2.0,3.0,1.0,4.0,4.0,16,5,11,1.0,0.0,1.0
105021,9,5,4,4,1,8,39,2,3.0,1.0,2.0,2.0,0.0,3.0,8.0,24,9,15,5.0,3.0,2.0
9705330,2,1,1,1,0,2,6,529,2.0,1.0,1.0,1.0,2.0,0.0,0.0,5,2,3,2.0,2.0,0.0
9409404,2,2,0,0,2,0,0,353,2.0,2.0,0.0,0.0,2.0,0.0,0.0,2,2,0,1.0,1.0,0.0
9611446,4,2,2,2,0,4,4,68,3.0,1.0,2.0,2.0,0.0,3.0,3.0,8,4,4,3.0,3.0,0.0
9701340,5,3,2,2,3,2,2,266,2.0,1.0,1.0,1.0,0.0,2.0,2.0,7,5,2,2.0,1.0,1.0
102059,0,0,0,0,0,0,0,1159,0.0,0.0,0.0,0.0,0.0,0.0,0.0,5,0,5,,,
111367,1,1,0,0,0,1,2,189,1.0,1.0,0.0,0.0,0.0,1.0,2.0,5,1,4,2.0,1.0,1.0
9902321,4,3,1,1,1,3,16,114,2.0,2.0,0.0,0.0,0.0,2.0,11.0,27,4,23,14.0,2.0,12.0
9910325,2,2,0,0,1,1,7,95,1.0,1.0,0.0,0.0,0.0,1.0,7.0,11,2,9,7.0,0.0,7.0
205331,6,4,2,3,1,5,52,2,3.0,1.0,2.0,3.0,0.0,3.0,19.0,34,6,28,12.0,3.0,9.0
9906552,3,1,2,2,0,3,11,44,3.0,1.0,2.0,2.0,0.0,3.0,11.0,9,3,6,9.0,3.0,6.0
9506316,0,0,0,0,0,0,0,208,0.0,0.0,0.0,0.0,0.0,0.0,0.0,13,0,13,6.0,0.0,6.0
1252,0,0,0,0,0,0,0,144,0.0,0.0,0.0,0.0,0.0,0.0,0.0,4,0,4,2.0,0.0,2.0
110331,4,3,1,1,1,3,26,19,1.0,1.0,0.0,0.0,0.0,1.0,9.0,46,4,42,11.0,1.0,10.0
9812530,5,2,3,6,0,5,40,1,0.0,0.0,0.0,0.0,0.0,0.0,0.0,39,5,34,4.0,4.0,0.0
9803496,9,8,1,1,5,4,6,101,4.0,4.0,0.0,0.0,4.0,0.0,0.0,15,9,6,4.0,2.0,2.0
210016,0,0,0,0,0,0,0,10,0.0,0.0,0.0,0.0,0.0,0.0,0.0,10,0,10,4.0,0.0,4.0
9810293,1,1,0,0,0,1,1,254,1.0,1.0,0.0,0.0,0.0,1.0,1.0,2,1,1,1.0,0.0,1.0
209364,4,4,0,0,3,1,1,106,0.0,0.0,0.0,0.0,0.0,0.0,0.0,19,4,15,4.0,0.0,4.0
101161,2,2,0,0,0,2,11,76,1.0,1.0,0.0,0.0,0.0,1.0,5.0,13,2,11,7.0,1.0,6.0
2170,3,2,1,1,2,1,1,159,3.0,2.0,1.0,1.0,2.0,1.0,1.0,6,3,3,1.0,0.0,1.0
207147,1,1,0,0,0,1,29,8,0.0,0.0,0.0,0.0,0.0,0.0,0.0,56,1,55,24.0,0.0,24.0
209009,1,1,0,0,0,1,13,37,1.0,1.0,0.0,0.0,0.0,1.0,7.0,27,1,26,12.0,1.0,11.0
202020,1,1,0,0,0,1,1,24,0.0,0.0,0.0,0.0,0.0,0.0,0.0,27,1,26,2.0,0.0,2.0
9705277,0,0,0,0,0,0,0,1447,,,,,,,,1,0,1,,,
104197,2,1,1,1,0,2,8,53,1.0,1.0,0.0,0.0,0.0,1.0,5.0,25,2,23,8.0,1.0,7.0
9907440,0,0,0,0,0,0,0,232,0.0,0.0,0.0,0.0,0.0,0.0,0.0,6,0,6,2.0,0.0,2.0
9906248,1,1,0,0,0,1,2,45,1.0,1.0,0.0,0.0,0.0,1.0,2.0,14,1,13,1.0,0.0,1.0
8173,0,0,0,0,0,0,0,8,0.0,0.0,0.0,0.0,0.0,0.0,0.0,5,0,5,,,
9410276,2,1,1,1,0,2,6,96,1.0,1.0,0.0,0.0,0.0,1.0,3.0,7,2,5,4.0,1.0,3.0
9802244,1,1,0,0,1,0,0,25,1.0,1.0,0.0,0.0,1.0,0.0,0.0,9,1,8,1.0,1.0,0.0
9704227,0,0,0,0,0,0,0,93,0.0,0.0,0.0,0.0,0.0,0.0,0.0,17,0,17,2.0,0.0,2.0
9711270,2,2,0,0,0,2,7,158,1.0,1.0,0.0,0.0,0.0,1.0,6.0,10,2,8,7.0,1.0,6.0
9610466,1,1,0,0,0,1,2,70,1.0,1.0,0.0,0.0,0.0,1.0,2.0,3,1,2,3.0,1.0,2.0
110404,2,1,1,1,0,2,10,47,2.0,1.0,1.0,1.0,0.0,2.0,4.0,17,2,15,1.0,0.0,1.0
9905271,11,6,5,12,0,11,70,30,8.0,4.0,4.0,8.0,0.0,8.0,23.0,28,11,17,14.0,6.0,8.0
9601304,3,2,1,1,3,0,0,589,1.0,1.0,0.0,0.0,1.0,0.0,0.0,4,3,1,2.0,2.0,0.0
106342,5,3,2,3,0,5,27,51,5.0,3.0,2.0,3.0,0.0,5.0,16.0,17,5,12,10.0,2.0,8.0
212057,0,0,0,0,0,0,0,3,0.0,0.0,0.0,0.0,0.0,0.0,0.0,11,0,11,2.0,0.0,2.0
9036,2,2,0,0,0,2,39,24,1.0,1.0,0.0,0.0,0.0,1.0,22.0,40,2,38,21.0,1.0,20.0
1107,1,1,0,0,0,1,3,59,1.0,1.0,0.0,0.0,0.0,1.0,2.0,5,1,4,2.0,0.0,2.0
8193,1,1,0,0,0,1,12,0,0.0,0.0,0.0,0.0,0.0,0.0,0.0,26,1,25,6.0,0.0,6.0
212329,0,0,0,0,0,0,0,52,0.0,0.0,0.0,0.0,0.0,0.0,0.0,6,0,6,1.0,0.0,1.0
9804205,1,1,0,0,0,1,4,21,1.0,1.0,0.0,0.0,0.0,1.0,3.0,13,1,12,1.0,1.0,0.0
9705241,4,2,2,3,1,3,6,236,3.0,1.0,2.0,3.0,1.0,2.0,4.0,8,4,4,7.0,4.0,3.0
9510273,0,0,0,0,0,0,0,1619,0.0,0.0,0.0,0.0,0.0,0.0,0.0,2,0,2,1.0,0.0,1.0
210063,1,1,0,0,1,0,0,1502,1.0,1.0,0.0,0.0,1.0,0.0,0.0,3,1,2,,,
212264,0,0,0,0,0,0,0,80,0.0,0.0,0.0,0.0,0.0,0.0,0.0,28,0,28,7.0,0.0,7.0
9708453,1,1,0,0,1,0,0,1456,1.0,1.0,0.0,0.0,1.0,0.0,0.0,1,1,0,1.0,1.0,0.0
104158,4,2,2,2,0,4,6,2,0.0,0.0,0.0,0.0,0.0,0.0,0.0,15,4,11,4.0,0.0,4.0
9810511,1,1,0,0,0,1,4,133,1.0,1.0,0.0,0.0,0.0,1.0,4.0,14,1,13,4.0,1.0,3.0
9502375,1,1,0,0,1,0,0,304,0.0,0.0,0.0,0.0,0.0,0.0,0.0,2,1,1,1.0,0.0,1.0
204202,4,4,0,0,0,4,27,2,1.0,1.0,0.0,0.0,0.0,1.0,7.0,21,4,17,4.0,1.0,3.0
107098,3,2,1,1,3,0,0,104,0.0,0.0,0.0,0.0,0.0,0.0,0.0,7,3,4,1.0,1.0,0.0
5010,0,0,0,0,0,0,0,132,0.0,0.0,0.0,0.0,0.0,0.0,0.0,4,0,4,1.0,0.0,1.0
12273,1,1,0,0,0,1,4,52,1.0,1.0,0.0,0.0,0.0,1.0,4.0,6,1,5,3.0,1.0,2.0
210441,2,2,0,0,0,2,13,18,0.0,0.0,0.0,0.0,0.0,0.0,0.0,35,2,33,1.0,0.0,1.0
9810464,0,0,0,0,0,0,0,44,0.0,0.0,0.0,0.0,0.0,0.0,0.0,16,0,16,10.0,0.0,10.0
9809202,1,1,0,0,0,1,1,76,0.0,0.0,0.0,0.0,0.0,0.0,0.0,5,1,4,1.0,0.0,1.0
9511429,1,1,0,0,0,1,1,231,0.0,0.0,0.0,0.0,0.0,0.0,0.0,5,1,4,,,
108257,3,3,0,0,0,3,18,9,1.0,1.0,0.0,0.0,0.0,1.0,2.0,16,3,13,3.0,2.0,1.0
9507421,4,2,2,2,3,1,2,232,3.0,1.0,2.0,2.0,2.0,1.0,2.0,9,4,5,4.0,3.0,1.0
210299,0,0,0,0,0,0,0,26,0.0,0.0,0.0,0.0,0.0,0.0,0.0,34,0,34,13.0,0.0,13.0
9509354,1,1,0,0,0,1,4,237,1.0,1.0,0.0,0.0,0.0,1.0,2.0,6,1,5,4.0,1.0,3.0
9812297,0,0,0,0,0,0,0,14,0.0,0.0,0.0,0.0,0.0,0.0,0.0,8,0,8,5.0,0.0,5.0
112092,2,2,0,0,0,2,2,230,2.0,2.0,0.0,0.0,0.0,2.0,2.0,4,2,2,2.0,1.0,1.0
9706217,2,2,0,0,0,2,15,8,1.0,1.0,0.0,0.0,0.0,1.0,3.0,22,2,20,5.0,1.0,4.0
9702269,0,0,0,0,0,0,0,1202,0.0,0.0,0.0,0.0,0.0,0.0,0.0,1,0,1,1.0,0.0,1.0
111011,1,1,0,0,1,0,0,444,0.0,0.0,0.0,0.0,0.0,0.0,0.0,6,1,5,2.0,0.0,2.0
201237,0,0,0,0,0,0,0,425,,,,,,,,2,0,2,1.0,0.0,1.0
9910478,2,2,0,0,2,0,0,99,1.0,1.0,0.0,0.0,1.0,0.0,0.0,2,2,0,1.0,1.0,0.0
211051,0,0,0,0,0,0,0,353,0.0,0.0,0.0,0.0,0.0,0.0,0.0,2,0,2,1.0,0.0,1.0
111279,0,0,0,0,0,0,0,201,0.0,0.0,0.0,0.0,0.0,0.0,0.0,4,0,4,1.0,0.0,1.0
9411319,1,1,0,0,1,0,0,567,1.0,1.0,0.0,0.0,1.0,0.0,0.0,2,1,1,2.0,1.0,1.0
9308268,0,0,0,0,0,0,0,1377,,,,,,,,1,0,1,,,
9706358,1,1,0,0,1,0,0,139,,,,,,,,1,1,0,,,
9701315,1,1,0,0,1,0,0,603,1.0,1.0,0.0,0.0,1.0,0.0,0.0,4,1,3,1.0,1.0,0.0
106042,1,1,0,0,0,1,1,0,,,,,,,,8,1,7,6.0,0.0,6.0
9710303,0,0,0,0,0,0,0,114,0.0,0.0,0.0,0.0,0.0,0.0,0.0,13,0,13,8.0,0.0,8.0
9140,2,1,1,1,0,2,40,12,1.0,1.0,0.0,0.0,0.0,1.0,13.0,40,2,38,14.0,1.0,13.0
9609205,1,1,0,0,0,1,2,187,1.0,1.0,0.0,0.0,0.0,1.0,1.0,4,1,3,,,
204312,0,0,0,0,0,0,0,125,0.0,0.0,0.0,0.0,0.0,0.0,0.0,2,0,2,,,
9807559,4,2,2,3,1,3,5,347,4.0,2.0,2.0,3.0,1.0,3.0,5.0,6,4,2,6.0,4.0,2.0
102249,0,0,0,0,0,0,0,634,0.0,0.0,0.0,0.0,0.0,0.0,0.0,7,0,7,2.0,0.0,2.0
9812281,3,1,2,3,3,0,0,44,,,,,,,,3,3,0,,,
209322,2,2,0,0,0,2,2,568,2.0,2.0,0.0,0.0,0.0,2.0,2.0,3,2,1,2.0,1.0,1.0
110368,0,0,0,0,0,0,0,1471,,,,,,,,2,0,2,1.0,0.0,1.0
9902470,1,1,0,0,0,1,13,137,1.0,1.0,0.0,0.0,0.0,1.0,13.0,18,1,17,16.0,1.0,15.0
12166,1,1,0,0,1,0,0,36,1.0,1.0,0.0,0.0,1.0,0.0,0.0,6,1,5,2.0,0.0,2.0
111122,0,0,0,0,0,0,0,6,0.0,0.0,0.0,0.0,0.0,0.0,0.0,17,0,17,7.0,0.0,7.0
211306,0,0,0,0,0,0,0,1473,0.0,0.0,0.0,0.0,0.0,0.0,0.0,1,0,1,1.0,0.0,1.0
9810205,1,1,0,0,1,0,0,1995,1.0,1.0,0.0,0.0,1.0,0.0,0.0,2,1,1,,,
9902454,0,0,0,0,0,0,0,15,0.0,0.0,0.0,0.0,0.0,0.0,0.0,4,0,4,1.0,0.0,1.0
9809370,0,0,0,0,0,0,0,87,0.0,0.0,0.0,0.0,0.0,0.0,0.0,55,0,55,19.0,0.0,19.0
9807520,2,1,1,1,2,0,0,212,2.0,1.0,1.0,1.0,2.0,0.0,0.0,6,2,4,3.0,0.0,3.0
4073,0,0,0,0,0,0,0,122,0.0,0.0,0.0,0.0,0.0,0.0,0.0,7,0,7,1.0,0.0,1.0
205179,0,0,0,0,0,0,0,37,0.0,0.0,0.0,0.0,0.0,0.0,0.0,8,0,8,,,
9705301,0,0,0,0,0,0,0,35,0.0,0.0,0.0,0.0,0.0,0.0,0.0,8,0,8,3.0,0.0,3.0
9707469,1,1,0,0,0,1,5,514,1.0,1.0,0.0,0.0,0.0,1.0,2.0,7,1,6,3.0,1.0,2.0
9707455,0,0,0,0,0,0,0,15,,,,,,,,6,0,6,,,
107224,7,4,3,3,0,7,70,9,4.0,2.0,2.0,2.0,0.0,4.0,37.0,43,7,36,7.0,4.0,3.0
101284,2,2,0,0,0,2,5,205,1.0,1.0,0.0,0.0,0.0,1.0,1.0,8,2,6,1.0,0.0,1.0
1199,0,0,0,0,0,0,0,99,0.0,0.0,0.0,0.0,0.0,0.0,0.0,6,0,6,5.0,0.0,5.0
302185,0,0,0,0,0,0,0,77,0.0,0.0,0.0,0.0,0.0,0.0,0.0,10,0,10,1.0,0.0,1.0
9909365,3,2,1,1,0,3,15,175,2.0,2.0,0.0,0.0,0.0,2.0,13.0,15,3,12,12.0,2.0,10.0
12233,1,1,0,0,1,0,0,86,0.0,0.0,0.0,0.0,0.0,0.0,0.0,11,1,10,6.0,0.0,6.0
9209221,5,4,1,1,5,0,0,261,2.0,1.0,1.0,1.0,2.0,0.0,0.0,5,5,0,2.0,2.0,0.0
9505305,1,1,0,0,1,0,0,682,1.0,1.0,0.0,0.0,1.0,0.0,0.0,3,1,2,1.0,1.0,0.0
9909347,1,1,0,0,0,1,7,52,1.0,1.0,0.0,0.0,0.0,1.0,5.0,12,1,11,3.0,0.0,3.0
211185,1,1,0,0,0,1,3,147,1.0,1.0,0.0,0.0,0.0,1.0,3.0,8,1,7,4.0,1.0,3.0
109107,0,0,0,0,0,0,0,683,0.0,0.0,0.0,0.0,0.0,0.0,0.0,1,0,1,1.0,0.0,1.0
212258,0,0,0,0,0,0,0,81,0.0,0.0,0.0,0.0,0.0,0.0,0.0,17,0,17,6.0,0.0,6.0
9114,0,0,0,0,0,0,0,98,,,,,,,,2,0,2,,,
211207,0,0,0,0,0,0,0,170,0.0,0.0,0.0,0.0,0.0,0.0,0.0,9,0,9,4.0,0.0,4.0
9811502,0,0,0,0,0,0,0,55,0.0,0.0,0.0,0.0,0.0,0.0,0.0,35,0,35,2.0,0.0,2.0
105162,2,2,0,0,0,2,7,63,2.0,2.0,0.0,0.0,0.0,2.0,6.0,11,2,9,4.0,1.0,3.0
9809325,2,2,0,0,1,1,1,45,1.0,1.0,0.0,0.0,0.0,1.0,1.0,4,2,2,,,
101282,0,0,0,0,0,0,0,2,0.0,0.0,0.0,0.0,0.0,0.0,0.0,12,0,12,8.0,0.0,8.0
9608278,0,0,0,0,0,0,0,254,0.0,0.0,0.0,0.0,0.0,0.0,0.0,1,0,1,,,
207143,3,2,1,1,3,0,0,219,1.0,1.0,0.0,0.0,1.0,0.0,0.0,5,3,2,1.0,1.0,0.0
1181,0,0,0,0,0,0,0,96,0.0,0.0,0.0,0.0,0.0,0.0,0.0,8,0,8,4.0,0.0,4.0
212245,1,1,0,0,0,1,5,3,0.0,0.0,0.0,0.0,0.0,0.0,0.0,32,1,31,2.0,1.0,1.0
211340,1,1,0,0,0,1,5,7,0.0,0.0,0.0,0.0,0.0,0.0,0.0,25,1,24,3.0,0.0,3.0
5022,0,0,0,0,0,0,0,522,0.0,0.0,0.0,0.0,0.0,0.0,0.0,1,0,1,1.0,0.0,1.0
9705213,1,1,0,0,1,0,0,243,0.0,0.0,0.0,0.0,0.0,0.0,0.0,2,1,1,1.0,1.0,0.0
9802347,2,2,0,0,1,1,1,117,0.0,0.0,0.0,0.0,0.0,0.0,0.0,6,2,4,2.0,1.0,1.0
10249,1,1,0,0,1,0,0,22,0.0,0.0,0.0,0.0,0.0,0.0,0.0,20,1,19,16.0,0.0,16.0
9608250,0,0,0,0,0,0,0,11,0.0,0.0,0.0,0.0,0.0,0.0,0.0,11,0,11,6.0,0.0,6.0
9901364,1,1,0,0,0,1,1,254,1.0,1.0,0.0,0.0,0.0,1.0,1.0,2,1,1,1.0,0.0,1.0
302013,0,0,0,0,0,0,0,178,0.0,0.0,0.0,0.0,0.0,0.0,0.0,8,0,8,6.0,0.0,6.0
9807530,0,0,0,0,0,0,0,496,0.0,0.0,0.0,0.0,0.0,0.0,0.0,1,0,1,1.0,0.0,1.0
301023,0,0,0,0,0,0,0,4,0.0,0.0,0.0,0.0,0.0,0.0,0.0,180,0,180,24.0,0.0,24.0
9712485,1,1,0,0,0,1,4,155,1.0,1.0,0.0,0.0,0.0,1.0,2.0,10,1,9,,,
9410290,0,0,0,0,0,0,0,371,0.0,0.0,0.0,0.0,0.0,0.0,0.0,2,0,2,1.0,0.0,1.0
3043,2,2,0,0,0,2,4,19,1.0,1.0,0.0,0.0,0.0,1.0,1.0,9,2,7,1.0,1.0,0.0
9510297,0,0,0,0,0,0,0,77,0.0,0.0,0.0,0.0,0.0,0.0,0.0,2,0,2,,,
210327,0,0,0,0,0,0,0,18,0.0,0.0,0.0,0.0,0.0,0.0,0.0,25,0,25,14.0,0.0,14.0
9606376,0,0,0,0,0,0,0,140,0.0,0.0,0.0,0.0,0.0,0.0,0.0,15,0,15,3.0,0.0,3.0
9709278,3,1,2,3,0,3,6,284,3.0,1.0,2.0,3.0,0.0,3.0,6.0,7,3,4,7.0,3.0,4.0
301099,1,1,0,0,0,1,1,393,0.0,0.0,0.0,0.0,0.0,0.0,0.0,4,1,3,2.0,0.0,2.0
205110,0,0,0,0,0,0,0,91,0.0,0.0,0.0,0.0,0.0,0.0,0.0,18,0,18,4.0,0.0,4.0
302151,0,0,0,0,0,0,0,15,0.0,0.0,0.0,0.0,0.0,0.0,0.0,26,0,26,3.0,0.0,3.0
111409,0,0,0,0,0,0,0,185,0.0,0.0,0.0,0.0,0.0,0.0,0.0,2,0,2,,,
211337,0,0,0,0,0,0,0,51,0.0,0.0,0.0,0.0,0.0,0.0,0.0,14,0,14,5.0,0.0,5.0
3162,0,0,0,0,0,0,0,10,0.0,0.0,0.0,0.0,0.0,0.0,0.0,7,0,7,7.0,0.0,7.0
9802295,0,0,0,0,0,0,0,91,0.0,0.0,0.0,0.0,0.0,0.0,0.0,14,0,14,5.0,0.0,5.0
9908461,3,1,2,2,0,3,7,357,3.0,1.0,2.0,2.0,0.0,3.0,6.0,10,3,7,6.0,3.0,3.0
110176,2,2,0,0,1,1,5,23,1.0,1.0,0.0,0.0,0.0,1.0,1.0,12,2,10,3.0,2.0,1.0
9608235,0,0,0,0,0,0,0,2069,0.0,0.0,0.0,0.0,0.0,0.0,0.0,6,0,6,2.0,0.0,2.0
212317,0,0,0,0,0,0,0,20,0.0,0.0,0.0,0.0,0.0,0.0,0.0,24,0,24,8.0,0.0,8.0
9510397,2,2,0,0,2,0,0,174,1.0,1.0,0.0,0.0,1.0,0.0,0.0,2,2,0,1.0,1.0,0.0
211186,1,1,0,0,0,1,10,23,1.0,1.0,0.0,0.0,0.0,1.0,9.0,23,1,22,8.0,1.0,7.0
110417,2,2,0,0,0,2,14,11,1.0,1.0,0.0,0.0,0.0,1.0,9.0,33,2,31,4.0,1.0,3.0
201157,0,0,0,0,0,0,0,326,0.0,0.0,0.0,0.0,0.0,0.0,0.0,8,0,8,1.0,0.0,1.0
211395,1,1,0,0,0,1,43,28,1.0,1.0,0.0,0.0,0.0,1.0,19.0,60,1,59,23.0,1.0,22.0
9604308,1,1,0,0,0,1,2,174,1.0,1.0,0.0,0.0,0.0,1.0,2.0,5,1,4,2.0,1.0,1.0
9803373,1,1,0,0,1,0,0,472,1.0,1.0,0.0,0.0,1.0,0.0,0.0,1,1,0,1.0,1.0,0.0
209138,0,0,0,0,0,0,0,68,0.0,0.0,0.0,0.0,0.0,0.0,0.0,14,0,14,10.0,0.0,10.0
9707527,0,0,0,0,0,0,0,48,,,,,,,,2,0,2,,,
4042,1,1,0,0,0,1,3,15,,,,,,,,11,1,10,,,
9610263,0,0,0,0,0,0,0,111,0.0,0.0,0.0,0.0,0.0,0.0,0.0,3,0,3,1.0,0.0,1.0
9908506,1,1,0,0,0,1,3,234,0.0,0.0,0.0,0.0,0.0,0.0,0.0,8,1,7,5.0,1.0,4.0
201115,0,0,0,0,0,0,0,197,0.0,0.0,0.0,0.0,0.0,0.0,0.0,3,0,3,,,
9710366,1,1,0,0,0,1,2,44,1.0,1.0,0.0,0.0,1.0,0.0,0.0,5,1,4,1.0,0.0,1.0
210149,2,2,0,0,1,1,7,37,0.0,0.0,0.0,0.0,0.0,0.0,0.0,21,2,19,7.0,1.0,6.0
112350,0,0,0,0,0,0,0,58,0.0,0.0,0.0,0.0,0.0,0.0,0.0,5,0,5,,,
9503343,0,0,0,0,0,0,0,1184,0.0,0.0,0.0,0.0,0.0,0.0,0.0,1,0,1,1.0,0.0,1.0
9612255,0,0,0,0,0,0,0,100,0.0,0.0,0.0,0.0,0.0,0.0,0.0,7,0,7,4.0,0.0,4.0
108194,1,1,0,0,0,1,3,76,1.0,1.0,0.0,0.0,0.0,1.0,3.0,5,1,4,4.0,1.0,3.0
9802222,0,0,0,0,0,0,0,85,,,,,,,,4,0,4,4.0,0.0,4.0
9710325,0,0,0,0,0,0,0,40,,,,,,,,2,0,2,,,
9910241,0,0,0,0,0,0,0,92,0.0,0.0,0.0,0.0,0.0,0.0,0.0,6,0,6,3.0,0.0,3.0
111353,2,1,1,1,0,2,4,20,,,,,,,,4,2,2,,,
207180,1,1,0,0,0,1,5,107,0.0,0.0,0.0,0.0,0.0,0.0,0.0,59,1,58,16.0,0.0,16.0
108038,0,0,0,0,0,0,0,27,0.0,0.0,0.0,0.0,0.0,0.0,0.0,5,0,5,4.0,0.0,4.0
9807252,3,2,1,2,3,0,0,111,2.0,2.0,0.0,0.0,2.0,0.0,0.0,3,3,0,1.0,1.0,0.0
9606365,2,2,0,0,1,1,1,76,1.0,1.0,0.0,0.0,1.0,0.0,0.0,4,2,2,1.0,1.0,0.0
9809369,1,1,0,0,1,0,0,86,0.0,0.0,0.0,0.0,0.0,0.0,0.0,8,1,7,2.0,0.0,2.0
9712433,0,0,0,0,0,0,0,102,0.0,0.0,0.0,0.0,0.0,0.0,0.0,1,0,1,1.0,0.0,1.0
207178,0,0,0,0,0,0,0,33,0.0,0.0,0.0,0.0,0.0,0.0,0.0,33,0,33,19.0,0.0,19.0
9270,0,0,0,0,0,0,0,277,0.0,0.0,0.0,0.0,0.0,0.0,0.0,6,0,6,6.0,0.0,6.0
6170,0,0,0,0,0,0,0,101,0.0,0.0,0.0,0.0,0.0,0.0,0.0,28,0,28,7.0,0.0,7.0
111301,1,1,0,0,0,1,5,188,1.0,1.0,0.0,0.0,0.0,1.0,3.0,9,1,8,6.0,1.0,5.0
212282,0,0,0,0,0,0,0,13,0.0,0.0,0.0,0.0,0.0,0.0,0.0,16,0,16,,,
9508238,0,0,0,0,0,0,0,44,,,,,,,,3,0,3,,,
301201,3,3,0,0,0,3,13,38,1.0,1.0,0.0,0.0,0.0,1.0,2.0,10,3,7,3.0,1.0,2.0
201153,0,0,0,0,0,0,0,701,0.0,0.0,0.0,0.0,0.0,0.0,0.0,1,0,1,1.0,0.0,1.0
9910376,0,0,0,0,0,0,0,843,,,,,,,,1,0,1,,,
105044,1,1,0,0,1,0,0,392,0.0,0.0,0.0,0.0,0.0,0.0,0.0,4,1,3,2.0,0.0,2.0
211263,0,0,0,0,0,0,0,279,0.0,0.0,0.0,0.0,0.0,0.0,0.0,10,0,10,2.0,0.0,2.0
9209293,1,1,0,0,1,0,0,2028,,,,,,,,1,1,0,,,
9811213,1,1,0,0,0,1,5,275,1.0,1.0,0.0,0.0,0.0,1.0,4.0,7,1,6,4.0,1.0,3.0
209079,1,1,0,0,0,1,11,25,1.0,1.0,0.0,0.0,0.0,1.0,7.0,19,1,18,10.0,1.0,9.0
9712247,1,1,0,0,0,1,3,59,0.0,0.0,0.0,0.0,0.0,0.0,0.0,8,1,7,1.0,0.0,1.0
9608285,0,0,0,0,0,0,0,5,,,,,,,,13,0,13,,,
9912300,0,0,0,0,0,0,0,43,0.0,0.0,0.0,0.0,0.0,0.0,0.0,5,0,5,5.0,0.0,5.0
106323,1,1,0,0,0,1,4,258,0.0,0.0,0.0,0.0,0.0,0.0,0.0,9,1,8,1.0,0.0,1.0
9505380,0,0,0,0,0,0,0,39,,,,,,,,4,0,4,1.0,0.0,1.0
206232,1,1,0,0,0,1,9,256,1.0,1.0,0.0,0.0,0.0,1.0,9.0,11,1,10,10.0,1.0,9.0
103303,1,1,0,0,0,1,8,21,1.0,1.0,0.0,0.0,0.0,1.0,5.0,10,1,9,,,
9904430,4,1,3,5,0,4,9,316,4.0,1.0,3.0,5.0,0.0,4.0,5.0,10,4,6,6.0,4.0,2.0
203106,0,0,0,0,0,0,0,34,,,,,,,,7,0,7,2.0,0.0,2.0
9305210,0,0,0,0,0,0,0,276,0.0,0.0,0.0,0.0,0.0,0.0,0.0,1,0,1,1.0,0.0,1.0
12355,0,0,0,0,0,0,0,68,0.0,0.0,0.0,0.0,0.0,0.0,0.0,8,0,8,3.0,0.0,3.0
8118,1,1,0,0,0,1,2,203,1.0,1.0,0.0,0.0,0.0,1.0,1.0,9,1,8,3.0,0.0,3.0
9404350,0,0,0,0,0,0,0,709,0.0,0.0,0.0,0.0,0.0,0.0,0.0,2,0,2,1.0,0.0,1.0
9402334,0,0,0,0,0,0,0,210,,,,,,,,1,0,1,,,
9511213,0,0,0,0,0,0,0,69,0.0,0.0,0.0,0.0,0.0,0.0,0.0,4,0,4,1.0,0.0,1.0
5087,0,0,0,0,0,0,0,1399,0.0,0.0,0.0,0.0,0.0,0.0,0.0,3,0,3,1.0,0.0,1.0
203248,1,1,0,0,0,1,4,89,1.0,1.0,0.0,0.0,0.0,1.0,4.0,17,1,16,3.0,0.0,3.0
301221,1,1,0,0,0,1,11,7,0.0,0.0,0.0,0.0,0.0,0.0,0.0,40,1,39,8.0,0.0,8.0
101191,0,0,0,0,0,0,0,141,0.0,0.0,0.0,0.0,0.0,0.0,0.0,2,0,2,2.0,0.0,2.0
9606481,1,1,0,0,0,1,1,341,1.0,1.0,0.0,0.0,0.0,1.0,1.0,3,1,2,3.0,1.0,2.0
4167,0,0,0,0,0,0,0,141,0.0,0.0,0.0,0.0,0.0,0.0,0.0,4,0,4,1.0,0.0,1.0
9608237,0,0,0,0,0,0,0,153,0.0,0.0,0.0,0.0,0.0,0.0,0.0,2,0,2,1.0,0.0,1.0
6209,0,0,0,0,0,0,0,66,0.0,0.0,0.0,0.0,0.0,0.0,0.0,5,0,5,1.0,0.0,1.0
302217,0,0,0,0,0,0,0,71,0.0,0.0,0.0,0.0,0.0,0.0,0.0,6,0,6,2.0,0.0,2.0
9912235,0,0,0,0,0,0,0,48,0.0,0.0,0.0,0.0,0.0,0.0,0.0,2,0,2,,,
9802269,0,0,0,0,0,0,0,230,0.0,0.0,0.0,0.0,0.0,0.0,0.0,4,0,4,1.0,0.0,1.0
208061,3,2,1,1,0,3,13,9,2.0,1.0,1.0,1.0,0.0,2.0,7.0,16,3,13,1.0,1.0,0.0
204160,1,1,0,0,0,1,3,0,0.0,0.0,0.0,0.0,0.0,0.0,0.0,14,1,13,6.0,0.0,6.0
1195,0,0,0,0,0,0,0,14,0.0,0.0,0.0,0.0,0.0,0.0,0.0,17,0,17,14.0,0.0,14.0
9505269,1,1,0,0,0,1,13,124,1.0,1.0,0.0,0.0,0.0,1.0,13.0,17,1,16,14.0,1.0,13.0
302247,0,0,0,0,0,0,0,28,0.0,0.0,0.0,0.0,0.0,0.0,0.0,29,0,29,2.0,0.0,2.0
9705455,0,0,0,0,0,0,0,154,0.0,0.0,0.0,0.0,0.0,0.0,0.0,5,0,5,5.0,0.0,5.0
103143,0,0,0,0,0,0,0,53,0.0,0.0,0.0,0.0,0.0,0.0,0.0,7,0,7,2.0,0.0,2.0
9306304,1,1,0,0,1,0,0,325,1.0,1.0,0.0,0.0,1.0,0.0,0.0,1,1,0,1.0,1.0,0.0
201181,0,0,0,0,0,0,0,14,0.0,0.0,0.0,0.0,0.0,0.0,0.0,23,0,23,13.0,0.0,13.0
207072,0,0,0,0,0,0,0,8,0.0,0.0,0.0,0.0,0.0,0.0,0.0,13,0,13,,,
9708230,0,0,0,0,0,0,0,1780,,,,,,,,1,0,1,,,
208198,2,2,0,0,0,2,41,1,2.0,2.0,0.0,0.0,0.0,2.0,18.0,27,2,25,8.0,2.0,6.0
12326,0,0,0,0,0,0,0,1804,,,,,,,,2,0,2,,,
112196,0,0,0,0,0,0,0,51,0.0,0.0,0.0,0.0,0.0,0.0,0.0,6,0,6,2.0,0.0,2.0
12342,0,0,0,0,0,0,0,74,0.0,0.0,0.0,0.0,0.0,0.0,0.0,10,0,10,4.0,0.0,4.0
103139,0,0,0,0,0,0,0,335,0.0,0.0,0.0,0.0,0.0,0.0,0.0,2,0,2,1.0,0.0,1.0
9810417,0,0,0,0,0,0,0,913,,,,,,,,1,0,1,,,
9309226,0,0,0,0,0,0,0,162,,,,,,,,1,0,1,1.0,0.0,1.0
3243,0,0,0,0,0,0,0,27,0.0,0.0,0.0,0.0,0.0,0.0,0.0,5,0,5,,,
9250,0,0,0,0,0,0,0,56,0.0,0.0,0.0,0.0,0.0,0.0,0.0,25,0,25,13.0,0.0,13.0
9904217,0,0,0,0,0,0,0,100,0.0,0.0,0.0,0.0,0.0,0.0,0.0,12,0,12,6.0,0.0,6.0
9704341,0,0,0,0,0,0,0,211,0.0,0.0,0.0,0.0,0.0,0.0,0.0,2,0,2,2.0,0.0,2.0
9311208,0,0,0,0,0,0,0,854,,,,,,,,1,0,1,,,
302068,0,0,0,0,0,0,0,37,0.0,0.0,0.0,0.0,0.0,0.0,0.0,17,0,17,10.0,0.0,10.0
9303285,0,0,0,0,0,0,0,248,0.0,0.0,0.0,0.0,0.0,0.0,0.0,3,0,3,1.0,0.0,1.0
211242,0,0,0,0,0,0,0,60,0.0,0.0,0.0,0.0,0.0,0.0,0.0,12,0,12,3.0,0.0,3.0
9157,0,0,0,0,0,0,0,142,0.0,0.0,0.0,0.0,0.0,0.0,0.0,12,0,12,8.0,0.0,8.0
9906279,0,0,0,0,0,0,0,167,0.0,0.0,0.0,0.0,0.0,0.0,0.0,6,0,6,5.0,0.0,5.0
208090,0,0,0,0,0,0,0,14,0.0,0.0,0.0,0.0,0.0,0.0,0.0,18,0,18,16.0,0.0,16.0
209209,0,0,0,0,0,0,0,80,0.0,0.0,0.0,0.0,0.0,0.0,0.0,20,0,20,6.0,0.0,6.0
211179,0,0,0,0,0,0,0,225,0.0,0.0,0.0,0.0,0.0,0.0,0.0,9,0,9,2.0,0.0,2.0
204249,0,0,0,0,0,0,0,197,0.0,0.0,0.0,0.0,0.0,0.0,0.0,12,0,12,6.0,0.0,6.0
212369,0,0,0,0,0,0,0,65,0.0,0.0,0.0,0.0,0.0,0.0,0.0,7,0,7,2.0,0.0,2.0
9903514,0,0,0,0,0,0,0,357,0.0,0.0,0.0,0.0,0.0,0.0,0.0,1,0,1,,,
211372,0,0,0,0,0,0,0,21,0.0,0.0,0.0,0.0,0.0,0.0,0.0,19,0,19,7.0,0.0,7.0
103019,1,1,0,0,0,1,5,76,1.0,1.0,0.0,0.0,0.0,1.0,3.0,10,1,9,2.0,0.0,2.0
110026,0,0,0,0,0,0,0,1,0.0,0.0,0.0,0.0,0.0,0.0,0.0,15,0,15,2.0,0.0,2.0
212034,0,0,0,0,0,0,0,24,0.0,0.0,0.0,0.0,0.0,0.0,0.0,22,0,22,5.0,0.0,5.0
9809342,0,0,0,0,0,0,0,40,,,,,,,,8,0,8,1.0,0.0,1.0
9311369,1,1,0,0,1,0,0,90,1.0,1.0,0.0,0.0,1.0,0.0,0.0,1,1,0,,,
106235,0,0,0,0,0,0,0,171,0.0,0.0,0.0,0.0,0.0,0.0,0.0,1,0,1,,,
12130,0,0,0,0,0,0,0,1144,,,,,,,,5,0,5,,,
9211237,2,1,1,1,2,0,0,176,2.0,1.0,1.0,1.0,2.0,0.0,0.0,2,2,0,,,
207128,0,0,0,0,0,0,0,220,0.0,0.0,0.0,0.0,0.0,0.0,0.0,1,0,1,,,
9708422,0,0,0,0,0,0,0,40,0.0,0.0,0.0,0.0,0.0,0.0,0.0,4,0,4,1.0,0.0,1.0
3280,0,0,0,0,0,0,0,13,,,,,,,,4,0,4,1.0,0.0,1.0
207312,0,0,0,0,0,0,0,9,,,,,,,,10,0,10,1.0,0.0,1.0
204329,0,0,0,0,0,0,0,64,,,,,,,,3,0,3,,,
12234,0,0,0,0,0,0,0,24,0.0,0.0,0.0,0.0,0.0,0.0,0.0,19,0,19,3.0,0.0,3.0
212267,0,0,0,0,0,0,0,79,0.0,0.0,0.0,0.0,0.0,0.0,0.0,8,0,8,3.0,0.0,3.0
9907448,0,0,0,0,0,0,0,29,0.0,0.0,0.0,0.0,0.0,0.0,0.0,71,0,71,7.0,0.0,7.0
8162,1,1,0,0,0,1,2,132,1.0,1.0,0.0,0.0,0.0,1.0,1.0,3,1,2,2.0,1.0,1.0
9602371,0,0,0,0,0,0,0,28,0.0,0.0,0.0,0.0,0.0,0.0,0.0,4,0,4,1.0,0.0,1.0
9344,0,0,0,0,0,0,0,147,0.0,0.0,0.0,0.0,0.0,0.0,0.0,1,0,1,1.0,0.0,1.0
106297,0,0,0,0,0,0,0,77,,,,,,,,3,0,3,,,
8176,0,0,0,0,0,0,0,167,0.0,0.0,0.0,0.0,0.0,0.0,0.0,6,0,6,3.0,0.0,3.0
9807232,0,0,0,0,0,0,0,125,0.0,0.0,0.0,0.0,0.0,0.0,0.0,3,0,3,3.0,0.0,3.0
9904356,0,0,0,0,0,0,0,148,0.0,0.0,0.0,0.0,0.0,0.0,0.0,2,0,2,1.0,0.0,1.0
212325,0,0,0,0,0,0,0,13,0.0,0.0,0.0,0.0,0.0,0.0,0.0,27,0,27,12.0,0.0,12.0
211441,0,0,0,0,0,0,0,12,0.0,0.0,0.0,0.0,0.0,0.0,0.0,30,0,30,7.0,0.0,7.0
7216,1,1,0,0,0,1,1,84,,,,,,,,3,1,2,,,
9401223,0,0,0,0,0,0,0,149,,,,,,,,1,0,1,1.0,0.0,1.0
9904342,1,1,0,0,1,0,0,465,1.0,1.0,0.0,0.0,1.0,0.0,0.0,1,1,0,1.0,1.0,0.0
9309209,0,0,0,0,0,0,0,880,,,,,,,,1,0,1,,,
9506294,0,0,0,0,0,0,0,6,0.0,0.0,0.0,0.0,0.0,0.0,0.0,10,0,10,2.0,0.0,2.0
9709294,0,0,0,0,0,0,0,15,0.0,0.0,0.0,0.0,0.0,0.0,0.0,18,0,18,5.0,0.0,5.0
9240,1,1,0,0,0,1,1,22,1.0,1.0,0.0,0.0,1.0,0.0,0.0,9,1,8,2.0,1.0,1.0
9406259,0,0,0,0,0,0,0,1353,,,,,,,,1,0,1,,,
301060,0,0,0,0,0,0,0,0,0.0,0.0,0.0,0.0,0.0,0.0,0.0,20,0,20,2.0,0.0,2.0
10138,0,0,0,0,0,0,0,246,0.0,0.0,0.0,0.0,0.0,0.0,0.0,2,0,2,1.0,0.0,1.0
12054,0,0,0,0,0,0,0,128,0.0,0.0,0.0,0.0,0.0,0.0,0.0,13,0,13,1.0,0.0,1.0
7235,0,0,0,0,0,0,0,100,0.0,0.0,0.0,0.0,0.0,0.0,0.0,5,0,5,1.0,0.0,1.0
9910520,0,0,0,0,0,0,0,30,0.0,0.0,0.0,0.0,0.0,0.0,0.0,12,0,12,3.0,0.0,3.0
9305264,1,1,0,0,1,0,0,737,1.0,1.0,0.0,0.0,1.0,0.0,0.0,1,1,0,1.0,1.0,0.0
210423,0,0,0,0,0,0,0,29,0.0,0.0,0.0,0.0,0.0,0.0,0.0,23,0,23,11.0,0.0,11.0
211422,0,0,0,0,0,0,0,45,0.0,0.0,0.0,0.0,0.0,0.0,0.0,19,0,19,1.0,0.0,1.0
2080,0,0,0,0,0,0,0,2,0.0,0.0,0.0,0.0,0.0,0.0,0.0,24,0,24,2.0,0.0,2.0
5145,0,0,0,0,0,0,0,1771,0.0,0.0,0.0,0.0,0.0,0.0,0.0,6,0,6,1.0,0.0,1.0
9709253,0,0,0,0,0,0,0,92,0.0,0.0,0.0,0.0,0.0,0.0,0.0,8,0,8,2.0,0.0,2.0
107323,0,0,0,0,0,0,0,9,0.0,0.0,0.0,0.0,0.0,0.0,0.0,10,0,10,,,
9705353,0,0,0,0,0,0,0,16,0.0,0.0,0.0,0.0,0.0,0.0,0.0,11,0,11,1.0,0.0,1.0
9904343,0,0,0,0,0,0,0,388,0.0,0.0,0.0,0.0,0.0,0.0,0.0,1,0,1,1.0,0.0,1.0
207117,0,0,0,0,0,0,0,32,0.0,0.0,0.0,0.0,0.0,0.0,0.0,21,0,21,1.0,0.0,1.0
9802385,0,0,0,0,0,0,0,17,0.0,0.0,0.0,0.0,0.0,0.0,0.0,17,0,17,2.0,0.0,2.0
9311275,0,0,0,0,0,0,0,217,0.0,0.0,0.0,0.0,0.0,0.0,0.0,1,0,1,1.0,0.0,1.0
211285,0,0,0,0,0,0,0,1657,,,,,,,,1,0,1,,,
9510444,0,0,0,0,0,0,0,182,0.0,0.0,0.0,0.0,0.0,0.0,0.0,9,0,9,1.0,0.0,1.0
9809533,0,0,0,0,0,0,0,126,0.0,0.0,0.0,0.0,0.0,0.0,0.0,2,0,2,1.0,0.0,1.0
9501418,0,0,0,0,0,0,0,6,0.0,0.0,0.0,0.0,0.0,0.0,0.0,20,0,20,1.0,0.0,1.0
9612488,0,0,0,0,0,0,0,63,0.0,0.0,0.0,0.0,0.0,0.0,0.0,14,0,14,8.0,0.0,8.0
9811389,0,0,0,0,0,0,0,114,0.0,0.0,0.0,0.0,0.0,0.0,0.0,11,0,11,7.0,0.0,7.0
211126,0,0,0,0,0,0,0,103,0.0,0.0,0.0,0.0,0.0,0.0,0.0,38,0,38,10.0,0.0,10.0
9705365,0,0,0,0,0,0,0,48,0.0,0.0,0.0,0.0,0.0,0.0,0.0,7,0,7,6.0,0.0,6.0
9412226,0,0,0,0,0,0,0,1826,,,,,,,,3,0,3,,,
211437,0,0,0,0,0,0,0,71,0.0,0.0,0.0,0.0,0.0,0.0,0.0,18,0,18,11.0,0.0,11.0
112204,0,0,0,0,0,0,0,6,0.0,0.0,0.0,0.0,0.0,0.0,0.0,15,0,15,6.0,0.0,6.0
12327,0,0,0,0,0,0,0,31,,,,,,,,3,0,3,,,
9608454,0,0,0,0,0,0,0,47,0.0,0.0,0.0,0.0,0.0,0.0,0.0,5,0,5,1.0,0.0,1.0
210309,0,0,0,0,0,0,0,65,0.0,0.0,0.0,0.0,0.0,0.0,0.0,39,0,39,22.0,0.0,22.0
201312,0,0,0,0,0,0,0,118,0.0,0.0,0.0,0.0,0.0,0.0,0.0,17,0,17,12.0,0.0,12.0
1277,1,1,0,0,1,0,0,746,1.0,1.0,0.0,0.0,1.0,0.0,0.0,1,1,0,1.0,1.0,0.0
9411374,0,0,0,0,0,0,0,680,0.0,0.0,0.0,0.0,0.0,0.0,0.0,2,0,2,1.0,0.0,1.0
9410208,0,0,0,0,0,0,0,34,,,,,,,,3,0,3,,,
9502366,119,40,79,263,27,92,258,13,24.0,3.0,21.0,75.0,10.0,14.0,14.0,153,119,34,14.0,13.0,1.0
9910236,31,10,21,69,2,29,235,34,15.0,3.0,12.0,38.0,0.0,15.0,153.0,65,31,34,33.0,12.0,21.0
8018,28,3,25,110,0,28,98,1,15.0,1.0,14.0,37.0,0.0,15.0,47.0,42,28,14,20.0,16.0,4.0
9712225,122,10,112,954,3,119,560,1,71.0,2.0,69.0,647.0,1.0,70.0,329.0,153,122,31,56.0,50.0,6.0
9211333,4,2,2,2,4,0,0,537,1.0,1.0,0.0,0.0,1.0,0.0,0.0,4,4,0,1.0,1.0,0.0
9405259,51,7,44,252,19,32,40,1,14.0,3.0,11.0,28.0,3.0,11.0,14.0,53,51,2,13.0,12.0,1.0
9507248,19,5,14,53,2,17,67,7,9.0,2.0,7.0,20.0,1.0,8.0,22.0,27,19,8,1.0,1.0,0.0
9711217,34,16,18,35,8,26,194,1,9.0,2.0,7.0,16.0,0.0,9.0,59.0,106,34,72,11.0,1.0,10.0
9604240,14,7,7,13,12,2,2,34,2.0,2.0,0.0,0.0,2.0,0.0,0.0,15,14,1,2.0,2.0,0.0
103324,40,9,31,65,2,38,479,32,8.0,3.0,5.0,8.0,0.0,8.0,134.0,128,40,88,17.0,3.0,14.0
9811377,25,8,17,32,6,19,110,6,9.0,4.0,5.0,9.0,0.0,9.0,67.0,53,25,28,4.0,4.0,0.0
111276,17,6,11,24,3,14,29,4,3.0,1.0,2.0,2.0,0.0,3.0,8.0,24,17,7,5.0,3.0,2.0
9410307,20,3,17,49,20,0,0,114,5.0,1.0,4.0,6.0,5.0,0.0,0.0,22,20,2,7.0,7.0,0.0
9701412,54,26,28,42,54,0,0,141,7.0,1.0,6.0,10.0,7.0,0.0,0.0,59,54,5,7.0,7.0,0.0
9604223,73,13,60,354,16,57,157,33,44.0,4.0,40.0,269.0,9.0,35.0,53.0,86,73,13,34.0,31.0,3.0
9902434,26,7,19,45,0,26,94,4,10.0,2.0,8.0,15.0,0.0,10.0,20.0,40,26,14,11.0,7.0,4.0
7160,11,3,8,13,4,7,26,48,2.0,1.0,1.0,1.0,1.0,1.0,1.0,20,11,9,3.0,3.0,0.0
9406411,11,6,5,10,9,2,4,133,0.0,0.0,0.0,0.0,0.0,0.0,0.0,21,11,10,3.0,3.0,0.0
9608415,41,12,29,58,13,28,78,12,6.0,5.0,1.0,2.0,1.0,5.0,12.0,59,41,18,15.0,4.0,11.0
9706379,9,5,4,5,5,4,4,162,3.0,2.0,1.0,1.0,0.0,3.0,3.0,10,9,1,2.0,1.0,1.0
9805498,28,7,21,60,6,22,102,48,18.0,4.0,14.0,40.0,2.0,16.0,67.0,39,28,11,19.0,13.0,6.0
9903498,39,4,35,115,3,36,284,24,27.0,1.0,26.0,90.0,0.0,27.0,210.0,67,39,28,28.0,19.0,9.0
206205,4,2,2,2,0,4,20,4,1.0,1.0,0.0,0.0,0.0,1.0,2.0,34,4,30,5.0,0.0,5.0
11144,9,5,4,6,2,7,47,26,5.0,4.0,1.0,2.0,0.0,5.0,38.0,28,9,19,17.0,4.0,13.0
9304269,6,2,4,5,6,0,0,229,3.0,1.0,2.0,2.0,3.0,0.0,0.0,6,6,0,2.0,2.0,0.0
9608324,4,3,1,1,0,4,7,35,3.0,2.0,1.0,1.0,0.0,3.0,4.0,8,4,4,5.0,3.0,2.0
9811250,12,3,9,20,7,5,17,168,9.0,2.0,7.0,17.0,9.0,0.0,0.0,26,12,14,6.0,6.0,0.0
9808443,32,6,26,87,10,22,26,4,15.0,2.0,13.0,35.0,8.0,7.0,7.0,35,32,3,16.0,15.0,1.0
9805229,14,5,9,15,1,13,80,35,8.0,3.0,5.0,9.0,0.0,8.0,35.0,35,14,21,10.0,3.0,7.0
11014,90,49,41,86,16,74,94,2,7.0,3.0,4.0,6.0,1.0,6.0,10.0,97,90,7,5.0,5.0,0.0
9804235,48,15,33,84,13,35,157,4,17.0,2.0,15.0,51.0,4.0,13.0,62.0,61,48,13,6.0,4.0,2.0
9705340,5,4,1,1,0,5,15,275,3.0,2.0,1.0,1.0,0.0,3.0,10.0,16,5,11,6.0,3.0,3.0
104074,19,3,16,41,0,19,166,2,12.0,2.0,10.0,18.0,0.0,12.0,115.0,41,19,22,24.0,10.0,14.0
202155,18,6,12,18,1,17,121,2,6.0,3.0,3.0,3.0,0.0,6.0,73.0,37,18,19,19.0,5.0,14.0
9410322,12,6,6,11,12,0,0,41,6.0,2.0,4.0,7.0,6.0,0.0,0.0,13,12,1,1.0,1.0,0.0
9402259,16,10,6,8,16,0,0,63,6.0,3.0,3.0,3.0,6.0,0.0,0.0,17,16,1,1.0,1.0,0.0
9601260,7,4,3,4,1,6,10,149,3.0,3.0,0.0,0.0,0.0,3.0,5.0,15,7,8,6.0,2.0,4.0
9403250,30,6,24,75,9,21,35,25,18.0,1.0,17.0,55.0,5.0,13.0,21.0,34,30,4,12.0,11.0,1.0
9503463,57,1,56,389,37,20,24,23,39.0,1.0,38.0,259.0,22.0,17.0,17.0,60,57,3,27.0,26.0,1.0
9801209,72,22,50,213,72,0,0,102,27.0,3.0,24.0,129.0,27.0,0.0,0.0,72,72,0,23.0,23.0,0.0
9503367,7,4,3,3,4,3,10,10,2.0,1.0,1.0,1.0,0.0,2.0,5.0,16,7,9,1.0,1.0,0.0
9207245,40,11,29,96,40,0,0,42,15.0,2.0,13.0,42.0,15.0,0.0,0.0,40,40,0,3.0,3.0,0.0
9312217,17,10,7,9,15,2,3,107,3.0,1.0,2.0,3.0,3.0,0.0,0.0,23,17,6,2.0,2.0,0.0
9403345,14,8,6,13,7,7,7,0,2.0,2.0,0.0,0.0,1.0,1.0,1.0,16,14,2,4.0,3.0,1.0
9710476,4,2,2,3,4,0,0,144,4.0,2.0,2.0,3.0,4.0,0.0,0.0,4,4,0,2.0,2.0,0.0
9708403,27,6,21,75,13,14,23,0,8.0,3.0,5.0,14.0,8.0,0.0,0.0,33,27,6,12.0,11.0,1.0
9808470,42,14,28,95,18,24,24,0,8.0,2.0,6.0,10.0,8.0,0.0,0.0,43,42,1,11.0,11.0,0.0
9507393,37,14,23,57,18,19,58,0,2.0,2.0,0.0,0.0,0.0,2.0,8.0,47,37,10,8.0,2.0,6.0
9411274,34,6,28,62,18,16,35,3,8.0,1.0,7.0,13.0,8.0,0.0,0.0,38,34,4,9.0,9.0,0.0
9909469,58,5,53,417,4,54,387,0,51.0,3.0,48.0,398.0,2.0,49.0,328.0,75,58,17,54.0,42.0,12.0
9808241,27,8,19,48,12,15,25,3,6.0,3.0,3.0,3.0,1.0,5.0,7.0,33,27,6,7.0,5.0,2.0
9905440,16,4,12,21,4,12,29,3,3.0,1.0,2.0,2.0,3.0,0.0,0.0,25,16,9,3.0,3.0,0.0
9702343,54,5,49,234,26,28,45,0,23.0,3.0,20.0,94.0,14.0,9.0,12.0,60,54,6,13.0,12.0,1.0
9703454,50,8,42,136,3,47,164,119,26.0,3.0,23.0,67.0,0.0,26.0,115.0,58,50,8,30.0,22.0,8.0
9308348,16,7,9,13,13,3,3,0,3.0,1.0,2.0,2.0,3.0,0.0,0.0,19,16,3,2.0,2.0,0.0
9809368,25,3,22,49,0,25,248,0,12.0,2.0,10.0,23.0,0.0,12.0,136.0,66,25,41,30.0,7.0,23.0
9806400,24,11,13,19,0,24,289,0,9.0,6.0,3.0,5.0,0.0,9.0,101.0,101,24,77,20.0,5.0,15.0
9701357,7,5,2,3,1,6,31,93,0.0,0.0,0.0,0.0,0.0,0.0,0.0,57,7,50,10.0,0.0,10.0
9709473,56,16,40,86,22,34,76,0,8.0,2.0,6.0,10.0,0.0,8.0,20.0,65,56,9,4.0,4.0,0.0
9606295,27,5,22,58,4,23,26,288,10.0,3.0,7.0,16.0,1.0,9.0,11.0,31,27,4,11.0,9.0,2.0
9809458,20,4,16,40,3,17,56,119,9.0,2.0,7.0,11.0,0.0,9.0,27.0,29,20,9,13.0,9.0,4.0
9903464,27,7,20,44,3,24,90,0,2.0,2.0,0.0,0.0,0.0,2.0,6.0,42,27,15,10.0,5.0,5.0
9711339,21,6,15,49,6,15,47,81,14.0,1.0,13.0,41.0,6.0,8.0,16.0,38,21,17,9.0,5.0,4.0
9704363,15,8,7,14,2,13,112,36,11.0,5.0,6.0,12.0,0.0,11.0,94.0,39,15,24,19.0,10.0,9.0
9411366,99,6,93,677,66,33,55,46,69.0,2.0,67.0,499.0,45.0,24.0,42.0,103,99,4,24.0,21.0,3.0
9212267,12,5,7,17,10,2,2,256,6.0,3.0,3.0,6.0,6.0,0.0,0.0,13,12,1,6.0,6.0,0.0
9712201,112,41,71,167,86,26,31,3,16.0,3.0,13.0,48.0,13.0,3.0,5.0,130,112,18,13.0,13.0,0.0
9712277,20,5,15,36,0,20,236,12,17.0,3.0,14.0,30.0,0.0,17.0,137.0,80,20,60,23.0,12.0,11.0
9608218,6,6,0,0,1,5,32,63,1.0,1.0,0.0,0.0,0.0,1.0,8.0,21,6,15,12.0,1.0,11.0
9511221,40,10,30,115,2,38,131,50,18.0,1.0,17.0,57.0,0.0,18.0,24.0,59,40,19,21.0,18.0,3.0
9606215,28,5,23,67,6,22,58,10,12.0,3.0,9.0,24.0,4.0,8.0,14.0,38,28,10,9.0,8.0,1.0
9703209,56,10,46,133,10,46,112,42,26.0,4.0,22.0,76.0,2.0,24.0,72.0,63,56,7,20.0,16.0,4.0
9308329,34,10,24,62,10,24,33,10,14.0,3.0,11.0,35.0,1.0,13.0,13.0,38,34,4,6.0,6.0,0.0
9712516,24,6,18,30,2,22,100,81,5.0,1.0,4.0,6.0,0.0,5.0,23.0,55,24,31,9.0,4.0,5.0
9502315,26,3,23,55,25,1,1,107,7.0,1.0,6.0,10.0,7.0,0.0,0.0,27,26,1,7.0,7.0,0.0
9703427,53,3,50,310,3,50,273,36,44.0,3.0,41.0,271.0,0.0,44.0,222.0,64,53,11,39.0,33.0,6.0
9401241,106,13,93,443,83,23,28,10,29.0,4.0,25.0,156.0,29.0,0.0,0.0,108,106,2,25.0,25.0,0.0
111376,2,2,0,0,1,1,2,377,0.0,0.0,0.0,0.0,0.0,0.0,0.0,5,2,3,1.0,0.0,1.0
105194,20,12,8,17,2,18,92,1,6.0,6.0,0.0,0.0,0.0,6.0,23.0,48,20,28,6.0,4.0,2.0
9911233,66,3,63,338,4,62,631,34,46.0,2.0,44.0,275.0,0.0,46.0,533.0,104,66,38,56.0,33.0,23.0
105246,6,4,2,2,0,6,41,1,2.0,2.0,0.0,0.0,0.0,2.0,15.0,57,6,51,15.0,0.0,15.0
102204,100,6,94,1020,2,98,373,23,70.0,5.0,65.0,773.0,0.0,70.0,239.0,120,100,20,54.0,47.0,7.0
12297,13,7,6,7,4,9,60,67,2.0,1.0,1.0,1.0,0.0,2.0,12.0,53,13,40,15.0,2.0,13.0
9809347,4,1,3,6,4,0,0,1938,,,,,,,,4,4,0,,,
9306314,41,17,24,57,39,2,2,5,5.0,2.0,3.0,6.0,5.0,0.0,0.0,42,41,1,2.0,2.0,0.0
9609529,62,1,61,409,2,60,371,5,50.0,1.0,49.0,347.0,0.0,50.0,335.0,80,62,18,25.0,24.0,1.0
9705228,39,2,37,106,1,38,279,5,21.0,1.0,20.0,63.0,0.0,21.0,208.0,59,39,20,16.0,9.0,7.0
9605259,77,16,61,250,18,59,171,1,20.0,2.0,18.0,52.0,11.0,9.0,12.0,90,77,13,17.0,15.0,2.0
9303294,17,1,16,49,17,0,0,93,15.0,1.0,14.0,46.0,15.0,0.0,0.0,17,17,0,15.0,15.0,0.0
9606379,7,5,2,4,1,6,8,411,4.0,2.0,2.0,4.0,0.0,4.0,6.0,9,7,2,6.0,4.0,2.0
9804271,3,3,0,0,0,3,4,13,0.0,0.0,0.0,0.0,0.0,0.0,0.0,24,3,21,5.0,0.0,5.0
11124,13,4,9,14,6,7,24,6,8.0,4.0,4.0,6.0,7.0,1.0,1.0,20,13,7,6.0,6.0,0.0
9511454,71,6,65,300,5,66,503,6,48.0,1.0,47.0,216.0,0.0,48.0,426.0,96,71,25,36.0,18.0,18.0
9712541,10,2,8,20,3,7,8,9,7.0,1.0,6.0,15.0,1.0,6.0,6.0,12,10,2,8.0,7.0,1.0
9511255,39,2,37,201,3,36,136,34,28.0,2.0,26.0,162.0,3.0,25.0,110.0,48,39,9,28.0,22.0,6.0
9806266,22,12,10,15,2,20,163,1,8.0,6.0,2.0,3.0,0.0,8.0,60.0,83,22,61,21.0,1.0,20.0
9610337,16,5,11,20,7,9,18,69,5.0,3.0,2.0,2.0,0.0,5.0,9.0,19,16,3,3.0,3.0,0.0
9903544,46,1,45,248,0,46,184,32,35.0,1.0,34.0,187.0,0.0,35.0,103.0,71,46,25,19.0,17.0,2.0
201117,1,1,0,0,0,1,4,86,1.0,1.0,0.0,0.0,0.0,1.0,3.0,12,1,11,2.0,1.0,1.0
9807332,23,3,20,72,3,20,61,86,18.0,2.0,16.0,54.0,0.0,18.0,55.0,28,23,5,17.0,13.0,4.0
9912354,11,6,5,9,4,7,15,31,5.0,2.0,3.0,3.0,0.0,5.0,9.0,18,11,7,5.0,4.0,1.0
9508378,47,3,44,223,4,43,85,21,33.0,1.0,32.0,178.0,0.0,33.0,62.0,50,47,3,22.0,20.0,2.0
9708299,18,5,13,38,0,18,47,7,13.0,4.0,9.0,26.0,2.0,11.0,17.0,29,18,11,5.0,3.0,2.0
9505314,8,4,4,5,2,6,7,7,5.0,2.0,3.0,4.0,1.0,4.0,5.0,12,8,4,1.0,1.0,0.0
9707416,3,3,0,0,1,2,7,7,1.0,1.0,0.0,0.0,0.0,1.0,4.0,18,3,15,4.0,1.0,3.0
9904220,49,4,45,355,0,49,374,2,45.0,5.0,40.0,332.0,0.0,45.0,352.0,59,49,10,38.0,29.0,9.0
9605301,29,5,24,80,11,18,29,0,10.0,1.0,9.0,36.0,10.0,0.0,0.0,33,29,4,11.0,11.0,0.0
9404201,117,9,108,712,35,82,207,15,36.0,1.0,35.0,247.0,4.0,32.0,64.0,129,117,12,19.0,17.0,2.0
9409327,21,6,15,44,21,0,0,76,14.0,2.0,12.0,36.0,14.0,0.0,0.0,21,21,0,13.0,13.0,0.0
9810492,1,1,0,0,0,1,7,98,1.0,1.0,0.0,0.0,0.0,1.0,7.0,16,1,15,9.0,0.0,9.0
9406365,14,10,4,4,13,1,2,378,3.0,3.0,0.0,0.0,2.0,1.0,1.0,16,14,2,2.0,1.0,1.0
9707309,33,4,29,103,1,32,189,19,18.0,5.0,13.0,40.0,0.0,18.0,60.0,46,33,13,24.0,15.0,9.0
9207240,16,2,14,35,16,0,0,62,15.0,2.0,13.0,34.0,15.0,0.0,0.0,16,16,0,7.0,7.0,0.0
9505304,47,10,37,122,17,30,35,61,21.0,2.0,19.0,52.0,3.0,18.0,18.0,50,47,3,15.0,14.0,1.0
9702218,23,11,12,24,2,21,36,24,6.0,2.0,4.0,5.0,0.0,6.0,10.0,27,23,4,4.0,3.0,1.0
9310257,46,13,33,66,12,34,34,11,13.0,4.0,9.0,15.0,13.0,0.0,0.0,48,46,2,8.0,8.0,0.0
9503294,17,6,11,15,6,11,11,194,8.0,3.0,5.0,6.0,3.0,5.0,5.0,18,17,1,8.0,7.0,1.0
9707463,25,6,19,45,8,17,31,57,17.0,3.0,14.0,34.0,1.0,16.0,30.0,28,25,3,11.0,9.0,2.0
9706427,68,20,48,157,7,61,120,16,30.0,2.0,28.0,97.0,3.0,27.0,48.0,76,68,8,21.0,19.0,2.0
9711303,3,2,1,1,0,3,5,98,,,,,,,,8,3,5,2.0,2.0,0.0
9302311,55,13,42,241,55,0,0,24,17.0,2.0,15.0,82.0,17.0,0.0,0.0,55,55,0,14.0,14.0,0.0
9703305,47,3,44,177,18,29,65,151,22.0,1.0,21.0,89.0,6.0,16.0,33.0,54,47,7,21.0,18.0,3.0
9811464,2,1,1,1,0,2,22,151,2.0,1.0,1.0,1.0,0.0,2.0,19.0,14,2,12,12.0,2.0,10.0
9902230,18,4,14,37,2,16,59,86,8.0,2.0,6.0,16.0,1.0,7.0,13.0,34,18,16,10.0,8.0,2.0
9310244,13,6,7,11,11,2,2,86,5.0,2.0,3.0,4.0,5.0,0.0,0.0,14,13,1,4.0,4.0,0.0
9603276,28,4,24,83,12,16,25,59,23.0,3.0,20.0,75.0,7.0,16.0,25.0,30,28,2,18.0,16.0,2.0
9502224,108,14,94,475,56,52,87,24,31.0,2.0,29.0,217.0,31.0,0.0,0.0,115,108,7,6.0,6.0,0.0
9605465,68,18,50,171,10,58,422,6,26.0,7.0,19.0,54.0,0.0,26.0,296.0,114,68,46,29.0,10.0,19.0
9311337,25,4,21,101,9,16,39,6,11.0,2.0,9.0,41.0,0.0,11.0,31.0,30,25,5,3.0,2.0,1.0
9607293,15,6,9,23,13,2,2,85,8.0,2.0,6.0,14.0,8.0,0.0,0.0,26,15,11,2.0,0.0,2.0
9502346,17,3,14,25,8,9,25,6,5.0,2.0,3.0,4.0,5.0,0.0,0.0,21,17,4,8.0,6.0,2.0
9403290,163,8,155,1481,94,69,69,2,96.0,2.0,94.0,1028.0,53.0,43.0,43.0,164,163,1,40.0,39.0,1.0
9711335,8,3,5,7,1,7,22,135,5.0,3.0,2.0,3.0,0.0,5.0,8.0,18,8,10,7.0,5.0,2.0
6329,16,4,12,29,2,14,75,32,4.0,3.0,1.0,1.0,0.0,4.0,34.0,47,16,31,7.0,6.0,1.0
9410360,86,2,84,655,86,0,0,38,62.0,1.0,61.0,519.0,62.0,0.0,0.0,86,86,0,42.0,42.0,0.0
9905239,39,7,32,105,1,38,280,22,30.0,5.0,25.0,91.0,0.0,30.0,242.0,61,39,22,34.0,19.0,15.0
9805271,8,3,5,10,0,8,19,45,4.0,2.0,2.0,4.0,0.0,4.0,8.0,12,8,4,1.0,0.0,1.0
4074,30,8,22,62,1,29,457,20,26.0,7.0,19.0,58.0,0.0,26.0,433.0,68,30,38,51.0,15.0,36.0
10252,3,1,2,2,0,3,24,38,2.0,2.0,0.0,0.0,0.0,2.0,16.0,13,3,10,12.0,2.0,10.0
9702376,54,7,47,285,4,50,135,38,43.0,4.0,39.0,254.0,2.0,41.0,107.0,62,54,8,34.0,30.0,4.0
9708219,21,4,17,70,0,21,99,38,19.0,2.0,17.0,70.0,0.0,19.0,91.0,38,21,17,25.0,17.0,8.0
9607431,33,11,22,41,29,4,4,88,12.0,3.0,9.0,16.0,12.0,0.0,0.0,34,33,1,8.0,8.0,0.0
9503400,8,6,2,2,5,3,7,22,0.0,0.0,0.0,0.0,0.0,0.0,0.0,26,8,18,2.0,1.0,1.0
9809490,38,2,36,205,2,36,159,21,35.0,2.0,33.0,198.0,1.0,34.0,155.0,51,38,13,37.0,25.0,12.0
9805211,14,7,7,11,3,11,53,21,8.0,4.0,4.0,5.0,0.0,8.0,44.0,24,14,10,14.0,5.0,9.0
9806404,296,51,245,734,135,161,293,11,17.0,5.0,12.0,25.0,1.0,16.0,17.0,316,296,20,19.0,15.0,4.0
9610498,27,7,20,94,0,27,83,19,15.0,4.0,11.0,45.0,0.0,15.0,60.0,35,27,8,13.0,12.0,1.0
9809550,23,8,15,38,0,23,152,39,5.0,3.0,2.0,3.0,0.0,5.0,39.0,48,23,25,17.0,4.0,13.0
9907385,63,6,57,683,4,59,88,19,50.0,3.0,47.0,609.0,2.0,48.0,48.0,71,63,8,44.0,43.0,1.0
9603327,26,7,19,31,13,13,28,39,5.0,2.0,3.0,5.0,5.0,0.0,0.0,32,26,6,5.0,5.0,0.0
9801381,1,1,0,0,0,1,5,43,1.0,1.0,0.0,0.0,0.0,1.0,5.0,9,1,8,,,
9707300,2,2,0,0,1,1,3,66,0.0,0.0,0.0,0.0,0.0,0.0,0.0,6,2,4,1.0,0.0,1.0
110285,1,1,0,0,1,0,0,220,0.0,0.0,0.0,0.0,0.0,0.0,0.0,9,1,8,2.0,0.0,2.0
9501417,31,1,30,112,18,13,23,31,17.0,2.0,15.0,71.0,9.0,8.0,8.0,35,31,4,14.0,13.0,1.0
9212315,16,8,8,21,16,0,0,29,7.0,4.0,3.0,6.0,7.0,0.0,0.0,16,16,0,4.0,4.0,0.0
9409423,4,4,0,0,3,1,1,326,1.0,1.0,0.0,0.0,1.0,0.0,0.0,7,4,3,1.0,1.0,0.0
9906346,45,8,37,170,9,36,158,20,32.0,5.0,27.0,140.0,3.0,29.0,142.0,56,45,11,17.0,17.0,0.0
9910295,14,5,9,22,0,14,81,20,10.0,2.0,8.0,17.0,0.0,10.0,58.0,27,14,13,2.0,2.0,0.0
9409246,16,7,9,15,13,3,3,430,6.0,3.0,3.0,4.0,4.0,2.0,2.0,17,16,1,4.0,4.0,0.0
107265,30,4,26,75,1,29,188,20,26.0,2.0,24.0,70.0,0.0,26.0,180.0,60,30,30,28.0,5.0,23.0
109068,10,5,5,9,0,10,36,80,4.0,2.0,2.0,2.0,0.0,4.0,11.0,19,10,9,4.0,2.0,2.0
9310216,14,3,11,16,6,8,15,78,5.0,2.0,3.0,3.0,1.0,4.0,8.0,19,14,5,6.0,4.0,2.0
9409408,27,16,11,21,9,18,38,1,7.0,5.0,2.0,2.0,1.0,6.0,8.0,37,27,10,4.0,3.0,1.0
9904250,49,6,43,253,4,45,117,5,25.0,1.0,24.0,170.0,0.0,25.0,50.0,56,49,7,22.0,21.0,1.0
9412281,11,4,7,12,6,5,14,10,3.0,1.0,2.0,3.0,0.0,3.0,12.0,15,11,4,5.0,5.0,0.0
9809582,75,2,73,382,8,67,328,2,43.0,1.0,42.0,232.0,0.0,43.0,228.0,100,75,25,10.0,10.0,0.0
9801365,43,9,34,98,3,40,299,10,18.0,4.0,14.0,41.0,1.0,17.0,98.0,80,43,37,12.0,10.0,2.0
9711501,17,5,12,27,0,17,120,99,8.0,2.0,6.0,17.0,0.0,8.0,58.0,38,17,21,17.0,10.0,7.0
9511237,12,6,6,9,10,2,2,37,2.0,2.0,0.0,0.0,2.0,0.0,0.0,14,12,2,2.0,2.0,0.0
9710329,5,1,4,6,0,5,20,42,5.0,1.0,4.0,6.0,0.0,5.0,20.0,11,5,6,2.0,2.0,0.0
9311335,8,5,3,3,6,2,2,179,4.0,3.0,1.0,1.0,4.0,0.0,0.0,9,8,1,3.0,3.0,0.0
9506396,8,4,4,4,6,2,4,269,2.0,1.0,1.0,1.0,0.0,2.0,2.0,14,8,6,4.0,2.0,2.0
9404342,49,14,35,111,36,13,19,5,15.0,6.0,9.0,21.0,5.0,10.0,10.0,51,49,2,9.0,9.0,0.0
9510324,3,2,1,1,1,2,18,35,1.0,1.0,0.0,0.0,0.0,1.0,6.0,18,3,15,4.0,1.0,3.0
9604328,22,5,17,58,2,20,54,24,6.0,3.0,3.0,3.0,0.0,6.0,17.0,29,22,7,10.0,6.0,4.0
9511385,36,3,33,127,2,34,61,4,19.0,1.0,18.0,77.0,0.0,19.0,19.0,41,36,5,5.0,4.0,1.0
9905542,33,5,28,128,6,27,131,4,25.0,3.0,22.0,96.0,3.0,22.0,104.0,44,33,11,28.0,21.0,7.0
9907458,8,7,1,2,2,6,28,3,1.0,1.0,0.0,0.0,0.0,1.0,17.0,55,8,47,7.0,0.0,7.0
9807513,205,8,197,1260,102,103,183,11,77.0,2.0,75.0,573.0,35.0,42.0,48.0,220,205,15,49.0,48.0,1.0
9901350,54,4,50,215,8,46,219,0,15.0,3.0,12.0,56.0,2.0,13.0,22.0,77,54,23,16.0,14.0,2.0
9806361,35,7,28,56,15,20,58,62,11.0,4.0,7.0,16.0,6.0,5.0,9.0,51,35,16,12.0,10.0,2.0
9604302,18,6,12,19,1,17,59,41,10.0,2.0,8.0,12.0,0.0,10.0,33.0,27,18,9,12.0,7.0,5.0
9311356,29,4,25,94,15,14,17,41,18.0,4.0,14.0,53.0,9.0,9.0,9.0,32,29,3,16.0,15.0,1.0
9810277,24,10,14,41,6,18,45,36,2.0,1.0,1.0,1.0,0.0,2.0,6.0,65,24,41,27.0,0.0,27.0
9607459,26,12,14,19,15,11,17,89,3.0,1.0,2.0,2.0,3.0,0.0,0.0,29,26,3,5.0,5.0,0.0
9503356,80,21,59,148,50,30,81,17,36.0,4.0,32.0,98.0,20.0,16.0,44.0,93,80,13,5.0,5.0,0.0
9501354,3,2,1,1,3,0,0,354,1.0,1.0,0.0,0.0,1.0,0.0,0.0,10,3,7,2.0,1.0,1.0
9710512,10,4,6,9,0,10,60,6,4.0,1.0,3.0,3.0,0.0,4.0,22.0,30,10,20,8.0,4.0,4.0
103199,76,10,66,291,4,72,335,23,26.0,4.0,22.0,88.0,0.0,26.0,130.0,107,76,31,30.0,19.0,11.0
9602429,35,9,26,93,4,31,80,13,18.0,1.0,17.0,70.0,1.0,17.0,45.0,46,35,11,20.0,16.0,4.0
9511234,6,6,0,0,0,6,8,231,2.0,2.0,0.0,0.0,0.0,2.0,3.0,10,6,4,4.0,2.0,2.0
9507366,42,13,29,83,7,35,74,10,10.0,3.0,7.0,16.0,3.0,7.0,11.0,54,42,12,7.0,6.0,1.0
9803320,14,1,13,46,1,13,53,55,7.0,1.0,6.0,19.0,1.0,6.0,21.0,27,14,13,2.0,0.0,2.0
9902407,47,2,45,304,1,46,128,2,37.0,1.0,36.0,260.0,1.0,36.0,103.0,50,47,3,32.0,29.0,3.0
9806504,2,2,0,0,1,1,2,300,0.0,0.0,0.0,0.0,0.0,0.0,0.0,8,2,6,3.0,1.0,2.0
9712532,7,1,6,15,0,7,43,55,6.0,1.0,5.0,13.0,0.0,6.0,36.0,20,7,13,7.0,2.0,5.0
9911341,53,12,41,124,20,33,168,3,9.0,2.0,7.0,11.0,0.0,9.0,76.0,88,53,35,23.0,4.0,19.0
9606464,12,5,7,23,1,11,17,31,9.0,2.0,7.0,23.0,1.0,8.0,13.0,19,12,7,5.0,3.0,2.0
9507206,6,3,3,4,2,4,12,253,3.0,1.0,2.0,3.0,1.0,2.0,6.0,10,6,4,7.0,3.0,4.0
101020,12,2,10,19,0,12,64,18,7.0,3.0,4.0,6.0,0.0,7.0,35.0,32,12,20,6.0,4.0,2.0
3154,93,25,68,252,6,87,1015,10,1.0,1.0,0.0,0.0,0.0,1.0,8.0,415,93,322,22.0,2.0,20.0
9504220,29,10,19,69,1,28,52,27,22.0,6.0,16.0,54.0,0.0,22.0,40.0,36,29,7,12.0,12.0,0.0
9911323,112,12,100,348,1,111,397,5,19.0,2.0,17.0,80.0,0.0,19.0,25.0,136,112,24,8.0,8.0,0.0
9211286,41,12,29,119,38,3,3,75,12.0,7.0,5.0,15.0,10.0,2.0,2.0,42,41,1,7.0,6.0,1.0
4001,11,7,4,7,2,9,73,5,2.0,2.0,0.0,0.0,0.0,2.0,34.0,44,11,33,24.0,2.0,22.0
9803405,34,8,26,92,1,33,190,10,21.0,6.0,15.0,56.0,0.0,21.0,111.0,47,34,13,28.0,20.0,8.0
9212304,2,2,0,0,2,0,0,553,1.0,1.0,0.0,0.0,1.0,0.0,0.0,2,2,0,1.0,1.0,0.0
9911337,35,8,27,92,0,35,229,32,24.0,7.0,17.0,51.0,0.0,24.0,170.0,52,35,17,20.0,13.0,7.0
9712515,27,14,13,23,3,24,54,18,2.0,2.0,0.0,0.0,1.0,1.0,3.0,43,27,16,4.0,1.0,3.0
108108,12,4,8,15,3,9,24,0,11.0,3.0,8.0,15.0,2.0,9.0,24.0,18,12,6,3.0,2.0,1.0
105139,33,6,27,67,9,24,52,0,7.0,1.0,6.0,7.0,4.0,3.0,5.0,45,33,12,2.0,2.0,0.0
9412336,8,2,6,12,7,1,1,111,6.0,2.0,4.0,6.0,6.0,0.0,0.0,9,8,1,4.0,4.0,0.0
9407328,14,8,6,11,1,13,51,164,10.0,6.0,4.0,6.0,0.0,10.0,43.0,21,14,7,15.0,10.0,5.0
9702397,9,2,7,9,1,8,14,118,8.0,1.0,7.0,9.0,1.0,7.0,7.0,12,9,3,4.0,4.0,0.0
9705257,11,5,6,8,1,10,25,51,7.0,3.0,4.0,6.0,0.0,7.0,21.0,19,11,8,11.0,5.0,6.0
9507321,21,6,15,59,0,21,103,16,10.0,3.0,7.0,20.0,0.0,10.0,61.0,29,21,8,14.0,8.0,6.0
9804431,7,4,3,3,1,6,17,16,4.0,2.0,2.0,2.0,1.0,3.0,9.0,13,7,6,8.0,2.0,6.0
9910262,28,6,22,38,6,22,27,11,4.0,3.0,1.0,2.0,4.0,0.0,0.0,31,28,3,4.0,4.0,0.0
9809552,8,3,5,8,2,6,26,4,5.0,1.0,4.0,5.0,1.0,4.0,12.0,17,8,9,8.0,5.0,3.0
9610456,15,4,11,31,1,14,124,94,13.0,4.0,9.0,22.0,1.0,12.0,88.0,35,15,20,16.0,7.0,9.0
9906506,1,1,0,0,0,1,12,114,0.0,0.0,0.0,0.0,0.0,0.0,0.0,13,1,12,11.0,0.0,11.0
9812495,11,5,6,24,0,11,74,52,9.0,5.0,4.0,16.0,0.0,9.0,51.0,32,11,21,17.0,8.0,9.0
9412348,27,3,24,71,10,17,33,39,19.0,2.0,17.0,48.0,6.0,13.0,18.0,31,27,4,15.0,14.0,1.0
9305305,37,15,22,47,37,0,0,8,4.0,3.0,1.0,1.0,4.0,0.0,0.0,37,37,0,6.0,6.0,0.0
9907522,44,6,38,122,0,44,492,2,11.0,3.0,8.0,12.0,0.0,11.0,222.0,117,44,73,27.0,22.0,5.0
9701263,4,3,1,1,3,1,1,157,0.0,0.0,0.0,0.0,0.0,0.0,0.0,16,4,12,4.0,0.0,4.0
9912455,10,8,2,2,2,8,68,2,4.0,3.0,1.0,1.0,0.0,4.0,43.0,27,10,17,6.0,3.0,3.0
9512418,13,7,6,8,1,12,29,138,8.0,5.0,3.0,4.0,1.0,7.0,13.0,21,13,8,9.0,5.0,4.0
9708275,30,3,27,76,13,17,31,11,17.0,2.0,15.0,38.0,12.0,5.0,5.0,39,30,9,5.0,3.0,2.0
5328,30,3,27,227,0,30,170,19,29.0,3.0,26.0,223.0,0.0,29.0,164.0,40,30,10,36.0,28.0,8.0
9907327,23,7,16,29,8,15,45,19,12.0,1.0,11.0,18.0,0.0,12.0,37.0,32,23,9,16.0,9.0,7.0
204244,14,8,6,16,2,12,94,80,7.0,5.0,2.0,6.0,0.0,7.0,58.0,40,14,26,26.0,5.0,21.0
12261,7,5,2,2,0,7,35,135,2.0,1.0,1.0,1.0,0.0,2.0,14.0,18,7,11,3.0,1.0,2.0
204031,3,2,1,1,0,3,44,2,0.0,0.0,0.0,0.0,0.0,0.0,0.0,232,3,229,16.0,0.0,16.0
103123,20,3,17,38,0,20,182,19,11.0,2.0,9.0,16.0,0.0,11.0,82.0,57,20,37,20.0,8.0,12.0
1031,40,5,35,191,3,37,196,28,25.0,1.0,24.0,136.0,9.0,16.0,21.0,61,40,21,11.0,9.0,2.0
109184,6,2,4,7,0,6,58,28,6.0,2.0,4.0,7.0,0.0,6.0,23.0,24,6,18,2.0,1.0,1.0
9909523,9,1,8,21,0,9,68,2,7.0,1.0,6.0,17.0,0.0,7.0,17.0,21,9,12,8.0,6.0,2.0
9802357,111,41,70,259,15,96,368,14,31.0,6.0,25.0,96.0,0.0,31.0,168.0,161,111,50,27.0,18.0,9.0
9512428,21,4,17,41,21,0,0,91,12.0,1.0,11.0,25.0,12.0,0.0,0.0,21,21,0,6.0,6.0,0.0
212269,3,3,0,0,0,3,17,2,3.0,3.0,0.0,0.0,0.0,3.0,5.0,20,3,17,9.0,3.0,6.0
11095,6,2,4,7,0,6,28,2,3.0,1.0,2.0,2.0,0.0,3.0,6.0,13,6,7,2.0,2.0,0.0
204067,6,5,1,1,1,5,49,2,2.0,2.0,0.0,0.0,0.0,2.0,24.0,41,6,35,8.0,2.0,6.0
6275,7,6,1,1,0,7,56,2,3.0,2.0,1.0,1.0,0.0,3.0,21.0,30,7,23,13.0,2.0,11.0
9709364,44,2,42,251,2,42,143,10,32.0,2.0,30.0,182.0,0.0,32.0,77.0,55,44,11,32.0,28.0,4.0
112021,3,1,2,2,0,3,44,10,3.0,1.0,2.0,2.0,0.0,3.0,32.0,33,3,30,16.0,3.0,13.0
9806309,1,1,0,0,0,1,2,1101,,,,,,,,8,1,7,1.0,0.0,1.0
9706468,2,2,0,0,2,0,0,84,0.0,0.0,0.0,0.0,0.0,0.0,0.0,7,2,5,1.0,1.0,0.0
9912417,6,2,4,11,0,6,11,28,6.0,2.0,4.0,11.0,0.0,6.0,11.0,9,6,3,9.0,6.0,3.0
9507397,15,8,7,11,0,15,15,5,7.0,1.0,6.0,10.0,0.0,7.0,7.0,17,15,2,5.0,4.0,1.0
103017,6,5,1,1,2,4,5,234,1.0,1.0,0.0,0.0,0.0,1.0,2.0,15,6,9,3.0,2.0,1.0
9702420,3,3,0,0,1,2,7,17,0.0,0.0,0.0,0.0,0.0,0.0,0.0,13,3,10,3.0,0.0,3.0
9812488,19,6,13,27,4,15,42,4,9.0,3.0,6.0,9.0,0.0,9.0,22.0,28,19,9,11.0,8.0,3.0
9901280,5,5,0,0,2,3,11,4,0.0,0.0,0.0,0.0,0.0,0.0,0.0,41,5,36,4.0,0.0,4.0
202170,25,4,21,69,1,24,127,1,11.0,2.0,9.0,24.0,0.0,11.0,45.0,44,25,19,3.0,2.0,1.0
5227,8,4,4,6,0,8,82,34,2.0,1.0,1.0,1.0,0.0,2.0,22.0,58,8,50,8.0,3.0,5.0
101045,7,4,3,3,0,7,34,7,0.0,0.0,0.0,0.0,0.0,0.0,0.0,39,7,32,5.0,0.0,5.0
9809468,11,5,6,8,0,11,127,7,6.0,3.0,3.0,5.0,0.0,6.0,95.0,40,11,29,26.0,4.0,22.0
9512227,16,5,11,18,3,13,98,61,6.0,2.0,4.0,5.0,0.0,6.0,37.0,35,16,19,12.0,4.0,8.0
9801433,7,4,3,4,4,3,3,79,2.0,1.0,1.0,1.0,0.0,2.0,2.0,8,7,1,3.0,2.0,1.0
9306241,45,4,41,188,45,0,0,68,23.0,1.0,22.0,63.0,23.0,0.0,0.0,45,45,0,15.0,15.0,0.0
9801262,85,10,75,369,0,85,444,9,53.0,6.0,47.0,244.0,0.0,53.0,321.0,102,85,17,41.0,26.0,15.0
9808215,7,3,4,8,0,7,28,11,1.0,1.0,0.0,0.0,1.0,0.0,0.0,13,7,6,2.0,1.0,1.0
9511315,176,10,166,1214,3,173,599,17,135.0,3.0,132.0,1044.0,0.0,135.0,514.0,187,176,11,66.0,58.0,8.0
9508373,56,4,52,210,0,56,258,17,42.0,3.0,39.0,167.0,0.0,42.0,215.0,66,56,10,32.0,24.0,8.0
9606382,4,2,2,2,2,2,3,26,2.0,2.0,0.0,0.0,2.0,0.0,0.0,8,4,4,4.0,3.0,1.0
9607331,6,5,1,1,4,2,5,211,3.0,3.0,0.0,0.0,2.0,1.0,3.0,11,6,5,5.0,2.0,3.0
9702225,11,7,4,4,1,10,45,17,4.0,3.0,1.0,1.0,0.0,4.0,27.0,23,11,12,5.0,5.0,0.0
5052,2,1,1,1,0,2,3,425,2.0,1.0,1.0,1.0,0.0,2.0,3.0,4,2,2,4.0,2.0,2.0
9510326,9,3,6,9,6,3,3,186,5.0,1.0,4.0,7.0,2.0,3.0,3.0,13,9,4,6.0,5.0,1.0
9611417,2,2,0,0,2,0,0,236,1.0,1.0,0.0,0.0,1.0,0.0,0.0,7,2,5,2.0,0.0,2.0
9208227,11,2,9,27,11,0,0,15,2.0,1.0,1.0,1.0,2.0,0.0,0.0,11,11,0,2.0,2.0,0.0
105288,11,8,3,3,0,11,101,2,5.0,5.0,0.0,0.0,0.0,5.0,32.0,52,11,41,22.0,4.0,18.0
9704385,18,2,16,47,7,11,32,7,8.0,3.0,5.0,10.0,0.0,8.0,24.0,28,18,10,5.0,5.0,0.0
9803460,47,7,40,174,5,42,209,7,14.0,1.0,13.0,56.0,3.0,11.0,11.0,63,47,16,18.0,13.0,5.0
9509361,11,1,10,37,0,11,27,29,10.0,1.0,9.0,36.0,0.0,10.0,21.0,21,11,10,11.0,10.0,1.0
9411290,13,5,8,11,1,12,28,99,4.0,2.0,2.0,3.0,0.0,4.0,7.0,21,13,8,8.0,5.0,3.0
9811371,6,6,0,0,0,6,32,73,4.0,4.0,0.0,0.0,0.0,4.0,28.0,15,6,9,11.0,4.0,7.0
9608434,51,8,43,161,1,50,138,27,17.0,6.0,11.0,26.0,0.0,17.0,38.0,62,51,11,11.0,10.0,1.0
9809398,9,1,8,17,6,3,3,54,8.0,1.0,7.0,15.0,8.0,0.0,0.0,14,9,5,7.0,7.0,0.0
9605271,7,3,4,7,3,4,17,16,1.0,1.0,0.0,0.0,0.0,1.0,6.0,21,7,14,2.0,2.0,0.0
4087,10,2,8,20,0,10,99,24,10.0,2.0,8.0,20.0,0.0,10.0,78.0,33,10,23,19.0,8.0,11.0
9912226,26,5,21,109,1,25,279,24,24.0,4.0,20.0,106.0,0.0,24.0,244.0,48,26,22,34.0,18.0,16.0
9808298,4,4,0,0,1,3,3,224,2.0,2.0,0.0,0.0,0.0,2.0,2.0,12,4,8,3.0,2.0,1.0
9706525,11,5,6,8,8,3,3,88,6.0,1.0,5.0,7.0,6.0,0.0,0.0,15,11,4,2.0,2.0,0.0
9707503,2,1,1,1,1,1,1,214,2.0,1.0,1.0,1.0,2.0,0.0,0.0,3,2,1,2.0,2.0,0.0
102051,7,6,1,1,2,5,58,9,3.0,2.0,1.0,1.0,0.0,3.0,24.0,65,7,58,12.0,2.0,10.0
9706420,37,1,36,134,6,31,100,27,19.0,1.0,18.0,55.0,10.0,9.0,13.0,48,37,11,15.0,12.0,3.0
9502340,55,11,44,209,18,37,82,14,28.0,3.0,25.0,125.0,5.0,23.0,32.0,61,55,6,14.0,13.0,1.0
9702363,32,9,23,75,1,31,89,117,27.0,5.0,22.0,73.0,1.0,26.0,40.0,46,32,14,21.0,19.0,2.0
9604220,31,7,24,87,11,20,30,27,11.0,2.0,9.0,24.0,9.0,2.0,2.0,36,31,5,10.0,10.0,0.0
9902255,31,7,24,68,0,31,175,27,25.0,4.0,21.0,56.0,0.0,25.0,143.0,54,31,23,21.0,16.0,5.0
9206255,8,3,5,7,6,2,2,280,3.0,1.0,2.0,3.0,3.0,0.0,0.0,9,8,1,4.0,4.0,0.0
9509304,19,4,15,37,1,18,36,13,10.0,2.0,8.0,21.0,0.0,10.0,17.0,24,19,5,3.0,3.0,0.0
9403245,2,2,0,0,1,1,1,132,1.0,1.0,0.0,0.0,1.0,0.0,0.0,3,2,1,1.0,1.0,0.0
9809351,13,8,5,8,13,0,0,156,3.0,1.0,2.0,3.0,3.0,0.0,0.0,14,13,1,2.0,1.0,1.0
9806485,2,2,0,0,2,0,0,1524,,,,,,,,2,2,0,,,
9605260,7,6,1,1,4,3,4,273,2.0,1.0,1.0,1.0,2.0,0.0,0.0,12,7,5,2.0,0.0,2.0
9804268,4,2,2,2,0,4,11,162,1.0,1.0,0.0,0.0,0.0,1.0,4.0,11,4,7,5.0,1.0,4.0
9605265,5,3,2,3,4,1,1,778,1.0,1.0,0.0,0.0,1.0,0.0,0.0,6,5,1,1.0,0.0,1.0
9512373,5,3,2,3,4,1,1,47,1.0,1.0,0.0,0.0,1.0,0.0,0.0,6,5,1,1.0,1.0,0.0
9706215,1,1,0,0,0,1,2,57,0.0,0.0,0.0,0.0,0.0,0.0,0.0,6,1,5,3.0,0.0,3.0
9709433,6,5,1,2,1,5,23,16,0.0,0.0,0.0,0.0,0.0,0.0,0.0,24,6,18,4.0,0.0,4.0
9703448,26,4,22,78,1,25,109,13,19.0,2.0,17.0,58.0,0.0,19.0,83.0,49,26,23,15.0,6.0,9.0
9309277,12,6,6,10,8,4,6,18,3.0,1.0,2.0,3.0,3.0,0.0,0.0,20,12,8,1.0,1.0,0.0
9604410,17,2,15,30,4,13,13,97,15.0,2.0,13.0,26.0,2.0,13.0,13.0,18,17,1,9.0,8.0,1.0
9605283,79,10,69,591,0,79,642,15,60.0,7.0,53.0,505.0,0.0,60.0,508.0,113,79,34,58.0,44.0,14.0
9312221,38,18,20,42,10,28,80,15,6.0,5.0,1.0,1.0,1.0,5.0,5.0,48,38,10,4.0,4.0,0.0
9503335,3,3,0,0,1,2,11,223,1.0,1.0,0.0,0.0,0.0,1.0,2.0,11,3,8,5.0,1.0,4.0
9706287,25,11,14,35,9,16,43,15,11.0,4.0,7.0,20.0,0.0,11.0,31.0,33,25,8,5.0,5.0,0.0
102087,5,5,0,0,0,5,47,11,2.0,2.0,0.0,0.0,0.0,2.0,32.0,64,5,59,3.0,1.0,2.0
9311332,44,12,32,112,43,1,1,133,22.0,3.0,19.0,64.0,22.0,0.0,0.0,45,44,1,17.0,17.0,0.0
108137,1,1,0,0,1,0,0,3,0.0,0.0,0.0,0.0,0.0,0.0,0.0,27,1,26,7.0,0.0,7.0
9912492,37,8,29,110,4,33,238,3,19.0,5.0,14.0,49.0,1.0,18.0,173.0,61,37,24,19.0,6.0,13.0
9711310,2,1,1,1,1,1,4,120,2.0,1.0,1.0,1.0,1.0,1.0,1.0,6,2,4,1.0,0.0,1.0
9707372,2,2,0,0,0,2,15,0,1.0,1.0,0.0,0.0,0.0,1.0,11.0,24,2,22,2.0,1.0,1.0
9509382,3,2,1,1,3,0,0,254,2.0,1.0,1.0,1.0,2.0,0.0,0.0,3,3,0,1.0,1.0,0.0
9907254,35,10,25,64,6,29,68,71,8.0,5.0,3.0,4.0,0.0,8.0,15.0,48,35,13,9.0,7.0,2.0
9311278,45,7,38,92,19,26,46,112,17.0,1.0,16.0,52.0,10.0,7.0,7.0,55,45,10,14.0,13.0,1.0
9502222,2,1,1,1,2,0,0,206,1.0,1.0,0.0,0.0,1.0,0.0,0.0,8,2,6,1.0,1.0,0.0
9712502,15,6,9,12,11,4,4,1,3.0,3.0,0.0,0.0,3.0,0.0,0.0,18,15,3,3.0,2.0,1.0
9909459,5,4,1,1,3,2,2,128,4.0,3.0,1.0,1.0,2.0,2.0,2.0,6,5,1,2.0,2.0,0.0
6047,22,4,18,44,0,22,114,5,14.0,2.0,12.0,31.0,0.0,14.0,63.0,41,22,19,18.0,13.0,5.0
9604395,4,3,1,1,2,2,2,343,3.0,2.0,1.0,1.0,1.0,2.0,2.0,7,4,3,4.0,3.0,1.0
9707392,9,2,7,23,1,8,13,8,5.0,2.0,3.0,7.0,5.0,0.0,0.0,16,9,7,5.0,5.0,0.0
7213,26,6,20,53,5,21,142,10,6.0,2.0,4.0,4.0,2.0,4.0,7.0,58,26,32,12.0,7.0,5.0
9803476,28,8,20,54,0,28,212,10,8.0,4.0,4.0,5.0,0.0,8.0,61.0,70,28,42,15.0,7.0,8.0
9905278,5,3,2,2,0,5,24,10,0.0,0.0,0.0,0.0,0.0,0.0,0.0,28,5,23,2.0,1.0,1.0
9605277,5,2,3,4,0,5,9,123,4.0,2.0,2.0,3.0,1.0,3.0,5.0,11,5,6,5.0,4.0,1.0
9604413,3,1,2,3,3,0,0,1651,0.0,0.0,0.0,0.0,0.0,0.0,0.0,7,3,4,,,
9505440,5,4,1,1,1,4,10,15,4.0,3.0,1.0,1.0,1.0,3.0,3.0,17,5,12,4.0,3.0,1.0
9807354,18,4,14,80,1,17,104,49,15.0,4.0,11.0,70.0,0.0,15.0,38.0,33,18,15,18.0,14.0,4.0
9508295,4,3,1,2,0,4,17,35,3.0,2.0,1.0,2.0,0.0,3.0,10.0,12,4,8,7.0,3.0,4.0
6025,2,1,1,1,0,2,13,14,2.0,1.0,1.0,1.0,0.0,2.0,4.0,12,2,10,5.0,2.0,3.0
9501236,6,3,3,3,6,0,0,225,4.0,2.0,2.0,2.0,4.0,0.0,0.0,7,6,1,3.0,3.0,0.0
9604316,26,6,20,61,3,23,68,30,8.0,6.0,2.0,3.0,0.0,8.0,30.0,38,26,12,9.0,2.0,7.0
9504340,8,4,4,5,1,7,12,71,5.0,3.0,2.0,2.0,0.0,5.0,5.0,15,8,7,5.0,3.0,2.0
107276,4,4,0,0,0,4,19,32,0.0,0.0,0.0,0.0,0.0,0.0,0.0,51,4,47,15.0,1.0,14.0
9703239,11,4,7,10,0,11,96,60,4.0,2.0,2.0,2.0,0.0,4.0,47.0,53,11,42,23.0,3.0,20.0
4145,8,4,4,6,1,7,21,46,6.0,2.0,4.0,6.0,0.0,6.0,15.0,16,8,8,1.0,0.0,1.0
12040,2,2,0,0,1,1,14,55,1.0,1.0,0.0,0.0,0.0,1.0,14.0,28,2,26,15.0,0.0,15.0
9506356,38,16,22,51,35,3,3,100,8.0,2.0,6.0,11.0,8.0,0.0,0.0,39,38,1,6.0,6.0,0.0
9811275,53,5,48,125,10,43,168,8,15.0,2.0,13.0,35.0,0.0,15.0,36.0,93,53,40,21.0,11.0,10.0
9904419,3,2,1,1,1,2,4,14,0.0,0.0,0.0,0.0,0.0,0.0,0.0,9,3,6,1.0,0.0,1.0
9311353,8,5,3,5,0,8,12,112,6.0,3.0,3.0,3.0,0.0,6.0,6.0,14,8,6,5.0,4.0,1.0
7228,13,7,6,7,1,12,123,12,5.0,3.0,2.0,2.0,0.0,5.0,30.0,60,13,47,12.0,2.0,10.0
9303238,36,6,30,187,36,0,0,36,27.0,3.0,24.0,131.0,27.0,0.0,0.0,36,36,0,18.0,18.0,0.0
9502286,20,7,13,33,1,19,83,7,10.0,3.0,7.0,18.0,0.0,10.0,34.0,29,20,9,2.0,1.0,1.0
107001,26,1,25,125,0,26,83,193,20.0,1.0,19.0,105.0,0.0,20.0,38.0,32,26,6,21.0,19.0,2.0
205064,8,7,1,1,2,6,31,26,3.0,3.0,0.0,0.0,0.0,3.0,20.0,31,8,23,4.0,0.0,4.0
205210,6,5,1,1,0,6,17,17,1.0,1.0,0.0,0.0,0.0,1.0,1.0,12,6,6,4.0,2.0,2.0
9306211,4,3,1,1,4,0,0,89,,,,,,,,4,4,0,,,
9804299,14,2,12,49,0,14,114,67,14.0,2.0,12.0,49.0,0.0,14.0,99.0,37,14,23,24.0,14.0,10.0
9412398,13,6,7,15,1,12,69,6,9.0,4.0,5.0,11.0,0.0,9.0,55.0,31,13,18,5.0,4.0,1.0
12195,3,2,1,1,2,1,1,86,0.0,0.0,0.0,0.0,0.0,0.0,0.0,26,3,23,14.0,0.0,14.0
6309,5,3,2,2,0,5,35,30,4.0,2.0,2.0,2.0,0.0,4.0,24.0,21,5,16,15.0,2.0,13.0
9506265,10,6,4,5,6,4,4,345,3.0,1.0,2.0,2.0,0.0,3.0,3.0,12,10,2,4.0,3.0,1.0
9410270,12,8,4,5,10,2,2,320,3.0,1.0,2.0,3.0,3.0,0.0,0.0,13,12,1,3.0,3.0,0.0
3317,12,5,7,10,0,12,70,21,7.0,4.0,3.0,5.0,0.0,7.0,43.0,31,12,19,13.0,5.0,8.0
9401347,27,11,16,34,26,1,1,7,9.0,1.0,8.0,13.0,9.0,0.0,0.0,28,27,1,7.0,7.0,0.0
9142,2,2,0,0,0,2,7,1,0.0,0.0,0.0,0.0,0.0,0.0,0.0,16,2,14,2.0,0.0,2.0
9803232,19,7,12,40,4,15,82,34,9.0,2.0,7.0,24.0,0.0,9.0,23.0,39,19,20,13.0,9.0,4.0
9403281,45,6,39,112,45,0,0,57,20.0,3.0,17.0,53.0,20.0,0.0,0.0,45,45,0,11.0,11.0,0.0
9803419,11,5,6,14,3,8,23,154,9.0,3.0,6.0,13.0,4.0,5.0,13.0,18,11,7,7.0,7.0,0.0
9706210,8,1,7,9,0,8,30,19,7.0,1.0,6.0,8.0,2.0,5.0,15.0,26,8,18,10.0,5.0,5.0
9307261,3,3,0,0,2,1,1,432,1.0,1.0,0.0,0.0,1.0,0.0,0.0,4,3,1,1.0,0.0,1.0
9308313,6,3,3,3,2,4,7,78,2.0,1.0,1.0,1.0,0.0,2.0,4.0,12,6,6,3.0,2.0,1.0
10130,10,5,5,5,2,8,11,126,5.0,2.0,3.0,3.0,0.0,5.0,8.0,14,10,4,4.0,2.0,2.0
9907539,8,5,3,3,0,8,76,13,7.0,5.0,2.0,2.0,0.0,7.0,58.0,40,8,32,22.0,6.0,16.0
102266,2,1,1,1,0,2,30,25,2.0,1.0,1.0,1.0,0.0,2.0,17.0,36,2,34,17.0,2.0,15.0
9509242,26,11,15,31,11,15,21,3,6.0,1.0,5.0,9.0,6.0,0.0,0.0,32,26,6,6.0,6.0,0.0
9505267,31,12,19,71,8,23,45,90,23.0,6.0,17.0,65.0,5.0,18.0,23.0,39,31,8,17.0,15.0,2.0
101205,12,6,6,13,0,12,133,8,9.0,3.0,6.0,13.0,0.0,9.0,117.0,36,12,24,27.0,5.0,22.0
9311378,1,1,0,0,0,1,2,39,0.0,0.0,0.0,0.0,0.0,0.0,0.0,5,1,4,1.0,0.0,1.0
104121,5,1,4,6,0,5,22,22,2.0,1.0,1.0,1.0,0.0,2.0,8.0,22,5,17,7.0,3.0,4.0
9906325,3,3,0,0,0,3,10,22,0.0,0.0,0.0,0.0,0.0,0.0,0.0,14,3,11,2.0,0.0,2.0
110414,10,4,6,16,1,9,27,0,7.0,3.0,4.0,11.0,0.0,7.0,21.0,33,10,23,2.0,1.0,1.0
103052,14,7,7,11,2,12,51,0,9.0,4.0,5.0,8.0,0.0,9.0,39.0,36,14,22,3.0,1.0,2.0
9509238,13,4,9,16,0,13,29,200,13.0,4.0,9.0,16.0,0.0,13.0,25.0,19,13,6,14.0,11.0,3.0
9604314,15,7,8,15,11,4,5,1,3.0,2.0,1.0,1.0,3.0,0.0,0.0,22,15,7,3.0,3.0,0.0
9905522,1,1,0,0,1,0,0,53,0.0,0.0,0.0,0.0,0.0,0.0,0.0,5,1,4,4.0,0.0,4.0
107197,12,3,9,14,1,11,50,66,2.0,2.0,0.0,0.0,0.0,2.0,10.0,26,12,14,8.0,1.0,7.0
9605405,5,3,2,2,5,0,0,412,2.0,2.0,0.0,0.0,2.0,0.0,0.0,8,5,3,2.0,2.0,0.0
9809524,23,5,18,66,2,21,58,0,14.0,3.0,11.0,40.0,1.0,13.0,27.0,49,23,26,12.0,10.0,2.0
9812525,14,3,11,19,5,9,25,63,12.0,3.0,9.0,16.0,4.0,8.0,24.0,18,14,4,4.0,2.0,2.0
7334,8,3,5,20,0,8,107,3,7.0,3.0,4.0,14.0,0.0,7.0,99.0,44,8,36,16.0,7.0,9.0
9810539,6,3,3,5,4,2,2,14,2.0,1.0,1.0,1.0,1.0,1.0,1.0,11,6,5,1.0,0.0,1.0
9405329,17,9,8,11,7,10,16,10,5.0,2.0,3.0,5.0,0.0,5.0,5.0,22,17,5,4.0,3.0,1.0
3059,0,0,0,0,0,0,0,235,0.0,0.0,0.0,0.0,0.0,0.0,0.0,2,0,2,1.0,0.0,1.0
7299,1,1,0,0,0,1,4,67,1.0,1.0,0.0,0.0,0.0,1.0,1.0,15,1,14,1.0,0.0,1.0
9412254,14,3,11,14,13,1,1,152,7.0,1.0,6.0,6.0,7.0,0.0,0.0,16,14,2,6.0,6.0,0.0
103083,8,3,5,16,0,8,137,23,6.0,1.0,5.0,14.0,0.0,6.0,131.0,47,8,39,25.0,6.0,19.0
9307244,63,6,57,485,59,4,11,53,57.0,3.0,54.0,470.0,57.0,0.0,0.0,66,63,3,42.0,42.0,0.0
9501246,7,5,2,3,4,3,3,267,2.0,2.0,0.0,0.0,1.0,1.0,1.0,12,7,5,3.0,2.0,1.0
110246,4,2,2,2,0,4,28,56,4.0,2.0,2.0,2.0,0.0,4.0,28.0,22,4,18,12.0,1.0,11.0
9608328,2,1,1,1,2,0,0,1907,,,,,,,,2,2,0,,,
9303233,40,10,30,184,40,0,0,94,27.0,4.0,23.0,158.0,27.0,0.0,0.0,40,40,0,23.0,23.0,0.0
9603203,3,1,2,2,0,3,5,92,2.0,1.0,1.0,1.0,2.0,0.0,0.0,6,3,3,3.0,2.0,1.0
9902368,10,3,7,19,0,10,51,2,7.0,1.0,6.0,15.0,0.0,7.0,39.0,22,10,12,1.0,1.0,0.0
9903484,3,3,0,0,0,3,5,3,1.0,1.0,0.0,0.0,1.0,0.0,0.0,10,3,7,1.0,0.0,1.0
103242,21,8,13,35,6,15,68,3,11.0,1.0,10.0,20.0,0.0,11.0,42.0,37,21,16,17.0,10.0,7.0
9903490,11,7,4,4,1,10,47,1,1.0,1.0,0.0,0.0,0.0,1.0,7.0,36,11,25,3.0,2.0,1.0
9603301,9,4,5,9,0,9,39,69,3.0,1.0,2.0,3.0,0.0,3.0,12.0,32,9,23,6.0,1.0,5.0
9210244,12,4,8,23,12,0,0,176,11.0,3.0,8.0,23.0,11.0,0.0,0.0,12,12,0,11.0,11.0,0.0
9812201,20,5,15,46,3,17,59,4,2.0,1.0,1.0,1.0,0.0,2.0,16.0,40,20,20,13.0,3.0,10.0
9308248,18,5,13,23,13,5,5,35,6.0,3.0,3.0,3.0,6.0,0.0,0.0,20,18,2,5.0,5.0,0.0
9812301,5,3,2,2,4,1,1,306,1.0,1.0,0.0,0.0,0.0,1.0,1.0,6,5,1,2.0,1.0,1.0
9412235,38,7,31,111,26,12,18,260,15.0,1.0,14.0,39.0,15.0,0.0,0.0,43,38,5,13.0,13.0,0.0
9904286,35,10,25,67,6,29,158,3,15.0,3.0,12.0,27.0,2.0,13.0,54.0,63,35,28,13.0,11.0,2.0
202030,36,7,29,131,1,35,247,46,23.0,4.0,19.0,96.0,1.0,22.0,133.0,89,36,53,30.0,15.0,15.0
12236,3,3,0,0,0,3,7,0,1.0,1.0,0.0,0.0,0.0,1.0,2.0,17,3,14,1.0,0.0,1.0
9605215,16,3,13,43,8,8,9,255,13.0,3.0,10.0,35.0,7.0,6.0,6.0,20,16,4,11.0,10.0,1.0
107012,6,5,1,1,2,4,18,79,2.0,2.0,0.0,0.0,0.0,2.0,12.0,22,6,16,8.0,1.0,7.0
9407346,2,2,0,0,2,0,0,250,0.0,0.0,0.0,0.0,0.0,0.0,0.0,8,2,6,4.0,0.0,4.0
108152,15,4,11,29,0,15,159,37,14.0,3.0,11.0,29.0,0.0,14.0,151.0,38,15,23,29.0,14.0,15.0
108097,2,2,0,0,0,2,9,500,0.0,0.0,0.0,0.0,0.0,0.0,0.0,17,2,15,1.0,0.0,1.0
103213,2,1,1,1,0,2,10,47,0.0,0.0,0.0,0.0,0.0,0.0,0.0,23,2,21,9.0,0.0,9.0
111078,10,2,8,12,0,10,74,47,8.0,2.0,6.0,10.0,0.0,8.0,53.0,43,10,33,19.0,7.0,12.0
110300,14,3,11,31,1,13,68,3,8.0,2.0,6.0,10.0,1.0,7.0,19.0,22,14,8,12.0,9.0,3.0
108202,7,1,6,6,0,7,18,381,5.0,1.0,4.0,4.0,0.0,5.0,11.0,16,7,9,10.0,4.0,6.0
9710386,0,0,0,0,0,0,0,1742,,,,,,,,1,0,1,,,
1243,19,5,14,37,4,15,30,65,12.0,3.0,9.0,30.0,3.0,9.0,20.0,31,19,12,10.0,8.0,2.0
9710522,0,0,0,0,0,0,0,148,,,,,,,,1,0,1,,,
9408252,1,1,0,0,0,1,2,35,1.0,1.0,0.0,0.0,0.0,1.0,1.0,3,1,2,,,
9504237,15,2,13,31,1,14,45,100,11.0,1.0,10.0,24.0,1.0,10.0,32.0,26,15,11,14.0,10.0,4.0
9903500,3,2,1,1,2,1,1,26,2.0,1.0,1.0,1.0,2.0,0.0,0.0,8,3,5,2.0,2.0,0.0
103113,11,5,6,9,1,10,48,54,7.0,2.0,5.0,8.0,0.0,7.0,29.0,33,11,22,12.0,7.0,5.0
106112,21,5,16,55,0,21,287,11,17.0,2.0,15.0,52.0,0.0,17.0,271.0,57,21,36,43.0,15.0,28.0
9207207,2,1,1,1,2,0,0,234,2.0,1.0,1.0,1.0,2.0,0.0,0.0,2,2,0,,,
9411423,11,7,4,5,11,0,0,100,2.0,2.0,0.0,0.0,2.0,0.0,0.0,11,11,0,1.0,1.0,0.0
9807567,25,11,14,41,7,18,24,65,12.0,4.0,8.0,32.0,0.0,12.0,12.0,30,25,5,11.0,10.0,1.0
9609308,5,2,3,3,2,3,7,59,3.0,3.0,0.0,0.0,3.0,0.0,0.0,9,5,4,1.0,1.0,0.0
9503495,9,1,8,18,0,9,21,15,5.0,1.0,4.0,5.0,0.0,5.0,5.0,13,9,4,10.0,9.0,1.0
9908246,22,3,19,47,1,21,140,32,12.0,3.0,9.0,26.0,0.0,12.0,91.0,50,22,28,20.0,11.0,9.0
9609500,14,6,8,14,0,14,211,17,12.0,6.0,6.0,12.0,0.0,12.0,189.0,48,14,34,33.0,9.0,24.0
9807456,1,1,0,0,0,1,2,4,0.0,0.0,0.0,0.0,0.0,0.0,0.0,15,1,14,1.0,0.0,1.0
10118,2,2,0,0,0,2,10,102,1.0,1.0,0.0,0.0,0.0,1.0,5.0,24,2,22,8.0,1.0,7.0
9707226,10,7,3,4,3,7,17,113,2.0,2.0,0.0,0.0,0.0,2.0,5.0,24,10,14,3.0,3.0,0.0
9212219,10,8,2,2,4,6,6,207,3.0,2.0,1.0,1.0,3.0,0.0,0.0,12,10,2,2.0,2.0,0.0
9707403,5,3,2,3,2,3,10,304,2.0,1.0,1.0,1.0,0.0,2.0,3.0,15,5,10,4.0,2.0,2.0
9501319,21,10,11,14,15,6,6,195,4.0,2.0,2.0,3.0,4.0,0.0,0.0,22,21,1,3.0,3.0,0.0
9612327,5,3,2,2,0,5,37,1,3.0,2.0,1.0,1.0,0.0,3.0,22.0,52,5,47,21.0,2.0,19.0
9802211,5,3,2,2,1,4,5,88,1.0,1.0,0.0,0.0,0.0,1.0,2.0,9,5,4,4.0,1.0,3.0
9712443,16,8,8,13,8,8,14,99,2.0,2.0,0.0,0.0,0.0,2.0,4.0,19,16,3,5.0,5.0,0.0
9705274,7,5,2,2,3,4,4,35,1.0,1.0,0.0,0.0,1.0,0.0,0.0,10,7,3,2.0,1.0,1.0
9304288,2,1,1,1,2,0,0,2122,,,,,,,,2,2,0,1.0,1.0,0.0
9402248,5,2,3,5,5,0,0,147,3.0,1.0,2.0,3.0,3.0,0.0,0.0,7,5,2,3.0,3.0,0.0
9610437,8,2,6,15,4,4,5,157,7.0,1.0,6.0,12.0,4.0,3.0,3.0,14,8,6,2.0,2.0,0.0
9809363,29,4,25,110,1,28,173,50,25.0,4.0,21.0,102.0,1.0,24.0,146.0,49,29,20,28.0,19.0,9.0
9506479,3,3,0,0,3,0,0,326,1.0,1.0,0.0,0.0,1.0,0.0,0.0,4,3,1,2.0,1.0,1.0
5324,3,3,0,0,0,3,7,19,2.0,2.0,0.0,0.0,0.0,2.0,5.0,12,3,9,11.0,2.0,9.0
9802302,12,8,4,4,1,11,46,30,1.0,1.0,0.0,0.0,0.0,1.0,3.0,196,12,184,16.0,0.0,16.0
107148,6,5,1,2,0,6,6,37,3.0,2.0,1.0,2.0,3.0,0.0,0.0,11,6,5,2.0,2.0,0.0
209249,0,0,0,0,0,0,0,20,0.0,0.0,0.0,0.0,0.0,0.0,0.0,19,0,19,1.0,0.0,1.0
9705390,13,6,7,11,0,13,41,6,5.0,3.0,2.0,3.0,5.0,0.0,0.0,22,13,9,6.0,6.0,0.0
9408291,11,10,1,2,9,2,2,14,2.0,2.0,0.0,0.0,2.0,0.0,0.0,15,11,4,2.0,2.0,0.0
9609496,17,8,9,13,7,10,14,212,10.0,3.0,7.0,10.0,2.0,8.0,8.0,19,17,2,7.0,6.0,1.0
10016,1,1,0,0,0,1,7,77,1.0,1.0,0.0,0.0,0.0,1.0,5.0,11,1,10,6.0,1.0,5.0
9902436,5,3,2,2,0,5,19,277,4.0,2.0,2.0,2.0,0.0,4.0,12.0,11,5,6,10.0,4.0,6.0
9811341,6,5,1,1,2,4,19,5,1.0,1.0,0.0,0.0,1.0,0.0,0.0,26,6,20,3.0,1.0,2.0
9809510,15,3,12,29,0,15,65,8,9.0,2.0,7.0,15.0,0.0,9.0,53.0,29,15,14,17.0,9.0,8.0
9806305,61,14,47,192,11,50,295,9,37.0,5.0,32.0,152.0,0.0,37.0,205.0,82,61,21,29.0,15.0,14.0
9504430,2,2,0,0,2,0,0,389,2.0,2.0,0.0,0.0,2.0,0.0,0.0,3,2,1,2.0,2.0,0.0
9607438,5,4,1,1,2,3,7,105,1.0,1.0,0.0,0.0,0.0,1.0,1.0,10,5,5,3.0,1.0,2.0
9812467,22,4,18,59,0,22,119,9,19.0,3.0,16.0,55.0,0.0,19.0,100.0,37,22,15,20.0,11.0,9.0
9411302,29,9,20,33,12,17,17,51,12.0,6.0,6.0,8.0,2.0,10.0,10.0,31,29,2,8.0,8.0,0.0
9809494,2,2,0,0,1,1,1,106,1.0,1.0,0.0,0.0,0.0,1.0,1.0,3,2,1,1.0,1.0,0.0
9512228,6,4,2,4,2,4,11,29,1.0,1.0,0.0,0.0,0.0,1.0,5.0,19,6,13,4.0,3.0,1.0
9710222,16,7,9,28,1,15,53,25,9.0,4.0,5.0,12.0,0.0,9.0,30.0,32,16,16,15.0,8.0,7.0
207158,6,2,4,8,6,0,0,121,4.0,2.0,2.0,3.0,4.0,0.0,0.0,11,6,5,5.0,5.0,0.0
9903299,10,5,5,7,1,9,33,48,4.0,2.0,2.0,3.0,0.0,4.0,22.0,26,10,16,7.0,4.0,3.0
9307254,4,4,0,0,4,0,0,276,4.0,4.0,0.0,0.0,4.0,0.0,0.0,4,4,0,2.0,2.0,0.0
9506377,4,3,1,1,3,1,1,338,2.0,1.0,1.0,1.0,2.0,0.0,0.0,8,4,4,2.0,2.0,0.0
7127,2,1,1,1,0,2,9,222,2.0,1.0,1.0,1.0,0.0,2.0,7.0,11,2,9,8.0,2.0,6.0
9609315,2,2,0,0,2,0,0,241,1.0,1.0,0.0,0.0,1.0,0.0,0.0,3,2,1,1.0,1.0,0.0
9805234,6,5,1,1,2,4,6,334,3.0,3.0,0.0,0.0,0.0,3.0,3.0,11,6,5,3.0,2.0,1.0
9407211,15,4,11,23,5,10,59,53,10.0,2.0,8.0,19.0,0.0,10.0,59.0,22,15,7,15.0,8.0,7.0
9803396,27,7,20,50,10,17,27,31,16.0,4.0,12.0,23.0,1.0,15.0,23.0,45,27,18,6.0,6.0,0.0
9802356,12,5,7,9,1,11,24,3,3.0,1.0,2.0,2.0,2.0,1.0,1.0,27,12,15,5.0,3.0,2.0
9910409,1,1,0,0,0,1,1,950,0.0,0.0,0.0,0.0,0.0,0.0,0.0,3,1,2,,,
9901317,12,5,7,19,1,11,96,25,6.0,1.0,5.0,10.0,0.0,6.0,51.0,49,12,37,17.0,7.0,10.0
9906503,9,6,3,4,3,6,10,27,3.0,2.0,1.0,1.0,1.0,2.0,2.0,17,9,8,5.0,4.0,1.0
111218,3,2,1,1,0,3,22,9,2.0,1.0,1.0,1.0,0.0,2.0,14.0,19,3,16,2.0,1.0,1.0
7047,2,2,0,0,0,2,2,27,1.0,1.0,0.0,0.0,0.0,1.0,1.0,12,2,10,1.0,1.0,0.0
9912341,4,3,1,1,0,4,18,9,1.0,1.0,0.0,0.0,0.0,1.0,1.0,20,4,16,5.0,0.0,5.0
9809418,3,2,1,1,0,3,10,143,3.0,2.0,1.0,1.0,0.0,3.0,10.0,10,3,7,7.0,2.0,5.0
9801323,2,1,1,1,0,2,3,95,2.0,1.0,1.0,1.0,0.0,2.0,3.0,6,2,4,4.0,0.0,4.0
102228,13,4,9,19,0,13,190,3,8.0,3.0,5.0,9.0,0.0,8.0,99.0,73,13,60,16.0,4.0,12.0
11296,10,3,7,18,0,10,66,56,5.0,2.0,3.0,5.0,0.0,5.0,27.0,31,10,21,9.0,7.0,2.0
9402294,3,2,1,1,1,2,5,223,0.0,0.0,0.0,0.0,0.0,0.0,0.0,10,3,7,1.0,0.0,1.0
9801297,23,8,15,28,3,20,70,13,7.0,1.0,6.0,6.0,0.0,7.0,36.0,38,23,15,7.0,5.0,2.0
9401301,9,8,1,1,5,4,12,29,2.0,1.0,1.0,1.0,2.0,0.0,0.0,12,9,3,1.0,1.0,0.0
9708430,3,3,0,0,0,3,12,39,2.0,2.0,0.0,0.0,0.0,2.0,5.0,16,3,13,2.0,1.0,1.0
9712209,20,4,16,60,7,13,75,25,11.0,2.0,9.0,25.0,1.0,10.0,46.0,42,20,22,16.0,4.0,12.0
9402236,9,5,4,4,7,2,2,240,2.0,1.0,1.0,1.0,2.0,0.0,0.0,11,9,2,1.0,1.0,0.0
205084,10,5,5,6,1,9,59,15,2.0,1.0,1.0,1.0,0.0,2.0,17.0,42,10,32,3.0,0.0,3.0
9903309,2,1,1,1,0,2,9,87,2.0,1.0,1.0,1.0,0.0,2.0,6.0,20,2,18,4.0,0.0,4.0
9807508,9,4,5,6,1,8,59,68,5.0,4.0,1.0,1.0,0.0,5.0,39.0,39,9,30,8.0,0.0,8.0
210318,1,1,0,0,0,1,9,2,1.0,1.0,0.0,0.0,0.0,1.0,6.0,23,1,22,3.0,0.0,3.0
9809505,4,4,0,0,0,4,33,7,2.0,2.0,0.0,0.0,0.0,2.0,15.0,95,4,91,8.0,0.0,8.0
9806380,4,4,0,0,0,4,14,119,1.0,1.0,0.0,0.0,0.0,1.0,2.0,11,4,7,4.0,1.0,3.0
9801395,3,3,0,0,1,2,4,5,0.0,0.0,0.0,0.0,0.0,0.0,0.0,18,3,15,2.0,1.0,1.0
9601212,6,5,1,1,2,4,4,98,1.0,1.0,0.0,0.0,1.0,0.0,0.0,12,6,6,1.0,1.0,0.0
9711218,8,3,5,7,6,2,2,263,4.0,2.0,2.0,3.0,4.0,0.0,0.0,12,8,4,3.0,1.0,2.0
9408393,1,1,0,0,0,1,1,823,,,,,,,,2,1,1,,,
12296,4,3,1,1,0,4,29,17,1.0,1.0,0.0,0.0,0.0,1.0,14.0,26,4,22,10.0,0.0,10.0
9910274,4,2,2,2,0,4,31,17,3.0,2.0,1.0,1.0,0.0,3.0,24.0,15,4,11,,,
9812253,6,3,3,7,1,5,5,267,4.0,1.0,3.0,5.0,0.0,4.0,4.0,13,6,7,6.0,4.0,2.0
9811370,7,2,5,10,0,7,39,78,7.0,2.0,5.0,10.0,0.0,7.0,32.0,18,7,11,11.0,5.0,6.0
103215,11,1,10,27,1,10,93,2,5.0,1.0,4.0,6.0,0.0,5.0,52.0,34,11,23,5.0,5.0,0.0
112209,3,3,0,0,1,2,31,15,1.0,1.0,0.0,0.0,0.0,1.0,6.0,42,3,39,4.0,0.0,4.0
205333,0,0,0,0,0,0,0,38,0.0,0.0,0.0,0.0,0.0,0.0,0.0,20,0,20,2.0,0.0,2.0
101030,8,6,2,3,2,6,24,13,4.0,4.0,0.0,0.0,2.0,2.0,7.0,21,8,13,4.0,1.0,3.0
9601215,9,2,7,15,7,2,4,66,4.0,1.0,3.0,5.0,4.0,0.0,0.0,12,9,3,1.0,1.0,0.0
9211224,4,3,1,1,4,0,0,276,2.0,2.0,0.0,0.0,2.0,0.0,0.0,4,4,0,3.0,3.0,0.0
9901346,8,2,6,14,3,5,5,168,6.0,2.0,4.0,10.0,1.0,5.0,5.0,16,8,8,7.0,6.0,1.0
107263,1,1,0,0,0,1,1,2066,,,,,,,,2,1,1,,,
9902413,1,1,0,0,1,0,0,1819,,,,,,,,1,1,0,,,
4136,15,4,11,32,2,13,13,278,8.0,3.0,5.0,13.0,0.0,8.0,8.0,18,15,3,9.0,8.0,1.0
9803225,33,6,27,148,5,28,107,68,27.0,3.0,24.0,135.0,2.0,25.0,96.0,40,33,7,30.0,24.0,6.0
9407392,3,2,1,1,1,2,2,265,2.0,1.0,1.0,1.0,0.0,2.0,2.0,8,3,5,3.0,2.0,1.0
9810426,7,3,4,4,0,7,29,13,2.0,1.0,1.0,1.0,0.0,2.0,12.0,21,7,14,5.0,1.0,4.0
9412293,7,6,1,1,2,5,5,49,2.0,2.0,0.0,0.0,2.0,0.0,0.0,10,7,3,3.0,3.0,0.0
9608338,8,7,1,2,0,8,36,57,4.0,4.0,0.0,0.0,0.0,4.0,13.0,24,8,16,4.0,2.0,2.0
9304202,9,5,4,7,9,0,0,335,5.0,2.0,3.0,5.0,5.0,0.0,0.0,9,9,0,4.0,4.0,0.0
9610257,2,2,0,0,0,2,7,3,0.0,0.0,0.0,0.0,0.0,0.0,0.0,13,2,11,10.0,0.0,10.0
9611206,18,5,13,26,4,14,33,167,11.0,1.0,10.0,19.0,1.0,10.0,15.0,26,18,8,11.0,10.0,1.0
102120,4,4,0,0,1,3,13,22,0.0,0.0,0.0,0.0,0.0,0.0,0.0,39,4,35,2.0,0.0,2.0
9911304,5,2,3,6,0,5,53,7,4.0,1.0,3.0,6.0,0.0,4.0,44.0,26,5,21,18.0,4.0,14.0
9811431,2,2,0,0,1,1,7,162,0.0,0.0,0.0,0.0,0.0,0.0,0.0,16,2,14,1.0,0.0,1.0
9912367,13,4,9,14,0,13,182,11,10.0,3.0,7.0,11.0,0.0,10.0,146.0,41,13,28,24.0,7.0,17.0
9405294,7,4,3,4,5,2,2,8,4.0,2.0,2.0,2.0,4.0,0.0,0.0,13,7,6,4.0,3.0,1.0
9710544,12,4,8,20,8,4,5,117,6.0,1.0,5.0,7.0,6.0,0.0,0.0,16,12,4,8.0,8.0,0.0
9210223,3,2,1,1,3,0,0,206,2.0,2.0,0.0,0.0,2.0,0.0,0.0,4,3,1,2.0,2.0,0.0
201026,4,2,2,2,1,3,8,28,4.0,2.0,2.0,2.0,1.0,3.0,8.0,10,4,6,3.0,0.0,3.0
9503424,2,1,1,1,2,0,0,367,1.0,1.0,0.0,0.0,1.0,0.0,0.0,2,2,0,2.0,2.0,0.0
108090,12,2,10,21,1,11,35,0,8.0,1.0,7.0,16.0,0.0,8.0,18.0,20,12,8,7.0,6.0,1.0
102070,7,3,4,5,0,7,31,1,5.0,2.0,3.0,4.0,3.0,2.0,5.0,21,7,14,4.0,3.0,1.0
9710489,3,2,1,1,0,3,12,67,2.0,1.0,1.0,1.0,0.0,2.0,9.0,15,3,12,6.0,2.0,4.0
9808320,28,10,18,72,0,28,117,11,23.0,7.0,16.0,63.0,0.0,23.0,102.0,43,28,15,24.0,15.0,9.0
112362,1,1,0,0,0,1,4,51,1.0,1.0,0.0,0.0,0.0,1.0,2.0,11,1,10,5.0,1.0,4.0
9306232,6,3,3,3,6,0,0,332,6.0,3.0,3.0,3.0,6.0,0.0,0.0,7,6,1,5.0,5.0,0.0
208223,3,2,1,1,1,2,6,0,1.0,1.0,0.0,0.0,0.0,1.0,3.0,10,3,7,6.0,1.0,5.0
206304,15,4,11,40,0,15,168,46,14.0,3.0,11.0,40.0,0.0,14.0,105.0,74,15,59,23.0,8.0,15.0
105110,3,3,0,0,2,1,1,139,2.0,2.0,0.0,0.0,2.0,0.0,0.0,5,3,2,1.0,1.0,0.0
102164,4,2,2,3,1,3,3,81,2.0,1.0,1.0,1.0,1.0,1.0,1.0,8,4,4,2.0,1.0,1.0
9804432,8,2,6,8,2,6,6,127,7.0,2.0,5.0,6.0,2.0,5.0,5.0,9,8,1,6.0,5.0,1.0
9809330,4,3,1,1,3,1,1,294,2.0,1.0,1.0,1.0,2.0,0.0,0.0,9,4,5,3.0,0.0,3.0
112073,0,0,0,0,0,0,0,2017,,,,,,,,1,0,1,,,
9707271,5,4,1,1,0,5,33,7,1.0,1.0,0.0,0.0,0.0,1.0,6.0,44,5,39,10.0,1.0,9.0
209245,1,1,0,0,1,0,0,32,0.0,0.0,0.0,0.0,0.0,0.0,0.0,11,1,10,1.0,0.0,1.0
209096,1,1,0,0,1,0,0,24,0.0,0.0,0.0,0.0,0.0,0.0,0.0,17,1,16,1.0,1.0,0.0
9909241,3,2,1,1,2,1,2,59,1.0,1.0,0.0,0.0,1.0,0.0,0.0,10,3,7,2.0,0.0,2.0
7129,19,5,14,23,0,19,89,25,6.0,2.0,4.0,6.0,0.0,6.0,36.0,41,19,22,16.0,5.0,11.0
112190,2,2,0,0,0,2,15,5,0.0,0.0,0.0,0.0,0.0,0.0,0.0,46,2,44,16.0,0.0,16.0
103163,17,5,12,30,0,17,72,30,12.0,2.0,10.0,27.0,0.0,12.0,48.0,31,17,14,14.0,6.0,8.0
9612358,11,7,4,6,3,8,27,116,5.0,2.0,3.0,5.0,0.0,5.0,14.0,21,11,10,8.0,4.0,4.0
9609528,1,1,0,0,1,0,0,1224,,,,,,,,3,1,2,1.0,1.0,0.0
107256,9,2,7,13,0,9,195,11,9.0,2.0,7.0,13.0,0.0,9.0,169.0,70,9,61,39.0,8.0,31.0
9505328,13,3,10,22,3,10,17,54,8.0,4.0,4.0,6.0,3.0,5.0,5.0,17,13,4,6.0,5.0,1.0
209059,11,7,4,5,0,11,109,0,2.0,2.0,0.0,0.0,0.0,2.0,37.0,46,11,35,21.0,2.0,19.0
110106,7,2,5,8,0,7,31,32,1.0,1.0,0.0,0.0,0.0,1.0,1.0,59,7,52,4.0,2.0,2.0
102081,18,4,14,32,1,17,182,4,12.0,3.0,9.0,22.0,0.0,12.0,153.0,53,18,35,30.0,9.0,21.0
9811493,5,4,1,1,5,0,0,267,0.0,0.0,0.0,0.0,0.0,0.0,0.0,7,5,2,2.0,0.0,2.0
107200,19,2,17,48,4,15,27,38,9.0,1.0,8.0,13.0,4.0,5.0,7.0,24,19,5,9.0,8.0,1.0
9901345,3,3,0,0,0,3,16,5,1.0,1.0,0.0,0.0,0.0,1.0,6.0,22,3,19,3.0,0.0,3.0
9404314,1,1,0,0,0,1,1,75,0.0,0.0,0.0,0.0,0.0,0.0,0.0,14,1,13,1.0,0.0,1.0
9906282,5,5,0,0,1,4,8,84,0.0,0.0,0.0,0.0,0.0,0.0,0.0,19,5,14,3.0,1.0,2.0
205020,5,5,0,0,0,5,15,141,0.0,0.0,0.0,0.0,0.0,0.0,0.0,15,5,10,1.0,0.0,1.0
9503449,0,0,0,0,0,0,0,938,0.0,0.0,0.0,0.0,0.0,0.0,0.0,5,0,5,,,
9604385,4,1,3,5,0,4,5,151,4.0,1.0,3.0,5.0,0.0,4.0,5.0,8,4,4,1.0,0.0,1.0
9607480,1,1,0,0,1,0,0,135,0.0,0.0,0.0,0.0,0.0,0.0,0.0,7,1,6,6.0,0.0,6.0
9606371,7,6,1,1,2,5,10,169,2.0,2.0,0.0,0.0,0.0,2.0,2.0,12,7,5,2.0,1.0,1.0
9903208,1,1,0,0,1,0,0,268,1.0,1.0,0.0,0.0,1.0,0.0,0.0,1,1,0,,,
108125,2,2,0,0,0,2,4,22,1.0,1.0,0.0,0.0,0.0,1.0,2.0,27,2,25,6.0,0.0,6.0
9908479,1,1,0,0,0,1,2,27,0.0,0.0,0.0,0.0,0.0,0.0,0.0,6,1,5,2.0,1.0,1.0
12309,2,2,0,0,0,2,7,12,1.0,1.0,0.0,0.0,0.0,1.0,4.0,15,2,13,2.0,0.0,2.0
210428,3,1,2,2,0,3,31,0,2.0,1.0,1.0,1.0,0.0,2.0,20.0,30,3,27,11.0,2.0,9.0
9809376,19,6,13,75,1,18,59,0,14.0,4.0,10.0,60.0,0.0,14.0,39.0,27,19,8,18.0,14.0,4.0
205244,8,4,4,13,0,8,69,32,7.0,3.0,4.0,10.0,0.0,7.0,59.0,25,8,17,3.0,0.0,3.0
105296,6,4,2,2,1,5,9,53,3.0,2.0,1.0,1.0,0.0,3.0,3.0,19,6,13,5.0,3.0,2.0
9912376,13,3,10,20,0,13,44,27,7.0,1.0,6.0,11.0,0.0,7.0,18.0,23,13,10,10.0,7.0,3.0
9312283,2,2,0,0,2,0,0,223,1.0,1.0,0.0,0.0,1.0,0.0,0.0,2,2,0,1.0,1.0,0.0
9403218,7,4,3,3,7,0,0,289,5.0,4.0,1.0,1.0,5.0,0.0,0.0,7,7,0,2.0,2.0,0.0
9809248,5,4,1,1,3,2,2,66,1.0,1.0,0.0,0.0,1.0,0.0,0.0,9,5,4,2.0,2.0,0.0
9205217,2,2,0,0,2,0,0,655,1.0,1.0,0.0,0.0,1.0,0.0,0.0,2,2,0,1.0,1.0,0.0
9911485,5,4,1,1,0,5,8,104,2.0,2.0,0.0,0.0,2.0,0.0,0.0,7,5,2,3.0,2.0,1.0
9701296,15,6,9,17,3,12,26,113,10.0,2.0,8.0,14.0,1.0,9.0,19.0,20,15,5,10.0,8.0,2.0
5011,4,4,0,0,1,3,5,0,0.0,0.0,0.0,0.0,0.0,0.0,0.0,39,4,35,1.0,0.0,1.0
9711442,18,10,8,14,0,18,58,115,11.0,7.0,4.0,8.0,0.0,11.0,42.0,24,18,6,7.0,4.0,3.0
111295,3,3,0,0,1,2,27,18,1.0,1.0,0.0,0.0,0.0,1.0,4.0,34,3,31,1.0,0.0,1.0
9805212,8,4,4,5,1,7,16,1,3.0,2.0,1.0,1.0,3.0,0.0,0.0,16,8,8,2.0,2.0,0.0
9501366,4,2,2,2,0,4,18,40,4.0,2.0,2.0,2.0,0.0,4.0,18.0,13,4,9,2.0,1.0,1.0
211231,2,2,0,0,2,0,0,28,,,,,,,,4,2,2,1.0,1.0,0.0
9710488,2,2,0,0,0,2,13,17,1.0,1.0,0.0,0.0,0.0,1.0,10.0,25,2,23,1.0,1.0,0.0
9605346,5,2,3,5,5,0,0,137,1.0,1.0,0.0,0.0,1.0,0.0,0.0,5,5,0,2.0,2.0,0.0
7356,4,3,1,1,3,1,1,429,3.0,3.0,0.0,0.0,2.0,1.0,1.0,7,4,3,5.0,2.0,3.0
9305244,1,1,0,0,1,0,0,847,,,,,,,,1,1,0,,,
207288,7,5,2,3,0,7,56,32,2.0,2.0,0.0,0.0,0.0,2.0,21.0,36,7,29,6.0,2.0,4.0
9310325,4,4,0,0,4,0,0,138,2.0,2.0,0.0,0.0,2.0,0.0,0.0,4,4,0,2.0,2.0,0.0
9706283,4,4,0,0,0,4,5,297,3.0,3.0,0.0,0.0,0.0,3.0,3.0,7,4,3,3.0,2.0,1.0
9805456,1,1,0,0,1,0,0,49,,,,,,,,3,1,2,1.0,1.0,0.0
9408379,4,3,1,1,1,3,5,62,1.0,1.0,0.0,0.0,1.0,0.0,0.0,7,4,3,1.0,1.0,0.0
9047,1,1,0,0,0,1,2,33,0.0,0.0,0.0,0.0,0.0,0.0,0.0,10,1,9,3.0,1.0,2.0
9510362,2,2,0,0,1,1,1,14,0.0,0.0,0.0,0.0,0.0,0.0,0.0,18,2,16,2.0,0.0,2.0
6120,1,1,0,0,0,1,5,34,1.0,1.0,0.0,0.0,0.0,1.0,5.0,16,1,15,1.0,0.0,1.0
9510338,7,4,3,3,7,0,0,100,2.0,1.0,1.0,1.0,2.0,0.0,0.0,7,7,0,3.0,3.0,0.0
6073,3,2,1,1,0,3,17,65,3.0,2.0,1.0,1.0,0.0,3.0,11.0,17,3,14,5.0,1.0,4.0
9909355,6,1,5,11,0,6,14,0,6.0,1.0,5.0,11.0,1.0,5.0,13.0,22,6,16,8.0,4.0,4.0
9910305,5,2,3,6,4,1,1,228,5.0,2.0,3.0,6.0,5.0,0.0,0.0,8,5,3,3.0,3.0,0.0
9306336,1,1,0,0,1,0,0,223,1.0,1.0,0.0,0.0,1.0,0.0,0.0,1,1,0,,,
9409462,1,1,0,0,1,0,0,8,,,,,,,,5,1,4,,,
103131,3,3,0,0,3,0,0,217,0.0,0.0,0.0,0.0,0.0,0.0,0.0,14,3,11,6.0,0.0,6.0
9608335,0,0,0,0,0,0,0,156,0.0,0.0,0.0,0.0,0.0,0.0,0.0,3,0,3,3.0,0.0,3.0
102127,3,3,0,0,3,0,0,216,,,,,,,,4,3,1,1.0,0.0,1.0
9801354,0,0,0,0,0,0,0,222,0.0,0.0,0.0,0.0,0.0,0.0,0.0,7,0,7,5.0,0.0,5.0
9910560,10,3,7,8,0,10,14,103,8.0,2.0,6.0,7.0,0.0,8.0,12.0,13,10,3,7.0,4.0,3.0
9403352,3,2,1,2,2,1,2,206,2.0,1.0,1.0,1.0,1.0,1.0,2.0,5,3,2,4.0,2.0,2.0
9504348,0,0,0,0,0,0,0,86,,,,,,,,2,0,2,,,
9305341,4,2,2,2,4,0,0,1983,2.0,1.0,1.0,1.0,2.0,0.0,0.0,5,4,1,2.0,2.0,0.0
9305288,1,1,0,0,1,0,0,1469,,,,,,,,1,1,0,,,
9810332,5,4,1,1,1,4,18,64,4.0,3.0,1.0,1.0,0.0,4.0,16.0,14,5,9,11.0,3.0,8.0
9512232,6,6,0,0,1,5,22,25,3.0,3.0,0.0,0.0,0.0,3.0,14.0,37,6,31,1.0,1.0,0.0
11364,14,4,10,19,0,14,93,92,4.0,2.0,2.0,3.0,0.0,4.0,20.0,44,14,30,12.0,6.0,6.0
201177,2,2,0,0,1,1,1,95,1.0,1.0,0.0,0.0,0.0,1.0,1.0,6,2,4,5.0,1.0,4.0
9808366,4,2,2,2,1,3,10,125,3.0,1.0,2.0,2.0,0.0,3.0,9.0,16,4,12,8.0,3.0,5.0
204279,4,2,2,5,1,3,22,49,4.0,2.0,2.0,5.0,1.0,3.0,17.0,23,4,19,7.0,1.0,6.0
105298,2,1,1,1,1,1,1,0,0.0,0.0,0.0,0.0,0.0,0.0,0.0,22,2,20,2.0,0.0,2.0
9806314,4,3,1,1,3,1,1,14,1.0,1.0,0.0,0.0,1.0,0.0,0.0,17,4,13,1.0,1.0,0.0
9711312,3,1,2,3,3,0,0,64,0.0,0.0,0.0,0.0,0.0,0.0,0.0,6,3,3,1.0,1.0,0.0
5042,3,1,2,3,0,3,10,13,3.0,1.0,2.0,3.0,0.0,3.0,10.0,7,3,4,,,
5041,3,3,0,0,0,3,4,18,1.0,1.0,0.0,0.0,1.0,0.0,0.0,8,3,5,2.0,1.0,1.0
9410220,2,1,1,1,2,0,0,173,0.0,0.0,0.0,0.0,0.0,0.0,0.0,4,2,2,2.0,2.0,0.0
9709210,3,3,0,0,1,2,3,88,1.0,1.0,0.0,0.0,0.0,1.0,2.0,7,3,4,3.0,1.0,2.0
9211261,9,4,5,10,9,0,0,90,3.0,1.0,2.0,3.0,3.0,0.0,0.0,9,9,0,3.0,3.0,0.0
9610552,3,2,1,1,3,0,0,443,0.0,0.0,0.0,0.0,0.0,0.0,0.0,6,3,3,2.0,1.0,1.0
9709258,1,1,0,0,1,0,0,141,0.0,0.0,0.0,0.0,0.0,0.0,0.0,3,1,2,,,
205185,2,2,0,0,0,2,17,37,1.0,1.0,0.0,0.0,0.0,1.0,7.0,20,2,18,9.0,2.0,7.0
109285,1,1,0,0,0,1,3,52,1.0,1.0,0.0,0.0,0.0,1.0,2.0,7,1,6,5.0,1.0,4.0
9908240,5,2,3,3,0,5,32,5,4.0,2.0,2.0,2.0,0.0,4.0,21.0,27,5,22,3.0,1.0,2.0
9904284,7,4,3,5,1,6,23,42,1.0,1.0,0.0,0.0,0.0,1.0,8.0,18,7,11,11.0,1.0,10.0
9410355,3,3,0,0,3,0,0,236,2.0,2.0,0.0,0.0,2.0,0.0,0.0,3,3,0,1.0,1.0,0.0
9805487,1,1,0,0,0,1,7,78,1.0,1.0,0.0,0.0,0.0,1.0,6.0,13,1,12,7.0,1.0,6.0
9702278,7,5,2,2,0,7,13,58,6.0,4.0,2.0,2.0,0.0,6.0,12.0,10,7,3,7.0,5.0,2.0
9507266,1,1,0,0,0,1,2,99,1.0,1.0,0.0,0.0,0.0,1.0,2.0,8,1,7,1.0,1.0,0.0
105142,6,2,4,10,0,6,31,52,5.0,1.0,4.0,10.0,0.0,5.0,29.0,13,6,7,12.0,5.0,7.0
103101,5,4,1,1,4,1,3,285,5.0,4.0,1.0,1.0,4.0,1.0,3.0,10,5,5,4.0,1.0,3.0
9808281,4,2,2,3,0,4,12,288,2.0,1.0,1.0,1.0,1.0,1.0,3.0,32,4,28,6.0,1.0,5.0
9805295,7,5,2,3,2,5,29,27,1.0,1.0,0.0,0.0,0.0,1.0,3.0,20,7,13,8.0,1.0,7.0
9712440,4,3,1,1,0,4,22,6,2.0,1.0,1.0,1.0,0.0,2.0,12.0,13,4,9,9.0,2.0,7.0
6322,2,1,1,1,1,1,4,6,0.0,0.0,0.0,0.0,0.0,0.0,0.0,29,2,27,3.0,0.0,3.0
2176,1,1,0,0,1,0,0,71,0.0,0.0,0.0,0.0,0.0,0.0,0.0,7,1,6,3.0,0.0,3.0
109182,2,2,0,0,0,2,5,95,2.0,2.0,0.0,0.0,0.0,2.0,4.0,6,2,4,4.0,2.0,2.0
9609414,2,2,0,0,0,2,4,439,1.0,1.0,0.0,0.0,0.0,1.0,2.0,7,2,5,3.0,1.0,2.0
205030,3,2,1,1,0,3,19,34,0.0,0.0,0.0,0.0,0.0,0.0,0.0,56,3,53,11.0,0.0,11.0
9406388,0,0,0,0,0,0,0,329,0.0,0.0,0.0,0.0,0.0,0.0,0.0,4,0,4,2.0,0.0,2.0
9410256,8,4,4,5,6,2,2,199,5.0,3.0,2.0,3.0,5.0,0.0,0.0,9,8,1,4.0,4.0,0.0
107029,5,4,1,1,4,1,1,226,2.0,1.0,1.0,1.0,2.0,0.0,0.0,6,5,1,2.0,2.0,0.0
210069,0,0,0,0,0,0,0,126,0.0,0.0,0.0,0.0,0.0,0.0,0.0,4,0,4,4.0,0.0,4.0
10134,4,2,2,2,1,3,5,126,3.0,1.0,2.0,2.0,1.0,2.0,2.0,9,4,5,6.0,3.0,3.0
9509291,2,2,0,0,1,1,4,320,1.0,1.0,0.0,0.0,0.0,1.0,3.0,6,2,4,3.0,1.0,2.0
206010,3,2,1,1,0,3,9,28,1.0,1.0,0.0,0.0,0.0,1.0,1.0,7,3,4,5.0,2.0,3.0
9905540,3,3,0,0,0,3,8,125,1.0,1.0,0.0,0.0,0.0,1.0,5.0,10,3,7,6.0,1.0,5.0
103115,1,1,0,0,0,1,4,2,1.0,1.0,0.0,0.0,0.0,1.0,3.0,11,1,10,6.0,0.0,6.0
9803331,2,2,0,0,1,1,4,58,1.0,1.0,0.0,0.0,0.0,1.0,4.0,6,2,4,5.0,1.0,4.0
9405300,6,4,2,3,6,0,0,90,4.0,2.0,2.0,3.0,4.0,0.0,0.0,6,6,0,2.0,2.0,0.0
9812323,0,0,0,0,0,0,0,25,0.0,0.0,0.0,0.0,0.0,0.0,0.0,4,0,4,,,
3110,3,2,1,1,0,3,12,0,0.0,0.0,0.0,0.0,0.0,0.0,0.0,8,3,5,6.0,1.0,5.0
9802247,3,3,0,0,1,2,5,213,2.0,2.0,0.0,0.0,0.0,2.0,4.0,10,3,7,6.0,1.0,5.0
9510247,1,1,0,0,0,1,3,16,1.0,1.0,0.0,0.0,0.0,1.0,1.0,7,1,6,3.0,1.0,2.0
9185,3,2,1,2,0,3,8,180,3.0,2.0,1.0,2.0,0.0,3.0,4.0,8,3,5,6.0,3.0,3.0
9702346,0,0,0,0,0,0,0,382,0.0,0.0,0.0,0.0,0.0,0.0,0.0,2,0,2,2.0,0.0,2.0
9904505,26,6,20,82,2,24,136,16,22.0,3.0,19.0,81.0,1.0,21.0,127.0,44,26,18,13.0,10.0,3.0
210048,1,1,0,0,0,1,13,46,1.0,1.0,0.0,0.0,0.0,1.0,11.0,42,1,41,3.0,0.0,3.0
10246,6,1,5,7,1,5,12,64,3.0,1.0,2.0,3.0,0.0,3.0,9.0,12,6,6,6.0,3.0,3.0
9601257,3,3,0,0,0,3,10,78,1.0,1.0,0.0,0.0,0.0,1.0,3.0,19,3,16,4.0,1.0,3.0
1047,2,2,0,0,2,0,0,138,0.0,0.0,0.0,0.0,0.0,0.0,0.0,3,2,1,1.0,0.0,1.0
301240,0,0,0,0,0,0,0,193,0.0,0.0,0.0,0.0,0.0,0.0,0.0,10,0,10,9.0,0.0,9.0
105130,0,0,0,0,0,0,0,934,0.0,0.0,0.0,0.0,0.0,0.0,0.0,3,0,3,,,
9904435,2,1,1,1,0,2,5,168,0.0,0.0,0.0,0.0,0.0,0.0,0.0,12,2,10,4.0,0.0,4.0
9607452,12,2,10,20,0,12,33,113,11.0,1.0,10.0,20.0,0.0,11.0,30.0,17,12,5,15.0,11.0,4.0
8006,5,1,4,6,0,5,64,16,5.0,1.0,4.0,6.0,0.0,5.0,64.0,26,5,21,11.0,5.0,6.0
208101,3,3,0,0,0,3,36,7,2.0,2.0,0.0,0.0,0.0,2.0,25.0,29,3,26,18.0,2.0,16.0
105347,3,3,0,0,0,3,20,28,3.0,3.0,0.0,0.0,0.0,3.0,20.0,11,3,8,1.0,0.0,1.0
7349,7,7,0,0,2,5,21,89,0.0,0.0,0.0,0.0,0.0,0.0,0.0,20,7,13,9.0,1.0,8.0
9705303,1,1,0,0,0,1,4,36,,,,,,,,5,1,4,,,
9401296,1,1,0,0,0,1,1,98,1.0,1.0,0.0,0.0,0.0,1.0,1.0,3,1,2,2.0,1.0,1.0
9701356,1,1,0,0,0,1,4,115,0.0,0.0,0.0,0.0,0.0,0.0,0.0,5,1,4,4.0,0.0,4.0
112274,13,5,8,14,0,13,90,9,8.0,3.0,5.0,10.0,0.0,8.0,24.0,37,13,24,8.0,4.0,4.0
101053,8,6,2,3,2,6,14,79,2.0,2.0,0.0,0.0,0.0,2.0,3.0,16,8,8,5.0,3.0,2.0
9912209,1,1,0,0,1,0,0,763,0.0,0.0,0.0,0.0,0.0,0.0,0.0,2,1,1,1.0,0.0,1.0
9912362,3,2,1,1,3,0,0,62,0.0,0.0,0.0,0.0,0.0,0.0,0.0,15,3,12,2.0,2.0,0.0
9511245,1,1,0,0,1,0,0,1125,,,,,,,,1,1,0,,,
108129,1,1,0,0,0,1,3,21,1.0,1.0,0.0,0.0,0.0,1.0,2.0,6,1,5,,,
111075,7,3,4,6,2,5,18,172,5.0,2.0,3.0,5.0,0.0,5.0,16.0,13,7,6,9.0,4.0,5.0
6071,6,3,3,5,3,3,11,112,5.0,2.0,3.0,5.0,3.0,2.0,7.0,14,6,8,7.0,3.0,4.0
205076,4,3,1,1,0,4,65,7,2.0,2.0,0.0,0.0,0.0,2.0,8.0,36,4,32,12.0,2.0,10.0
9312352,1,1,0,0,1,0,0,453,1.0,1.0,0.0,0.0,1.0,0.0,0.0,4,1,3,,,
9610385,6,6,0,0,0,6,21,6,1.0,1.0,0.0,0.0,0.0,1.0,11.0,59,6,53,36.0,0.0,36.0
9211213,2,2,0,0,2,0,0,295,2.0,2.0,0.0,0.0,2.0,0.0,0.0,2,2,0,2.0,2.0,0.0
9809358,4,4,0,0,1,3,12,41,1.0,1.0,0.0,0.0,0.0,1.0,4.0,16,4,12,6.0,1.0,5.0
9904371,2,2,0,0,0,2,7,42,0.0,0.0,0.0,0.0,0.0,0.0,0.0,12,2,10,4.0,0.0,4.0
2068,0,0,0,0,0,0,0,519,0.0,0.0,0.0,0.0,0.0,0.0,0.0,1,0,1,1.0,0.0,1.0
9901262,2,1,1,1,2,0,0,831,,,,,,,,2,2,0,,,
202188,0,0,0,0,0,0,0,32,0.0,0.0,0.0,0.0,0.0,0.0,0.0,29,0,29,6.0,0.0,6.0
112267,4,4,0,0,2,2,5,126,0.0,0.0,0.0,0.0,0.0,0.0,0.0,14,4,10,2.0,0.0,2.0
6080,5,5,0,0,0,5,10,11,,,,,,,,7,5,2,,,
9503348,1,1,0,0,0,1,2,363,1.0,1.0,0.0,0.0,0.0,1.0,1.0,11,1,10,5.0,1.0,4.0
6115,3,3,0,0,0,3,7,21,2.0,2.0,0.0,0.0,0.0,2.0,3.0,9,3,6,1.0,1.0,0.0
9509385,1,1,0,0,1,0,0,4,,,,,,,,9,1,8,1.0,0.0,1.0
212165,0,0,0,0,0,0,0,1425,,,,,,,,3,0,3,1.0,0.0,1.0
9906330,3,3,0,0,0,3,5,32,2.0,2.0,0.0,0.0,1.0,1.0,1.0,16,3,13,2.0,1.0,1.0
207032,0,0,0,0,0,0,0,151,0.0,0.0,0.0,0.0,0.0,0.0,0.0,5,0,5,2.0,0.0,2.0
8013,2,2,0,0,1,1,1,3,1.0,1.0,0.0,0.0,1.0,0.0,0.0,19,2,17,1.0,1.0,0.0
11193,0,0,0,0,0,0,0,38,0.0,0.0,0.0,0.0,0.0,0.0,0.0,2,0,2,,,
9152,2,2,0,0,0,2,2,28,1.0,1.0,0.0,0.0,0.0,1.0,1.0,7,2,5,3.0,1.0,2.0
9904442,5,2,3,4,0,5,10,13,3.0,3.0,0.0,0.0,3.0,0.0,0.0,13,5,8,2.0,2.0,0.0
101200,3,3,0,0,3,0,0,221,2.0,2.0,0.0,0.0,2.0,0.0,0.0,4,3,1,1.0,0.0,1.0
9807566,1,1,0,0,1,0,0,1330,0.0,0.0,0.0,0.0,0.0,0.0,0.0,3,1,2,1.0,0.0,1.0
9810363,10,2,8,17,10,0,0,262,7.0,1.0,6.0,14.0,7.0,0.0,0.0,10,10,0,7.0,7.0,0.0
9702407,3,2,1,1,1,2,4,171,1.0,1.0,0.0,0.0,0.0,1.0,3.0,7,3,4,4.0,1.0,3.0
112281,7,5,2,3,0,7,38,1,1.0,1.0,0.0,0.0,0.0,1.0,2.0,45,7,38,5.0,2.0,3.0
9707453,5,2,3,5,5,0,0,61,0.0,0.0,0.0,0.0,0.0,0.0,0.0,16,5,11,2.0,2.0,0.0
106180,3,3,0,0,0,3,11,105,3.0,3.0,0.0,0.0,0.0,3.0,10.0,26,3,23,9.0,1.0,8.0
211371,1,1,0,0,0,1,3,4,0.0,0.0,0.0,0.0,0.0,0.0,0.0,12,1,11,3.0,1.0,2.0
10129,1,1,0,0,1,0,0,147,1.0,1.0,0.0,0.0,1.0,0.0,0.0,7,1,6,2.0,0.0,2.0
9004,4,2,2,3,0,4,8,14,3.0,1.0,2.0,3.0,3.0,0.0,0.0,10,4,6,3.0,3.0,0.0
9905361,3,1,2,3,3,0,0,297,3.0,1.0,2.0,3.0,3.0,0.0,0.0,8,3,5,3.0,3.0,0.0
9510391,1,1,0,0,1,0,0,332,0.0,0.0,0.0,0.0,0.0,0.0,0.0,3,1,2,1.0,1.0,0.0
9608295,2,2,0,0,1,1,1,139,1.0,1.0,0.0,0.0,0.0,1.0,1.0,6,2,4,3.0,0.0,3.0
9808349,4,2,2,3,0,4,17,22,4.0,2.0,2.0,3.0,0.0,4.0,15.0,15,4,11,6.0,1.0,5.0
9509271,11,5,6,8,11,0,0,191,7.0,2.0,5.0,7.0,7.0,0.0,0.0,13,11,2,6.0,6.0,0.0
108230,2,2,0,0,2,0,0,63,0.0,0.0,0.0,0.0,0.0,0.0,0.0,9,2,7,2.0,0.0,2.0
9806431,9,6,3,4,0,9,20,54,2.0,1.0,1.0,1.0,0.0,2.0,5.0,17,9,8,5.0,2.0,3.0
11065,1,1,0,0,1,0,0,32,0.0,0.0,0.0,0.0,0.0,0.0,0.0,15,1,14,8.0,0.0,8.0
111067,4,4,0,0,0,4,14,8,3.0,3.0,0.0,0.0,0.0,3.0,10.0,12,4,8,8.0,3.0,5.0
210039,0,0,0,0,0,0,0,17,0.0,0.0,0.0,0.0,0.0,0.0,0.0,14,0,14,5.0,0.0,5.0
211419,0,0,0,0,0,0,0,2,0.0,0.0,0.0,0.0,0.0,0.0,0.0,10,0,10,,,
9406269,2,2,0,0,2,0,0,368,1.0,1.0,0.0,0.0,1.0,0.0,0.0,2,2,0,1.0,1.0,0.0
9703333,2,2,0,0,2,0,0,785,0.0,0.0,0.0,0.0,0.0,0.0,0.0,5,2,3,1.0,0.0,1.0
105304,13,3,10,29,1,12,89,25,6.0,1.0,5.0,14.0,0.0,6.0,36.0,55,13,42,17.0,6.0,11.0
9806453,9,2,7,18,0,9,73,90,7.0,1.0,6.0,16.0,0.0,7.0,41.0,28,9,19,13.0,7.0,6.0
112130,0,0,0,0,0,0,0,4,0.0,0.0,0.0,0.0,0.0,0.0,0.0,49,0,49,5.0,0.0,5.0
9807433,1,1,0,0,0,1,1,84,1.0,1.0,0.0,0.0,0.0,1.0,1.0,6,1,5,1.0,0.0,1.0
9601250,0,0,0,0,0,0,0,114,,,,,,,,3,0,3,,,
301057,2,1,1,1,0,2,20,38,2.0,1.0,1.0,1.0,0.0,2.0,20.0,18,2,16,14.0,2.0,12.0
2181,4,3,1,1,0,4,14,15,2.0,1.0,1.0,1.0,0.0,2.0,4.0,13,4,9,6.0,3.0,3.0
302170,0,0,0,0,0,0,0,77,0.0,0.0,0.0,0.0,0.0,0.0,0.0,19,0,19,10.0,0.0,10.0
109274,3,1,2,2,0,3,6,53,2.0,1.0,1.0,1.0,0.0,2.0,5.0,8,3,5,2.0,2.0,0.0
9210207,1,1,0,0,1,0,0,858,1.0,1.0,0.0,0.0,1.0,0.0,0.0,1,1,0,1.0,1.0,0.0
102334,5,4,1,1,2,3,15,113,0.0,0.0,0.0,0.0,0.0,0.0,0.0,25,5,20,10.0,0.0,10.0
109248,3,2,1,1,0,3,46,7,0.0,0.0,0.0,0.0,0.0,0.0,0.0,34,3,31,9.0,0.0,9.0
9906249,3,3,0,0,0,3,7,31,0.0,0.0,0.0,0.0,0.0,0.0,0.0,14,3,11,,,
206172,9,6,3,3,0,9,18,106,4.0,3.0,1.0,1.0,0.0,4.0,10.0,18,9,9,8.0,3.0,5.0
9703380,3,1,2,2,1,2,2,225,3.0,1.0,2.0,2.0,2.0,1.0,1.0,6,3,3,3.0,2.0,1.0
103298,1,1,0,0,0,1,3,120,0.0,0.0,0.0,0.0,0.0,0.0,0.0,8,1,7,7.0,0.0,7.0
9606284,5,5,0,0,3,2,3,51,2.0,2.0,0.0,0.0,2.0,0.0,0.0,10,5,5,4.0,1.0,3.0
9907285,1,1,0,0,0,1,7,11,,,,,,,,8,1,7,,,
9708368,2,1,1,1,1,1,10,529,1.0,1.0,0.0,0.0,0.0,1.0,1.0,12,2,10,3.0,1.0,2.0
9810355,3,3,0,0,3,0,0,353,1.0,1.0,0.0,0.0,1.0,0.0,0.0,5,3,2,2.0,1.0,1.0
9709263,0,0,0,0,0,0,0,70,0.0,0.0,0.0,0.0,0.0,0.0,0.0,8,0,8,,,
9710250,3,3,0,0,3,0,0,262,1.0,1.0,0.0,0.0,1.0,0.0,0.0,3,3,0,2.0,2.0,0.0
10072,2,1,1,1,0,2,11,8,0.0,0.0,0.0,0.0,0.0,0.0,0.0,13,2,11,8.0,0.0,8.0
104061,1,1,0,0,1,0,0,189,0.0,0.0,0.0,0.0,0.0,0.0,0.0,4,1,3,2.0,0.0,2.0
9811388,2,2,0,0,0,2,5,35,1.0,1.0,0.0,0.0,1.0,0.0,0.0,9,2,7,3.0,1.0,2.0
9412290,0,0,0,0,0,0,0,18,,,,,,,,5,0,5,,,
8077,0,0,0,0,0,0,0,221,0.0,0.0,0.0,0.0,0.0,0.0,0.0,3,0,3,1.0,0.0,1.0
302006,0,0,0,0,0,0,0,27,0.0,0.0,0.0,0.0,0.0,0.0,0.0,21,0,21,9.0,0.0,9.0
204313,0,0,0,0,0,0,0,239,0.0,0.0,0.0,0.0,0.0,0.0,0.0,1,0,1,1.0,0.0,1.0
8254,0,0,0,0,0,0,0,64,0.0,0.0,0.0,0.0,0.0,0.0,0.0,8,0,8,1.0,0.0,1.0
8325,0,0,0,0,0,0,0,68,0.0,0.0,0.0,0.0,0.0,0.0,0.0,29,0,29,14.0,0.0,14.0
9603355,2,2,0,0,1,1,2,85,0.0,0.0,0.0,0.0,0.0,0.0,0.0,7,2,5,1.0,0.0,1.0
9506230,1,1,0,0,1,0,0,440,0.0,0.0,0.0,0.0,0.0,0.0,0.0,7,1,6,3.0,0.0,3.0
110323,4,1,3,5,0,4,8,10,4.0,1.0,3.0,5.0,0.0,4.0,8.0,8,4,4,2.0,0.0,2.0
9504396,3,1,2,3,3,0,0,254,3.0,1.0,2.0,3.0,3.0,0.0,0.0,3,3,0,2.0,2.0,0.0
301206,1,1,0,0,1,0,0,178,0.0,0.0,0.0,0.0,0.0,0.0,0.0,8,1,7,1.0,0.0,1.0
102275,4,4,0,0,0,4,15,76,2.0,2.0,0.0,0.0,0.0,2.0,6.0,19,4,15,7.0,1.0,6.0
9708298,1,1,0,0,1,0,0,159,0.0,0.0,0.0,0.0,0.0,0.0,0.0,4,1,3,2.0,0.0,2.0
207214,1,1,0,0,0,1,5,80,0.0,0.0,0.0,0.0,0.0,0.0,0.0,12,1,11,,,
9911466,2,2,0,0,0,2,2,120,0.0,0.0,0.0,0.0,0.0,0.0,0.0,11,2,9,2.0,0.0,2.0
9037,10,6,4,9,3,7,27,14,2.0,1.0,1.0,1.0,0.0,2.0,8.0,24,10,14,4.0,2.0,2.0
212298,2,2,0,0,0,2,12,38,1.0,1.0,0.0,0.0,0.0,1.0,4.0,17,2,15,7.0,1.0,6.0
211256,1,1,0,0,0,1,2,166,0.0,0.0,0.0,0.0,0.0,0.0,0.0,11,1,10,6.0,0.0,6.0
9404221,3,3,0,0,3,0,0,175,2.0,2.0,0.0,0.0,2.0,0.0,0.0,3,3,0,2.0,2.0,0.0
7130,2,2,0,0,2,0,0,732,1.0,1.0,0.0,0.0,1.0,0.0,0.0,3,2,1,1.0,1.0,0.0
4140,3,3,0,0,0,3,16,8,2.0,2.0,0.0,0.0,0.0,2.0,7.0,15,3,12,7.0,1.0,6.0
9503355,3,2,1,1,0,3,8,96,2.0,1.0,1.0,1.0,0.0,2.0,7.0,9,3,6,7.0,2.0,5.0
206218,1,1,0,0,0,1,2,11,0.0,0.0,0.0,0.0,0.0,0.0,0.0,9,1,8,,,
201229,6,3,3,6,0,6,30,62,5.0,2.0,3.0,6.0,0.0,5.0,29.0,21,6,15,12.0,5.0,7.0
7076,5,3,2,3,3,2,4,0,3.0,1.0,2.0,3.0,3.0,0.0,0.0,15,5,10,3.0,3.0,0.0
11162,1,1,0,0,1,0,0,70,0.0,0.0,0.0,0.0,0.0,0.0,0.0,18,1,17,17.0,0.0,17.0
9907315,1,1,0,0,0,1,2,17,,,,,,,,11,1,10,1.0,0.0,1.0
9807279,5,2,3,6,0,5,17,30,4.0,2.0,2.0,3.0,1.0,3.0,8.0,10,5,5,9.0,5.0,4.0
9808212,0,0,0,0,0,0,0,313,0.0,0.0,0.0,0.0,0.0,0.0,0.0,2,0,2,,,
111139,2,2,0,0,0,2,9,76,1.0,1.0,0.0,0.0,0.0,1.0,4.0,9,2,7,4.0,1.0,3.0
9607313,2,2,0,0,1,1,1,348,1.0,1.0,0.0,0.0,0.0,1.0,1.0,3,2,1,1.0,0.0,1.0
9107,2,2,0,0,0,2,41,24,1.0,1.0,0.0,0.0,0.0,1.0,23.0,54,2,52,22.0,1.0,21.0
9810221,5,1,4,6,0,5,11,227,4.0,1.0,3.0,4.0,0.0,4.0,9.0,8,5,3,8.0,5.0,3.0
9908272,2,1,1,1,2,0,0,437,0.0,0.0,0.0,0.0,0.0,0.0,0.0,5,2,3,3.0,0.0,3.0
204158,1,1,0,0,0,1,2,52,0.0,0.0,0.0,0.0,0.0,0.0,0.0,10,1,9,1.0,1.0,0.0
7230,1,1,0,0,0,1,7,5,0.0,0.0,0.0,0.0,0.0,0.0,0.0,33,1,32,4.0,1.0,3.0
106279,1,1,0,0,0,1,20,26,1.0,1.0,0.0,0.0,0.0,1.0,18.0,21,1,20,15.0,1.0,14.0
9307372,2,2,0,0,2,0,0,487,2.0,2.0,0.0,0.0,2.0,0.0,0.0,2,2,0,1.0,1.0,0.0
5174,2,1,1,1,0,2,10,294,2.0,1.0,1.0,1.0,0.0,2.0,10.0,8,2,6,7.0,2.0,5.0
6325,2,2,0,0,1,1,1,118,0.0,0.0,0.0,0.0,0.0,0.0,0.0,7,2,5,4.0,0.0,4.0
9610392,1,1,0,0,0,1,2,97,1.0,1.0,0.0,0.0,0.0,1.0,2.0,4,1,3,1.0,1.0,0.0
9704368,2,2,0,0,1,1,1,454,2.0,2.0,0.0,0.0,1.0,1.0,1.0,6,2,4,1.0,1.0,0.0
209232,0,0,0,0,0,0,0,1244,,,,,,,,4,0,4,,,
9305231,1,1,0,0,1,0,0,304,1.0,1.0,0.0,0.0,1.0,0.0,0.0,1,1,0,1.0,1.0,0.0
207118,1,1,0,0,0,1,2,9,1.0,1.0,0.0,0.0,0.0,1.0,1.0,27,1,26,11.0,0.0,11.0
9405282,0,0,0,0,0,0,0,543,0.0,0.0,0.0,0.0,0.0,0.0,0.0,6,0,6,2.0,0.0,2.0
210267,0,0,0,0,0,0,0,28,0.0,0.0,0.0,0.0,0.0,0.0,0.0,12,0,12,1.0,0.0,1.0
9903378,1,1,0,0,0,1,1,1700,,,,,,,,2,1,1,,,
211213,2,2,0,0,0,2,29,18,2.0,2.0,0.0,0.0,0.0,2.0,21.0,43,2,41,21.0,1.0,20.0
9807538,2,2,0,0,0,2,22,44,2.0,2.0,0.0,0.0,0.0,2.0,20.0,13,2,11,10.0,2.0,8.0
102314,0,0,0,0,0,0,0,42,0.0,0.0,0.0,0.0,0.0,0.0,0.0,21,0,21,2.0,0.0,2.0
211154,1,1,0,0,0,1,3,1,0.0,0.0,0.0,0.0,0.0,0.0,0.0,51,1,50,14.0,0.0,14.0
106262,2,2,0,0,1,1,4,178,1.0,1.0,0.0,0.0,0.0,1.0,4.0,10,2,8,7.0,1.0,6.0
9901211,1,1,0,0,0,1,2,100,0.0,0.0,0.0,0.0,0.0,0.0,0.0,6,1,5,2.0,0.0,2.0
109029,1,1,0,0,0,1,2,26,0.0,0.0,0.0,0.0,0.0,0.0,0.0,12,1,11,3.0,0.0,3.0
9204235,2,1,1,1,2,0,0,96,2.0,1.0,1.0,1.0,2.0,0.0,0.0,2,2,0,2.0,2.0,0.0
210333,0,0,0,0,0,0,0,390,0.0,0.0,0.0,0.0,0.0,0.0,0.0,7,0,7,7.0,0.0,7.0
9511427,1,1,0,0,1,0,0,230,0.0,0.0,0.0,0.0,0.0,0.0,0.0,3,1,2,1.0,0.0,1.0
204128,4,2,2,4,0,4,43,71,4.0,2.0,2.0,4.0,0.0,4.0,28.0,25,4,21,13.0,2.0,11.0
212209,0,0,0,0,0,0,0,102,0.0,0.0,0.0,0.0,0.0,0.0,0.0,12,0,12,9.0,0.0,9.0
204319,1,1,0,0,1,0,0,15,0.0,0.0,0.0,0.0,0.0,0.0,0.0,29,1,28,3.0,0.0,3.0
1020,1,1,0,0,1,0,0,425,0.0,0.0,0.0,0.0,0.0,0.0,0.0,6,1,5,1.0,1.0,0.0
9807355,1,1,0,0,0,1,1,14,0.0,0.0,0.0,0.0,0.0,0.0,0.0,22,1,21,4.0,0.0,4.0
202017,1,1,0,0,0,1,1,353,1.0,1.0,0.0,0.0,0.0,1.0,1.0,3,1,2,1.0,1.0,0.0
110013,1,1,0,0,1,0,0,201,0.0,0.0,0.0,0.0,0.0,0.0,0.0,15,1,14,7.0,0.0,7.0
11123,0,0,0,0,0,0,0,305,0.0,0.0,0.0,0.0,0.0,0.0,0.0,5,0,5,,,
302091,0,0,0,0,0,0,0,47,0.0,0.0,0.0,0.0,0.0,0.0,0.0,15,0,15,10.0,0.0,10.0
9711273,1,1,0,0,1,0,0,139,,,,,,,,1,1,0,,,
9905201,1,1,0,0,0,1,1,49,,,,,,,,3,1,2,3.0,1.0,2.0
205221,0,0,0,0,0,0,0,51,0.0,0.0,0.0,0.0,0.0,0.0,0.0,9,0,9,4.0,0.0,4.0
9708433,1,1,0,0,1,0,0,175,0.0,0.0,0.0,0.0,0.0,0.0,0.0,3,1,2,1.0,0.0,1.0
9705203,3,2,1,1,0,3,15,48,3.0,2.0,1.0,1.0,0.0,3.0,8.0,11,3,8,6.0,2.0,4.0
101216,4,3,1,1,0,4,10,205,2.0,1.0,1.0,1.0,2.0,0.0,0.0,9,4,5,1.0,1.0,0.0
12293,0,0,0,0,0,0,0,14,,,,,,,,6,0,6,,,
9504233,5,1,4,9,5,0,0,347,5.0,1.0,4.0,9.0,5.0,0.0,0.0,5,5,0,5.0,5.0,0.0
11041,1,1,0,0,1,0,0,634,1.0,1.0,0.0,0.0,1.0,0.0,0.0,1,1,0,1.0,1.0,0.0
9907299,2,2,0,0,0,2,8,44,2.0,2.0,0.0,0.0,0.0,2.0,7.0,10,2,8,3.0,1.0,2.0
210057,1,1,0,0,1,0,0,1123,1.0,1.0,0.0,0.0,1.0,0.0,0.0,1,1,0,1.0,1.0,0.0
112270,2,2,0,0,0,2,14,2,0.0,0.0,0.0,0.0,0.0,0.0,0.0,17,2,15,2.0,0.0,2.0
9506415,2,2,0,0,2,0,0,379,0.0,0.0,0.0,0.0,0.0,0.0,0.0,3,2,1,1.0,0.0,1.0
9607211,3,1,2,2,3,0,0,266,3.0,1.0,2.0,2.0,3.0,0.0,0.0,4,3,1,3.0,3.0,0.0
106208,4,3,1,1,0,4,32,29,4.0,3.0,1.0,1.0,0.0,4.0,26.0,20,4,16,10.0,3.0,7.0
210407,0,0,0,0,0,0,0,55,,,,,,,,6,0,6,,,
9710440,1,1,0,0,0,1,2,92,0.0,0.0,0.0,0.0,0.0,0.0,0.0,30,1,29,8.0,0.0,8.0
210095,1,1,0,0,0,1,1,42,1.0,1.0,0.0,0.0,1.0,0.0,0.0,3,1,2,1.0,0.0,1.0
9704306,1,1,0,0,0,1,6,87,1.0,1.0,0.0,0.0,0.0,1.0,4.0,16,1,15,3.0,0.0,3.0
9309206,1,1,0,0,0,1,1,237,1.0,1.0,0.0,0.0,0.0,1.0,1.0,2,1,1,2.0,1.0,1.0
9711500,1,1,0,0,0,1,1,266,1.0,1.0,0.0,0.0,0.0,1.0,1.0,3,1,2,2.0,1.0,1.0
11181,0,0,0,0,0,0,0,6,0.0,0.0,0.0,0.0,0.0,0.0,0.0,21,0,21,11.0,0.0,11.0
9510355,0,0,0,0,0,0,0,53,0.0,0.0,0.0,0.0,0.0,0.0,0.0,8,0,8,2.0,0.0,2.0
9704429,3,1,2,3,0,3,3,514,3.0,1.0,2.0,3.0,3.0,0.0,0.0,5,3,2,3.0,3.0,0.0
106260,3,2,1,1,0,3,10,27,3.0,2.0,1.0,1.0,0.0,3.0,3.0,7,3,4,7.0,3.0,4.0
10346,1,1,0,0,1,0,0,84,0.0,0.0,0.0,0.0,0.0,0.0,0.0,5,1,4,,,
9702283,4,3,1,1,3,1,1,91,2.0,1.0,1.0,1.0,2.0,0.0,0.0,6,4,2,2.0,2.0,0.0
7204,0,0,0,0,0,0,0,520,0.0,0.0,0.0,0.0,0.0,0.0,0.0,1,0,1,1.0,0.0,1.0
206017,2,2,0,0,0,2,24,11,1.0,1.0,0.0,0.0,0.0,1.0,9.0,61,2,59,25.0,0.0,25.0
9703205,3,1,2,2,3,0,0,175,3.0,1.0,2.0,2.0,3.0,0.0,0.0,3,3,0,,,
107016,0,0,0,0,0,0,0,84,0.0,0.0,0.0,0.0,0.0,0.0,0.0,7,0,7,2.0,0.0,2.0
9306263,0,0,0,0,0,0,0,515,0.0,0.0,0.0,0.0,0.0,0.0,0.0,1,0,1,1.0,0.0,1.0
105208,1,1,0,0,0,1,4,383,1.0,1.0,0.0,0.0,0.0,1.0,4.0,6,1,5,6.0,1.0,5.0
9509401,2,1,1,1,2,0,0,104,0.0,0.0,0.0,0.0,0.0,0.0,0.0,5,2,3,2.0,2.0,0.0
9311354,1,1,0,0,1,0,0,13,0.0,0.0,0.0,0.0,0.0,0.0,0.0,6,1,5,1.0,0.0,1.0
12074,1,1,0,0,1,0,0,683,1.0,1.0,0.0,0.0,1.0,0.0,0.0,1,1,0,1.0,1.0,0.0
110381,4,3,1,1,1,3,7,81,1.0,1.0,0.0,0.0,0.0,1.0,4.0,17,4,13,3.0,2.0,1.0
9801239,1,1,0,0,0,1,3,267,1.0,1.0,0.0,0.0,0.0,1.0,1.0,7,1,6,3.0,1.0,2.0
9606299,1,1,0,0,0,1,4,6,0.0,0.0,0.0,0.0,0.0,0.0,0.0,23,1,22,2.0,1.0,1.0
109235,0,0,0,0,0,0,0,16,0.0,0.0,0.0,0.0,0.0,0.0,0.0,16,0,16,4.0,0.0,4.0
9706240,2,2,0,0,0,2,2,107,1.0,1.0,0.0,0.0,0.0,1.0,1.0,4,2,2,3.0,1.0,2.0
9902457,1,1,0,0,1,0,0,152,0.0,0.0,0.0,0.0,0.0,0.0,0.0,7,1,6,4.0,0.0,4.0
107021,0,0,0,0,0,0,0,764,0.0,0.0,0.0,0.0,0.0,0.0,0.0,3,0,3,2.0,0.0,2.0
9511246,1,1,0,0,0,1,2,535,0.0,0.0,0.0,0.0,0.0,0.0,0.0,6,1,5,2.0,0.0,2.0
9609407,0,0,0,0,0,0,0,355,0.0,0.0,0.0,0.0,0.0,0.0,0.0,10,0,10,4.0,0.0,4.0
302007,0,0,0,0,0,0,0,9,0.0,0.0,0.0,0.0,0.0,0.0,0.0,47,0,47,21.0,0.0,21.0
201083,3,3,0,0,2,1,1,789,1.0,1.0,0.0,0.0,0.0,1.0,1.0,6,3,3,2.0,1.0,1.0
211342,3,2,1,1,0,3,22,2,3.0,2.0,1.0,1.0,0.0,3.0,22.0,14,3,11,11.0,3.0,8.0
9903442,2,2,0,0,1,1,1,43,0.0,0.0,0.0,0.0,0.0,0.0,0.0,4,2,2,1.0,0.0,1.0
204260,0,0,0,0,0,0,0,179,0.0,0.0,0.0,0.0,0.0,0.0,0.0,7,0,7,1.0,0.0,1.0
9504213,3,2,1,1,3,0,0,173,2.0,1.0,1.0,1.0,2.0,0.0,0.0,6,3,3,2.0,2.0,0.0
9904231,2,2,0,0,0,2,2,541,2.0,2.0,0.0,0.0,2.0,0.0,0.0,4,2,2,2.0,2.0,0.0
207154,0,0,0,0,0,0,0,61,0.0,0.0,0.0,0.0,0.0,0.0,0.0,4,0,4,1.0,0.0,1.0
301032,0,0,0,0,0,0,0,264,0.0,0.0,0.0,0.0,0.0,0.0,0.0,3,0,3,1.0,0.0,1.0
9306258,0,0,0,0,0,0,0,190,0.0,0.0,0.0,0.0,0.0,0.0,0.0,2,0,2,2.0,0.0,2.0
9810401,1,1,0,0,0,1,1,28,1.0,1.0,0.0,0.0,1.0,0.0,0.0,6,1,5,1.0,1.0,0.0
4161,2,1,1,1,2,0,0,1481,1.0,1.0,0.0,0.0,1.0,0.0,0.0,2,2,0,1.0,1.0,0.0
9909270,1,1,0,0,0,1,5,155,1.0,1.0,0.0,0.0,0.0,1.0,4.0,6,1,5,5.0,1.0,4.0
1235,1,1,0,0,0,1,3,34,1.0,1.0,0.0,0.0,0.0,1.0,3.0,12,1,11,1.0,1.0,0.0
106069,2,2,0,0,0,2,9,19,0.0,0.0,0.0,0.0,0.0,0.0,0.0,34,2,32,20.0,0.0,20.0
9607219,0,0,0,0,0,0,0,240,0.0,0.0,0.0,0.0,0.0,0.0,0.0,4,0,4,1.0,0.0,1.0
112111,1,1,0,0,1,0,0,1483,,,,,,,,1,1,0,,,
9810423,0,0,0,0,0,0,0,266,0.0,0.0,0.0,0.0,0.0,0.0,0.0,6,0,6,4.0,0.0,4.0
9611262,1,1,0,0,1,0,0,284,1.0,1.0,0.0,0.0,1.0,0.0,0.0,3,1,2,,,
212069,0,0,0,0,0,0,0,1177,0.0,0.0,0.0,0.0,0.0,0.0,0.0,1,0,1,1.0,0.0,1.0
104248,1,1,0,0,0,1,4,91,0.0,0.0,0.0,0.0,0.0,0.0,0.0,5,1,4,2.0,0.0,2.0
212213,1,1,0,0,0,1,3,219,0.0,0.0,0.0,0.0,0.0,0.0,0.0,16,1,15,7.0,0.0,7.0
9810305,0,0,0,0,0,0,0,15,0.0,0.0,0.0,0.0,0.0,0.0,0.0,13,0,13,1.0,0.0,1.0
206109,1,1,0,0,0,1,7,51,1.0,1.0,0.0,0.0,0.0,1.0,3.0,10,1,9,4.0,1.0,3.0
1155,0,0,0,0,0,0,0,1680,0.0,0.0,0.0,0.0,0.0,0.0,0.0,6,0,6,,,
9712454,1,1,0,0,0,1,4,91,1.0,1.0,0.0,0.0,0.0,1.0,3.0,5,1,4,5.0,1.0,4.0
9807463,2,2,0,0,1,1,2,338,1.0,1.0,0.0,0.0,0.0,1.0,2.0,4,2,2,3.0,1.0,2.0
204124,3,3,0,0,0,3,10,20,2.0,2.0,0.0,0.0,0.0,2.0,6.0,21,3,18,5.0,1.0,4.0
203115,0,0,0,0,0,0,0,115,0.0,0.0,0.0,0.0,0.0,0.0,0.0,6,0,6,2.0,0.0,2.0
206186,1,1,0,0,0,1,5,1,1.0,1.0,0.0,0.0,0.0,1.0,5.0,45,1,44,15.0,0.0,15.0
112229,1,1,0,0,0,1,4,34,0.0,0.0,0.0,0.0,0.0,0.0,0.0,8,1,7,1.0,0.0,1.0
9701405,1,1,0,0,1,0,0,715,1.0,1.0,0.0,0.0,1.0,0.0,0.0,4,1,3,1.0,1.0,0.0
107140,3,2,1,1,0,3,9,1,1.0,1.0,0.0,0.0,0.0,1.0,4.0,20,3,17,3.0,2.0,1.0
203228,0,0,0,0,0,0,0,120,0.0,0.0,0.0,0.0,0.0,0.0,0.0,5,0,5,2.0,0.0,2.0
9803205,0,0,0,0,0,0,0,41,0.0,0.0,0.0,0.0,0.0,0.0,0.0,6,0,6,4.0,0.0,4.0
106234,0,0,0,0,0,0,0,464,0.0,0.0,0.0,0.0,0.0,0.0,0.0,7,0,7,3.0,0.0,3.0
9807273,0,0,0,0,0,0,0,5,0.0,0.0,0.0,0.0,0.0,0.0,0.0,36,0,36,12.0,0.0,12.0
209115,1,1,0,0,1,0,0,864,,,,,,,,1,1,0,,,
109116,0,0,0,0,0,0,0,88,0.0,0.0,0.0,0.0,0.0,0.0,0.0,7,0,7,1.0,0.0,1.0
12042,0,0,0,0,0,0,0,202,0.0,0.0,0.0,0.0,0.0,0.0,0.0,7,0,7,1.0,0.0,1.0
207328,2,2,0,0,1,1,7,55,0.0,0.0,0.0,0.0,0.0,0.0,0.0,30,2,28,2.0,1.0,1.0
9908354,0,0,0,0,0,0,0,72,,,,,,,,2,0,2,,,
9504201,1,1,0,0,1,0,0,284,1.0,1.0,0.0,0.0,1.0,0.0,0.0,2,1,1,1.0,1.0,0.0
209032,0,0,0,0,0,0,0,85,0.0,0.0,0.0,0.0,0.0,0.0,0.0,23,0,23,8.0,0.0,8.0
9501217,1,1,0,0,1,0,0,1287,,,,,,,,1,1,0,1.0,1.0,0.0
209366,2,1,1,1,0,2,18,52,2.0,1.0,1.0,1.0,0.0,2.0,18.0,12,2,10,12.0,2.0,10.0
203219,0,0,0,0,0,0,0,12,0.0,0.0,0.0,0.0,0.0,0.0,0.0,154,0,154,10.0,0.0,10.0
207099,0,0,0,0,0,0,0,1376,0.0,0.0,0.0,0.0,0.0,0.0,0.0,1,0,1,1.0,0.0,1.0
209104,0,0,0,0,0,0,0,0,0.0,0.0,0.0,0.0,0.0,0.0,0.0,30,0,30,3.0,0.0,3.0
204110,0,0,0,0,0,0,0,306,0.0,0.0,0.0,0.0,0.0,0.0,0.0,7,0,7,5.0,0.0,5.0
9910469,0,0,0,0,0,0,0,327,0.0,0.0,0.0,0.0,0.0,0.0,0.0,2,0,2,1.0,0.0,1.0
107305,0,0,0,0,0,0,0,41,0.0,0.0,0.0,0.0,0.0,0.0,0.0,19,0,19,,,
112162,2,2,0,0,0,2,24,20,1.0,1.0,0.0,0.0,0.0,1.0,20.0,30,2,28,24.0,1.0,23.0
111426,0,0,0,0,0,0,0,2048,,,,,,,,1,0,1,1.0,0.0,1.0
105118,0,0,0,0,0,0,0,126,0.0,0.0,0.0,0.0,0.0,0.0,0.0,19,0,19,7.0,0.0,7.0
9909209,3,2,1,1,2,1,3,111,2.0,1.0,1.0,1.0,2.0,0.0,0.0,8,3,5,2.0,2.0,0.0
9307358,0,0,0,0,0,0,0,304,0.0,0.0,0.0,0.0,0.0,0.0,0.0,2,0,2,1.0,0.0,1.0
302041,0,0,0,0,0,0,0,2,0.0,0.0,0.0,0.0,0.0,0.0,0.0,7,0,7,3.0,0.0,3.0
9803430,0,0,0,0,0,0,0,148,0.0,0.0,0.0,0.0,0.0,0.0,0.0,2,0,2,1.0,0.0,1.0
205196,0,0,0,0,0,0,0,44,0.0,0.0,0.0,0.0,0.0,0.0,0.0,19,0,19,8.0,0.0,8.0
9612411,0,0,0,0,0,0,0,97,0.0,0.0,0.0,0.0,0.0,0.0,0.0,4,0,4,2.0,0.0,2.0
9909463,1,1,0,0,0,1,13,101,1.0,1.0,0.0,0.0,0.0,1.0,5.0,17,1,16,6.0,1.0,5.0
109234,1,1,0,0,0,1,5,188,1.0,1.0,0.0,0.0,0.0,1.0,3.0,7,1,6,5.0,1.0,4.0
210398,2,2,0,0,1,1,9,13,1.0,1.0,0.0,0.0,0.0,1.0,7.0,118,2,116,23.0,0.0,23.0
212082,0,0,0,0,0,0,0,64,0.0,0.0,0.0,0.0,0.0,0.0,0.0,10,0,10,6.0,0.0,6.0
9405258,0,0,0,0,0,0,0,1499,,,,,,,,1,0,1,,,
107051,1,1,0,0,1,0,0,701,1.0,1.0,0.0,0.0,1.0,0.0,0.0,1,1,0,1.0,1.0,0.0
106173,0,0,0,0,0,0,0,43,,,,,,,,3,0,3,,,
211273,0,0,0,0,0,0,0,915,,,,,,,,1,0,1,,,
9811497,0,0,0,0,0,0,0,117,0.0,0.0,0.0,0.0,0.0,0.0,0.0,7,0,7,2.0,0.0,2.0
9804292,1,1,0,0,1,0,0,156,,,,,,,,2,1,1,1.0,1.0,0.0
11180,0,0,0,0,0,0,0,125,0.0,0.0,0.0,0.0,0.0,0.0,0.0,6,0,6,1.0,0.0,1.0
301088,0,0,0,0,0,0,0,56,0.0,0.0,0.0,0.0,0.0,0.0,0.0,32,0,32,12.0,0.0,12.0
301123,0,0,0,0,0,0,0,193,0.0,0.0,0.0,0.0,0.0,0.0,0.0,21,0,21,8.0,0.0,8.0
9507412,0,0,0,0,0,0,0,74,0.0,0.0,0.0,0.0,0.0,0.0,0.0,20,0,20,2.0,0.0,2.0
9901361,0,0,0,0,0,0,0,160,0.0,0.0,0.0,0.0,0.0,0.0,0.0,5,0,5,2.0,0.0,2.0
9603296,0,0,0,0,0,0,0,462,0.0,0.0,0.0,0.0,0.0,0.0,0.0,2,0,2,2.0,0.0,2.0
109153,0,0,0,0,0,0,0,238,0.0,0.0,0.0,0.0,0.0,0.0,0.0,4,0,4,3.0,0.0,3.0
9907289,1,1,0,0,1,0,0,277,1.0,1.0,0.0,0.0,1.0,0.0,0.0,5,1,4,2.0,1.0,1.0
9808358,0,0,0,0,0,0,0,36,0.0,0.0,0.0,0.0,0.0,0.0,0.0,11,0,11,,,
9502234,1,1,0,0,1,0,0,289,0.0,0.0,0.0,0.0,0.0,0.0,0.0,2,1,1,1.0,1.0,0.0
9605333,1,1,0,0,1,0,0,60,0.0,0.0,0.0,0.0,0.0,0.0,0.0,16,1,15,2.0,0.0,2.0
9706290,0,0,0,0,0,0,0,57,0.0,0.0,0.0,0.0,0.0,0.0,0.0,9,0,9,5.0,0.0,5.0
7271,1,1,0,0,1,0,0,113,0.0,0.0,0.0,0.0,0.0,0.0,0.0,7,1,6,1.0,0.0,1.0
9903523,2,2,0,0,0,2,2,203,1.0,1.0,0.0,0.0,0.0,1.0,1.0,4,2,2,1.0,1.0,0.0
9212247,1,1,0,0,1,0,0,709,1.0,1.0,0.0,0.0,1.0,0.0,0.0,1,1,0,1.0,1.0,0.0
106142,0,0,0,0,0,0,0,143,0.0,0.0,0.0,0.0,0.0,0.0,0.0,2,0,2,2.0,0.0,2.0
211431,1,1,0,0,0,1,8,29,1.0,1.0,0.0,0.0,0.0,1.0,2.0,9,1,8,3.0,1.0,2.0
302015,0,0,0,0,0,0,0,791,0.0,0.0,0.0,0.0,0.0,0.0,0.0,2,0,2,1.0,0.0,1.0
210166,0,0,0,0,0,0,0,74,0.0,0.0,0.0,0.0,0.0,0.0,0.0,16,0,16,3.0,0.0,3.0
11300,2,2,0,0,0,2,15,54,1.0,1.0,0.0,0.0,0.0,1.0,4.0,26,2,24,5.0,1.0,4.0
9602252,0,0,0,0,0,0,0,77,0.0,0.0,0.0,0.0,0.0,0.0,0.0,9,0,9,7.0,0.0,7.0
9803492,0,0,0,0,0,0,0,231,0.0,0.0,0.0,0.0,0.0,0.0,0.0,3,0,3,,,
9908437,0,0,0,0,0,0,0,14,0.0,0.0,0.0,0.0,0.0,0.0,0.0,13,0,13,3.0,0.0,3.0
6030,0,0,0,0,0,0,0,4,0.0,0.0,0.0,0.0,0.0,0.0,0.0,54,0,54,5.0,0.0,5.0
9711209,0,0,0,0,0,0,0,7,0.0,0.0,0.0,0.0,0.0,0.0,0.0,19,0,19,2.0,0.0,2.0
212079,0,0,0,0,0,0,0,7,0.0,0.0,0.0,0.0,0.0,0.0,0.0,23,0,23,3.0,0.0,3.0
9408350,0,0,0,0,0,0,0,1303,,,,,,,,3,0,3,,,
1220,0,0,0,0,0,0,0,244,0.0,0.0,0.0,0.0,0.0,0.0,0.0,8,0,8,2.0,0.0,2.0
9802250,0,0,0,0,0,0,0,51,0.0,0.0,0.0,0.0,0.0,0.0,0.0,5,0,5,,,
207342,1,1,0,0,0,1,1,0,0.0,0.0,0.0,0.0,0.0,0.0,0.0,46,1,45,3.0,0.0,3.0
9076,0,0,0,0,0,0,0,117,0.0,0.0,0.0,0.0,0.0,0.0,0.0,9,0,9,1.0,0.0,1.0
9912203,1,1,0,0,0,1,1,374,0.0,0.0,0.0,0.0,0.0,0.0,0.0,7,1,6,2.0,1.0,1.0
302088,0,0,0,0,0,0,0,33,0.0,0.0,0.0,0.0,0.0,0.0,0.0,9,0,9,2.0,0.0,2.0
9705355,1,1,0,0,0,1,4,154,1.0,1.0,0.0,0.0,0.0,1.0,4.0,9,1,8,8.0,1.0,7.0
9709248,0,0,0,0,0,0,0,97,0.0,0.0,0.0,0.0,0.0,0.0,0.0,9,0,9,7.0,0.0,7.0
208074,1,1,0,0,0,1,1,52,0.0,0.0,0.0,0.0,0.0,0.0,0.0,7,1,6,1.0,0.0,1.0
9407281,0,0,0,0,0,0,0,10,0.0,0.0,0.0,0.0,0.0,0.0,0.0,7,0,7,,,
9208261,1,1,0,0,1,0,0,186,1.0,1.0,0.0,0.0,1.0,0.0,0.0,1,1,0,1.0,1.0,0.0
208229,0,0,0,0,0,0,0,40,0.0,0.0,0.0,0.0,0.0,0.0,0.0,31,0,31,16.0,0.0,16.0
9910370,0,0,0,0,0,0,0,247,0.0,0.0,0.0,0.0,0.0,0.0,0.0,1,0,1,,,
9812226,3,2,1,1,0,3,6,105,1.0,1.0,0.0,0.0,0.0,1.0,1.0,8,3,5,5.0,2.0,3.0
2298,1,1,0,0,1,0,0,51,1.0,1.0,0.0,0.0,1.0,0.0,0.0,7,1,6,2.0,1.0,1.0
9704316,2,2,0,0,0,2,2,74,2.0,2.0,0.0,0.0,0.0,2.0,2.0,3,2,1,3.0,2.0,1.0
9605338,0,0,0,0,0,0,0,61,0.0,0.0,0.0,0.0,0.0,0.0,0.0,12,0,12,1.0,0.0,1.0
8027,0,0,0,0,0,0,0,38,0.0,0.0,0.0,0.0,0.0,0.0,0.0,7,0,7,,,
9504258,0,0,0,0,0,0,0,1521,,,,,,,,1,0,1,,,
107096,0,0,0,0,0,0,0,51,0.0,0.0,0.0,0.0,0.0,0.0,0.0,5,0,5,2.0,0.0,2.0
9811408,2,2,0,0,2,0,0,317,0.0,0.0,0.0,0.0,0.0,0.0,0.0,9,2,7,3.0,0.0,3.0
103266,0,0,0,0,0,0,0,68,,,,,,,,2,0,2,,,
210254,0,0,0,0,0,0,0,2,0.0,0.0,0.0,0.0,0.0,0.0,0.0,27,0,27,4.0,0.0,4.0
210404,0,0,0,0,0,0,0,80,0.0,0.0,0.0,0.0,0.0,0.0,0.0,3,0,3,,,
111446,0,0,0,0,0,0,0,22,,,,,,,,5,0,5,4.0,0.0,4.0
102126,1,1,0,0,0,1,4,33,1.0,1.0,0.0,0.0,0.0,1.0,4.0,9,1,8,,,
210255,1,1,0,0,1,0,0,346,0.0,0.0,0.0,0.0,0.0,0.0,0.0,20,1,19,1.0,0.0,1.0
210360,1,1,0,0,0,1,5,48,1.0,1.0,0.0,0.0,0.0,1.0,5.0,20,1,19,12.0,1.0,11.0
109038,0,0,0,0,0,0,0,27,0.0,0.0,0.0,0.0,0.0,0.0,0.0,18,0,18,5.0,0.0,5.0
1213,2,1,1,1,2,0,0,10,0.0,0.0,0.0,0.0,0.0,0.0,0.0,16,2,14,3.0,0.0,3.0
9703419,0,0,0,0,0,0,0,88,0.0,0.0,0.0,0.0,0.0,0.0,0.0,6,0,6,1.0,0.0,1.0
111134,2,2,0,0,0,2,3,225,2.0,2.0,0.0,0.0,1.0,1.0,1.0,8,2,6,2.0,1.0,1.0
206278,0,0,0,0,0,0,0,172,0.0,0.0,0.0,0.0,0.0,0.0,0.0,8,0,8,6.0,0.0,6.0
302053,0,0,0,0,0,0,0,14,0.0,0.0,0.0,0.0,0.0,0.0,0.0,38,0,38,18.0,0.0,18.0
9808495,0,0,0,0,0,0,0,227,0.0,0.0,0.0,0.0,0.0,0.0,0.0,7,0,7,2.0,0.0,2.0
205240,1,1,0,0,0,1,7,445,1.0,1.0,0.0,0.0,1.0,0.0,0.0,10,1,9,1.0,0.0,1.0
9506343,0,0,0,0,0,0,0,1134,0.0,0.0,0.0,0.0,0.0,0.0,0.0,1,0,1,1.0,0.0,1.0
201035,0,0,0,0,0,0,0,19,0.0,0.0,0.0,0.0,0.0,0.0,0.0,11,0,11,3.0,0.0,3.0
9706514,0,0,0,0,0,0,0,2074,0.0,0.0,0.0,0.0,0.0,0.0,0.0,1,0,1,1.0,0.0,1.0
207354,0,0,0,0,0,0,0,70,0.0,0.0,0.0,0.0,0.0,0.0,0.0,26,0,26,24.0,0.0,24.0
4265,0,0,0,0,0,0,0,49,0.0,0.0,0.0,0.0,0.0,0.0,0.0,9,0,9,4.0,0.0,4.0
106209,0,0,0,0,0,0,0,40,0.0,0.0,0.0,0.0,0.0,0.0,0.0,20,0,20,6.0,0.0,6.0
206211,1,1,0,0,0,1,18,18,1.0,1.0,0.0,0.0,0.0,1.0,17.0,27,1,26,18.0,1.0,17.0
9309205,1,1,0,0,0,1,7,176,1.0,1.0,0.0,0.0,0.0,1.0,7.0,8,1,7,7.0,1.0,6.0
211369,0,0,0,0,0,0,0,21,0.0,0.0,0.0,0.0,0.0,0.0,0.0,17,0,17,1.0,0.0,1.0
9612472,1,1,0,0,1,0,0,40,1.0,1.0,0.0,0.0,1.0,0.0,0.0,3,1,2,1.0,1.0,0.0
9712510,0,0,0,0,0,0,0,55,0.0,0.0,0.0,0.0,0.0,0.0,0.0,17,0,17,,,
9601288,0,0,0,0,0,0,0,1132,,,,,,,,2,0,2,,,
8100,0,0,0,0,0,0,0,32,0.0,0.0,0.0,0.0,0.0,0.0,0.0,15,0,15,1.0,0.0,1.0
9607364,0,0,0,0,0,0,0,355,0.0,0.0,0.0,0.0,0.0,0.0,0.0,3,0,3,2.0,0.0,2.0
9909535,0,0,0,0,0,0,0,1463,0.0,0.0,0.0,0.0,0.0,0.0,0.0,2,0,2,2.0,0.0,2.0
207268,0,0,0,0,0,0,0,64,0.0,0.0,0.0,0.0,0.0,0.0,0.0,10,0,10,5.0,0.0,5.0
9505370,0,0,0,0,0,0,0,235,0.0,0.0,0.0,0.0,0.0,0.0,0.0,2,0,2,2.0,0.0,2.0
211133,0,0,0,0,0,0,0,792,0.0,0.0,0.0,0.0,0.0,0.0,0.0,3,0,3,1.0,0.0,1.0
9902477,0,0,0,0,0,0,0,42,0.0,0.0,0.0,0.0,0.0,0.0,0.0,9,0,9,5.0,0.0,5.0
9510239,0,0,0,0,0,0,0,253,0.0,0.0,0.0,0.0,0.0,0.0,0.0,6,0,6,1.0,0.0,1.0
112271,0,0,0,0,0,0,0,107,0.0,0.0,0.0,0.0,0.0,0.0,0.0,13,0,13,7.0,0.0,7.0
9212216,0,0,0,0,0,0,0,1003,,,,,,,,1,0,1,,,
110112,0,0,0,0,0,0,0,100,0.0,0.0,0.0,0.0,0.0,0.0,0.0,13,0,13,11.0,0.0,11.0
2052,0,0,0,0,0,0,0,41,0.0,0.0,0.0,0.0,0.0,0.0,0.0,7,0,7,3.0,0.0,3.0
302168,0,0,0,0,0,0,0,37,0.0,0.0,0.0,0.0,0.0,0.0,0.0,7,0,7,1.0,0.0,1.0
9911301,1,1,0,0,0,1,3,84,1.0,1.0,0.0,0.0,0.0,1.0,3.0,7,1,6,3.0,1.0,2.0
103148,1,1,0,0,0,1,3,21,0.0,0.0,0.0,0.0,0.0,0.0,0.0,13,1,12,6.0,0.0,6.0
106290,0,0,0,0,0,0,0,155,0.0,0.0,0.0,0.0,0.0,0.0,0.0,5,0,5,1.0,0.0,1.0
210337,0,0,0,0,0,0,0,87,0.0,0.0,0.0,0.0,0.0,0.0,0.0,18,0,18,5.0,0.0,5.0
9209,0,0,0,0,0,0,0,6,0.0,0.0,0.0,0.0,0.0,0.0,0.0,14,0,14,6.0,0.0,6.0
9608408,0,0,0,0,0,0,0,14,0.0,0.0,0.0,0.0,0.0,0.0,0.0,7,0,7,,,
103117,0,0,0,0,0,0,0,160,0.0,0.0,0.0,0.0,0.0,0.0,0.0,4,0,4,3.0,0.0,3.0
104128,0,0,0,0,0,0,0,194,0.0,0.0,0.0,0.0,0.0,0.0,0.0,6,0,6,4.0,0.0,4.0
9909329,0,0,0,0,0,0,0,13,0.0,0.0,0.0,0.0,0.0,0.0,0.0,9,0,9,1.0,0.0,1.0
208168,0,0,0,0,0,0,0,29,0.0,0.0,0.0,0.0,0.0,0.0,0.0,29,0,29,18.0,0.0,18.0
301246,0,0,0,0,0,0,0,17,0.0,0.0,0.0,0.0,0.0,0.0,0.0,4,0,4,,,
209132,0,0,0,0,0,0,0,221,0.0,0.0,0.0,0.0,0.0,0.0,0.0,9,0,9,4.0,0.0,4.0
105072,0,0,0,0,0,0,0,201,0.0,0.0,0.0,0.0,0.0,0.0,0.0,12,0,12,4.0,0.0,4.0
112005,0,0,0,0,0,0,0,98,0.0,0.0,0.0,0.0,0.0,0.0,0.0,5,0,5,1.0,0.0,1.0
9704218,0,0,0,0,0,0,0,10,0.0,0.0,0.0,0.0,0.0,0.0,0.0,6,0,6,5.0,0.0,5.0
205137,0,0,0,0,0,0,0,750,0.0,0.0,0.0,0.0,0.0,0.0,0.0,3,0,3,,,
105210,0,0,0,0,0,0,0,17,0.0,0.0,0.0,0.0,0.0,0.0,0.0,20,0,20,3.0,0.0,3.0
5097,0,0,0,0,0,0,0,408,0.0,0.0,0.0,0.0,0.0,0.0,0.0,1,0,1,1.0,0.0,1.0
209213,0,0,0,0,0,0,0,152,0.0,0.0,0.0,0.0,0.0,0.0,0.0,4,0,4,1.0,0.0,1.0
212387,0,0,0,0,0,0,0,28,0.0,0.0,0.0,0.0,0.0,0.0,0.0,44,0,44,14.0,0.0,14.0
9605372,0,0,0,0,0,0,0,205,0.0,0.0,0.0,0.0,0.0,0.0,0.0,1,0,1,1.0,0.0,1.0
9806264,0,0,0,0,0,0,0,101,0.0,0.0,0.0,0.0,0.0,0.0,0.0,6,0,6,4.0,0.0,4.0
9407256,0,0,0,0,0,0,0,208,0.0,0.0,0.0,0.0,0.0,0.0,0.0,7,0,7,4.0,0.0,4.0
205291,0,0,0,0,0,0,0,68,0.0,0.0,0.0,0.0,0.0,0.0,0.0,12,0,12,2.0,0.0,2.0
6289,0,0,0,0,0,0,0,1252,0.0,0.0,0.0,0.0,0.0,0.0,0.0,1,0,1,1.0,0.0,1.0
9910507,1,1,0,0,0,1,1,321,0.0,0.0,0.0,0.0,0.0,0.0,0.0,10,1,9,5.0,0.0,5.0
302026,0,0,0,0,0,0,0,82,0.0,0.0,0.0,0.0,0.0,0.0,0.0,26,0,26,21.0,0.0,21.0
9708340,0,0,0,0,0,0,0,90,0.0,0.0,0.0,0.0,0.0,0.0,0.0,42,0,42,16.0,0.0,16.0
9806201,0,0,0,0,0,0,0,591,0.0,0.0,0.0,0.0,0.0,0.0,0.0,1,0,1,1.0,0.0,1.0
9405358,1,1,0,0,1,0,0,243,0.0,0.0,0.0,0.0,0.0,0.0,0.0,5,1,4,,,
208245,0,0,0,0,0,0,0,31,0.0,0.0,0.0,0.0,0.0,0.0,0.0,13,0,13,4.0,0.0,4.0
9203209,1,1,0,0,1,0,0,103,,,,,,,,1,1,0,,,
108088,0,0,0,0,0,0,0,278,0.0,0.0,0.0,0.0,0.0,0.0,0.0,12,0,12,2.0,0.0,2.0
9607231,0,0,0,0,0,0,0,75,0.0,0.0,0.0,0.0,0.0,0.0,0.0,8,0,8,4.0,0.0,4.0
10336,0,0,0,0,0,0,0,43,0.0,0.0,0.0,0.0,0.0,0.0,0.0,60,0,60,2.0,0.0,2.0
110223,0,0,0,0,0,0,0,20,0.0,0.0,0.0,0.0,0.0,0.0,0.0,16,0,16,2.0,0.0,2.0
12059,0,0,0,0,0,0,0,1961,0.0,0.0,0.0,0.0,0.0,0.0,0.0,5,0,5,,,
111320,0,0,0,0,0,0,0,70,0.0,0.0,0.0,0.0,0.0,0.0,0.0,24,0,24,22.0,0.0,22.0
6220,0,0,0,0,0,0,0,126,0.0,0.0,0.0,0.0,0.0,0.0,0.0,3,0,3,2.0,0.0,2.0
9811343,0,0,0,0,0,0,0,318,0.0,0.0,0.0,0.0,0.0,0.0,0.0,6,0,6,1.0,0.0,1.0
9711420,0,0,0,0,0,0,0,94,,,,,,,,3,0,3,,,
208167,0,0,0,0,0,0,0,29,0.0,0.0,0.0,0.0,0.0,0.0,0.0,14,0,14,1.0,0.0,1.0
110271,0,0,0,0,0,0,0,9,0.0,0.0,0.0,0.0,0.0,0.0,0.0,13,0,13,1.0,0.0,1.0
9504372,130,18,112,509,79,51,59,31,54.0,2.0,52.0,258.0,28.0,26.0,26.0,133,130,3,24.0,23.0,1.0
9810333,52,16,36,132,26,26,43,1,12.0,3.0,9.0,36.0,10.0,2.0,2.0,61,52,9,11.0,11.0,0.0
8159,23,3,20,61,0,23,206,1,16.0,2.0,14.0,44.0,0.0,16.0,117.0,51,23,28,14.0,8.0,6.0
9712306,38,3,35,134,15,23,44,1,19.0,1.0,18.0,62.0,2.0,17.0,34.0,43,38,5,5.0,5.0,0.0
9302244,38,10,28,97,38,0,0,7,16.0,4.0,12.0,36.0,16.0,0.0,0.0,38,38,0,3.0,3.0,0.0
9405346,45,5,40,169,3,42,193,6,20.0,3.0,17.0,64.0,0.0,20.0,103.0,59,45,14,20.0,11.0,9.0
9507262,99,6,93,580,18,81,174,1,25.0,2.0,23.0,150.0,0.0,25.0,52.0,107,99,8,24.0,22.0,2.0
9802289,52,18,34,69,12,40,137,1,9.0,6.0,3.0,5.0,1.0,8.0,24.0,78,52,26,5.0,5.0,0.0
9604330,71,12,59,321,7,64,181,34,28.0,5.0,23.0,147.0,1.0,27.0,66.0,85,71,14,25.0,22.0,3.0
104027,23,4,19,34,0,23,194,32,0.0,0.0,0.0,0.0,0.0,0.0,0.0,117,23,94,18.0,1.0,17.0
9911321,47,23,24,65,7,40,416,1,5.0,4.0,1.0,1.0,0.0,5.0,46.0,169,47,122,8.0,3.0,5.0
112313,3,3,0,0,0,3,8,170,1.0,1.0,0.0,0.0,0.0,1.0,2.0,26,3,23,4.0,1.0,3.0
9410369,6,4,2,2,6,0,0,114,3.0,2.0,1.0,1.0,3.0,0.0,0.0,11,6,5,2.0,2.0,0.0
9704448,155,37,118,597,64,91,279,4,37.0,4.0,33.0,202.0,5.0,32.0,92.0,182,155,27,11.0,8.0,3.0
9606397,26,7,19,49,7,19,59,33,7.0,3.0,4.0,8.0,1.0,6.0,18.0,39,26,13,5.0,5.0,0.0
9902479,12,5,7,18,3,9,9,252,9.0,3.0,6.0,12.0,2.0,7.0,7.0,13,12,1,10.0,9.0,1.0
7316,9,5,4,9,3,6,29,48,1.0,1.0,0.0,0.0,0.0,1.0,1.0,22,9,13,2.0,1.0,1.0
9408313,38,14,24,49,38,0,0,4,8.0,1.0,7.0,13.0,8.0,0.0,0.0,38,38,0,2.0,2.0,0.0
9608460,22,1,21,122,0,22,64,33,20.0,1.0,19.0,108.0,0.0,20.0,52.0,31,22,9,23.0,19.0,4.0
9706412,12,2,10,24,0,12,54,33,9.0,5.0,4.0,12.0,0.0,9.0,41.0,20,12,8,14.0,7.0,7.0
9806244,24,6,18,41,4,20,47,24,7.0,3.0,4.0,5.0,3.0,4.0,5.0,37,24,13,7.0,4.0,3.0
9904468,59,8,51,216,1,58,736,24,42.0,4.0,38.0,173.0,0.0,42.0,505.0,104,59,45,41.0,24.0,17.0
207066,3,1,2,3,0,3,3,210,3.0,1.0,2.0,3.0,0.0,3.0,3.0,7,3,4,2.0,1.0,1.0
12256,3,2,1,1,0,3,21,26,3.0,2.0,1.0,1.0,0.0,3.0,20.0,15,3,12,3.0,1.0,2.0
9305258,72,26,46,133,46,26,52,26,33.0,13.0,20.0,55.0,17.0,16.0,35.0,77,72,5,13.0,13.0,0.0
9610446,11,4,7,17,0,11,39,26,9.0,4.0,5.0,11.0,0.0,9.0,36.0,18,11,7,7.0,4.0,3.0
9811357,28,7,21,50,1,27,144,26,22.0,5.0,17.0,40.0,0.0,22.0,115.0,44,28,16,19.0,12.0,7.0
9809352,60,33,27,47,28,32,118,4,2.0,2.0,0.0,0.0,1.0,1.0,2.0,102,60,42,5.0,5.0,0.0
9806263,110,5,105,772,20,90,273,2,51.0,2.0,49.0,380.0,1.0,50.0,189.0,116,110,6,34.0,30.0,4.0
11243,7,5,2,2,2,5,11,30,3.0,1.0,2.0,2.0,3.0,0.0,0.0,10,7,3,6.0,4.0,2.0
9806432,11,8,3,5,4,7,7,30,3.0,2.0,1.0,1.0,3.0,0.0,0.0,12,11,1,6.0,5.0,1.0
9809275,13,5,8,15,2,11,55,4,4.0,2.0,2.0,3.0,0.0,4.0,14.0,28,13,15,10.0,3.0,7.0
104152,32,22,10,13,6,26,169,2,3.0,2.0,1.0,1.0,0.0,3.0,34.0,76,32,44,5.0,5.0,0.0
202162,5,4,1,2,0,5,44,26,0.0,0.0,0.0,0.0,0.0,0.0,0.0,26,5,21,2.0,0.0,2.0
9405224,7,6,1,1,3,4,4,43,3.0,3.0,0.0,0.0,3.0,0.0,0.0,8,7,1,2.0,2.0,0.0
9403398,68,15,53,153,23,45,101,63,14.0,3.0,11.0,25.0,0.0,14.0,43.0,85,68,17,18.0,13.0,5.0
9401257,7,3,4,4,7,0,0,149,2.0,2.0,0.0,0.0,2.0,0.0,0.0,7,7,0,1.0,1.0,0.0
9406363,103,10,93,401,53,50,53,25,34.0,2.0,32.0,119.0,10.0,24.0,24.0,106,103,3,21.0,20.0,1.0
9505207,87,17,70,312,5,82,193,61,40.0,3.0,37.0,152.0,2.0,38.0,56.0,103,87,16,30.0,29.0,1.0
9401357,15,8,7,11,9,6,6,25,3.0,2.0,1.0,1.0,0.0,3.0,3.0,17,15,2,2.0,2.0,0.0
9504307,56,8,48,154,16,40,78,42,12.0,1.0,11.0,21.0,6.0,6.0,7.0,65,56,9,5.0,4.0,1.0
9306293,7,2,5,10,3,4,4,99,4.0,1.0,3.0,4.0,1.0,3.0,3.0,11,7,4,5.0,4.0,1.0
9406354,23,4,19,48,5,18,38,36,12.0,2.0,10.0,21.0,1.0,11.0,17.0,26,23,3,13.0,10.0,3.0
9406372,63,17,46,127,43,20,22,0,13.0,5.0,8.0,17.0,6.0,7.0,7.0,66,63,3,14.0,13.0,1.0
9711354,10,6,4,8,3,7,14,144,6.0,4.0,2.0,3.0,1.0,5.0,11.0,14,10,4,8.0,5.0,3.0
9708483,114,11,103,587,52,62,130,3,63.0,1.0,62.0,420.0,37.0,26.0,50.0,129,114,15,13.0,13.0,0.0
9809508,13,3,10,17,1,12,28,0,7.0,2.0,5.0,5.0,7.0,0.0,0.0,17,13,4,8.0,7.0,1.0
9712392,83,7,76,491,47,36,45,12,35.0,1.0,34.0,207.0,35.0,0.0,0.0,92,83,9,19.0,19.0,0.0
9610481,69,13,56,346,9,60,261,3,36.0,7.0,29.0,212.0,17.0,19.0,19.0,97,69,28,17.0,6.0,11.0
9911440,2,2,0,0,1,1,14,0,1.0,1.0,0.0,0.0,0.0,1.0,12.0,36,2,34,3.0,0.0,3.0
9808261,25,4,21,84,3,22,116,3,19.0,3.0,16.0,62.0,2.0,17.0,71.0,40,25,15,9.0,9.0,0.0
9905470,17,2,15,24,0,17,174,3,13.0,2.0,11.0,19.0,0.0,13.0,133.0,51,17,34,27.0,9.0,18.0
9805272,67,7,60,284,24,43,124,0,20.0,2.0,18.0,79.0,20.0,0.0,0.0,76,67,9,19.0,18.0,1.0
9706426,11,4,7,8,0,11,22,0,1.0,1.0,0.0,0.0,0.0,1.0,2.0,28,11,17,1.0,0.0,1.0
9606226,17,6,11,25,17,0,0,0,7.0,1.0,6.0,11.0,7.0,0.0,0.0,18,17,1,4.0,4.0,0.0
9809401,33,11,22,55,22,11,17,46,9.0,2.0,7.0,16.0,9.0,0.0,0.0,35,33,2,3.0,3.0,0.0
9807253,13,4,9,19,4,9,51,42,6.0,3.0,3.0,6.0,0.0,6.0,25.0,24,13,11,11.0,6.0,5.0
9904302,2,2,0,0,0,2,3,0,0.0,0.0,0.0,0.0,0.0,0.0,0.0,9,2,7,4.0,1.0,3.0
9502297,70,15,55,236,30,40,47,3,31.0,4.0,27.0,111.0,13.0,18.0,18.0,72,70,2,14.0,13.0,1.0
9606353,12,4,8,14,9,3,3,288,3.0,1.0,2.0,3.0,1.0,2.0,2.0,14,12,2,2.0,2.0,0.0
9809481,11,7,4,5,2,9,48,0,4.0,2.0,2.0,2.0,0.0,4.0,14.0,27,11,16,7.0,4.0,3.0
9903499,12,2,10,29,0,12,33,3,2.0,1.0,1.0,1.0,0.0,2.0,8.0,24,12,12,4.0,1.0,3.0
9712551,36,14,22,51,3,33,123,87,19.0,6.0,13.0,27.0,0.0,19.0,88.0,45,36,9,20.0,12.0,8.0
9511426,11,7,4,4,2,9,26,81,3.0,2.0,1.0,1.0,0.0,3.0,7.0,18,11,7,7.0,4.0,3.0
9502304,21,9,12,22,9,12,20,3,4.0,1.0,3.0,3.0,4.0,0.0,0.0,29,21,8,3.0,3.0,0.0
9303275,19,8,11,18,19,0,0,3,4.0,1.0,3.0,3.0,4.0,0.0,0.0,19,19,0,2.0,2.0,0.0
9807237,5,4,1,1,4,1,1,136,1.0,1.0,0.0,0.0,1.0,0.0,0.0,7,5,2,,,
9211207,6,2,4,5,6,0,0,1566,,,,,,,,7,6,1,,,
9609442,13,6,7,11,9,4,6,103,1.0,1.0,0.0,0.0,0.0,1.0,1.0,17,13,4,2.0,1.0,1.0
9602325,17,8,9,22,1,16,100,10,4.0,3.0,1.0,1.0,0.0,4.0,24.0,64,17,47,14.0,5.0,9.0
9711288,16,8,8,14,3,13,29,81,1.0,1.0,0.0,0.0,0.0,1.0,3.0,28,16,12,7.0,2.0,5.0
9205229,29,6,23,69,29,0,0,99,16.0,4.0,12.0,34.0,16.0,0.0,0.0,29,29,0,12.0,12.0,0.0
9308365,37,10,27,58,18,19,21,81,6.0,3.0,3.0,8.0,6.0,0.0,0.0,39,37,2,10.0,10.0,0.0
9209220,55,17,38,145,50,5,5,75,13.0,6.0,7.0,28.0,13.0,0.0,0.0,56,55,1,8.0,8.0,0.0
9504337,38,8,30,69,17,21,51,12,8.0,1.0,7.0,17.0,8.0,0.0,0.0,56,38,18,5.0,5.0,0.0
9703433,46,3,43,256,4,42,171,36,35.0,2.0,33.0,213.0,0.0,35.0,153.0,53,46,7,36.0,30.0,6.0
9206218,95,32,63,334,95,0,0,10,23.0,5.0,18.0,49.0,23.0,0.0,0.0,95,95,0,6.0,6.0,0.0
112089,7,6,1,1,0,7,121,6,1.0,1.0,0.0,0.0,0.0,1.0,27.0,98,7,91,15.0,1.0,14.0
9711412,2,1,1,1,2,0,0,436,0.0,0.0,0.0,0.0,0.0,0.0,0.0,4,2,2,1.0,0.0,1.0
9911252,71,14,57,241,3,68,552,2,27.0,4.0,23.0,74.0,0.0,27.0,296.0,96,71,25,33.0,19.0,14.0
9307291,155,24,131,822,38,117,247,6,81.0,11.0,70.0,558.0,5.0,76.0,160.0,164,155,9,43.0,40.0,3.0
102331,102,6,96,704,3,99,1269,23,55.0,3.0,52.0,402.0,0.0,55.0,625.0,170,102,68,56.0,42.0,14.0
12371,13,4,9,18,2,11,102,34,10.0,3.0,7.0,15.0,1.0,9.0,95.0,32,13,19,21.0,9.0,12.0
9809545,9,4,5,12,1,8,96,1,6.0,1.0,5.0,10.0,0.0,6.0,87.0,65,9,56,25.0,6.0,19.0
9307249,72,17,55,239,36,36,70,75,31.0,9.0,22.0,74.0,7.0,24.0,47.0,74,72,2,29.0,27.0,2.0
9610233,102,13,89,944,3,99,496,23,58.0,3.0,55.0,655.0,1.0,57.0,145.0,138,102,36,49.0,46.0,3.0
9705271,62,16,46,202,3,59,416,5,39.0,8.0,31.0,151.0,0.0,39.0,304.0,82,62,20,27.0,20.0,7.0
9302231,8,4,4,7,8,0,0,293,3.0,1.0,2.0,3.0,3.0,0.0,0.0,8,8,0,3.0,3.0,0.0
9308217,39,8,31,109,4,35,60,69,17.0,4.0,13.0,24.0,0.0,17.0,29.0,42,39,3,14.0,12.0,2.0
9606475,20,12,8,14,20,0,0,148,5.0,2.0,3.0,4.0,5.0,0.0,0.0,20,20,0,4.0,4.0,0.0
9901409,18,9,9,13,1,17,107,7,0.0,0.0,0.0,0.0,0.0,0.0,0.0,99,18,81,12.0,1.0,11.0
11266,20,4,16,47,0,20,78,7,6.0,1.0,5.0,9.0,0.0,6.0,6.0,34,20,14,4.0,4.0,0.0
9603314,107,7,100,524,14,93,705,6,65.0,5.0,60.0,313.0,0.0,65.0,570.0,130,107,23,38.0,19.0,19.0
9802204,30,6,24,52,9,21,49,9,11.0,2.0,9.0,19.0,1.0,10.0,31.0,38,30,8,14.0,9.0,5.0
9606279,6,2,4,6,1,5,11,34,5.0,1.0,4.0,6.0,0.0,5.0,11.0,10,6,4,1.0,1.0,0.0
9812375,64,15,49,155,16,48,82,1,27.0,4.0,23.0,90.0,7.0,20.0,29.0,77,64,13,17.0,17.0,0.0
9909260,28,10,18,33,4,24,230,69,14.0,5.0,9.0,16.0,1.0,13.0,118.0,61,28,33,25.0,7.0,18.0
9905464,66,8,58,278,1,65,162,32,34.0,1.0,33.0,140.0,0.0,34.0,99.0,81,66,15,18.0,17.0,1.0
1093,25,8,17,46,1,24,61,4,14.0,3.0,11.0,24.0,7.0,7.0,10.0,34,25,9,10.0,9.0,1.0
9901365,10,9,1,1,2,8,26,4,0.0,0.0,0.0,0.0,0.0,0.0,0.0,27,10,17,2.0,2.0,0.0
9311209,4,2,2,3,4,0,0,31,3.0,1.0,2.0,2.0,3.0,0.0,0.0,4,4,0,1.0,1.0,0.0
9601377,12,2,10,27,0,12,20,21,10.0,1.0,9.0,23.0,0.0,10.0,16.0,15,12,3,2.0,2.0,0.0
9710428,10,5,5,11,1,9,33,7,3.0,2.0,1.0,1.0,0.0,3.0,12.0,33,10,23,5.0,0.0,5.0
9308266,37,14,23,73,3,34,99,75,23.0,9.0,14.0,37.0,1.0,22.0,75.0,45,37,8,19.0,15.0,4.0
9711301,1,1,0,0,0,1,4,7,1.0,1.0,0.0,0.0,0.0,1.0,2.0,10,1,9,1.0,0.0,1.0
9904234,23,2,21,164,0,23,334,2,20.0,1.0,19.0,153.0,0.0,20.0,313.0,45,23,22,38.0,20.0,18.0
9605288,104,15,89,369,24,80,202,15,37.0,3.0,34.0,154.0,9.0,28.0,94.0,112,104,8,11.0,11.0,0.0
9502321,29,8,21,58,2,27,118,15,18.0,5.0,13.0,44.0,1.0,17.0,78.0,40,29,11,8.0,3.0,5.0
9409349,24,4,20,68,4,20,25,76,21.0,3.0,18.0,63.0,2.0,19.0,24.0,26,24,2,18.0,17.0,1.0
9212255,4,2,2,3,4,0,0,76,2.0,1.0,1.0,1.0,2.0,0.0,0.0,4,4,0,1.0,1.0,0.0
9412323,2,2,0,0,0,2,2,378,1.0,1.0,0.0,0.0,1.0,0.0,0.0,3,2,1,1.0,1.0,0.0
9707338,32,14,18,35,2,30,95,19,12.0,10.0,2.0,2.0,0.0,12.0,38.0,47,32,15,10.0,4.0,6.0
9407401,63,13,50,233,36,27,28,62,33.0,5.0,28.0,125.0,19.0,14.0,15.0,65,63,2,19.0,19.0,0.0
9512306,8,4,4,5,6,2,5,62,1.0,1.0,0.0,0.0,0.0,1.0,3.0,12,8,4,5.0,1.0,4.0
9707481,101,3,98,849,23,78,251,24,69.0,2.0,67.0,648.0,18.0,51.0,171.0,111,101,10,44.0,39.0,5.0
9405237,97,18,79,435,68,29,29,11,44.0,4.0,40.0,263.0,24.0,20.0,20.0,98,97,1,31.0,30.0,1.0
9510329,12,7,5,6,1,11,28,194,5.0,4.0,1.0,1.0,0.0,5.0,13.0,18,12,6,8.0,4.0,4.0
9712235,5,4,1,1,1,4,4,106,0.0,0.0,0.0,0.0,0.0,0.0,0.0,8,5,3,1.0,0.0,1.0
9709390,13,9,4,4,0,13,64,16,7.0,5.0,2.0,2.0,0.0,7.0,21.0,32,13,19,11.0,2.0,9.0
9806317,24,3,21,48,0,24,112,19,7.0,1.0,6.0,7.0,0.0,7.0,33.0,43,24,19,22.0,8.0,14.0
9403246,21,6,15,35,14,7,8,24,9.0,2.0,7.0,10.0,9.0,0.0,0.0,23,21,2,7.0,7.0,0.0
9703358,58,10,48,155,10,48,118,151,22.0,2.0,20.0,74.0,0.0,22.0,68.0,65,58,7,23.0,18.0,5.0
9602409,13,4,9,17,3,10,40,30,7.0,2.0,5.0,9.0,0.0,7.0,28.0,24,13,11,8.0,6.0,2.0
9301288,9,6,3,4,9,0,0,190,3.0,2.0,1.0,1.0,3.0,0.0,0.0,9,9,0,3.0,3.0,0.0
9310340,13,5,8,22,13,0,0,86,9.0,5.0,4.0,10.0,9.0,0.0,0.0,13,13,0,7.0,7.0,0.0
9611333,24,7,17,51,5,19,52,59,16.0,4.0,12.0,44.0,1.0,15.0,46.0,29,24,5,19.0,14.0,5.0
9704245,43,2,41,167,6,37,221,6,17.0,1.0,16.0,52.0,0.0,17.0,159.0,65,43,22,11.0,6.0,5.0
9610277,4,2,2,2,0,4,8,6,0.0,0.0,0.0,0.0,0.0,0.0,0.0,7,4,3,2.0,1.0,1.0
9704325,37,4,33,186,8,29,72,24,24.0,1.0,23.0,143.0,5.0,19.0,36.0,45,37,8,22.0,20.0,2.0
9607300,9,6,3,6,9,0,0,85,5.0,3.0,2.0,4.0,5.0,0.0,0.0,12,9,3,4.0,4.0,0.0
9506476,13,3,10,19,4,9,22,6,2.0,2.0,0.0,0.0,2.0,0.0,0.0,16,13,3,7.0,6.0,1.0
9811448,214,19,195,1398,10,204,1068,2,60.0,5.0,55.0,363.0,0.0,60.0,580.0,231,214,17,48.0,47.0,1.0
9404270,259,57,202,1065,175,84,144,14,63.0,9.0,54.0,412.0,26.0,37.0,64.0,263,259,4,25.0,25.0,0.0
9812421,14,3,11,18,4,10,44,87,2.0,1.0,1.0,1.0,0.0,2.0,6.0,50,14,36,9.0,0.0,9.0
9501375,87,7,80,331,19,68,185,38,31.0,1.0,30.0,132.0,3.0,28.0,85.0,98,87,11,22.0,18.0,4.0
9906485,25,8,17,42,1,24,260,22,18.0,6.0,12.0,31.0,0.0,18.0,200.0,61,25,36,31.0,8.0,23.0
9805292,12,2,10,27,0,12,53,45,12.0,2.0,10.0,27.0,0.0,12.0,51.0,20,12,8,15.0,10.0,5.0
5003,55,5,50,183,8,47,387,38,35.0,2.0,33.0,120.0,0.0,35.0,303.0,85,55,30,41.0,26.0,15.0
11333,121,23,98,483,14,107,1116,20,76.0,8.0,68.0,374.0,0.0,76.0,990.0,194,121,73,75.0,24.0,51.0
9703266,37,9,28,132,3,34,171,22,22.0,5.0,17.0,79.0,0.0,22.0,118.0,45,37,8,18.0,13.0,5.0
9708257,26,2,24,102,2,24,63,38,23.0,1.0,22.0,99.0,0.0,23.0,58.0,32,26,6,23.0,20.0,3.0
9608299,14,6,8,16,0,14,36,88,8.0,3.0,5.0,11.0,0.0,8.0,14.0,28,14,14,8.0,6.0,2.0
9506436,34,10,24,57,14,20,23,188,13.0,4.0,9.0,25.0,9.0,4.0,4.0,36,34,2,8.0,8.0,0.0
9901319,28,4,24,138,0,28,349,21,27.0,4.0,23.0,132.0,0.0,27.0,333.0,91,28,63,53.0,21.0,32.0
9805473,52,11,41,134,9,43,129,21,20.0,5.0,15.0,42.0,1.0,19.0,51.0,62,52,10,17.0,13.0,4.0
9808474,8,4,4,7,0,8,8,66,3.0,1.0,2.0,3.0,0.0,3.0,3.0,9,8,1,1.0,1.0,0.0
9612479,16,7,9,11,4,12,12,30,2.0,1.0,1.0,1.0,2.0,0.0,0.0,17,16,1,2.0,2.0,0.0
9810319,22,2,20,82,0,22,75,19,16.0,1.0,15.0,53.0,4.0,12.0,24.0,42,22,20,12.0,10.0,2.0
9907387,9,2,7,12,1,8,22,66,7.0,2.0,5.0,10.0,1.0,6.0,11.0,14,9,5,7.0,5.0,2.0
9604298,20,9,11,18,1,19,118,41,15.0,6.0,9.0,13.0,1.0,14.0,81.0,89,20,69,13.0,7.0,6.0
9802414,27,3,24,94,7,20,28,43,16.0,2.0,14.0,60.0,3.0,13.0,18.0,32,27,5,13.0,11.0,2.0
202037,7,2,5,6,0,7,99,20,7.0,2.0,5.0,6.0,0.0,7.0,97.0,67,7,60,41.0,1.0,40.0
111178,5,1,4,9,0,5,43,20,5.0,1.0,4.0,9.0,0.0,5.0,43.0,17,5,12,4.0,3.0,1.0
9511335,86,22,64,199,41,45,73,31,45.0,10.0,35.0,116.0,17.0,28.0,38.0,91,86,5,20.0,18.0,2.0
9302265,19,8,11,24,0,19,24,29,11.0,4.0,7.0,15.0,0.0,11.0,16.0,21,19,2,7.0,6.0,1.0
9410333,38,16,22,77,3,35,46,49,10.0,1.0,9.0,35.0,10.0,0.0,0.0,49,38,11,11.0,11.0,0.0
9908235,25,3,22,120,0,25,166,20,24.0,2.0,22.0,120.0,0.0,24.0,164.0,33,25,8,28.0,20.0,8.0
9910541,8,2,6,9,0,8,91,20,7.0,2.0,5.0,8.0,0.0,7.0,85.0,26,8,18,21.0,5.0,16.0
9604404,50,13,37,86,20,30,52,40,15.0,3.0,12.0,34.0,15.0,0.0,0.0,63,50,13,7.0,6.0,1.0
108178,15,2,13,23,6,9,41,20,11.0,1.0,10.0,17.0,2.0,9.0,41.0,21,15,6,6.0,6.0,0.0
202176,10,6,4,4,1,9,22,19,1.0,1.0,0.0,0.0,0.0,1.0,2.0,22,10,12,3.0,1.0,2.0
9408238,9,4,5,16,5,4,7,6,6.0,2.0,4.0,12.0,3.0,3.0,6.0,12,9,3,9.0,7.0,2.0
9411215,1,1,0,0,0,1,4,78,1.0,1.0,0.0,0.0,0.0,1.0,1.0,5,1,4,1.0,0.0,1.0
9904378,90,9,81,499,6,84,354,5,35.0,2.0,33.0,250.0,0.0,35.0,109.0,107,90,17,33.0,30.0,3.0
9502260,82,11,71,342,47,35,44,5,18.0,1.0,17.0,77.0,13.0,5.0,5.0,85,82,3,14.0,14.0,0.0
9810280,61,5,56,296,5,56,159,2,46.0,1.0,45.0,247.0,0.0,46.0,125.0,77,61,16,12.0,11.0,1.0
9803463,11,6,5,9,4,7,29,10,2.0,2.0,0.0,0.0,0.0,2.0,7.0,25,11,14,4.0,1.0,3.0
9711514,69,2,67,416,1,68,212,73,61.0,1.0,60.0,399.0,0.0,61.0,179.0,80,69,11,46.0,41.0,5.0
5103,10,4,6,8,0,10,50,73,7.0,1.0,6.0,8.0,0.0,7.0,41.0,22,10,12,15.0,7.0,8.0
9710347,8,5,3,5,0,8,55,42,5.0,4.0,1.0,2.0,0.0,5.0,37.0,25,8,17,12.0,3.0,9.0
9312250,4,3,1,1,4,0,0,324,2.0,1.0,1.0,1.0,2.0,0.0,0.0,4,4,0,1.0,1.0,0.0
9309204,5,2,3,5,5,0,0,543,1.0,1.0,0.0,0.0,1.0,0.0,0.0,5,5,0,1.0,1.0,0.0
9412272,36,5,31,90,34,2,2,92,14.0,1.0,13.0,33.0,14.0,0.0,0.0,37,36,1,8.0,8.0,0.0
9605313,16,5,11,23,1,15,15,109,9.0,2.0,7.0,15.0,0.0,9.0,9.0,20,16,4,9.0,8.0,1.0
9605412,37,5,32,150,14,23,46,92,25.0,3.0,22.0,98.0,7.0,18.0,35.0,42,37,5,24.0,21.0,3.0
9511402,53,3,50,236,4,49,165,4,30.0,4.0,26.0,152.0,2.0,28.0,68.0,75,53,22,12.0,6.0,6.0
9906206,85,11,74,483,8,77,469,32,62.0,6.0,56.0,406.0,1.0,61.0,395.0,99,85,14,48.0,39.0,9.0
9908450,28,15,13,32,22,6,6,28,6.0,2.0,4.0,11.0,6.0,0.0,0.0,30,28,2,3.0,3.0,0.0
9210202,2,1,1,1,2,0,0,107,1.0,1.0,0.0,0.0,1.0,0.0,0.0,2,2,0,1.0,1.0,0.0
9901399,14,8,6,13,4,10,38,82,10.0,6.0,4.0,9.0,2.0,8.0,30.0,21,14,7,10.0,4.0,6.0
9411239,46,9,37,161,35,11,15,41,18.0,4.0,14.0,51.0,18.0,0.0,0.0,52,46,6,18.0,18.0,0.0
9804228,11,4,7,14,1,10,26,21,7.0,1.0,6.0,11.0,0.0,7.0,21.0,30,11,19,11.0,8.0,3.0
9312329,14,1,13,36,5,9,17,41,3.0,1.0,2.0,3.0,1.0,2.0,4.0,17,14,3,9.0,6.0,3.0
9805486,11,6,5,7,4,7,20,41,5.0,3.0,2.0,3.0,0.0,5.0,15.0,28,11,17,11.0,2.0,9.0
9410323,2,2,0,0,2,0,0,84,,,,,,,,2,2,0,1.0,1.0,0.0
9504302,17,2,15,27,2,15,39,49,11.0,1.0,10.0,18.0,1.0,10.0,13.0,22,17,5,9.0,7.0,2.0
9502250,11,6,5,6,0,11,88,49,8.0,7.0,1.0,2.0,0.0,8.0,23.0,36,11,25,9.0,5.0,4.0
9712350,8,1,7,9,0,8,22,78,5.0,1.0,4.0,5.0,0.0,5.0,11.0,15,8,7,4.0,3.0,1.0
104267,18,3,15,33,3,15,62,23,12.0,1.0,11.0,26.0,1.0,11.0,36.0,31,18,13,6.0,4.0,2.0
11096,14,7,7,11,0,14,44,89,6.0,4.0,2.0,2.0,0.0,6.0,16.0,33,14,19,7.0,5.0,2.0
9512215,8,3,5,6,2,6,12,74,1.0,1.0,0.0,0.0,0.0,1.0,2.0,13,8,5,3.0,1.0,2.0
9508288,42,8,34,146,3,39,115,55,24.0,2.0,22.0,107.0,1.0,23.0,61.0,56,42,14,21.0,18.0,3.0
9804283,26,4,22,102,3,23,76,55,15.0,2.0,13.0,48.0,1.0,14.0,47.0,47,26,21,18.0,14.0,4.0
9903400,51,3,48,309,0,51,377,2,41.0,2.0,39.0,264.0,0.0,41.0,323.0,77,51,26,40.0,28.0,12.0
9807413,8,4,4,4,5,3,9,168,4.0,2.0,2.0,2.0,4.0,0.0,0.0,23,8,15,3.0,1.0,2.0
9804213,1,1,0,0,0,1,2,55,0.0,0.0,0.0,0.0,0.0,0.0,0.0,5,1,4,2.0,0.0,2.0
9912265,49,12,37,122,1,48,115,2,13.0,2.0,11.0,34.0,11.0,2.0,2.0,68,49,19,21.0,19.0,2.0
9703271,11,4,7,13,4,7,11,59,4.0,1.0,3.0,6.0,3.0,1.0,2.0,22,11,11,6.0,4.0,2.0
208092,0,0,0,0,0,0,0,18,0.0,0.0,0.0,0.0,0.0,0.0,0.0,49,0,49,20.0,0.0,20.0
9811300,5,1,4,6,2,3,28,5,2.0,1.0,1.0,1.0,0.0,2.0,10.0,22,5,17,9.0,3.0,6.0
6049,45,4,41,266,0,45,426,23,32.0,1.0,31.0,217.0,1.0,31.0,143.0,85,45,40,32.0,26.0,6.0
9510301,123,13,110,555,21,102,247,27,84.0,3.0,81.0,469.0,7.0,77.0,197.0,133,123,10,23.0,21.0,2.0
3219,90,15,75,444,7,83,446,0,23.0,4.0,19.0,106.0,0.0,23.0,231.0,128,90,38,36.0,23.0,13.0
9303231,18,8,10,19,13,5,8,75,9.0,5.0,4.0,9.0,6.0,3.0,4.0,22,18,4,7.0,5.0,2.0
7073,17,5,12,37,0,17,138,5,11.0,2.0,9.0,29.0,0.0,11.0,93.0,48,17,31,21.0,10.0,11.0
9805377,12,5,7,12,4,8,10,60,2.0,1.0,1.0,1.0,0.0,2.0,2.0,14,12,2,5.0,3.0,2.0
9305254,29,14,15,29,10,19,36,62,18.0,7.0,11.0,21.0,6.0,12.0,23.0,36,29,7,10.0,9.0,1.0
9912525,15,5,10,16,0,15,64,7,9.0,2.0,7.0,12.0,0.0,9.0,37.0,32,15,17,17.0,6.0,11.0
9803218,28,7,21,70,3,25,177,60,12.0,2.0,10.0,40.0,1.0,11.0,83.0,56,28,28,21.0,10.0,11.0
2293,45,11,34,150,4,41,162,0,26.0,4.0,22.0,121.0,5.0,21.0,62.0,77,45,32,12.0,8.0,4.0
9906456,10,5,5,14,0,10,246,0,9.0,4.0,5.0,14.0,0.0,9.0,217.0,58,10,48,40.0,8.0,32.0
9605379,11,2,9,16,11,0,0,97,6.0,1.0,5.0,8.0,6.0,0.0,0.0,11,11,0,6.0,6.0,0.0
9411255,19,6,13,17,5,14,14,10,10.0,3.0,7.0,10.0,0.0,10.0,10.0,20,19,1,1.0,1.0,0.0
9702398,9,4,5,8,2,7,7,118,7.0,2.0,5.0,8.0,2.0,5.0,5.0,12,9,3,3.0,3.0,0.0
9707363,11,3,8,12,4,7,9,118,6.0,2.0,4.0,5.0,0.0,6.0,8.0,13,11,2,6.0,5.0,1.0
9507336,18,9,9,19,2,16,53,35,7.0,3.0,4.0,7.0,1.0,6.0,14.0,48,18,30,5.0,2.0,3.0
9805208,56,7,49,232,2,54,130,16,28.0,2.0,26.0,136.0,0.0,28.0,54.0,61,56,5,27.0,25.0,2.0
9910490,1,1,0,0,0,1,3,66,0.0,0.0,0.0,0.0,0.0,0.0,0.0,11,1,10,4.0,0.0,4.0
9707224,33,5,28,144,3,30,90,19,22.0,1.0,21.0,126.0,3.0,19.0,45.0,45,33,12,11.0,7.0,4.0
9310313,81,15,66,480,78,3,3,8,28.0,3.0,25.0,163.0,28.0,0.0,0.0,83,81,2,20.0,20.0,0.0
9907434,10,5,5,11,0,10,27,210,3.0,2.0,1.0,1.0,0.0,3.0,6.0,24,10,14,5.0,1.0,4.0
9902459,1,1,0,0,0,1,1,52,0.0,0.0,0.0,0.0,0.0,0.0,0.0,5,1,4,,,
9502312,18,15,3,4,11,7,7,39,7.0,7.0,0.0,0.0,7.0,0.0,0.0,19,18,1,2.0,2.0,0.0
9706252,23,3,20,40,3,20,37,36,10.0,1.0,9.0,16.0,0.0,10.0,20.0,29,23,6,5.0,5.0,0.0
9909558,35,5,30,109,1,34,171,2,24.0,1.0,23.0,88.0,3.0,21.0,21.0,45,35,10,21.0,18.0,3.0
9907383,18,11,7,14,12,6,10,159,4.0,2.0,2.0,4.0,1.0,3.0,3.0,25,18,7,4.0,3.0,1.0
9904432,8,2,6,11,0,8,143,2,8.0,2.0,6.0,11.0,0.0,8.0,140.0,46,8,38,29.0,2.0,27.0
9606373,8,5,3,4,8,0,0,138,5.0,4.0,1.0,1.0,5.0,0.0,0.0,10,8,2,5.0,5.0,0.0
9709432,112,8,104,984,1,111,706,11,89.0,2.0,87.0,894.0,0.0,89.0,577.0,132,112,20,64.0,57.0,7.0
7032,29,1,28,159,0,29,167,19,26.0,1.0,25.0,147.0,0.0,26.0,136.0,40,29,11,30.0,23.0,7.0
8311,2,2,0,0,0,2,2,43,1.0,1.0,0.0,0.0,0.0,1.0,1.0,6,2,4,2.0,1.0,1.0
205023,3,3,0,0,0,3,10,33,1.0,1.0,0.0,0.0,0.0,1.0,4.0,34,3,31,12.0,0.0,12.0
12376,3,1,2,3,1,2,2,354,1.0,1.0,0.0,0.0,1.0,0.0,0.0,6,3,3,3.0,0.0,3.0
9205205,48,17,31,87,48,0,0,19,18.0,6.0,12.0,25.0,18.0,0.0,0.0,48,48,0,8.0,8.0,0.0
208050,2,1,1,1,0,2,16,19,2.0,1.0,1.0,1.0,0.0,2.0,16.0,15,2,13,13.0,2.0,11.0
2257,35,4,31,162,0,35,237,28,25.0,3.0,22.0,119.0,3.0,22.0,40.0,60,35,25,13.0,9.0,4.0
9319,4,1,3,4,0,4,34,28,3.0,1.0,2.0,3.0,0.0,3.0,8.0,20,4,16,5.0,1.0,4.0
9910498,24,2,22,63,0,24,115,2,16.0,4.0,12.0,33.0,0.0,16.0,49.0,34,24,10,17.0,13.0,4.0
9807358,117,15,102,449,5,112,769,9,65.0,5.0,60.0,310.0,0.0,65.0,502.0,163,117,46,56.0,29.0,27.0
9605250,34,12,22,46,14,20,45,91,18.0,5.0,13.0,26.0,13.0,5.0,8.0,47,34,13,10.0,8.0,2.0
7100,11,3,8,18,0,11,58,2,9.0,1.0,8.0,16.0,9.0,0.0,0.0,20,11,9,11.0,9.0,2.0
12306,6,3,3,4,0,6,22,2,2.0,2.0,0.0,0.0,0.0,2.0,6.0,13,6,7,2.0,1.0,1.0
9911421,29,11,18,34,3,26,79,37,8.0,4.0,4.0,7.0,3.0,5.0,9.0,39,29,10,1.0,1.0,0.0
8087,13,3,10,28,0,13,64,2,7.0,1.0,6.0,19.0,0.0,7.0,7.0,43,13,30,8.0,7.0,1.0
9709397,52,4,48,268,9,43,133,10,31.0,3.0,28.0,156.0,2.0,29.0,79.0,59,52,7,31.0,27.0,4.0
9409329,40,5,35,163,20,20,26,37,14.0,1.0,13.0,62.0,14.0,0.0,0.0,42,40,2,15.0,15.0,0.0
6217,6,3,3,3,0,6,27,2,0.0,0.0,0.0,0.0,0.0,0.0,0.0,25,6,19,2.0,2.0,0.0
9501323,14,7,7,10,8,6,8,266,7.0,4.0,3.0,4.0,5.0,2.0,2.0,18,14,4,4.0,4.0,0.0
1069,5,1,4,5,0,5,12,28,4.0,0.0,4.0,5.0,0.0,4.0,8.0,16,5,11,7.0,4.0,3.0
9508320,8,3,5,12,0,8,45,3,5.0,3.0,2.0,4.0,0.0,5.0,26.0,22,8,14,5.0,2.0,3.0
1039,11,4,7,9,2,9,21,0,4.0,1.0,3.0,4.0,1.0,3.0,3.0,37,11,26,2.0,2.0,0.0
9910316,17,6,11,26,3,14,54,28,10.0,2.0,8.0,17.0,1.0,9.0,34.0,31,17,14,13.0,7.0,6.0
9905369,19,13,6,7,7,12,42,4,6.0,3.0,3.0,3.0,4.0,2.0,2.0,62,19,43,6.0,5.0,1.0
9903360,1,1,0,0,1,0,0,1176,0.0,0.0,0.0,0.0,0.0,0.0,0.0,4,1,3,1.0,1.0,0.0
203004,1,1,0,0,0,1,2,1,1.0,1.0,0.0,0.0,1.0,0.0,0.0,14,1,13,1.0,1.0,0.0
5299,1,1,0,0,0,1,1,152,0.0,0.0,0.0,0.0,0.0,0.0,0.0,12,1,11,5.0,0.0,5.0
101066,4,3,1,1,0,4,24,7,2.0,2.0,0.0,0.0,0.0,2.0,6.0,29,4,25,2.0,0.0,2.0
9810400,8,3,5,9,1,7,51,25,2.0,1.0,1.0,1.0,0.0,2.0,13.0,29,8,21,1.0,1.0,0.0
9408375,12,7,5,8,11,1,1,61,3.0,3.0,0.0,0.0,3.0,0.0,0.0,18,12,6,3.0,3.0,0.0
9805438,26,8,18,50,21,5,5,79,16.0,2.0,14.0,40.0,12.0,4.0,4.0,27,26,1,11.0,11.0,0.0
9310330,18,5,13,25,18,0,0,72,8.0,3.0,5.0,11.0,8.0,0.0,0.0,18,18,0,2.0,2.0,0.0
9812448,205,11,194,1635,205,0,0,9,122.0,1.0,121.0,1197.0,122.0,0.0,0.0,205,205,0,49.0,49.0,0.0
9307248,15,4,11,20,12,3,3,57,8.0,2.0,6.0,12.0,8.0,0.0,0.0,16,15,1,3.0,3.0,0.0
9512320,28,2,26,114,0,28,60,17,24.0,1.0,23.0,104.0,0.0,24.0,53.0,32,28,4,23.0,19.0,4.0
9509308,51,7,44,115,0,51,356,17,44.0,5.0,39.0,104.0,0.0,44.0,331.0,65,51,14,35.0,25.0,10.0
9703428,19,11,8,12,6,13,39,26,2.0,2.0,0.0,0.0,0.0,2.0,7.0,38,19,19,9.0,2.0,7.0
9609298,11,8,3,4,2,9,35,26,5.0,2.0,3.0,4.0,0.0,5.0,26.0,22,11,11,8.0,2.0,6.0
9708306,24,4,20,83,1,23,59,24,18.0,2.0,16.0,76.0,5.0,13.0,13.0,32,24,8,10.0,6.0,4.0
103326,1,1,0,0,0,1,3,425,1.0,1.0,0.0,0.0,0.0,1.0,2.0,6,1,5,4.0,1.0,3.0
9512384,15,4,11,19,4,11,27,104,4.0,2.0,2.0,2.0,1.0,3.0,6.0,25,15,10,6.0,2.0,4.0
9205236,1,1,0,0,1,0,0,1196,,,,,,,,1,1,0,,,
9209258,9,3,6,11,9,0,0,112,7.0,3.0,4.0,6.0,7.0,0.0,0.0,9,9,0,4.0,4.0,0.0
107271,9,2,7,13,1,8,79,4,4.0,1.0,3.0,5.0,0.0,4.0,33.0,46,9,37,16.0,4.0,12.0
9705345,24,5,19,60,6,18,87,7,11.0,2.0,9.0,24.0,0.0,11.0,67.0,39,24,15,10.0,8.0,2.0
9806206,1,1,0,0,0,1,3,7,0.0,0.0,0.0,0.0,0.0,0.0,0.0,30,1,29,1.0,0.0,1.0
9603417,32,5,27,143,1,31,64,29,25.0,1.0,24.0,135.0,1.0,24.0,42.0,40,32,8,26.0,23.0,3.0
9502379,2,2,0,0,1,1,1,492,2.0,2.0,0.0,0.0,2.0,0.0,0.0,4,2,2,2.0,1.0,1.0
9702319,21,6,15,61,8,13,46,137,19.0,6.0,13.0,54.0,6.0,13.0,46.0,25,21,4,17.0,13.0,4.0
9707515,32,9,23,54,5,27,121,54,6.0,5.0,1.0,1.0,0.0,6.0,28.0,51,32,19,12.0,5.0,7.0
9809443,43,10,33,102,0,43,247,54,31.0,6.0,25.0,79.0,1.0,30.0,145.0,74,43,31,25.0,14.0,11.0
9711368,9,7,2,2,1,8,31,27,0.0,0.0,0.0,0.0,0.0,0.0,0.0,35,9,26,4.0,0.0,4.0
9911434,50,5,45,141,3,47,422,24,23.0,2.0,21.0,77.0,0.0,23.0,217.0,99,50,49,20.0,11.0,9.0
9902276,11,7,4,9,6,5,8,126,5.0,4.0,1.0,1.0,2.0,3.0,6.0,13,11,2,5.0,3.0,2.0
9808434,15,6,9,18,11,4,5,224,6.0,2.0,4.0,6.0,3.0,3.0,3.0,23,15,8,7.0,5.0,2.0
9708280,7,6,1,1,5,2,2,112,3.0,2.0,1.0,1.0,3.0,0.0,0.0,9,7,2,2.0,2.0,0.0
105324,13,3,10,25,0,13,37,9,13.0,3.0,10.0,25.0,0.0,13.0,34.0,22,13,9,9.0,7.0,2.0
104117,9,3,6,11,0,9,72,9,5.0,1.0,4.0,7.0,0.0,5.0,45.0,29,9,20,7.0,4.0,3.0
9707208,41,15,26,75,3,38,144,27,20.0,7.0,13.0,24.0,1.0,19.0,35.0,52,41,11,12.0,10.0,2.0
9512250,9,3,6,6,3,6,19,14,5.0,2.0,3.0,3.0,1.0,4.0,9.0,20,9,11,2.0,2.0,0.0
9703363,26,10,16,36,9,17,72,14,4.0,1.0,3.0,3.0,0.0,4.0,18.0,48,26,22,11.0,4.0,7.0
9604331,13,4,9,19,1,12,29,41,7.0,2.0,5.0,8.0,1.0,6.0,12.0,21,13,8,5.0,2.0,3.0
9902280,20,8,12,31,5,15,93,14,5.0,1.0,4.0,7.0,0.0,5.0,38.0,75,20,55,12.0,11.0,1.0
9608245,12,6,6,11,6,6,10,280,5.0,2.0,3.0,6.0,3.0,2.0,2.0,18,12,6,8.0,7.0,1.0
109195,1,1,0,0,0,1,3,227,1.0,1.0,0.0,0.0,0.0,1.0,2.0,4,1,3,3.0,1.0,2.0
9507210,14,7,7,15,14,0,0,76,6.0,3.0,3.0,4.0,6.0,0.0,0.0,15,14,1,6.0,6.0,0.0
9810357,7,1,6,15,0,7,11,118,6.0,1.0,5.0,13.0,0.0,6.0,10.0,13,7,6,8.0,6.0,2.0
9801252,23,5,18,69,0,23,213,9,17.0,4.0,13.0,52.0,0.0,17.0,164.0,61,23,38,30.0,11.0,19.0
9701404,20,2,18,62,1,19,50,17,13.0,2.0,11.0,41.0,3.0,10.0,13.0,33,20,13,13.0,12.0,1.0
9509236,22,5,17,29,12,10,17,14,7.0,2.0,5.0,7.0,1.0,6.0,12.0,29,22,7,6.0,6.0,0.0
9609425,3,2,1,1,3,0,0,16,2.0,1.0,1.0,1.0,2.0,0.0,0.0,26,3,23,3.0,0.0,3.0
9602227,1,1,0,0,0,1,1,2088,0.0,0.0,0.0,0.0,0.0,0.0,0.0,2,1,1,1.0,0.0,1.0
9706233,3,2,1,1,0,3,6,16,3.0,2.0,1.0,1.0,0.0,3.0,6.0,6,3,3,1.0,1.0,0.0
9710242,3,2,1,1,3,0,0,244,1.0,1.0,0.0,0.0,1.0,0.0,0.0,6,3,3,1.0,1.0,0.0
9302300,6,5,1,1,6,0,0,184,2.0,2.0,0.0,0.0,2.0,0.0,0.0,6,6,0,2.0,2.0,0.0
9412237,9,5,4,8,0,9,30,18,2.0,2.0,0.0,0.0,0.0,2.0,7.0,23,9,14,6.0,1.0,5.0
9610204,22,3,19,46,7,15,27,97,17.0,3.0,14.0,35.0,3.0,14.0,26.0,26,22,4,16.0,14.0,2.0
9612337,11,1,10,31,0,11,84,15,10.0,1.0,9.0,30.0,0.0,10.0,75.0,24,11,13,18.0,9.0,9.0
9401265,23,7,16,42,6,17,40,15,12.0,3.0,9.0,23.0,0.0,12.0,28.0,30,23,7,4.0,3.0,1.0
9503350,14,8,6,8,1,13,30,90,2.0,2.0,0.0,0.0,0.0,2.0,5.0,22,14,8,5.0,2.0,3.0
9406369,11,3,8,28,0,11,58,15,11.0,3.0,8.0,28.0,0.0,11.0,56.0,29,11,18,5.0,1.0,4.0
9607289,11,5,6,10,1,10,32,16,5.0,1.0,4.0,5.0,0.0,5.0,21.0,18,11,7,7.0,4.0,3.0
9508357,5,2,3,6,5,0,0,33,4.0,2.0,2.0,4.0,4.0,0.0,0.0,5,5,0,1.0,1.0,0.0
108147,11,3,8,15,0,11,33,0,9.0,2.0,7.0,12.0,0.0,9.0,21.0,21,11,10,4.0,3.0,1.0
9607279,18,3,15,30,0,18,48,0,5.0,3.0,2.0,4.0,1.0,4.0,7.0,30,18,12,7.0,5.0,2.0
9807511,4,3,1,1,3,1,1,327,0.0,0.0,0.0,0.0,0.0,0.0,0.0,6,4,2,1.0,0.0,1.0
9903552,2,1,1,1,0,2,6,1717,1.0,1.0,0.0,0.0,0.0,1.0,2.0,8,2,6,5.0,2.0,3.0
9510284,21,8,13,55,11,10,12,52,16.0,5.0,11.0,46.0,8.0,8.0,8.0,25,21,4,10.0,9.0,1.0
9907418,6,2,4,7,0,6,10,52,3.0,1.0,2.0,3.0,0.0,3.0,6.0,8,6,2,5.0,3.0,2.0
9406343,6,2,4,6,4,2,2,15,3.0,2.0,1.0,1.0,3.0,0.0,0.0,7,6,1,2.0,2.0,0.0
9507215,11,5,6,15,9,2,2,206,6.0,1.0,5.0,14.0,6.0,0.0,0.0,14,11,3,6.0,6.0,0.0
9807320,17,4,13,23,0,17,39,74,6.0,2.0,4.0,6.0,6.0,0.0,0.0,29,17,12,8.0,7.0,1.0
101160,1,1,0,0,0,1,4,120,0.0,0.0,0.0,0.0,0.0,0.0,0.0,18,1,17,10.0,0.0,10.0
8103,15,10,5,5,1,14,65,5,3.0,2.0,1.0,1.0,0.0,3.0,13.0,30,15,15,4.0,1.0,3.0
9604405,2,2,0,0,2,0,0,343,1.0,1.0,0.0,0.0,1.0,0.0,0.0,2,2,0,1.0,1.0,0.0
9709497,6,3,3,3,1,5,18,8,0.0,0.0,0.0,0.0,0.0,0.0,0.0,19,6,13,3.0,3.0,0.0
8228,5,3,2,2,1,4,31,18,2.0,1.0,1.0,1.0,0.0,2.0,13.0,25,5,20,11.0,3.0,8.0
9405334,1,1,0,0,1,0,0,944,1.0,1.0,0.0,0.0,1.0,0.0,0.0,1,1,0,,,
9911510,7,4,3,4,1,6,49,5,4.0,2.0,2.0,3.0,0.0,4.0,13.0,34,7,27,1.0,1.0,0.0
9607382,16,6,10,22,3,13,60,15,9.0,3.0,6.0,17.0,0.0,9.0,39.0,33,16,17,5.0,1.0,4.0
9811469,16,11,5,7,16,0,0,22,2.0,2.0,0.0,0.0,2.0,0.0,0.0,16,16,0,3.0,3.0,0.0
9807248,4,2,2,2,0,4,4,123,4.0,2.0,2.0,2.0,0.0,4.0,4.0,5,4,1,4.0,3.0,1.0
9807375,16,4,12,63,1,15,43,49,15.0,4.0,11.0,56.0,1.0,14.0,34.0,21,16,5,14.0,12.0,2.0
9511206,13,9,4,5,2,11,35,35,7.0,5.0,2.0,2.0,1.0,6.0,21.0,52,13,39,10.0,0.0,10.0
9411245,7,3,4,9,7,0,0,44,4.0,1.0,3.0,5.0,4.0,0.0,0.0,7,7,0,1.0,1.0,0.0
9512437,14,9,5,9,5,9,25,71,5.0,3.0,2.0,2.0,2.0,3.0,5.0,22,14,8,6.0,4.0,2.0
9612260,78,19,59,289,9,69,203,30,29.0,3.0,26.0,120.0,9.0,20.0,26.0,91,78,13,19.0,17.0,2.0
1215,6,4,2,2,4,2,2,95,1.0,1.0,0.0,0.0,1.0,0.0,0.0,9,6,3,1.0,1.0,0.0
9911522,11,8,3,7,0,11,80,32,6.0,3.0,3.0,7.0,0.0,6.0,10.0,34,11,23,14.0,5.0,9.0
9902363,1,1,0,0,1,0,0,246,0.0,0.0,0.0,0.0,0.0,0.0,0.0,6,1,5,4.0,0.0,4.0
8041,20,3,17,56,0,20,117,73,13.0,2.0,11.0,37.0,0.0,13.0,31.0,39,20,19,19.0,14.0,5.0
2172,5,5,0,0,1,4,13,2,1.0,1.0,0.0,0.0,1.0,0.0,0.0,13,5,8,2.0,1.0,1.0
9509374,22,2,20,49,11,11,17,13,9.0,1.0,8.0,11.0,4.0,5.0,7.0,25,22,3,8.0,8.0,0.0
9907519,15,10,5,5,8,7,9,5,2.0,2.0,0.0,0.0,2.0,0.0,0.0,18,15,3,4.0,3.0,1.0
9710266,13,9,4,6,2,11,22,14,3.0,2.0,1.0,1.0,3.0,0.0,0.0,19,13,6,3.0,3.0,0.0
9812490,4,3,1,1,0,4,21,9,3.0,2.0,1.0,1.0,0.0,3.0,12.0,25,4,21,9.0,2.0,7.0
101105,7,5,2,2,0,7,56,12,2.0,2.0,0.0,0.0,0.0,2.0,8.0,94,7,87,13.0,1.0,12.0
9306229,29,6,23,113,4,25,25,36,24.0,4.0,20.0,86.0,4.0,20.0,20.0,30,29,1,18.0,17.0,1.0
9508349,12,6,6,11,5,7,19,74,2.0,2.0,0.0,0.0,1.0,1.0,5.0,26,12,14,8.0,2.0,6.0
110050,4,4,0,0,2,2,2,312,1.0,1.0,0.0,0.0,1.0,0.0,0.0,6,4,2,1.0,1.0,0.0
206064,3,3,0,0,0,3,14,32,0.0,0.0,0.0,0.0,0.0,0.0,0.0,30,3,27,4.0,0.0,4.0
9404213,7,4,3,9,7,0,0,218,5.0,2.0,3.0,9.0,5.0,0.0,0.0,7,7,0,5.0,5.0,0.0
9604416,66,7,59,244,19,47,100,89,36.0,2.0,34.0,162.0,4.0,32.0,32.0,76,66,10,25.0,24.0,1.0
9811294,14,10,4,8,0,14,47,8,2.0,2.0,0.0,0.0,0.0,2.0,9.0,43,14,29,16.0,3.0,13.0
9506216,6,3,3,4,3,3,3,2130,1.0,1.0,0.0,0.0,1.0,0.0,0.0,7,6,1,1.0,1.0,0.0
102342,5,5,0,0,3,2,2,373,1.0,1.0,0.0,0.0,1.0,0.0,0.0,6,5,1,,,
210050,0,0,0,0,0,0,0,21,0.0,0.0,0.0,0.0,0.0,0.0,0.0,27,0,27,10.0,0.0,10.0
9303271,10,7,3,4,10,0,0,54,5.0,5.0,0.0,0.0,5.0,0.0,0.0,10,10,0,2.0,2.0,0.0
9511224,5,5,0,0,3,2,11,134,1.0,1.0,0.0,0.0,0.0,1.0,3.0,31,5,26,11.0,1.0,10.0
9906417,9,6,3,3,0,9,72,21,5.0,3.0,2.0,2.0,0.0,5.0,47.0,32,9,23,13.0,3.0,10.0
9504360,19,4,15,39,19,0,0,1,9.0,1.0,8.0,14.0,9.0,0.0,0.0,19,19,0,10.0,10.0,0.0
9906313,11,3,8,11,2,9,37,48,2.0,2.0,0.0,0.0,0.0,2.0,6.0,21,11,10,6.0,2.0,4.0
9903457,7,4,3,4,6,1,4,24,4.0,1.0,3.0,4.0,4.0,0.0,0.0,12,7,5,2.0,2.0,0.0
9602246,30,9,21,47,3,27,66,57,18.0,5.0,13.0,25.0,1.0,17.0,54.0,38,30,8,14.0,10.0,4.0
9804244,4,4,0,0,0,4,9,154,4.0,4.0,0.0,0.0,0.0,4.0,9.0,9,4,5,5.0,4.0,1.0
9706320,7,3,4,5,4,3,4,19,2.0,1.0,1.0,1.0,1.0,1.0,2.0,11,7,4,1.0,1.0,0.0
9610532,6,3,3,5,0,6,6,432,5.0,2.0,3.0,5.0,5.0,0.0,0.0,9,6,3,6.0,5.0,1.0
9508255,18,4,14,33,0,18,55,85,7.0,2.0,5.0,8.0,0.0,7.0,10.0,32,18,14,5.0,1.0,4.0
12053,9,7,2,2,1,8,14,126,3.0,2.0,1.0,1.0,0.0,3.0,7.0,14,9,5,2.0,1.0,1.0
9308244,13,8,5,8,9,4,5,85,2.0,1.0,1.0,1.0,2.0,0.0,0.0,17,13,4,4.0,4.0,0.0
1200,3,2,1,2,0,3,28,85,2.0,1.0,1.0,1.0,0.0,2.0,14.0,25,3,22,10.0,2.0,8.0
9607261,2,2,0,0,2,0,0,5,1.0,1.0,0.0,0.0,1.0,0.0,0.0,5,2,3,1.0,1.0,0.0
9606483,18,4,14,48,3,15,58,90,13.0,2.0,11.0,37.0,1.0,12.0,26.0,28,18,10,16.0,13.0,3.0
9812487,20,6,14,47,0,20,130,8,17.0,4.0,13.0,42.0,0.0,17.0,119.0,33,20,13,26.0,13.0,13.0
9405217,6,5,1,2,2,4,4,183,2.0,2.0,0.0,0.0,2.0,0.0,0.0,7,6,1,1.0,1.0,0.0
104134,5,1,4,7,0,5,42,22,5.0,1.0,4.0,7.0,0.0,5.0,36.0,26,5,21,12.0,5.0,7.0
9912331,2,2,0,0,1,1,1,375,1.0,1.0,0.0,0.0,0.0,1.0,1.0,4,2,2,3.0,1.0,2.0
111172,7,2,5,6,0,7,18,0,7.0,2.0,5.0,6.0,0.0,7.0,17.0,23,7,16,2.0,0.0,2.0
104266,14,6,8,15,5,9,29,0,5.0,4.0,1.0,3.0,3.0,2.0,2.0,31,14,17,7.0,5.0,2.0
9604359,6,4,2,2,1,5,19,200,4.0,2.0,2.0,2.0,0.0,4.0,16.0,19,6,13,10.0,4.0,6.0
9611303,2,1,1,1,0,2,3,1,0.0,0.0,0.0,0.0,0.0,0.0,0.0,11,2,9,1.0,0.0,1.0
1310,37,7,30,113,1,36,202,3,27.0,5.0,22.0,92.0,0.0,27.0,172.0,62,37,25,12.0,10.0,2.0
9507409,6,5,1,1,3,3,4,35,0.0,0.0,0.0,0.0,0.0,0.0,0.0,20,6,14,2.0,2.0,0.0
9610504,10,4,6,11,1,9,30,12,4.0,2.0,2.0,2.0,1.0,3.0,5.0,22,10,12,4.0,2.0,2.0
9906530,8,2,6,7,2,6,15,0,6.0,1.0,5.0,6.0,1.0,5.0,12.0,17,8,9,1.0,0.0,1.0
7157,14,4,10,20,0,14,224,12,10.0,2.0,8.0,15.0,0.0,10.0,175.0,60,14,46,31.0,7.0,24.0
9280,3,2,1,1,1,2,10,3,1.0,1.0,0.0,0.0,1.0,0.0,0.0,16,3,13,2.0,0.0,2.0
9812316,28,6,22,31,2,26,97,9,16.0,3.0,13.0,18.0,0.0,16.0,42.0,41,28,13,10.0,8.0,2.0
9604236,15,8,7,7,3,12,35,10,7.0,3.0,4.0,4.0,1.0,6.0,8.0,28,15,13,6.0,4.0,2.0
9912323,1,1,0,0,1,0,0,235,1.0,1.0,0.0,0.0,1.0,0.0,0.0,6,1,5,1.0,1.0,0.0
9706472,12,6,6,8,10,2,2,67,4.0,4.0,0.0,0.0,4.0,0.0,0.0,13,12,1,3.0,3.0,0.0
9606424,3,2,1,1,1,2,3,152,0.0,0.0,0.0,0.0,0.0,0.0,0.0,7,3,4,2.0,0.0,2.0
103105,14,4,10,34,2,12,123,23,10.0,2.0,8.0,31.0,0.0,10.0,120.0,39,14,25,18.0,8.0,10.0
9310379,126,20,106,552,41,85,384,53,67.0,6.0,61.0,425.0,2.0,65.0,321.0,137,126,11,52.0,45.0,7.0
9505229,1,1,0,0,1,0,0,206,0.0,0.0,0.0,0.0,0.0,0.0,0.0,4,1,3,1.0,0.0,1.0
9402243,42,5,37,147,0,42,136,56,41.0,5.0,36.0,146.0,0.0,41.0,135.0,48,42,6,33.0,28.0,5.0
9510455,12,3,9,15,1,11,22,26,5.0,2.0,3.0,5.0,0.0,5.0,5.0,31,12,19,3.0,2.0,1.0
9505277,11,4,7,14,1,10,14,25,10.0,3.0,7.0,14.0,0.0,10.0,14.0,13,11,2,10.0,8.0,2.0
9710286,13,1,12,28,0,13,82,92,11.0,1.0,10.0,22.0,0.0,11.0,65.0,27,13,14,19.0,11.0,8.0
9612440,21,6,15,30,7,14,37,41,10.0,3.0,7.0,12.0,1.0,9.0,20.0,42,21,21,11.0,4.0,7.0
9508402,8,2,6,11,1,7,35,10,6.0,1.0,5.0,9.0,0.0,6.0,19.0,21,8,13,11.0,5.0,6.0
201008,29,4,25,90,19,10,13,3,4.0,2.0,2.0,3.0,1.0,3.0,3.0,32,29,3,3.0,3.0,0.0
9912315,11,2,9,19,1,10,32,12,2.0,2.0,0.0,0.0,0.0,2.0,9.0,40,11,29,2.0,0.0,2.0
9707540,14,4,10,28,1,13,162,15,12.0,4.0,8.0,26.0,0.0,12.0,144.0,61,14,47,26.0,8.0,18.0
9211238,4,1,3,5,4,0,0,176,4.0,1.0,3.0,5.0,4.0,0.0,0.0,4,4,0,,,
9702312,6,6,0,0,2,4,24,7,0.0,0.0,0.0,0.0,0.0,0.0,0.0,43,6,37,3.0,0.0,3.0
9710551,9,6,3,3,4,5,27,1,1.0,1.0,0.0,0.0,0.0,1.0,9.0,55,9,46,14.0,0.0,14.0
9907350,5,3,2,2,0,5,12,66,1.0,1.0,0.0,0.0,0.0,1.0,2.0,11,5,6,3.0,3.0,0.0
9607408,27,8,19,47,5,22,22,260,15.0,3.0,12.0,30.0,2.0,13.0,13.0,29,27,2,14.0,13.0,1.0
107123,12,3,9,19,0,12,50,0,9.0,3.0,6.0,8.0,0.0,9.0,35.0,22,12,10,14.0,9.0,5.0
204049,5,3,2,4,0,5,24,3,1.0,1.0,0.0,0.0,0.0,1.0,3.0,23,5,18,4.0,1.0,3.0
12357,18,3,15,43,1,17,72,0,8.0,2.0,6.0,19.0,0.0,8.0,54.0,30,18,12,18.0,9.0,9.0
9605300,2,2,0,0,2,0,0,289,1.0,1.0,0.0,0.0,1.0,0.0,0.0,2,2,0,1.0,1.0,0.0
110307,21,7,14,37,0,21,134,0,12.0,1.0,11.0,31.0,0.0,12.0,78.0,59,21,38,17.0,9.0,8.0
9509370,11,3,8,23,2,9,9,82,8.0,2.0,6.0,14.0,0.0,8.0,8.0,13,11,2,3.0,2.0,1.0
210058,8,6,2,5,0,8,97,5,4.0,3.0,1.0,3.0,0.0,4.0,10.0,65,8,57,3.0,1.0,2.0
9907331,10,3,7,17,1,9,31,81,1.0,1.0,0.0,0.0,0.0,1.0,7.0,52,10,42,7.0,0.0,7.0
104230,7,2,5,10,0,7,47,47,6.0,1.0,5.0,10.0,0.0,6.0,34.0,24,7,17,16.0,5.0,11.0
9806302,0,0,0,0,0,0,0,493,0.0,0.0,0.0,0.0,0.0,0.0,0.0,1,0,1,1.0,0.0,1.0
110303,9,2,7,11,0,9,111,3,6.0,2.0,4.0,5.0,0.0,6.0,71.0,44,9,35,10.0,4.0,6.0
109027,5,3,2,4,0,5,13,283,2.0,2.0,0.0,0.0,0.0,2.0,4.0,17,5,12,6.0,0.0,6.0
10068,4,2,2,3,0,4,8,5,0.0,0.0,0.0,0.0,0.0,0.0,0.0,25,4,21,1.0,0.0,1.0
9709344,52,15,37,83,40,12,13,65,17.0,4.0,13.0,36.0,8.0,9.0,10.0,56,52,4,13.0,12.0,1.0
207003,9,2,7,17,0,9,140,28,8.0,1.0,7.0,17.0,0.0,8.0,113.0,39,9,30,27.0,8.0,19.0
9903386,8,3,5,5,5,3,8,58,4.0,2.0,2.0,2.0,4.0,0.0,0.0,16,8,8,3.0,3.0,0.0
9504404,18,5,13,22,1,17,40,13,10.0,2.0,8.0,14.0,1.0,9.0,9.0,26,18,8,10.0,9.0,1.0
9905330,5,5,0,0,0,5,72,10,3.0,3.0,0.0,0.0,0.0,3.0,37.0,36,5,31,8.0,2.0,6.0
110097,8,5,3,3,1,7,52,54,5.0,2.0,3.0,3.0,0.0,5.0,33.0,27,8,19,10.0,4.0,6.0
106240,16,3,13,30,0,16,243,11,14.0,2.0,12.0,28.0,0.0,14.0,209.0,70,16,54,34.0,11.0,23.0
107299,5,2,3,5,0,5,42,13,3.0,1.0,2.0,3.0,0.0,3.0,20.0,27,5,22,6.0,1.0,5.0
9709354,32,5,27,75,3,29,87,13,10.0,2.0,8.0,20.0,0.0,10.0,34.0,44,32,12,11.0,6.0,5.0
9709419,17,6,11,28,6,11,18,65,5.0,2.0,3.0,4.0,5.0,0.0,0.0,21,17,4,8.0,7.0,1.0
9908423,8,7,1,1,1,7,25,110,4.0,3.0,1.0,1.0,0.0,4.0,11.0,19,8,11,11.0,3.0,8.0
9507452,10,2,8,17,0,10,40,15,5.0,2.0,3.0,3.0,1.0,4.0,8.0,18,10,8,12.0,9.0,3.0
9606292,3,3,0,0,1,2,18,71,2.0,2.0,0.0,0.0,0.0,2.0,18.0,20,3,17,17.0,2.0,15.0
9611321,5,3,2,2,0,5,45,17,5.0,3.0,2.0,2.0,0.0,5.0,44.0,29,5,24,22.0,2.0,20.0
9712491,1,1,0,0,1,0,0,75,0.0,0.0,0.0,0.0,0.0,0.0,0.0,21,1,20,2.0,0.0,2.0
111385,4,1,3,6,3,1,5,23,3.0,1.0,2.0,3.0,3.0,0.0,0.0,15,4,11,4.0,4.0,0.0
9708459,7,4,3,5,1,6,27,101,6.0,3.0,3.0,5.0,0.0,6.0,21.0,15,7,8,5.0,4.0,1.0
9402297,1,1,0,0,1,0,0,886,,,,,,,,2,1,1,,,
9710349,6,3,3,6,0,6,6,8,1.0,1.0,0.0,0.0,0.0,1.0,1.0,8,6,2,1.0,1.0,0.0
9306288,1,1,0,0,1,0,0,117,,,,,,,,2,1,1,,,
9701377,1,1,0,0,1,0,0,58,0.0,0.0,0.0,0.0,0.0,0.0,0.0,20,1,19,3.0,0.0,3.0
9310222,9,7,2,3,8,1,1,40,6.0,4.0,2.0,3.0,5.0,1.0,1.0,11,9,2,1.0,0.0,1.0
9908271,7,5,2,3,0,7,28,128,5.0,4.0,1.0,2.0,0.0,5.0,18.0,20,7,13,9.0,4.0,5.0
9711367,5,2,3,3,0,5,10,109,0.0,0.0,0.0,0.0,0.0,0.0,0.0,8,5,3,2.0,1.0,1.0
9302301,14,9,5,7,13,1,1,173,2.0,1.0,1.0,1.0,2.0,0.0,0.0,15,14,1,2.0,2.0,0.0
9403351,15,5,10,19,15,0,0,315,6.0,4.0,2.0,3.0,6.0,0.0,0.0,15,15,0,3.0,3.0,0.0
9612399,6,3,3,3,6,0,0,157,4.0,1.0,3.0,3.0,4.0,0.0,0.0,6,6,0,3.0,3.0,0.0
9912363,4,3,1,1,2,2,14,50,0.0,0.0,0.0,0.0,0.0,0.0,0.0,15,4,11,5.0,0.0,5.0
9602309,22,6,16,31,3,19,52,29,13.0,2.0,11.0,21.0,1.0,12.0,22.0,38,22,16,12.0,10.0,2.0
102271,10,9,1,1,2,8,17,19,1.0,1.0,0.0,0.0,0.0,1.0,1.0,25,10,15,4.0,1.0,3.0
9806215,4,1,3,3,1,3,3,160,4.0,1.0,3.0,3.0,1.0,3.0,3.0,7,4,3,4.0,3.0,1.0
110102,12,7,5,9,1,11,11,37,5.0,2.0,3.0,4.0,5.0,0.0,0.0,13,12,1,3.0,3.0,0.0
109052,7,5,2,2,0,7,87,20,7.0,5.0,2.0,2.0,0.0,7.0,87.0,42,7,35,35.0,2.0,33.0
9706539,6,3,3,3,2,4,4,79,1.0,1.0,0.0,0.0,1.0,0.0,0.0,15,6,9,1.0,1.0,0.0
9410335,2,2,0,0,0,2,3,413,1.0,1.0,0.0,0.0,0.0,1.0,2.0,8,2,6,4.0,1.0,3.0
9609523,4,2,2,2,2,2,3,225,2.0,1.0,1.0,1.0,0.0,2.0,3.0,8,4,4,3.0,2.0,1.0
9602301,13,8,5,12,8,5,6,77,6.0,1.0,5.0,11.0,4.0,2.0,2.0,16,13,3,6.0,6.0,0.0
9702324,3,2,1,1,2,1,3,50,0.0,0.0,0.0,0.0,0.0,0.0,0.0,6,3,3,,,
9907205,6,4,2,4,0,6,25,58,3.0,2.0,1.0,1.0,0.0,3.0,14.0,16,6,10,3.0,2.0,1.0
9809513,11,1,10,24,0,11,65,8,11.0,1.0,10.0,24.0,0.0,11.0,61.0,36,11,25,20.0,11.0,9.0
9806390,20,1,19,52,0,20,42,9,6.0,3.0,3.0,4.0,6.0,0.0,0.0,29,20,9,10.0,9.0,1.0
9503496,4,4,0,0,4,0,0,389,3.0,3.0,0.0,0.0,3.0,0.0,0.0,4,4,0,2.0,2.0,0.0
9510243,4,2,2,3,0,4,7,14,1.0,1.0,0.0,0.0,1.0,0.0,0.0,8,4,4,1.0,0.0,1.0
9901429,19,4,15,40,0,19,146,9,17.0,3.0,14.0,37.0,0.0,17.0,114.0,39,19,20,22.0,10.0,12.0
9705275,14,4,10,19,1,13,60,51,12.0,4.0,8.0,15.0,1.0,11.0,50.0,26,14,12,12.0,6.0,6.0
9810370,14,10,4,6,2,12,32,209,3.0,1.0,2.0,3.0,1.0,2.0,5.0,25,14,11,4.0,1.0,3.0
9512231,9,6,3,3,7,2,2,324,3.0,2.0,1.0,1.0,3.0,0.0,0.0,12,9,3,3.0,2.0,1.0
9307225,3,3,0,0,3,0,0,141,1.0,1.0,0.0,0.0,1.0,0.0,0.0,3,3,0,1.0,1.0,0.0
208196,4,4,0,0,0,4,6,239,3.0,3.0,0.0,0.0,0.0,3.0,5.0,11,4,7,8.0,2.0,6.0
201143,6,1,5,7,6,0,0,8,4.0,1.0,3.0,3.0,4.0,0.0,0.0,6,6,0,1.0,1.0,0.0
9711466,0,0,0,0,0,0,0,116,0.0,0.0,0.0,0.0,0.0,0.0,0.0,4,0,4,1.0,0.0,1.0
9311258,0,0,0,0,0,0,0,63,0.0,0.0,0.0,0.0,0.0,0.0,0.0,4,0,4,,,
110005,3,3,0,0,2,1,2,222,1.0,1.0,0.0,0.0,0.0,1.0,2.0,15,3,12,10.0,1.0,9.0
9610509,3,2,1,2,2,1,3,41,0.0,0.0,0.0,0.0,0.0,0.0,0.0,7,3,4,1.0,1.0,0.0
9603364,4,2,2,2,1,3,12,27,1.0,1.0,0.0,0.0,0.0,1.0,1.0,12,4,8,2.0,1.0,1.0
9411434,4,1,3,6,0,4,12,53,4.0,1.0,3.0,6.0,0.0,4.0,12.0,7,4,3,,,
9804344,5,5,0,0,4,1,1,13,2.0,2.0,0.0,0.0,2.0,0.0,0.0,12,5,7,3.0,3.0,0.0
9405247,2,2,0,0,0,2,5,10,1.0,1.0,0.0,0.0,0.0,1.0,1.0,16,2,14,2.0,1.0,1.0
9911386,9,6,3,3,0,9,43,2,0.0,0.0,0.0,0.0,0.0,0.0,0.0,44,9,35,3.0,0.0,3.0
9903249,6,2,4,7,0,6,30,25,6.0,2.0,4.0,7.0,0.0,6.0,30.0,14,6,8,11.0,5.0,6.0
9408243,9,5,4,8,8,1,1,330,5.0,2.0,3.0,4.0,5.0,0.0,0.0,12,9,3,3.0,3.0,0.0
111240,1,1,0,0,0,1,8,14,0.0,0.0,0.0,0.0,0.0,0.0,0.0,14,1,13,6.0,1.0,5.0
9808368,20,8,12,32,2,18,68,27,16.0,7.0,9.0,27.0,1.0,15.0,61.0,30,20,10,13.0,10.0,3.0
1330,11,9,2,2,1,10,20,27,5.0,5.0,0.0,0.0,0.0,5.0,9.0,22,11,11,1.0,0.0,1.0
9901424,2,1,1,1,1,1,1,148,0.0,0.0,0.0,0.0,0.0,0.0,0.0,6,2,4,4.0,0.0,4.0
2079,4,3,1,1,0,4,36,2,3.0,2.0,1.0,1.0,0.0,3.0,19.0,18,4,14,7.0,2.0,5.0
103195,5,3,2,2,0,5,90,3,2.0,1.0,1.0,1.0,0.0,2.0,41.0,53,5,48,10.0,1.0,9.0
9303304,2,2,0,0,2,0,0,1257,,,,,,,,2,2,0,1.0,1.0,0.0
9404339,5,3,2,2,5,0,0,437,3.0,2.0,1.0,1.0,3.0,0.0,0.0,5,5,0,3.0,3.0,0.0
9607436,11,1,10,24,9,2,4,13,2.0,2.0,0.0,0.0,1.0,1.0,2.0,14,11,3,4.0,3.0,1.0
9811228,1,1,0,0,0,1,1,405,1.0,1.0,0.0,0.0,1.0,0.0,0.0,5,1,4,1.0,1.0,0.0
9612274,4,2,2,2,0,4,8,14,2.0,1.0,1.0,1.0,2.0,0.0,0.0,17,4,13,2.0,2.0,0.0
9805224,16,1,15,45,3,13,28,25,10.0,1.0,9.0,24.0,7.0,3.0,4.0,25,16,9,10.0,10.0,0.0
3228,5,2,3,4,2,3,3,12,1.0,1.0,0.0,0.0,1.0,0.0,0.0,27,5,22,4.0,1.0,3.0
206167,2,2,0,0,0,2,74,5,0.0,0.0,0.0,0.0,0.0,0.0,0.0,61,2,59,7.0,0.0,7.0
9904352,7,4,3,5,0,7,34,87,4.0,3.0,1.0,2.0,0.0,4.0,7.0,37,7,30,7.0,5.0,2.0
9810343,8,3,5,7,0,8,38,1,5.0,3.0,2.0,3.0,0.0,5.0,22.0,18,8,10,5.0,2.0,3.0
205099,2,1,1,1,0,2,27,2,1.0,1.0,0.0,0.0,0.0,1.0,11.0,41,2,39,4.0,1.0,3.0
9808448,3,2,1,1,1,2,2,168,0.0,0.0,0.0,0.0,0.0,0.0,0.0,19,3,16,3.0,0.0,3.0
9807374,17,6,11,19,14,3,3,125,4.0,2.0,2.0,2.0,4.0,0.0,0.0,18,17,1,4.0,4.0,0.0
9708451,1,1,0,0,0,1,1,265,0.0,0.0,0.0,0.0,0.0,0.0,0.0,13,1,12,1.0,0.0,1.0
9604281,13,3,10,16,1,12,31,150,8.0,2.0,6.0,8.0,0.0,8.0,17.0,18,13,5,8.0,5.0,3.0
9507207,2,1,1,1,2,0,0,706,2.0,1.0,1.0,1.0,2.0,0.0,0.0,4,2,2,1.0,0.0,1.0
9412335,3,1,2,3,0,3,5,8,,,,,,,,5,3,2,1.0,1.0,0.0
101199,3,3,0,0,1,2,6,16,0.0,0.0,0.0,0.0,0.0,0.0,0.0,31,3,28,8.0,0.0,8.0
9910457,1,1,0,0,0,1,5,23,0.0,0.0,0.0,0.0,0.0,0.0,0.0,30,1,29,1.0,0.0,1.0
11376,8,4,4,6,6,2,3,312,3.0,1.0,2.0,3.0,3.0,0.0,0.0,11,8,3,3.0,3.0,0.0
9904421,13,4,9,24,0,13,80,78,10.0,3.0,7.0,16.0,0.0,10.0,60.0,33,13,20,15.0,7.0,8.0
108225,11,3,8,23,0,11,128,2,4.0,2.0,2.0,2.0,0.0,4.0,56.0,49,11,38,10.0,2.0,8.0
202209,5,2,3,6,0,5,32,73,4.0,1.0,3.0,6.0,0.0,4.0,8.0,28,5,23,7.0,4.0,3.0
3176,4,3,1,1,3,1,2,153,1.0,1.0,0.0,0.0,0.0,1.0,1.0,8,4,4,2.0,1.0,1.0
108116,1,1,0,0,0,1,5,13,1.0,1.0,0.0,0.0,0.0,1.0,4.0,9,1,8,1.0,0.0,1.0
9610528,6,1,5,9,4,2,2,16,2.0,2.0,0.0,0.0,2.0,0.0,0.0,8,6,2,2.0,2.0,0.0
9512443,0,0,0,0,0,0,0,555,0.0,0.0,0.0,0.0,0.0,0.0,0.0,2,0,2,2.0,0.0,2.0
9906283,5,3,2,4,0,5,9,168,4.0,2.0,2.0,3.0,0.0,4.0,8.0,22,5,17,6.0,4.0,2.0
107297,5,5,0,0,1,4,14,28,0.0,0.0,0.0,0.0,0.0,0.0,0.0,25,5,20,6.0,0.0,6.0
9902462,6,6,0,0,0,6,14,0,2.0,2.0,0.0,0.0,0.0,2.0,2.0,26,6,20,1.0,1.0,0.0
5060,10,3,7,12,0,10,32,278,4.0,2.0,2.0,2.0,0.0,4.0,10.0,17,10,7,8.0,5.0,3.0
9808305,13,8,5,6,0,13,65,9,8.0,7.0,1.0,1.0,0.0,8.0,30.0,26,13,13,12.0,7.0,5.0
9504291,4,2,2,3,4,0,0,265,4.0,2.0,2.0,3.0,4.0,0.0,0.0,4,4,0,2.0,2.0,0.0
9901235,5,1,4,5,0,5,22,13,3.0,1.0,2.0,2.0,0.0,3.0,13.0,16,5,11,11.0,2.0,9.0
9612223,17,8,9,15,2,15,35,78,7.0,3.0,4.0,8.0,0.0,7.0,10.0,32,17,15,4.0,3.0,1.0
9701254,6,5,1,1,4,2,10,47,0.0,0.0,0.0,0.0,0.0,0.0,0.0,18,6,12,3.0,0.0,3.0
9305229,5,2,3,4,4,1,1,335,2.0,1.0,1.0,1.0,2.0,0.0,0.0,6,5,1,2.0,2.0,0.0
9406275,11,3,8,20,8,3,3,72,8.0,2.0,6.0,15.0,8.0,0.0,0.0,12,11,1,7.0,7.0,0.0
9710208,9,3,6,10,0,9,20,167,6.0,3.0,3.0,6.0,0.0,6.0,16.0,14,9,5,9.0,5.0,4.0
103025,3,2,1,1,0,3,17,22,1.0,1.0,0.0,0.0,0.0,1.0,5.0,21,3,18,11.0,1.0,10.0
9912420,3,1,2,3,0,3,38,7,3.0,1.0,2.0,3.0,0.0,3.0,29.0,25,3,22,17.0,3.0,14.0
9608382,7,3,4,4,0,7,21,4,2.0,1.0,1.0,1.0,1.0,1.0,1.0,13,7,6,1.0,0.0,1.0
9603235,2,2,0,0,1,1,2,19,1.0,1.0,0.0,0.0,1.0,0.0,0.0,8,2,6,1.0,0.0,1.0
9311343,0,0,0,0,0,0,0,22,0.0,0.0,0.0,0.0,0.0,0.0,0.0,5,0,5,1.0,0.0,1.0
9812393,10,5,5,7,0,10,44,117,5.0,3.0,2.0,2.0,0.0,5.0,9.0,22,10,12,10.0,5.0,5.0
210244,1,1,0,0,0,1,11,28,1.0,1.0,0.0,0.0,0.0,1.0,10.0,22,1,21,10.0,1.0,9.0
9502413,7,3,4,4,7,0,0,144,3.0,3.0,0.0,0.0,3.0,0.0,0.0,7,7,0,3.0,3.0,0.0
9503373,0,0,0,0,0,0,0,318,0.0,0.0,0.0,0.0,0.0,0.0,0.0,3,0,3,2.0,0.0,2.0
111030,12,8,4,6,3,9,54,0,5.0,1.0,4.0,5.0,0.0,5.0,39.0,37,12,25,15.0,3.0,12.0
9241,10,6,4,6,3,7,21,74,6.0,2.0,4.0,5.0,2.0,4.0,4.0,21,10,11,4.0,3.0,1.0
9704265,3,3,0,0,0,3,10,9,0.0,0.0,0.0,0.0,0.0,0.0,0.0,14,3,11,3.0,2.0,1.0
9912383,7,3,4,11,0,7,13,65,7.0,3.0,4.0,11.0,0.0,7.0,13.0,12,7,5,10.0,7.0,3.0
205305,5,3,2,2,0,5,29,51,3.0,1.0,2.0,2.0,0.0,3.0,14.0,34,5,29,13.0,2.0,11.0
9401344,2,2,0,0,0,2,5,332,1.0,1.0,0.0,0.0,0.0,1.0,4.0,6,2,4,5.0,1.0,4.0
203238,9,1,8,10,1,8,16,107,8.0,1.0,7.0,9.0,0.0,8.0,16.0,12,9,3,6.0,5.0,1.0
207053,9,4,5,12,0,9,98,46,7.0,2.0,5.0,12.0,0.0,7.0,92.0,43,9,34,25.0,6.0,19.0
9806379,3,2,1,1,2,1,1,45,3.0,2.0,1.0,1.0,2.0,1.0,1.0,4,3,1,,,
106320,7,1,6,9,1,6,23,28,5.0,3.0,2.0,2.0,0.0,5.0,15.0,14,7,7,5.0,4.0,1.0
209153,1,1,0,0,1,0,0,475,1.0,1.0,0.0,0.0,1.0,0.0,0.0,4,1,3,2.0,1.0,1.0
9602308,1,1,0,0,1,0,0,38,0.0,0.0,0.0,0.0,0.0,0.0,0.0,5,1,4,1.0,0.0,1.0
9711347,3,2,1,1,1,2,6,65,2.0,1.0,1.0,1.0,0.0,2.0,2.0,6,3,3,4.0,2.0,2.0
9707285,3,3,0,0,2,1,1,136,1.0,1.0,0.0,0.0,1.0,0.0,0.0,8,3,5,1.0,1.0,0.0
210027,5,3,2,2,1,4,42,6,2.0,1.0,1.0,1.0,0.0,2.0,32.0,42,5,37,11.0,1.0,10.0
209128,1,1,0,0,0,1,1,24,1.0,1.0,0.0,0.0,1.0,0.0,0.0,11,1,10,2.0,0.0,2.0
11191,12,7,5,11,4,8,19,59,4.0,2.0,2.0,2.0,0.0,4.0,13.0,24,12,12,5.0,1.0,4.0
101147,6,3,3,4,1,5,26,19,0.0,0.0,0.0,0.0,0.0,0.0,0.0,30,6,24,21.0,0.0,21.0
201056,7,5,2,5,1,6,27,37,2.0,1.0,1.0,1.0,0.0,2.0,5.0,17,7,10,6.0,3.0,3.0
104201,2,1,1,1,0,2,12,30,2.0,1.0,1.0,1.0,0.0,2.0,12.0,11,2,9,11.0,2.0,9.0
9701387,4,4,0,0,1,3,11,154,3.0,3.0,0.0,0.0,0.0,3.0,11.0,10,4,6,8.0,2.0,6.0
9508367,1,1,0,0,1,0,0,93,0.0,0.0,0.0,0.0,0.0,0.0,0.0,2,1,1,1.0,0.0,1.0
111227,10,4,6,17,0,10,128,11,7.0,2.0,5.0,16.0,0.0,7.0,120.0,38,10,28,28.0,7.0,21.0
9505427,9,6,3,4,1,8,17,53,4.0,2.0,2.0,2.0,0.0,4.0,7.0,13,9,4,4.0,3.0,1.0
209303,5,3,2,2,0,5,49,55,2.0,2.0,0.0,0.0,0.0,2.0,20.0,46,5,41,18.0,2.0,16.0
112303,19,7,12,25,0,19,61,32,3.0,1.0,2.0,2.0,3.0,0.0,0.0,40,19,21,9.0,0.0,9.0
9806250,3,1,2,2,0,3,15,4,3.0,1.0,2.0,2.0,0.0,3.0,14.0,17,3,14,2.0,0.0,2.0
9903427,8,4,4,8,0,8,20,267,4.0,1.0,3.0,5.0,0.0,4.0,4.0,29,8,21,5.0,4.0,1.0
111193,15,3,12,29,0,15,47,38,8.0,5.0,3.0,5.0,0.0,8.0,13.0,22,15,7,9.0,7.0,2.0
9505260,8,2,6,12,4,4,4,503,5.0,1.0,4.0,7.0,1.0,4.0,4.0,11,8,3,6.0,5.0,1.0
9406334,11,5,6,9,7,4,4,179,4.0,3.0,1.0,1.0,4.0,0.0,0.0,12,11,1,3.0,3.0,0.0
9609479,6,3,3,3,4,2,2,74,2.0,1.0,1.0,1.0,1.0,1.0,1.0,7,6,1,3.0,2.0,1.0
211039,2,1,1,1,0,2,9,95,0.0,0.0,0.0,0.0,0.0,0.0,0.0,13,2,11,7.0,0.0,7.0
9504410,13,4,9,15,9,4,6,305,6.0,1.0,5.0,8.0,4.0,2.0,2.0,19,13,6,7.0,6.0,1.0
9609213,12,3,9,34,8,4,8,151,8.0,2.0,6.0,20.0,4.0,4.0,6.0,16,12,4,9.0,8.0,1.0
9310323,2,1,1,1,1,1,1,1885,,,,,,,,3,2,1,,,
9702240,2,2,0,0,2,0,0,88,1.0,1.0,0.0,0.0,1.0,0.0,0.0,4,2,2,1.0,1.0,0.0
9905326,6,4,2,2,3,3,4,268,5.0,3.0,2.0,2.0,2.0,3.0,3.0,19,6,13,3.0,2.0,1.0
9911431,8,5,3,4,4,4,17,274,1.0,1.0,0.0,0.0,0.0,1.0,2.0,21,8,13,2.0,1.0,1.0
12226,3,1,2,3,0,3,5,27,2.0,1.0,1.0,1.0,0.0,2.0,3.0,13,3,10,4.0,3.0,1.0
9810271,5,2,3,4,1,4,15,1,1.0,1.0,0.0,0.0,1.0,0.0,0.0,20,5,15,2.0,1.0,1.0
211095,1,1,0,0,0,1,10,0,1.0,1.0,0.0,0.0,0.0,1.0,7.0,37,1,36,13.0,0.0,13.0
9909268,4,4,0,0,0,4,17,3,2.0,2.0,0.0,0.0,0.0,2.0,11.0,24,4,20,3.0,2.0,1.0
205248,2,2,0,0,0,2,48,4,1.0,1.0,0.0,0.0,0.0,1.0,17.0,83,2,81,8.0,0.0,8.0
2195,10,5,5,8,1,9,36,9,4.0,2.0,2.0,3.0,0.0,4.0,23.0,30,10,20,4.0,4.0,0.0
9905405,3,2,1,1,0,3,6,242,2.0,1.0,1.0,1.0,0.0,2.0,5.0,7,3,4,5.0,2.0,3.0
9405427,5,4,1,1,5,0,0,437,2.0,2.0,0.0,0.0,2.0,0.0,0.0,5,5,0,2.0,2.0,0.0
9404332,6,4,2,2,6,0,0,289,4.0,3.0,1.0,1.0,4.0,0.0,0.0,6,6,0,2.0,2.0,0.0
9401345,8,5,3,3,5,3,5,335,2.0,2.0,0.0,0.0,0.0,2.0,4.0,12,8,4,5.0,2.0,3.0
9908214,7,5,2,3,0,7,44,1,2.0,1.0,1.0,1.0,0.0,2.0,14.0,28,7,21,12.0,2.0,10.0
9905287,11,7,4,5,2,9,46,9,5.0,4.0,1.0,1.0,0.0,5.0,16.0,30,11,19,4.0,1.0,3.0
9703406,7,1,6,11,0,7,45,113,7.0,1.0,6.0,11.0,0.0,7.0,42.0,22,7,15,19.0,7.0,12.0
10007,8,4,4,5,0,8,52,6,2.0,2.0,0.0,0.0,0.0,2.0,9.0,64,8,56,12.0,1.0,11.0
9812459,7,4,3,8,0,7,37,11,6.0,3.0,3.0,7.0,0.0,6.0,20.0,23,7,16,11.0,6.0,5.0
112018,2,2,0,0,1,1,2,18,1.0,1.0,0.0,0.0,1.0,0.0,0.0,16,2,14,12.0,0.0,12.0
3092,4,4,0,0,3,1,2,296,1.0,1.0,0.0,0.0,1.0,0.0,0.0,6,4,2,2.0,1.0,1.0
9503205,8,4,4,6,1,7,16,40,4.0,3.0,1.0,1.0,0.0,4.0,13.0,12,8,4,,,
211406,1,1,0,0,0,1,16,28,0.0,0.0,0.0,0.0,0.0,0.0,0.0,37,1,36,13.0,0.0,13.0
9605362,4,3,1,1,1,3,4,17,0.0,0.0,0.0,0.0,0.0,0.0,0.0,13,4,9,2.0,1.0,1.0
9808326,7,2,5,10,4,3,5,103,5.0,1.0,4.0,9.0,3.0,2.0,4.0,14,7,7,7.0,5.0,2.0
101144,1,1,0,0,0,1,1,429,0.0,0.0,0.0,0.0,0.0,0.0,0.0,4,1,3,2.0,0.0,2.0
9308312,2,2,0,0,2,0,0,330,1.0,1.0,0.0,0.0,1.0,0.0,0.0,2,2,0,1.0,1.0,0.0
208226,8,2,6,8,0,8,48,1,5.0,2.0,3.0,4.0,0.0,5.0,26.0,32,8,24,11.0,5.0,6.0
9806333,3,1,2,3,2,1,1,54,3.0,1.0,2.0,3.0,3.0,0.0,0.0,6,3,3,3.0,3.0,0.0
9706345,1,1,0,0,1,0,0,1427,0.0,0.0,0.0,0.0,0.0,0.0,0.0,4,1,3,1.0,0.0,1.0
9309303,11,4,7,18,11,0,0,124,2.0,1.0,1.0,1.0,2.0,0.0,0.0,11,11,0,7.0,7.0,0.0
9906421,5,3,2,2,0,5,17,62,3.0,2.0,1.0,1.0,0.0,3.0,11.0,14,5,9,8.0,3.0,5.0
9909383,9,3,6,8,4,5,5,35,6.0,1.0,5.0,6.0,3.0,3.0,3.0,12,9,3,2.0,1.0,1.0
102225,1,1,0,0,1,0,0,133,0.0,0.0,0.0,0.0,0.0,0.0,0.0,6,1,5,2.0,0.0,2.0
9311259,3,3,0,0,0,3,4,35,1.0,1.0,0.0,0.0,0.0,1.0,1.0,15,3,12,7.0,0.0,7.0
9506301,0,0,0,0,0,0,0,256,0.0,0.0,0.0,0.0,0.0,0.0,0.0,7,0,7,4.0,0.0,4.0
9510285,3,2,1,1,0,3,5,84,2.0,2.0,0.0,0.0,0.0,2.0,2.0,5,3,2,4.0,3.0,1.0
5068,2,2,0,0,0,2,6,231,0.0,0.0,0.0,0.0,0.0,0.0,0.0,18,2,16,3.0,0.0,3.0
9709339,2,2,0,0,0,2,8,136,2.0,2.0,0.0,0.0,0.0,2.0,8.0,10,2,8,10.0,2.0,8.0
9411442,1,1,0,0,0,1,1,152,1.0,1.0,0.0,0.0,1.0,0.0,0.0,2,1,1,1.0,1.0,0.0
9606322,1,1,0,0,1,0,0,93,0.0,0.0,0.0,0.0,0.0,0.0,0.0,24,1,23,2.0,0.0,2.0
107277,8,5,3,3,6,2,2,0,2.0,1.0,1.0,1.0,2.0,0.0,0.0,11,8,3,2.0,2.0,0.0
9702357,4,3,1,1,0,4,7,170,2.0,1.0,1.0,1.0,0.0,2.0,3.0,8,4,4,2.0,1.0,1.0
103260,2,2,0,0,1,1,7,115,1.0,1.0,0.0,0.0,0.0,1.0,7.0,11,2,9,8.0,1.0,7.0
9405384,0,0,0,0,0,0,0,151,,,,,,,,1,0,1,1.0,0.0,1.0
9912356,6,3,3,6,0,6,14,103,6.0,3.0,3.0,6.0,0.0,6.0,14.0,10,6,4,4.0,2.0,2.0
9410350,1,1,0,0,1,0,0,206,1.0,1.0,0.0,0.0,1.0,0.0,0.0,1,1,0,,,
9708204,2,1,1,1,0,2,19,114,1.0,1.0,0.0,0.0,0.0,1.0,10.0,31,2,29,18.0,2.0,16.0
9407299,2,2,0,0,2,0,0,1598,1.0,1.0,0.0,0.0,1.0,0.0,0.0,2,2,0,1.0,1.0,0.0
9404360,1,1,0,0,0,1,5,10,1.0,1.0,0.0,0.0,0.0,1.0,4.0,22,1,21,3.0,0.0,3.0
9506469,4,3,1,1,1,3,8,64,3.0,2.0,1.0,1.0,0.0,3.0,8.0,10,4,6,6.0,3.0,3.0
9709252,6,3,3,4,1,5,10,92,3.0,2.0,1.0,1.0,0.0,3.0,7.0,12,6,6,2.0,0.0,2.0
105026,1,1,0,0,1,0,0,1137,,,,,,,,2,1,1,,,
106332,5,1,4,8,4,1,4,32,0.0,0.0,0.0,0.0,0.0,0.0,0.0,20,5,15,1.0,0.0,1.0
9211276,2,1,1,1,2,0,0,93,,,,,,,,2,2,0,1.0,1.0,0.0
205112,3,2,1,1,0,3,3,49,2.0,1.0,1.0,1.0,0.0,2.0,2.0,6,3,3,,,
104279,4,4,0,0,1,3,10,33,1.0,1.0,0.0,0.0,0.0,1.0,5.0,40,4,36,10.0,0.0,10.0
9807431,0,0,0,0,0,0,0,56,0.0,0.0,0.0,0.0,0.0,0.0,0.0,10,0,10,1.0,0.0,1.0
105223,3,3,0,0,2,1,6,0,0.0,0.0,0.0,0.0,0.0,0.0,0.0,54,3,51,5.0,0.0,5.0
9703247,5,2,3,4,2,3,3,13,2.0,1.0,1.0,1.0,2.0,0.0,0.0,8,5,3,2.0,2.0,0.0
5171,1,1,0,0,0,1,1,18,0.0,0.0,0.0,0.0,0.0,0.0,0.0,5,1,4,2.0,0.0,2.0
9306257,3,3,0,0,3,0,0,243,2.0,2.0,0.0,0.0,2.0,0.0,0.0,3,3,0,1.0,1.0,0.0
9603259,4,3,1,1,3,1,1,88,3.0,3.0,0.0,0.0,3.0,0.0,0.0,6,4,2,3.0,2.0,1.0
9402238,4,3,1,1,0,4,6,90,2.0,1.0,1.0,1.0,0.0,2.0,4.0,6,4,2,4.0,2.0,2.0
9603229,4,2,2,2,4,0,0,1709,3.0,1.0,2.0,2.0,3.0,0.0,0.0,4,4,0,,,
9905529,6,5,1,1,1,5,15,7,2.0,2.0,0.0,0.0,0.0,2.0,6.0,13,6,7,5.0,1.0,4.0
110276,7,1,6,10,0,7,56,3,6.0,1.0,5.0,7.0,0.0,6.0,42.0,27,7,20,16.0,7.0,9.0
110060,1,1,0,0,1,0,0,161,0.0,0.0,0.0,0.0,0.0,0.0,0.0,14,1,13,4.0,0.0,4.0
109071,2,1,1,1,0,2,11,4,0.0,0.0,0.0,0.0,0.0,0.0,0.0,27,2,25,7.0,0.0,7.0
9905450,4,2,2,2,0,4,38,42,3.0,1.0,2.0,2.0,0.0,3.0,21.0,23,4,19,13.0,3.0,10.0
9906288,2,2,0,0,0,2,2,214,2.0,2.0,0.0,0.0,0.0,2.0,2.0,4,2,2,3.0,2.0,1.0
9312234,1,1,0,0,1,0,0,133,1.0,1.0,0.0,0.0,1.0,0.0,0.0,2,1,1,,,
9405260,2,2,0,0,1,1,1,35,0.0,0.0,0.0,0.0,0.0,0.0,0.0,8,2,6,1.0,0.0,1.0
9210237,3,2,1,1,3,0,0,8,,,,,,,,3,3,0,1.0,1.0,0.0
202194,10,1,9,25,10,0,0,52,9.0,1.0,8.0,22.0,9.0,0.0,0.0,10,10,0,8.0,8.0,0.0
9610530,1,1,0,0,0,1,3,307,1.0,1.0,0.0,0.0,0.0,1.0,1.0,4,1,3,1.0,1.0,0.0
9602384,1,1,0,0,0,1,1,288,1.0,1.0,0.0,0.0,0.0,1.0,1.0,6,1,5,,,
9810262,1,1,0,0,0,1,7,27,0.0,0.0,0.0,0.0,0.0,0.0,0.0,13,1,12,1.0,0.0,1.0
9903469,1,1,0,0,0,1,1,198,1.0,1.0,0.0,0.0,0.0,1.0,1.0,2,1,1,,,
12008,1,1,0,0,0,1,5,230,1.0,1.0,0.0,0.0,0.0,1.0,3.0,8,1,7,4.0,1.0,3.0
11388,4,4,0,0,0,4,34,3,3.0,3.0,0.0,0.0,0.0,3.0,22.0,28,4,24,10.0,3.0,7.0
111285,2,2,0,0,1,1,9,69,1.0,1.0,0.0,0.0,0.0,1.0,6.0,24,2,22,10.0,1.0,9.0
9910239,2,1,1,1,0,2,20,24,2.0,1.0,1.0,1.0,0.0,2.0,17.0,18,2,16,,,
112042,4,4,0,0,0,4,18,34,1.0,1.0,0.0,0.0,0.0,1.0,1.0,14,4,10,12.0,3.0,9.0
9801314,3,1,2,2,0,3,12,40,2.0,1.0,1.0,1.0,0.0,2.0,10.0,12,3,9,2.0,1.0,1.0
9704422,3,1,2,2,1,2,2,40,2.0,1.0,1.0,1.0,2.0,0.0,0.0,8,3,5,4.0,3.0,1.0
203252,3,3,0,0,3,0,0,128,0.0,0.0,0.0,0.0,0.0,0.0,0.0,6,3,3,2.0,1.0,1.0
8227,3,1,2,3,2,1,1,126,3.0,1.0,2.0,3.0,2.0,1.0,1.0,5,3,2,4.0,3.0,1.0
205019,2,2,0,0,0,2,4,126,2.0,2.0,0.0,0.0,0.0,2.0,4.0,6,2,4,5.0,2.0,3.0
9907490,1,1,0,0,1,0,0,53,1.0,1.0,0.0,0.0,1.0,0.0,0.0,3,1,2,1.0,1.0,0.0
208093,1,1,0,0,0,1,7,28,0.0,0.0,0.0,0.0,0.0,0.0,0.0,12,1,11,6.0,1.0,5.0
9803412,13,7,6,11,4,9,20,131,6.0,3.0,3.0,5.0,0.0,6.0,12.0,17,13,4,7.0,4.0,3.0
9911499,7,6,1,1,2,5,14,2,2.0,1.0,1.0,1.0,2.0,0.0,0.0,18,7,11,4.0,0.0,4.0
9908456,2,2,0,0,0,2,7,9,1.0,1.0,0.0,0.0,1.0,0.0,0.0,33,2,31,8.0,0.0,8.0
9908514,8,2,6,15,2,6,8,20,6.0,1.0,5.0,13.0,6.0,0.0,0.0,11,8,3,7.0,7.0,0.0
6027,6,5,1,1,1,5,48,50,3.0,2.0,1.0,1.0,0.0,3.0,23.0,36,6,30,15.0,1.0,14.0
9909439,5,3,2,2,1,4,28,0,3.0,2.0,1.0,1.0,0.0,3.0,14.0,17,5,12,14.0,4.0,10.0
2202,2,2,0,0,2,0,0,144,0.0,0.0,0.0,0.0,0.0,0.0,0.0,3,2,1,1.0,0.0,1.0
1054,9,7,2,3,2,7,36,47,2.0,1.0,1.0,1.0,0.0,2.0,8.0,36,9,27,12.0,4.0,8.0
10078,1,1,0,0,0,1,2,180,1.0,1.0,0.0,0.0,0.0,1.0,2.0,3,1,2,3.0,1.0,2.0
9706237,0,0,0,0,0,0,0,1405,,,,,,,,1,0,1,,,
9910432,10,4,6,10,0,10,31,16,7.0,1.0,6.0,10.0,0.0,7.0,22.0,17,10,7,10.0,5.0,5.0
210125,3,3,0,0,0,3,26,55,2.0,2.0,0.0,0.0,0.0,2.0,17.0,22,3,19,15.0,2.0,13.0
10247,8,4,4,6,1,7,22,64,5.0,2.0,3.0,5.0,0.0,5.0,12.0,20,8,12,7.0,4.0,3.0
9601319,6,2,4,5,1,5,11,52,5.0,1.0,4.0,5.0,0.0,5.0,9.0,11,6,5,5.0,3.0,2.0
6118,2,2,0,0,0,2,4,216,1.0,1.0,0.0,0.0,0.0,1.0,2.0,11,2,9,3.0,1.0,2.0
9508396,0,0,0,0,0,0,0,322,0.0,0.0,0.0,0.0,0.0,0.0,0.0,1,0,1,1.0,0.0,1.0
9406265,0,0,0,0,0,0,0,138,0.0,0.0,0.0,0.0,0.0,0.0,0.0,1,0,1,,,
9710478,4,3,1,1,0,4,7,26,2.0,1.0,1.0,1.0,0.0,2.0,2.0,11,4,7,3.0,1.0,2.0
9707388,3,2,1,2,0,3,3,110,1.0,1.0,0.0,0.0,1.0,0.0,0.0,7,3,4,2.0,2.0,0.0
9901447,9,3,6,19,0,9,21,16,9.0,3.0,6.0,19.0,0.0,9.0,21.0,14,9,5,12.0,9.0,3.0
9507410,1,1,0,0,0,1,9,6,1.0,1.0,0.0,0.0,0.0,1.0,7.0,15,1,14,1.0,0.0,1.0
10152,2,1,1,1,0,2,5,28,0.0,0.0,0.0,0.0,0.0,0.0,0.0,6,2,4,2.0,0.0,2.0
110191,1,1,0,0,0,1,1,84,1.0,1.0,0.0,0.0,0.0,1.0,1.0,12,1,11,7.0,0.0,7.0
9503265,1,1,0,0,1,0,0,183,0.0,0.0,0.0,0.0,0.0,0.0,0.0,8,1,7,2.0,0.0,2.0
9408401,1,1,0,0,0,1,2,6,1.0,1.0,0.0,0.0,1.0,0.0,0.0,11,1,10,1.0,1.0,0.0
9504356,3,1,2,3,0,3,3,115,2.0,1.0,1.0,1.0,0.0,2.0,2.0,5,3,2,3.0,2.0,1.0
205109,7,4,3,8,0,7,71,9,5.0,2.0,3.0,5.0,0.0,5.0,44.0,33,7,26,10.0,6.0,4.0
10123,1,1,0,0,0,1,3,136,1.0,1.0,0.0,0.0,0.0,1.0,3.0,9,1,8,1.0,0.0,1.0
9908379,2,2,0,0,0,2,6,11,0.0,0.0,0.0,0.0,0.0,0.0,0.0,34,2,32,4.0,0.0,4.0
9503458,1,1,0,0,1,0,0,86,0.0,0.0,0.0,0.0,0.0,0.0,0.0,5,1,4,1.0,0.0,1.0
9809212,1,1,0,0,0,1,1,8,0.0,0.0,0.0,0.0,0.0,0.0,0.0,10,1,9,5.0,1.0,4.0
202139,7,5,2,2,0,7,45,18,2.0,2.0,0.0,0.0,2.0,0.0,0.0,27,7,20,2.0,2.0,0.0
210435,0,0,0,0,0,0,0,83,0.0,0.0,0.0,0.0,0.0,0.0,0.0,11,0,11,1.0,0.0,1.0
105086,1,1,0,0,0,1,2,112,1.0,1.0,0.0,0.0,0.0,1.0,2.0,12,1,11,7.0,1.0,6.0
210019,1,1,0,0,0,1,5,7,1.0,1.0,0.0,0.0,0.0,1.0,3.0,7,1,6,,,
9507357,3,2,1,1,3,0,0,72,2.0,1.0,1.0,1.0,2.0,0.0,0.0,6,3,3,2.0,2.0,0.0
9801421,3,3,0,0,1,2,4,29,1.0,1.0,0.0,0.0,1.0,0.0,0.0,11,3,8,1.0,1.0,0.0
202049,2,2,0,0,0,2,14,32,2.0,2.0,0.0,0.0,2.0,0.0,0.0,18,2,16,4.0,1.0,3.0
9402354,0,0,0,0,0,0,0,335,0.0,0.0,0.0,0.0,0.0,0.0,0.0,3,0,3,1.0,0.0,1.0
9812234,2,2,0,0,0,2,12,42,2.0,2.0,0.0,0.0,0.0,2.0,11.0,14,2,12,3.0,1.0,2.0
9704386,4,4,0,0,3,1,1,519,3.0,3.0,0.0,0.0,3.0,0.0,0.0,6,4,2,3.0,3.0,0.0
10213,1,1,0,0,0,1,8,0,0.0,0.0,0.0,0.0,0.0,0.0,0.0,14,1,13,10.0,1.0,9.0
9409239,1,1,0,0,1,0,0,164,1.0,1.0,0.0,0.0,1.0,0.0,0.0,7,1,6,1.0,1.0,0.0
9908528,11,3,8,21,0,11,91,11,10.0,2.0,8.0,17.0,1.0,9.0,34.0,31,11,20,16.0,10.0,6.0
7274,6,4,2,2,0,6,121,11,4.0,4.0,0.0,0.0,0.0,4.0,97.0,53,6,47,25.0,4.0,21.0
9401316,3,2,1,2,1,2,4,363,3.0,2.0,1.0,2.0,1.0,2.0,4.0,6,3,3,5.0,2.0,3.0
10224,1,1,0,0,0,1,3,21,1.0,1.0,0.0,0.0,1.0,0.0,0.0,4,1,3,1.0,1.0,0.0
9603369,2,2,0,0,1,1,2,320,1.0,1.0,0.0,0.0,0.0,1.0,1.0,7,2,5,3.0,1.0,2.0
207255,4,4,0,0,0,4,26,20,3.0,3.0,0.0,0.0,0.0,3.0,21.0,26,4,22,2.0,1.0,1.0
9604381,2,1,1,1,0,2,6,210,2.0,1.0,1.0,1.0,0.0,2.0,2.0,17,2,15,3.0,0.0,3.0
301255,1,1,0,0,0,1,27,1,1.0,1.0,0.0,0.0,0.0,1.0,15.0,42,1,41,8.0,0.0,8.0
9906498,12,4,8,35,2,10,60,46,9.0,1.0,8.0,30.0,0.0,9.0,47.0,30,12,18,16.0,9.0,7.0
9304228,1,1,0,0,1,0,0,248,1.0,1.0,0.0,0.0,1.0,0.0,0.0,4,1,3,2.0,0.0,2.0
9905307,1,1,0,0,0,1,1,28,0.0,0.0,0.0,0.0,0.0,0.0,0.0,4,1,3,1.0,0.0,1.0
101235,1,1,0,0,0,1,6,135,0.0,0.0,0.0,0.0,0.0,0.0,0.0,17,1,16,6.0,0.0,6.0
207037,2,1,1,1,0,2,8,28,2.0,1.0,1.0,1.0,0.0,2.0,8.0,6,2,4,,,
9507351,3,2,1,1,2,1,1,56,0.0,0.0,0.0,0.0,0.0,0.0,0.0,19,3,16,4.0,0.0,4.0
9703378,11,5,6,12,0,11,18,254,5.0,3.0,2.0,4.0,0.0,5.0,12.0,22,11,11,7.0,5.0,2.0
9607417,0,0,0,0,0,0,0,15,0.0,0.0,0.0,0.0,0.0,0.0,0.0,19,0,19,6.0,0.0,6.0
204147,4,2,2,2,0,4,14,29,2.0,2.0,0.0,0.0,0.0,2.0,5.0,22,4,18,6.0,2.0,4.0
9810484,2,2,0,0,1,1,1,63,1.0,1.0,0.0,0.0,1.0,0.0,0.0,4,2,2,,,
207259,2,2,0,0,0,2,15,105,2.0,2.0,0.0,0.0,0.0,2.0,5.0,15,2,13,5.0,2.0,3.0
211467,3,3,0,0,0,3,34,32,1.0,1.0,0.0,0.0,0.0,1.0,21.0,72,3,69,35.0,1.0,34.0
9901410,1,1,0,0,1,0,0,1,0.0,0.0,0.0,0.0,0.0,0.0,0.0,11,1,10,5.0,0.0,5.0
9303289,1,1,0,0,1,0,0,1316,,,,,,,,1,1,0,,,
6306,12,7,5,6,8,4,8,197,5.0,3.0,2.0,3.0,2.0,3.0,6.0,19,12,7,7.0,3.0,4.0
9903372,5,3,2,4,0,5,34,26,5.0,3.0,2.0,4.0,0.0,5.0,34.0,16,5,11,11.0,2.0,9.0
301179,0,0,0,0,0,0,0,10,0.0,0.0,0.0,0.0,0.0,0.0,0.0,28,0,28,6.0,0.0,6.0
9608464,2,2,0,0,0,2,5,31,,,,,,,,6,2,4,,,
1238,0,0,0,0,0,0,0,981,,,,,,,,3,0,3,,,
201275,2,2,0,0,1,1,2,165,2.0,2.0,0.0,0.0,1.0,1.0,2.0,7,2,5,1.0,1.0,0.0
9706461,1,1,0,0,0,1,1,54,0.0,0.0,0.0,0.0,0.0,0.0,0.0,3,1,2,1.0,0.0,1.0
9304253,1,1,0,0,1,0,0,1685,1.0,1.0,0.0,0.0,1.0,0.0,0.0,1,1,0,1.0,1.0,0.0
10257,6,3,3,5,0,6,17,8,5.0,2.0,3.0,5.0,0.0,5.0,14.0,10,6,4,6.0,4.0,2.0
202227,3,2,1,2,0,3,13,17,3.0,2.0,1.0,2.0,3.0,0.0,0.0,17,3,14,3.0,3.0,0.0
207269,2,2,0,0,0,2,14,2,0.0,0.0,0.0,0.0,0.0,0.0,0.0,29,2,27,16.0,0.0,16.0
9127,1,1,0,0,0,1,2,12,,,,,,,,7,1,6,,,
108113,2,2,0,0,1,1,10,21,1.0,1.0,0.0,0.0,0.0,1.0,8.0,43,2,41,8.0,1.0,7.0
110296,7,5,2,2,2,5,14,71,2.0,2.0,0.0,0.0,0.0,2.0,9.0,15,7,8,9.0,2.0,7.0
9611419,0,0,0,0,0,0,0,13,0.0,0.0,0.0,0.0,0.0,0.0,0.0,21,0,21,4.0,0.0,4.0
9709202,1,1,0,0,0,1,1,73,0.0,0.0,0.0,0.0,0.0,0.0,0.0,8,1,7,1.0,0.0,1.0
9711241,2,2,0,0,0,2,2,84,2.0,2.0,0.0,0.0,0.0,2.0,2.0,5,2,3,1.0,1.0,0.0
6072,1,1,0,0,0,1,3,25,0.0,0.0,0.0,0.0,0.0,0.0,0.0,10,1,9,5.0,0.0,5.0
301093,1,1,0,0,0,1,2,38,0.0,0.0,0.0,0.0,0.0,0.0,0.0,9,1,8,3.0,0.0,3.0
11318,4,4,0,0,2,2,2,395,1.0,1.0,0.0,0.0,1.0,0.0,0.0,6,4,2,2.0,1.0,1.0
104124,11,6,5,6,1,10,37,77,3.0,2.0,1.0,1.0,0.0,3.0,11.0,20,11,9,6.0,2.0,4.0
202153,2,2,0,0,0,2,6,53,1.0,1.0,0.0,0.0,0.0,1.0,3.0,13,2,11,2.0,1.0,1.0
1022,2,2,0,0,0,2,3,482,1.0,1.0,0.0,0.0,0.0,1.0,1.0,6,2,4,2.0,1.0,1.0
203011,3,2,1,1,2,1,1,166,1.0,1.0,0.0,0.0,0.0,1.0,1.0,11,3,8,2.0,0.0,2.0
203055,3,2,1,1,0,3,11,7,0.0,0.0,0.0,0.0,0.0,0.0,0.0,31,3,28,4.0,0.0,4.0
9812352,2,2,0,0,0,2,7,47,1.0,1.0,0.0,0.0,0.0,1.0,3.0,7,2,5,4.0,2.0,2.0
2303,3,3,0,0,1,2,6,194,2.0,2.0,0.0,0.0,0.0,2.0,4.0,8,3,5,4.0,2.0,2.0
9801400,1,1,0,0,1,0,0,30,0.0,0.0,0.0,0.0,0.0,0.0,0.0,12,1,11,3.0,0.0,3.0
105094,4,1,3,5,0,4,18,82,4.0,1.0,3.0,5.0,0.0,4.0,17.0,11,4,7,7.0,3.0,4.0
9712293,6,4,2,2,1,5,14,45,3.0,2.0,1.0,1.0,1.0,2.0,3.0,16,6,10,5.0,3.0,2.0
9803338,3,3,0,0,1,2,8,45,2.0,2.0,0.0,0.0,0.0,2.0,8.0,12,3,9,2.0,1.0,1.0
112155,1,1,0,0,0,1,2,251,1.0,1.0,0.0,0.0,0.0,1.0,1.0,10,1,9,1.0,0.0,1.0
9607477,1,1,0,0,1,0,0,353,1.0,1.0,0.0,0.0,1.0,0.0,0.0,1,1,0,1.0,1.0,0.0
9211243,5,3,2,3,5,0,0,596,4.0,3.0,1.0,1.0,4.0,0.0,0.0,5,5,0,4.0,4.0,0.0
9712204,5,3,2,2,4,1,1,213,2.0,1.0,1.0,1.0,1.0,1.0,1.0,6,5,1,1.0,1.0,0.0
9406209,0,0,0,0,0,0,0,53,0.0,0.0,0.0,0.0,0.0,0.0,0.0,10,0,10,1.0,0.0,1.0
9312244,4,3,1,1,4,0,0,189,4.0,3.0,1.0,1.0,4.0,0.0,0.0,4,4,0,2.0,2.0,0.0
9807323,4,3,1,1,0,4,13,1,2.0,2.0,0.0,0.0,0.0,2.0,11.0,21,4,17,3.0,2.0,1.0
302272,0,0,0,0,0,0,0,37,0.0,0.0,0.0,0.0,0.0,0.0,0.0,15,0,15,9.0,0.0,9.0
9910447,1,1,0,0,0,1,1,243,0.0,0.0,0.0,0.0,0.0,0.0,0.0,3,1,2,2.0,1.0,1.0
101280,5,5,0,0,2,3,5,27,1.0,1.0,0.0,0.0,1.0,0.0,0.0,18,5,13,1.0,1.0,0.0
9408403,2,2,0,0,2,0,0,239,2.0,2.0,0.0,0.0,2.0,0.0,0.0,2,2,0,1.0,1.0,0.0
9902365,1,1,0,0,0,1,1,64,0.0,0.0,0.0,0.0,0.0,0.0,0.0,8,1,7,7.0,0.0,7.0
9907560,3,3,0,0,0,3,12,101,1.0,1.0,0.0,0.0,0.0,1.0,2.0,16,3,13,2.0,0.0,2.0
9907208,0,0,0,0,0,0,0,974,0.0,0.0,0.0,0.0,0.0,0.0,0.0,1,0,1,1.0,0.0,1.0
9502344,0,0,0,0,0,0,0,10,0.0,0.0,0.0,0.0,0.0,0.0,0.0,12,0,12,2.0,0.0,2.0
201247,5,3,2,2,0,5,36,10,4.0,2.0,2.0,2.0,0.0,4.0,31.0,20,5,15,12.0,3.0,9.0
206170,2,1,1,1,0,2,5,29,0.0,0.0,0.0,0.0,0.0,0.0,0.0,15,2,13,2.0,1.0,1.0
302195,1,1,0,0,0,1,2,202,1.0,1.0,0.0,0.0,0.0,1.0,2.0,14,1,13,6.0,1.0,5.0
2275,2,2,0,0,2,0,0,76,1.0,1.0,0.0,0.0,1.0,0.0,0.0,2,2,0,,,
9712220,4,1,3,5,4,0,0,159,4.0,1.0,3.0,5.0,4.0,0.0,0.0,4,4,0,4.0,4.0,0.0
107194,2,2,0,0,1,1,10,19,1.0,1.0,0.0,0.0,0.0,1.0,5.0,40,2,38,12.0,1.0,11.0
9806310,2,2,0,0,0,2,3,179,1.0,1.0,0.0,0.0,1.0,0.0,0.0,5,2,3,1.0,1.0,0.0
105174,7,3,4,6,0,7,56,66,3.0,2.0,1.0,1.0,0.0,3.0,15.0,37,7,30,6.0,5.0,1.0
102329,1,1,0,0,0,1,4,38,1.0,1.0,0.0,0.0,0.0,1.0,3.0,6,1,5,5.0,1.0,4.0
9702272,1,1,0,0,0,1,4,166,1.0,1.0,0.0,0.0,0.0,1.0,3.0,5,1,4,4.0,1.0,3.0
1280,1,1,0,0,0,1,6,251,1.0,1.0,0.0,0.0,0.0,1.0,5.0,9,1,8,6.0,1.0,5.0
9308323,1,1,0,0,0,1,6,75,0.0,0.0,0.0,0.0,0.0,0.0,0.0,22,1,21,3.0,0.0,3.0
9603277,6,6,0,0,1,5,5,211,2.0,2.0,0.0,0.0,0.0,2.0,2.0,8,6,2,4.0,3.0,1.0
9503460,3,3,0,0,1,2,5,96,0.0,0.0,0.0,0.0,0.0,0.0,0.0,8,3,5,4.0,0.0,4.0
204095,7,5,2,2,0,7,36,45,3.0,2.0,1.0,1.0,0.0,3.0,15.0,30,7,23,11.0,2.0,9.0
205342,6,5,1,1,0,6,84,4,4.0,3.0,1.0,1.0,0.0,4.0,35.0,95,6,89,19.0,4.0,15.0
12153,2,1,1,1,0,2,13,0,0.0,0.0,0.0,0.0,0.0,0.0,0.0,18,2,16,5.0,2.0,3.0
9809560,1,1,0,0,0,1,2,70,0.0,0.0,0.0,0.0,0.0,0.0,0.0,9,1,8,,,
1016,4,1,3,4,0,4,15,47,4.0,1.0,3.0,4.0,0.0,4.0,15.0,11,4,7,9.0,4.0,5.0
9904243,4,2,2,3,2,2,7,24,0.0,0.0,0.0,0.0,0.0,0.0,0.0,49,4,45,11.0,1.0,10.0
209168,1,1,0,0,0,1,6,20,1.0,1.0,0.0,0.0,0.0,1.0,6.0,12,1,11,4.0,1.0,3.0
302085,0,0,0,0,0,0,0,106,0.0,0.0,0.0,0.0,0.0,0.0,0.0,4,0,4,1.0,0.0,1.0
11157,0,0,0,0,0,0,0,84,,,,,,,,2,0,2,,,
9218,1,1,0,0,0,1,7,25,1.0,1.0,0.0,0.0,0.0,1.0,4.0,23,1,22,8.0,1.0,7.0
9703366,1,1,0,0,1,0,0,227,0.0,0.0,0.0,0.0,0.0,0.0,0.0,7,1,6,2.0,0.0,2.0
9310269,1,1,0,0,1,0,0,621,1.0,1.0,0.0,0.0,1.0,0.0,0.0,4,1,3,,,
9510436,9,2,7,14,0,9,26,52,9.0,2.0,7.0,14.0,0.0,9.0,26.0,12,9,3,12.0,9.0,3.0
108056,2,2,0,0,0,2,14,10,1.0,1.0,0.0,0.0,0.0,1.0,2.0,19,2,17,5.0,1.0,4.0
106328,3,3,0,0,1,2,31,26,2.0,2.0,0.0,0.0,0.0,2.0,29.0,23,3,20,15.0,1.0,14.0
11377,5,2,3,5,2,3,3,13,0.0,0.0,0.0,0.0,0.0,0.0,0.0,20,5,15,4.0,4.0,0.0
9809585,2,1,1,1,1,1,3,294,2.0,1.0,1.0,1.0,1.0,1.0,1.0,5,2,3,3.0,2.0,1.0
110137,1,1,0,0,0,1,3,80,0.0,0.0,0.0,0.0,0.0,0.0,0.0,8,1,7,4.0,1.0,3.0
9702215,1,1,0,0,0,1,2,97,1.0,1.0,0.0,0.0,0.0,1.0,2.0,9,1,8,2.0,0.0,2.0
10018,2,2,0,0,1,1,5,95,1.0,1.0,0.0,0.0,1.0,0.0,0.0,16,2,14,8.0,0.0,8.0
9510317,0,0,0,0,0,0,0,27,0.0,0.0,0.0,0.0,0.0,0.0,0.0,7,0,7,3.0,0.0,3.0
9803441,1,1,0,0,0,1,4,51,1.0,1.0,0.0,0.0,0.0,1.0,4.0,9,1,8,4.0,1.0,3.0
111146,3,2,1,1,0,3,10,226,2.0,1.0,1.0,1.0,0.0,2.0,3.0,13,3,10,6.0,2.0,4.0
11020,1,1,0,0,0,1,6,81,1.0,1.0,0.0,0.0,0.0,1.0,6.0,9,1,8,8.0,1.0,7.0
101285,0,0,0,0,0,0,0,221,0.0,0.0,0.0,0.0,0.0,0.0,0.0,2,0,2,2.0,0.0,2.0
1314,0,0,0,0,0,0,0,273,0.0,0.0,0.0,0.0,0.0,0.0,0.0,2,0,2,2.0,0.0,2.0
211418,1,1,0,0,0,1,10,10,,,,,,,,19,1,18,8.0,1.0,7.0
9810450,3,3,0,0,0,3,23,44,3.0,3.0,0.0,0.0,0.0,3.0,21.0,18,3,15,5.0,3.0,2.0
5073,2,2,0,0,0,2,7,42,2.0,2.0,0.0,0.0,0.0,2.0,2.0,9,2,7,2.0,1.0,1.0
5161,4,3,1,1,1,3,6,84,2.0,1.0,1.0,1.0,0.0,2.0,4.0,14,4,10,3.0,3.0,0.0
206144,1,1,0,0,0,1,7,9,1.0,1.0,0.0,0.0,0.0,1.0,4.0,16,1,15,7.0,0.0,7.0
109134,0,0,0,0,0,0,0,8,0.0,0.0,0.0,0.0,0.0,0.0,0.0,7,0,7,1.0,0.0,1.0
9404304,1,1,0,0,1,0,0,164,0.0,0.0,0.0,0.0,0.0,0.0,0.0,7,1,6,6.0,0.0,6.0
9310275,3,2,1,1,3,0,0,96,2.0,1.0,1.0,1.0,2.0,0.0,0.0,4,3,1,3.0,2.0,1.0
9330,2,1,1,1,0,2,2,390,2.0,1.0,1.0,1.0,0.0,2.0,2.0,9,2,7,3.0,2.0,1.0
9502267,2,2,0,0,2,0,0,35,1.0,1.0,0.0,0.0,1.0,0.0,0.0,8,2,6,3.0,1.0,2.0
204308,4,2,2,2,0,4,45,71,4.0,2.0,2.0,2.0,0.0,4.0,39.0,40,4,36,22.0,3.0,19.0
207156,4,2,2,2,0,4,29,102,4.0,2.0,2.0,2.0,0.0,4.0,17.0,22,4,18,13.0,4.0,9.0
107104,1,1,0,0,1,0,0,54,0.0,0.0,0.0,0.0,0.0,0.0,0.0,9,1,8,3.0,0.0,3.0
9701290,1,1,0,0,0,1,1,59,1.0,1.0,0.0,0.0,0.0,1.0,1.0,8,1,7,3.0,0.0,3.0
9804415,2,2,0,0,1,1,1,1546,1.0,1.0,0.0,0.0,1.0,0.0,0.0,3,2,1,1.0,1.0,0.0
8259,1,1,0,0,0,1,5,44,1.0,1.0,0.0,0.0,0.0,1.0,2.0,7,1,6,3.0,1.0,2.0
9903281,1,1,0,0,0,1,2,338,0.0,0.0,0.0,0.0,0.0,0.0,0.0,12,1,11,3.0,0.0,3.0
9611202,0,0,0,0,0,0,0,992,,,,,,,,1,0,1,1.0,0.0,1.0
11319,1,1,0,0,0,1,1,47,0.0,0.0,0.0,0.0,0.0,0.0,0.0,5,1,4,,,
9712461,1,1,0,0,1,0,0,139,,,,,,,,1,1,0,,,
9907424,2,2,0,0,1,1,3,51,0.0,0.0,0.0,0.0,0.0,0.0,0.0,7,2,5,3.0,1.0,2.0
12382,3,1,2,2,0,3,11,51,3.0,1.0,2.0,2.0,0.0,3.0,7.0,15,3,12,5.0,3.0,2.0
9405404,0,0,0,0,0,0,0,208,0.0,0.0,0.0,0.0,0.0,0.0,0.0,9,0,9,5.0,0.0,5.0
9904364,1,1,0,0,0,1,1,173,0.0,0.0,0.0,0.0,0.0,0.0,0.0,16,1,15,5.0,0.0,5.0
9508222,0,0,0,0,0,0,0,231,0.0,0.0,0.0,0.0,0.0,0.0,0.0,1,0,1,1.0,0.0,1.0
9190,0,0,0,0,0,0,0,6,0.0,0.0,0.0,0.0,0.0,0.0,0.0,15,0,15,9.0,0.0,9.0
9712411,5,2,3,7,1,4,4,347,5.0,2.0,3.0,7.0,1.0,4.0,4.0,6,5,1,6.0,5.0,1.0
302271,0,0,0,0,0,0,0,167,,,,,,,,1,0,1,,,
10044,1,1,0,0,1,0,0,19,,,,,,,,8,1,7,,,
6064,2,1,1,1,1,1,1,220,2.0,1.0,1.0,1.0,1.0,1.0,1.0,3,2,1,3.0,2.0,1.0
205326,1,1,0,0,0,1,5,39,0.0,0.0,0.0,0.0,0.0,0.0,0.0,15,1,14,4.0,0.0,4.0
9711513,1,1,0,0,0,1,1,40,0.0,0.0,0.0,0.0,0.0,0.0,0.0,7,1,6,1.0,0.0,1.0
112361,5,2,3,7,0,5,15,33,5.0,2.0,3.0,7.0,0.0,5.0,15.0,12,5,7,5.0,5.0,0.0
211182,0,0,0,0,0,0,0,32,0.0,0.0,0.0,0.0,0.0,0.0,0.0,6,0,6,1.0,0.0,1.0
9508232,4,1,3,6,3,1,1,51,3.0,1.0,2.0,3.0,2.0,1.0,1.0,5,4,1,5.0,4.0,1.0
210232,1,1,0,0,0,1,1,46,0.0,0.0,0.0,0.0,0.0,0.0,0.0,8,1,7,2.0,1.0,1.0
109252,1,1,0,0,0,1,1,42,1.0,1.0,0.0,0.0,1.0,0.0,0.0,6,1,5,1.0,1.0,0.0
111419,0,0,0,0,0,0,0,8,0.0,0.0,0.0,0.0,0.0,0.0,0.0,12,0,12,,,
103301,0,0,0,0,0,0,0,259,0.0,0.0,0.0,0.0,0.0,0.0,0.0,3,0,3,1.0,0.0,1.0
9809246,0,0,0,0,0,0,0,101,,,,,,,,3,0,3,1.0,0.0,1.0
210346,0,0,0,0,0,0,0,88,0.0,0.0,0.0,0.0,0.0,0.0,0.0,6,0,6,1.0,0.0,1.0
104191,0,0,0,0,0,0,0,983,,,,,,,,1,0,1,,,
9706536,2,1,1,1,0,2,4,514,2.0,1.0,1.0,1.0,0.0,2.0,2.0,7,2,5,3.0,2.0,1.0
1137,0,0,0,0,0,0,0,16,0.0,0.0,0.0,0.0,0.0,0.0,0.0,4,0,4,,,
302126,0,0,0,0,0,0,0,143,0.0,0.0,0.0,0.0,0.0,0.0,0.0,11,0,11,4.0,0.0,4.0
9706465,0,0,0,0,0,0,0,100,0.0,0.0,0.0,0.0,0.0,0.0,0.0,8,0,8,2.0,0.0,2.0
9177,1,1,0,0,1,0,0,186,0.0,0.0,0.0,0.0,0.0,0.0,0.0,4,1,3,1.0,1.0,0.0
110184,1,1,0,0,0,1,14,11,1.0,1.0,0.0,0.0,0.0,1.0,13.0,37,1,36,7.0,0.0,7.0
9411430,3,3,0,0,0,3,7,116,2.0,2.0,0.0,0.0,0.0,2.0,6.0,8,3,5,6.0,2.0,4.0
9906293,8,6,2,2,5,3,3,213,2.0,2.0,0.0,0.0,0.0,2.0,2.0,23,8,15,5.0,0.0,5.0
9308228,0,0,0,0,0,0,0,1291,,,,,,,,1,0,1,,,
302163,0,0,0,0,0,0,0,12,0.0,0.0,0.0,0.0,0.0,0.0,0.0,28,0,28,2.0,0.0,2.0
9706528,1,1,0,0,0,1,3,332,1.0,1.0,0.0,0.0,1.0,0.0,0.0,8,1,7,2.0,1.0,1.0
9908249,2,2,0,0,0,2,6,13,,,,,,,,7,2,5,,,
9405251,0,0,0,0,0,0,0,170,0.0,0.0,0.0,0.0,0.0,0.0,0.0,2,0,2,1.0,0.0,1.0
208004,2,2,0,0,1,1,5,81,1.0,1.0,0.0,0.0,0.0,1.0,3.0,12,2,10,5.0,1.0,4.0
106151,0,0,0,0,0,0,0,64,0.0,0.0,0.0,0.0,0.0,0.0,0.0,2,0,2,2.0,0.0,2.0
9903356,1,1,0,0,1,0,0,1045,,,,,,,,1,1,0,1.0,1.0,0.0
9309296,0,0,0,0,0,0,0,75,,,,,,,,4,0,4,1.0,0.0,1.0
107269,0,0,0,0,0,0,0,16,0.0,0.0,0.0,0.0,0.0,0.0,0.0,29,0,29,13.0,0.0,13.0
9903330,1,1,0,0,1,0,0,1001,0.0,0.0,0.0,0.0,0.0,0.0,0.0,5,1,4,2.0,0.0,2.0
106018,1,1,0,0,1,0,0,764,1.0,1.0,0.0,0.0,1.0,0.0,0.0,3,1,2,1.0,1.0,0.0
9912359,1,1,0,0,0,1,3,68,1.0,1.0,0.0,0.0,0.0,1.0,2.0,6,1,5,4.0,1.0,3.0
2083,0,0,0,0,0,0,0,86,0.0,0.0,0.0,0.0,0.0,0.0,0.0,9,0,9,1.0,0.0,1.0
202279,3,1,2,3,0,3,18,9,3.0,1.0,2.0,3.0,0.0,3.0,18.0,15,3,12,3.0,2.0,1.0
9811432,0,0,0,0,0,0,0,582,0.0,0.0,0.0,0.0,0.0,0.0,0.0,4,0,4,1.0,0.0,1.0
2099,0,0,0,0,0,0,0,30,0.0,0.0,0.0,0.0,0.0,0.0,0.0,12,0,12,3.0,0.0,3.0
9907283,2,1,1,1,2,0,0,93,2.0,1.0,1.0,1.0,2.0,0.0,0.0,3,2,1,2.0,2.0,0.0
9911211,1,1,0,0,0,1,1,183,1.0,1.0,0.0,0.0,0.0,1.0,1.0,11,1,10,3.0,0.0,3.0
9707519,0,0,0,0,0,0,0,402,0.0,0.0,0.0,0.0,0.0,0.0,0.0,1,0,1,,,
110361,0,0,0,0,0,0,0,396,0.0,0.0,0.0,0.0,0.0,0.0,0.0,2,0,2,1.0,0.0,1.0
9909503,1,1,0,0,0,1,8,48,0.0,0.0,0.0,0.0,0.0,0.0,0.0,13,1,12,1.0,0.0,1.0
9207208,0,0,0,0,0,0,0,207,0.0,0.0,0.0,0.0,0.0,0.0,0.0,1,0,1,,,
11158,0,0,0,0,0,0,0,692,0.0,0.0,0.0,0.0,0.0,0.0,0.0,1,0,1,1.0,0.0,1.0
208072,1,1,0,0,0,1,1,18,0.0,0.0,0.0,0.0,0.0,0.0,0.0,34,1,33,3.0,1.0,2.0
204196,1,1,0,0,0,1,12,4,0.0,0.0,0.0,0.0,0.0,0.0,0.0,37,1,36,6.0,0.0,6.0
9407403,1,1,0,0,1,0,0,1235,,,,,,,,3,1,2,,,
9907457,1,1,0,0,0,1,2,966,,,,,,,,3,1,2,2.0,1.0,1.0
212382,0,0,0,0,0,0,0,70,0.0,0.0,0.0,0.0,0.0,0.0,0.0,8,0,8,,,
12071,1,1,0,0,1,0,0,429,1.0,1.0,0.0,0.0,1.0,0.0,0.0,3,1,2,3.0,1.0,2.0
208011,1,1,0,0,0,1,1,141,0.0,0.0,0.0,0.0,0.0,0.0,0.0,5,1,4,1.0,0.0,1.0
11249,0,0,0,0,0,0,0,254,0.0,0.0,0.0,0.0,0.0,0.0,0.0,5,0,5,5.0,0.0,5.0
9910377,1,1,0,0,0,1,1,115,1.0,1.0,0.0,0.0,0.0,1.0,1.0,13,1,12,6.0,0.0,6.0
9705238,0,0,0,0,0,0,0,693,0.0,0.0,0.0,0.0,0.0,0.0,0.0,1,0,1,1.0,0.0,1.0
9812268,2,1,1,1,0,2,4,91,1.0,1.0,0.0,0.0,0.0,1.0,3.0,10,2,8,7.0,1.0,6.0
301270,1,1,0,0,0,1,3,112,0.0,0.0,0.0,0.0,0.0,0.0,0.0,16,1,15,9.0,0.0,9.0
9309271,0,0,0,0,0,0,0,41,0.0,0.0,0.0,0.0,0.0,0.0,0.0,4,0,4,4.0,0.0,4.0
209141,2,2,0,0,0,2,8,51,2.0,2.0,0.0,0.0,0.0,2.0,8.0,11,2,9,6.0,1.0,5.0
9316,0,0,0,0,0,0,0,120,0.0,0.0,0.0,0.0,0.0,0.0,0.0,2,0,2,,,
9910322,0,0,0,0,0,0,0,57,0.0,0.0,0.0,0.0,0.0,0.0,0.0,14,0,14,5.0,0.0,5.0
9812214,0,0,0,0,0,0,0,51,0.0,0.0,0.0,0.0,0.0,0.0,0.0,3,0,3,1.0,0.0,1.0
9504254,1,1,0,0,0,1,1,269,1.0,1.0,0.0,0.0,0.0,1.0,1.0,2,1,1,2.0,1.0,1.0
9902414,2,1,1,1,1,1,4,115,2.0,1.0,1.0,1.0,2.0,0.0,0.0,6,2,4,3.0,2.0,1.0
205297,1,1,0,0,0,1,2,1,,,,,,,,11,1,10,,,
212244,0,0,0,0,0,0,0,5,0.0,0.0,0.0,0.0,0.0,0.0,0.0,20,0,20,2.0,0.0,2.0
207252,0,0,0,0,0,0,0,147,0.0,0.0,0.0,0.0,0.0,0.0,0.0,6,0,6,2.0,0.0,2.0
9902275,3,1,2,3,0,3,5,1,1.0,1.0,0.0,0.0,0.0,1.0,2.0,13,3,10,3.0,3.0,0.0
9911368,0,0,0,0,0,0,0,9,0.0,0.0,0.0,0.0,0.0,0.0,0.0,36,0,36,10.0,0.0,10.0
101196,0,0,0,0,0,0,0,118,0.0,0.0,0.0,0.0,0.0,0.0,0.0,14,0,14,10.0,0.0,10.0
9412369,0,0,0,0,0,0,0,660,0.0,0.0,0.0,0.0,0.0,0.0,0.0,1,0,1,1.0,0.0,1.0
9905422,2,1,1,1,0,2,55,75,1.0,1.0,0.0,0.0,0.0,1.0,12.0,70,2,68,19.0,1.0,18.0
111163,2,2,0,0,0,2,5,153,1.0,1.0,0.0,0.0,0.0,1.0,4.0,24,2,22,5.0,1.0,4.0
105012,0,0,0,0,0,0,0,303,0.0,0.0,0.0,0.0,0.0,0.0,0.0,13,0,13,4.0,0.0,4.0
9606218,2,2,0,0,2,0,0,491,1.0,1.0,0.0,0.0,1.0,0.0,0.0,2,2,0,1.0,1.0,0.0
205003,0,0,0,0,0,0,0,107,0.0,0.0,0.0,0.0,0.0,0.0,0.0,1,0,1,,,
9609387,2,2,0,0,0,2,8,9,0.0,0.0,0.0,0.0,0.0,0.0,0.0,13,2,11,3.0,1.0,2.0
9205215,1,1,0,0,1,0,0,284,1.0,1.0,0.0,0.0,1.0,0.0,0.0,1,1,0,,,
207134,1,1,0,0,0,1,5,85,1.0,1.0,0.0,0.0,0.0,1.0,5.0,22,1,21,7.0,1.0,6.0
9810362,0,0,0,0,0,0,0,21,0.0,0.0,0.0,0.0,0.0,0.0,0.0,9,0,9,1.0,0.0,1.0
107031,0,0,0,0,0,0,0,108,0.0,0.0,0.0,0.0,0.0,0.0,0.0,8,0,8,2.0,0.0,2.0
9128,2,2,0,0,1,1,7,12,1.0,1.0,0.0,0.0,0.0,1.0,6.0,30,2,28,18.0,0.0,18.0
9309280,1,1,0,0,1,0,0,135,,,,,,,,1,1,0,,,
102114,1,1,0,0,0,1,2,50,1.0,1.0,0.0,0.0,0.0,1.0,2.0,8,1,7,1.0,1.0,0.0
9809339,0,0,0,0,0,0,0,22,0.0,0.0,0.0,0.0,0.0,0.0,0.0,13,0,13,7.0,0.0,7.0
9909285,0,0,0,0,0,0,0,1721,,,,,,,,2,0,2,2.0,0.0,2.0
9902374,1,1,0,0,0,1,6,10,1.0,1.0,0.0,0.0,0.0,1.0,3.0,9,1,8,3.0,0.0,3.0
9412395,0,0,0,0,0,0,0,1679,0.0,0.0,0.0,0.0,0.0,0.0,0.0,1,0,1,,,
210239,1,1,0,0,0,1,1,171,1.0,1.0,0.0,0.0,0.0,1.0,1.0,5,1,4,4.0,1.0,3.0
209289,0,0,0,0,0,0,0,34,0.0,0.0,0.0,0.0,0.0,0.0,0.0,4,0,4,2.0,0.0,2.0
12323,1,1,0,0,0,1,2,31,,,,,,,,4,1,3,,,
9803395,0,0,0,0,0,0,0,114,,,,,,,,1,0,1,,,
208006,0,0,0,0,0,0,0,1,0.0,0.0,0.0,0.0,0.0,0.0,0.0,23,0,23,4.0,0.0,4.0
9910556,0,0,0,0,0,0,0,379,0.0,0.0,0.0,0.0,0.0,0.0,0.0,3,0,3,3.0,0.0,3.0
102188,1,1,0,0,0,1,13,44,1.0,1.0,0.0,0.0,0.0,1.0,9.0,21,1,20,10.0,1.0,9.0
5205,0,0,0,0,0,0,0,352,0.0,0.0,0.0,0.0,0.0,0.0,0.0,6,0,6,3.0,0.0,3.0
9610548,0,0,0,0,0,0,0,640,0.0,0.0,0.0,0.0,0.0,0.0,0.0,1,0,1,1.0,0.0,1.0
208149,1,1,0,0,0,1,6,10,0.0,0.0,0.0,0.0,0.0,0.0,0.0,10,1,9,1.0,0.0,1.0
11079,4,4,0,0,3,1,5,13,0.0,0.0,0.0,0.0,0.0,0.0,0.0,9,4,5,1.0,0.0,1.0
9607308,0,0,0,0,0,0,0,276,0.0,0.0,0.0,0.0,0.0,0.0,0.0,3,0,3,1.0,0.0,1.0
9911246,1,1,0,0,1,0,0,74,1.0,1.0,0.0,0.0,1.0,0.0,0.0,2,1,1,1.0,1.0,0.0
9807429,0,0,0,0,0,0,0,83,0.0,0.0,0.0,0.0,0.0,0.0,0.0,4,0,4,1.0,0.0,1.0
101111,0,0,0,0,0,0,0,95,0.0,0.0,0.0,0.0,0.0,0.0,0.0,17,0,17,14.0,0.0,14.0
111195,1,1,0,0,0,1,1,3,0.0,0.0,0.0,0.0,0.0,0.0,0.0,28,1,27,2.0,0.0,2.0
9805320,0,0,0,0,0,0,0,81,0.0,0.0,0.0,0.0,0.0,0.0,0.0,14,0,14,1.0,0.0,1.0
9411218,0,0,0,0,0,0,0,1600,,,,,,,,1,0,1,,,
111274,0,0,0,0,0,0,0,239,0.0,0.0,0.0,0.0,0.0,0.0,0.0,11,0,11,3.0,0.0,3.0
210026,1,1,0,0,0,1,12,56,1.0,1.0,0.0,0.0,0.0,1.0,12.0,21,1,20,18.0,1.0,17.0
110120,2,2,0,0,1,1,9,105,1.0,1.0,0.0,0.0,0.0,1.0,6.0,12,2,10,7.0,1.0,6.0
105341,0,0,0,0,0,0,0,42,0.0,0.0,0.0,0.0,0.0,0.0,0.0,7,0,7,1.0,0.0,1.0
9612215,1,1,0,0,0,1,2,160,1.0,1.0,0.0,0.0,0.0,1.0,2.0,3,1,2,2.0,1.0,1.0
207172,0,0,0,0,0,0,0,122,0.0,0.0,0.0,0.0,0.0,0.0,0.0,7,0,7,5.0,0.0,5.0
3237,1,1,0,0,1,0,0,704,1.0,1.0,0.0,0.0,1.0,0.0,0.0,2,1,1,1.0,1.0,0.0
9810434,1,1,0,0,1,0,0,277,1.0,1.0,0.0,0.0,1.0,0.0,0.0,1,1,0,1.0,1.0,0.0
9905398,0,0,0,0,0,0,0,152,0.0,0.0,0.0,0.0,0.0,0.0,0.0,5,0,5,2.0,0.0,2.0
10300,0,0,0,0,0,0,0,57,0.0,0.0,0.0,0.0,0.0,0.0,0.0,4,0,4,1.0,0.0,1.0
9310339,1,1,0,0,0,1,1,418,1.0,1.0,0.0,0.0,0.0,1.0,1.0,3,1,2,3.0,1.0,2.0
211389,0,0,0,0,0,0,0,286,0.0,0.0,0.0,0.0,0.0,0.0,0.0,7,0,7,1.0,0.0,1.0
3158,1,1,0,0,0,1,1,117,1.0,1.0,0.0,0.0,1.0,0.0,0.0,4,1,3,1.0,1.0,0.0
206089,0,0,0,0,0,0,0,1805,0.0,0.0,0.0,0.0,0.0,0.0,0.0,2,0,2,1.0,0.0,1.0
10189,0,0,0,0,0,0,0,27,0.0,0.0,0.0,0.0,0.0,0.0,0.0,7,0,7,1.0,0.0,1.0
9802332,0,0,0,0,0,0,0,42,,,,,,,,3,0,3,,,
209197,2,1,1,1,0,2,2,51,2.0,1.0,1.0,1.0,0.0,2.0,2.0,7,2,5,5.0,2.0,3.0
9503446,2,2,0,0,1,1,3,40,1.0,1.0,0.0,0.0,0.0,1.0,3.0,13,2,11,2.0,1.0,1.0
212243,0,0,0,0,0,0,0,13,0.0,0.0,0.0,0.0,0.0,0.0,0.0,8,0,8,3.0,0.0,3.0
9712439,0,0,0,0,0,0,0,0,0.0,0.0,0.0,0.0,0.0,0.0,0.0,8,0,8,1.0,0.0,1.0
212186,0,0,0,0,0,0,0,146,0.0,0.0,0.0,0.0,0.0,0.0,0.0,8,0,8,7.0,0.0,7.0
9306308,0,0,0,0,0,0,0,2005,0.0,0.0,0.0,0.0,0.0,0.0,0.0,1,0,1,,,
211209,0,0,0,0,0,0,0,102,0.0,0.0,0.0,0.0,0.0,0.0,0.0,11,0,11,3.0,0.0,3.0
211420,0,0,0,0,0,0,0,34,0.0,0.0,0.0,0.0,0.0,0.0,0.0,25,0,25,5.0,0.0,5.0
9911312,0,0,0,0,0,0,0,210,0.0,0.0,0.0,0.0,0.0,0.0,0.0,11,0,11,4.0,0.0,4.0
207353,1,1,0,0,0,1,10,7,1.0,1.0,0.0,0.0,0.0,1.0,9.0,48,1,47,13.0,0.0,13.0
9409337,0,0,0,0,0,0,0,90,0.0,0.0,0.0,0.0,0.0,0.0,0.0,1,0,1,,,
3192,0,0,0,0,0,0,0,67,0.0,0.0,0.0,0.0,0.0,0.0,0.0,8,0,8,1.0,0.0,1.0
112244,0,0,0,0,0,0,0,110,,,,,,,,1,0,1,,,
9806262,0,0,0,0,0,0,0,514,0.0,0.0,0.0,0.0,0.0,0.0,0.0,6,0,6,3.0,0.0,3.0
9124,0,0,0,0,0,0,0,213,0.0,0.0,0.0,0.0,0.0,0.0,0.0,3,0,3,1.0,0.0,1.0
210419,0,0,0,0,0,0,0,19,0.0,0.0,0.0,0.0,0.0,0.0,0.0,6,0,6,,,
9117,1,1,0,0,0,1,7,36,1.0,1.0,0.0,0.0,0.0,1.0,3.0,9,1,8,5.0,1.0,4.0
106261,0,0,0,0,0,0,0,121,0.0,0.0,0.0,0.0,0.0,0.0,0.0,6,0,6,1.0,0.0,1.0
101352,0,0,0,0,0,0,0,354,0.0,0.0,0.0,0.0,0.0,0.0,0.0,4,0,4,1.0,0.0,1.0
9703322,0,0,0,0,0,0,0,195,0.0,0.0,0.0,0.0,0.0,0.0,0.0,2,0,2,1.0,0.0,1.0
9805462,1,1,0,0,0,1,3,117,0.0,0.0,0.0,0.0,0.0,0.0,0.0,8,1,7,2.0,0.0,2.0
206277,1,1,0,0,0,1,8,52,1.0,1.0,0.0,0.0,0.0,1.0,7.0,11,1,10,8.0,1.0,7.0
9506463,0,0,0,0,0,0,0,6,0.0,0.0,0.0,0.0,0.0,0.0,0.0,12,0,12,1.0,0.0,1.0
207209,0,0,0,0,0,0,0,66,0.0,0.0,0.0,0.0,0.0,0.0,0.0,16,0,16,5.0,0.0,5.0
107235,0,0,0,0,0,0,0,299,0.0,0.0,0.0,0.0,0.0,0.0,0.0,6,0,6,,,
201100,0,0,0,0,0,0,0,11,0.0,0.0,0.0,0.0,0.0,0.0,0.0,16,0,16,1.0,0.0,1.0
9702329,0,0,0,0,0,0,0,327,0.0,0.0,0.0,0.0,0.0,0.0,0.0,3,0,3,2.0,0.0,2.0
9203221,1,1,0,0,1,0,0,301,1.0,1.0,0.0,0.0,1.0,0.0,0.0,1,1,0,1.0,1.0,0.0
9409222,0,0,0,0,0,0,0,1520,,,,,,,,1,0,1,,,
11042,1,1,0,0,0,1,4,226,1.0,1.0,0.0,0.0,0.0,1.0,3.0,10,1,9,3.0,1.0,2.0
209113,0,0,0,0,0,0,0,120,0.0,0.0,0.0,0.0,0.0,0.0,0.0,4,0,4,1.0,0.0,1.0
203216,0,0,0,0,0,0,0,132,0.0,0.0,0.0,0.0,0.0,0.0,0.0,2,0,2,,,
9804374,0,0,0,0,0,0,0,107,0.0,0.0,0.0,0.0,0.0,0.0,0.0,5,0,5,4.0,0.0,4.0
112335,0,0,0,0,0,0,0,219,0.0,0.0,0.0,0.0,0.0,0.0,0.0,7,0,7,3.0,0.0,3.0
9406229,0,0,0,0,0,0,0,57,,,,,,,,3,0,3,1.0,0.0,1.0
9402312,0,0,0,0,0,0,0,183,0.0,0.0,0.0,0.0,0.0,0.0,0.0,3,0,3,,,
208183,0,0,0,0,0,0,0,105,0.0,0.0,0.0,0.0,0.0,0.0,0.0,11,0,11,10.0,0.0,10.0
208164,2,2,0,0,2,0,0,346,1.0,1.0,0.0,0.0,1.0,0.0,0.0,2,2,0,1.0,1.0,0.0
9709464,0,0,0,0,0,0,0,211,0.0,0.0,0.0,0.0,0.0,0.0,0.0,3,0,3,,,
211099,0,0,0,0,0,0,0,127,0.0,0.0,0.0,0.0,0.0,0.0,0.0,20,0,20,9.0,0.0,9.0
9901371,0,0,0,0,0,0,0,266,0.0,0.0,0.0,0.0,0.0,0.0,0.0,4,0,4,1.0,0.0,1.0
110134,0,0,0,0,0,0,0,84,,,,,,,,4,0,4,1.0,0.0,1.0
9706353,1,1,0,0,1,0,0,754,1.0,1.0,0.0,0.0,1.0,0.0,0.0,1,1,0,1.0,1.0,0.0
9508219,0,0,0,0,0,0,0,10,0.0,0.0,0.0,0.0,0.0,0.0,0.0,9,0,9,1.0,0.0,1.0
3108,1,1,0,0,0,1,4,54,0.0,0.0,0.0,0.0,0.0,0.0,0.0,14,1,13,1.0,0.0,1.0
9605287,0,0,0,0,0,0,0,1437,0.0,0.0,0.0,0.0,0.0,0.0,0.0,1,0,1,1.0,0.0,1.0
205123,0,0,0,0,0,0,0,45,,,,,,,,4,0,4,,,
211125,0,0,0,0,0,0,0,19,0.0,0.0,0.0,0.0,0.0,0.0,0.0,9,0,9,5.0,0.0,5.0
210148,0,0,0,0,0,0,0,19,0.0,0.0,0.0,0.0,0.0,0.0,0.0,28,0,28,1.0,0.0,1.0
111330,0,0,0,0,0,0,0,0,0.0,0.0,0.0,0.0,0.0,0.0,0.0,10,0,10,5.0,0.0,5.0
104006,0,0,0,0,0,0,0,88,0.0,0.0,0.0,0.0,0.0,0.0,0.0,5,0,5,1.0,0.0,1.0
9908405,0,0,0,0,0,0,0,49,0.0,0.0,0.0,0.0,0.0,0.0,0.0,17,0,17,5.0,0.0,5.0
302065,0,0,0,0,0,0,0,30,0.0,0.0,0.0,0.0,0.0,0.0,0.0,15,0,15,6.0,0.0,6.0
103227,0,0,0,0,0,0,0,20,0.0,0.0,0.0,0.0,0.0,0.0,0.0,40,0,40,34.0,0.0,34.0
212405,0,0,0,0,0,0,0,116,0.0,0.0,0.0,0.0,0.0,0.0,0.0,15,0,15,11.0,0.0,11.0
9409351,0,0,0,0,0,0,0,1394,,,,,,,,1,0,1,,,
212013,0,0,0,0,0,0,0,19,0.0,0.0,0.0,0.0,0.0,0.0,0.0,31,0,31,8.0,0.0,8.0
9409228,0,0,0,0,0,0,0,26,0.0,0.0,0.0,0.0,0.0,0.0,0.0,31,0,31,3.0,0.0,3.0
107242,0,0,0,0,0,0,0,20,0.0,0.0,0.0,0.0,0.0,0.0,0.0,14,0,14,3.0,0.0,3.0
210018,0,0,0,0,0,0,0,83,0.0,0.0,0.0,0.0,0.0,0.0,0.0,11,0,11,5.0,0.0,5.0
10011,1,1,0,0,0,1,14,34,1.0,1.0,0.0,0.0,0.0,1.0,13.0,18,1,17,1.0,0.0,1.0
9606367,0,0,0,0,0,0,0,382,0.0,0.0,0.0,0.0,0.0,0.0,0.0,1,0,1,,,
7026,0,0,0,0,0,0,0,1530,,,,,,,,1,0,1,,,
210356,0,0,0,0,0,0,0,18,0.0,0.0,0.0,0.0,0.0,0.0,0.0,12,0,12,1.0,0.0,1.0
9903320,1,1,0,0,1,0,0,792,1.0,1.0,0.0,0.0,1.0,0.0,0.0,1,1,0,1.0,1.0,0.0
6337,0,0,0,0,0,0,0,142,0.0,0.0,0.0,0.0,0.0,0.0,0.0,7,0,7,3.0,0.0,3.0
111049,0,0,0,0,0,0,0,20,0.0,0.0,0.0,0.0,0.0,0.0,0.0,26,0,26,24.0,0.0,24.0
211189,0,0,0,0,0,0,0,2,0.0,0.0,0.0,0.0,0.0,0.0,0.0,9,0,9,1.0,0.0,1.0
8060,0,0,0,0,0,0,0,147,0.0,0.0,0.0,0.0,0.0,0.0,0.0,10,0,10,2.0,0.0,2.0
4097,1,1,0,0,0,1,8,100,1.0,1.0,0.0,0.0,0.0,1.0,8.0,10,1,9,10.0,1.0,9.0
9912444,1,1,0,0,0,1,4,41,1.0,1.0,0.0,0.0,0.0,1.0,2.0,10,1,9,3.0,1.0,2.0
106122,0,0,0,0,0,0,0,400,0.0,0.0,0.0,0.0,0.0,0.0,0.0,4,0,4,1.0,0.0,1.0
204157,0,0,0,0,0,0,0,260,0.0,0.0,0.0,0.0,0.0,0.0,0.0,16,0,16,7.0,0.0,7.0
9612419,0,0,0,0,0,0,0,1912,,,,,,,,3,0,3,,,
9702323,0,0,0,0,0,0,0,134,0.0,0.0,0.0,0.0,0.0,0.0,0.0,29,0,29,7.0,0.0,7.0
204098,1,1,0,0,0,1,5,87,1.0,1.0,0.0,0.0,0.0,1.0,3.0,9,1,8,4.0,1.0,3.0
9902262,0,0,0,0,0,0,0,71,0.0,0.0,0.0,0.0,0.0,0.0,0.0,31,0,31,16.0,0.0,16.0
9310294,0,0,0,0,0,0,0,75,0.0,0.0,0.0,0.0,0.0,0.0,0.0,8,0,8,1.0,0.0,1.0
211253,0,0,0,0,0,0,0,172,,,,,,,,9,0,9,1.0,0.0,1.0
9507387,0,0,0,0,0,0,0,330,0.0,0.0,0.0,0.0,0.0,0.0,0.0,3,0,3,1.0,0.0,1.0
9809274,0,0,0,0,0,0,0,382,0.0,0.0,0.0,0.0,0.0,0.0,0.0,6,0,6,3.0,0.0,3.0
9503487,0,0,0,0,0,0,0,10,0.0,0.0,0.0,0.0,0.0,0.0,0.0,12,0,12,,,
211240,0,0,0,0,0,0,0,78,0.0,0.0,0.0,0.0,0.0,0.0,0.0,18,0,18,9.0,0.0,9.0
203221,1,1,0,0,1,0,0,221,0.0,0.0,0.0,0.0,0.0,0.0,0.0,4,1,3,1.0,0.0,1.0
10033,0,0,0,0,0,0,0,13,0.0,0.0,0.0,0.0,0.0,0.0,0.0,6,0,6,2.0,0.0,2.0
106109,0,0,0,0,0,0,0,57,0.0,0.0,0.0,0.0,0.0,0.0,0.0,5,0,5,4.0,0.0,4.0
211322,0,0,0,0,0,0,0,55,0.0,0.0,0.0,0.0,0.0,0.0,0.0,28,0,28,4.0,0.0,4.0
301098,0,0,0,0,0,0,0,278,0.0,0.0,0.0,0.0,0.0,0.0,0.0,15,0,15,8.0,0.0,8.0
9809345,0,0,0,0,0,0,0,10,0.0,0.0,0.0,0.0,0.0,0.0,0.0,12,0,12,2.0,0.0,2.0
212036,0,0,0,0,0,0,0,22,0.0,0.0,0.0,0.0,0.0,0.0,0.0,11,0,11,3.0,0.0,3.0
9509298,0,0,0,0,0,0,0,22,,,,,,,,5,0,5,,,
301043,0,0,0,0,0,0,0,45,0.0,0.0,0.0,0.0,0.0,0.0,0.0,15,0,15,7.0,0.0,7.0
104206,0,0,0,0,0,0,0,31,0.0,0.0,0.0,0.0,0.0,0.0,0.0,10,0,10,3.0,0.0,3.0
205055,0,0,0,0,0,0,0,290,0.0,0.0,0.0,0.0,0.0,0.0,0.0,4,0,4,3.0,0.0,3.0
103073,0,0,0,0,0,0,0,51,0.0,0.0,0.0,0.0,0.0,0.0,0.0,16,0,16,2.0,0.0,2.0
9406434,0,0,0,0,0,0,0,1051,,,,,,,,5,0,5,1.0,0.0,1.0
9611234,0,0,0,0,0,0,0,189,0.0,0.0,0.0,0.0,0.0,0.0,0.0,1,0,1,,,
9612432,0,0,0,0,0,0,0,22,0.0,0.0,0.0,0.0,0.0,0.0,0.0,12,0,12,2.0,0.0,2.0
212296,0,0,0,0,0,0,0,9,0.0,0.0,0.0,0.0,0.0,0.0,0.0,22,0,22,7.0,0.0,7.0
9503237,0,0,0,0,0,0,0,1302,,,,,,,,2,0,2,1.0,0.0,1.0
9412262,0,0,0,0,0,0,0,81,,,,,,,,1,0,1,,,
204003,0,0,0,0,0,0,0,230,0.0,0.0,0.0,0.0,0.0,0.0,0.0,3,0,3,1.0,0.0,1.0
212087,0,0,0,0,0,0,0,83,0.0,0.0,0.0,0.0,0.0,0.0,0.0,21,0,21,10.0,0.0,10.0
9907441,0,0,0,0,0,0,0,9,0.0,0.0,0.0,0.0,0.0,0.0,0.0,12,0,12,9.0,0.0,9.0
9806529,0,0,0,0,0,0,0,73,0.0,0.0,0.0,0.0,0.0,0.0,0.0,12,0,12,11.0,0.0,11.0
9207224,0,0,0,0,0,0,0,1013,,,,,,,,1,0,1,1.0,0.0,1.0
2119,0,0,0,0,0,0,0,62,0.0,0.0,0.0,0.0,0.0,0.0,0.0,6,0,6,6.0,0.0,6.0
9502355,0,0,0,0,0,0,0,1666,,,,,,,,5,0,5,,,
209196,0,0,0,0,0,0,0,557,0.0,0.0,0.0,0.0,0.0,0.0,0.0,1,0,1,1.0,0.0,1.0
111072,0,0,0,0,0,0,0,31,0.0,0.0,0.0,0.0,0.0,0.0,0.0,9,0,9,1.0,0.0,1.0
9712403,0,0,0,0,0,0,0,5,0.0,0.0,0.0,0.0,0.0,0.0,0.0,11,0,11,5.0,0.0,5.0
102326,0,0,0,0,0,0,0,18,,,,,,,,4,0,4,1.0,0.0,1.0
209342,0,0,0,0,0,0,0,20,,,,,,,,4,0,4,1.0,0.0,1.0
9608484,0,0,0,0,0,0,0,126,,,,,,,,2,0,2,,,
9309318,0,0,0,0,0,0,0,1025,0.0,0.0,0.0,0.0,0.0,0.0,0.0,1,0,1,1.0,0.0,1.0
9511210,161,27,134,569,93,68,68,31,77.0,8.0,69.0,310.0,32.0,45.0,45.0,162,161,1,22.0,21.0,1.0
9901418,3,2,1,1,0,3,4,212,2.0,1.0,1.0,1.0,0.0,2.0,3.0,7,3,4,2.0,0.0,2.0
8216,7,3,4,5,0,7,31,1,7.0,3.0,4.0,5.0,0.0,7.0,27.0,13,7,6,10.0,6.0,4.0
9801443,55,6,49,193,3,52,211,29,26.0,6.0,20.0,62.0,1.0,25.0,100.0,90,55,35,23.0,18.0,5.0
9303225,51,15,36,153,36,15,18,58,12.0,5.0,7.0,15.0,6.0,6.0,6.0,55,51,4,6.0,5.0,1.0
9405368,47,10,37,172,22,25,30,1,9.0,3.0,6.0,11.0,3.0,6.0,9.0,50,47,3,6.0,6.0,0.0
9508272,30,8,22,57,6,24,173,1,11.0,5.0,6.0,19.0,1.0,10.0,80.0,57,30,27,17.0,7.0,10.0
9803368,96,9,87,382,20,76,425,7,29.0,5.0,24.0,112.0,3.0,26.0,163.0,144,96,48,18.0,18.0,0.0
9607392,43,14,29,65,16,27,109,1,15.0,3.0,12.0,38.0,2.0,13.0,29.0,65,43,22,13.0,10.0,3.0
104137,24,5,19,85,7,17,19,165,22.0,3.0,19.0,85.0,5.0,17.0,17.0,32,24,8,19.0,18.0,1.0
9707293,1,1,0,0,0,1,2,74,1.0,1.0,0.0,0.0,0.0,1.0,2.0,9,1,8,2.0,0.0,2.0
201160,1,1,0,0,0,1,1,4,0.0,0.0,0.0,0.0,0.0,0.0,0.0,16,1,15,9.0,0.0,9.0
9501212,19,5,14,29,9,10,11,114,7.0,2.0,5.0,10.0,4.0,3.0,3.0,22,19,3,6.0,5.0,1.0
9705442,316,73,243,928,213,103,236,4,18.0,2.0,16.0,64.0,18.0,0.0,0.0,357,316,41,20.0,19.0,1.0
9609326,21,8,13,27,2,19,83,35,13.0,4.0,9.0,20.0,0.0,13.0,64.0,36,21,15,17.0,10.0,7.0
9904287,30,12,18,45,5,25,112,4,10.0,4.0,6.0,12.0,1.0,9.0,25.0,43,30,13,11.0,6.0,5.0
8065,4,2,2,3,0,4,24,33,4.0,2.0,2.0,3.0,0.0,4.0,10.0,16,4,12,3.0,1.0,2.0
9409238,9,2,7,12,5,4,4,281,6.0,2.0,4.0,7.0,2.0,4.0,4.0,10,9,1,5.0,5.0,0.0
9609246,11,5,6,7,3,8,15,281,2.0,2.0,0.0,0.0,0.0,2.0,3.0,18,11,7,5.0,2.0,3.0
9706489,15,6,9,25,6,9,46,33,7.0,3.0,4.0,6.0,1.0,6.0,32.0,28,15,13,11.0,4.0,7.0
9806332,30,3,27,82,8,22,152,33,19.0,2.0,17.0,58.0,1.0,18.0,122.0,50,30,20,25.0,14.0,11.0
9906230,32,5,27,111,2,30,243,4,21.0,3.0,18.0,64.0,0.0,21.0,163.0,57,32,25,30.0,17.0,13.0
207210,5,3,2,2,2,3,34,57,3.0,2.0,1.0,1.0,0.0,3.0,16.0,17,5,12,3.0,2.0,1.0
12332,10,3,7,10,0,10,90,26,7.0,3.0,4.0,4.0,0.0,7.0,58.0,43,10,33,15.0,6.0,9.0
9308205,24,8,16,41,9,15,15,26,12.0,1.0,11.0,22.0,0.0,12.0,12.0,25,24,1,12.0,11.0,1.0
9702265,36,6,30,92,0,36,94,26,24.0,4.0,20.0,67.0,0.0,24.0,68.0,44,36,8,19.0,16.0,3.0
9812349,31,4,27,96,1,30,169,2,8.0,2.0,6.0,12.0,0.0,8.0,27.0,50,31,19,12.0,12.0,0.0
9902214,12,5,7,9,2,10,30,4,8.0,4.0,4.0,5.0,0.0,8.0,21.0,21,12,9,10.0,7.0,3.0
9902467,120,3,117,966,4,116,545,2,82.0,1.0,81.0,649.0,0.0,82.0,426.0,129,120,9,42.0,35.0,7.0
11282,2,2,0,0,2,0,0,209,0.0,0.0,0.0,0.0,0.0,0.0,0.0,8,2,6,2.0,1.0,1.0
9807275,30,12,18,55,8,22,54,4,6.0,2.0,4.0,4.0,4.0,2.0,2.0,41,30,11,4.0,4.0,0.0
9904295,9,5,4,6,0,9,30,3,2.0,1.0,1.0,1.0,0.0,2.0,8.0,27,9,18,8.0,2.0,6.0
105096,44,8,36,118,0,44,401,4,35.0,6.0,29.0,97.0,0.0,35.0,364.0,66,44,22,40.0,22.0,18.0
202199,8,6,2,2,0,8,109,32,3.0,2.0,1.0,1.0,0.0,3.0,28.0,71,8,63,16.0,3.0,13.0
9501260,12,5,7,11,1,11,29,26,2.0,2.0,0.0,0.0,0.0,2.0,4.0,18,12,6,6.0,5.0,1.0
9502284,16,4,12,33,9,7,7,63,9.0,1.0,8.0,20.0,4.0,5.0,5.0,17,16,1,8.0,8.0,0.0
9410365,18,6,12,29,15,3,3,149,9.0,2.0,7.0,19.0,6.0,3.0,3.0,20,18,2,10.0,9.0,1.0
9409303,13,4,9,15,13,0,0,25,9.0,3.0,6.0,10.0,9.0,0.0,0.0,13,13,0,4.0,4.0,0.0
9505251,54,1,53,298,6,48,113,23,34.0,1.0,33.0,185.0,3.0,31.0,66.0,64,54,10,26.0,23.0,3.0
9405218,89,12,77,328,65,24,39,8,27.0,4.0,23.0,113.0,10.0,17.0,25.0,94,89,5,15.0,14.0,1.0
9504393,10,4,6,9,8,2,3,61,2.0,1.0,1.0,1.0,2.0,0.0,0.0,19,10,9,2.0,2.0,0.0
9308292,110,24,86,339,94,16,16,99,29.0,3.0,26.0,99.0,29.0,0.0,0.0,111,110,1,14.0,14.0,0.0
9406423,34,9,25,59,10,24,63,10,6.0,2.0,4.0,5.0,1.0,5.0,13.0,43,34,9,2.0,2.0,0.0
9406396,15,8,7,12,4,11,22,0,4.0,4.0,0.0,0.0,2.0,2.0,5.0,34,15,19,6.0,2.0,4.0
9803449,5,2,3,4,3,2,4,144,2.0,1.0,1.0,1.0,0.0,2.0,2.0,9,5,4,1.0,0.0,1.0
9709388,128,10,118,1012,49,79,85,3,78.0,3.0,75.0,744.0,28.0,50.0,50.0,131,128,3,43.0,42.0,1.0
9809596,101,6,95,704,2,99,1113,3,73.0,5.0,68.0,542.0,1.0,72.0,825.0,161,101,60,62.0,38.0,24.0
9712493,97,5,92,484,27,70,224,0,39.0,3.0,36.0,180.0,11.0,28.0,56.0,126,97,29,30.0,29.0,1.0
9611423,56,12,44,173,29,27,40,0,11.0,2.0,9.0,22.0,11.0,0.0,0.0,64,56,8,8.0,8.0,0.0
9206209,12,9,3,3,12,0,0,143,4.0,3.0,1.0,1.0,4.0,0.0,0.0,12,12,0,2.0,2.0,0.0
9808265,77,4,73,465,3,74,574,12,55.0,4.0,51.0,357.0,1.0,54.0,461.0,104,77,27,33.0,19.0,14.0
9906296,61,6,55,327,1,60,220,5,36.0,2.0,34.0,197.0,0.0,36.0,101.0,70,61,9,32.0,29.0,3.0
9808270,64,15,49,230,5,59,324,0,6.0,3.0,3.0,4.0,0.0,6.0,26.0,98,64,34,17.0,14.0,3.0
9707505,12,5,7,12,0,12,66,182,8.0,3.0,5.0,9.0,0.0,8.0,45.0,25,12,13,16.0,8.0,8.0
9702243,41,7,34,124,8,33,72,0,12.0,3.0,9.0,19.0,2.0,10.0,16.0,48,41,7,11.0,9.0,2.0
9703267,33,5,28,115,32,1,1,0,17.0,2.0,15.0,65.0,17.0,0.0,0.0,34,33,1,16.0,16.0,0.0
9807534,4,2,2,3,4,0,0,159,1.0,1.0,0.0,0.0,1.0,0.0,0.0,5,4,1,1.0,1.0,0.0
9907216,20,10,10,22,2,18,34,0,2.0,1.0,1.0,1.0,0.0,2.0,8.0,39,20,19,6.0,2.0,4.0
9307344,20,9,11,23,7,13,36,10,8.0,7.0,1.0,2.0,2.0,6.0,12.0,28,20,8,4.0,3.0,1.0
9607201,35,7,28,139,7,28,45,82,28.0,3.0,25.0,110.0,5.0,23.0,38.0,39,35,4,23.0,21.0,2.0
9810387,11,6,5,11,1,10,39,0,1.0,1.0,0.0,0.0,0.0,1.0,6.0,27,11,16,10.0,0.0,10.0
9604387,400,40,360,2199,124,276,858,5,46.0,4.0,42.0,322.0,46.0,0.0,0.0,434,400,34,20.0,20.0,0.0
9912272,2,2,0,0,1,1,2,36,0.0,0.0,0.0,0.0,0.0,0.0,0.0,27,2,25,4.0,0.0,4.0
9607446,29,9,20,49,12,17,72,81,13.0,4.0,9.0,18.0,7.0,6.0,8.0,48,29,19,13.0,7.0,6.0
9604229,80,2,78,604,57,23,27,46,61.0,1.0,60.0,499.0,43.0,18.0,18.0,85,80,5,34.0,34.0,0.0
9306205,143,47,96,301,56,87,142,10,46.0,16.0,30.0,102.0,17.0,29.0,29.0,150,143,7,18.0,17.0,1.0
9603208,253,39,214,1225,54,199,1186,15,54.0,2.0,52.0,482.0,0.0,54.0,579.0,381,253,128,59.0,41.0,18.0
9301291,19,10,9,15,19,0,0,256,5.0,3.0,2.0,3.0,5.0,0.0,0.0,19,19,0,5.0,5.0,0.0
9611434,18,6,12,17,1,17,50,71,5.0,1.0,4.0,5.0,2.0,3.0,3.0,24,18,6,3.0,2.0,1.0
9602326,26,6,20,66,0,26,124,50,17.0,4.0,13.0,38.0,0.0,17.0,30.0,46,26,20,20.0,16.0,4.0
9712307,19,6,13,35,2,17,84,10,5.0,1.0,4.0,8.0,1.0,4.0,9.0,37,19,18,9.0,5.0,4.0
9409367,29,4,25,54,15,14,30,99,11.0,2.0,9.0,21.0,1.0,10.0,18.0,33,29,4,5.0,5.0,0.0
9403330,26,9,17,87,4,22,48,60,16.0,4.0,12.0,71.0,2.0,14.0,22.0,32,26,6,16.0,14.0,2.0
9302234,30,16,14,45,18,12,17,75,11.0,5.0,6.0,12.0,6.0,5.0,6.0,32,30,2,8.0,6.0,2.0
9511444,20,5,15,47,0,20,98,12,9.0,3.0,6.0,12.0,0.0,9.0,28.0,44,20,24,7.0,7.0,0.0
9703436,65,11,54,190,17,48,172,12,19.0,4.0,15.0,39.0,0.0,19.0,92.0,76,65,11,14.0,14.0,0.0
9207219,30,10,20,67,30,0,0,75,13.0,3.0,10.0,28.0,13.0,0.0,0.0,30,30,0,9.0,9.0,0.0
112129,9,5,4,8,0,9,27,62,6.0,2.0,4.0,8.0,0.0,6.0,21.0,21,9,12,10.0,6.0,4.0
9712401,31,4,27,74,19,12,18,1,12.0,1.0,11.0,32.0,2.0,10.0,12.0,35,31,4,5.0,5.0,0.0
9911309,44,4,40,217,20,24,32,34,33.0,1.0,32.0,184.0,15.0,18.0,18.0,49,44,5,10.0,9.0,1.0
9704357,103,3,100,675,61,42,52,1,62.0,1.0,61.0,436.0,49.0,13.0,13.0,107,103,4,38.0,38.0,0.0
103067,103,9,94,526,0,103,1136,23,55.0,4.0,51.0,330.0,0.0,55.0,557.0,156,103,53,57.0,41.0,16.0
101132,17,7,10,20,2,15,117,67,7.0,3.0,4.0,9.0,0.0,7.0,66.0,40,17,23,24.0,5.0,19.0
9810397,20,2,18,53,0,20,222,1,11.0,1.0,10.0,26.0,0.0,11.0,152.0,62,20,42,23.0,6.0,17.0
9309299,24,6,18,63,14,10,10,5,13.0,3.0,10.0,43.0,6.0,7.0,7.0,25,24,1,5.0,5.0,0.0
9611204,28,3,25,82,0,28,114,5,12.0,2.0,10.0,40.0,0.0,12.0,27.0,48,28,20,14.0,11.0,3.0
9705306,3,2,1,1,0,3,13,5,0.0,0.0,0.0,0.0,0.0,0.0,0.0,27,3,24,2.0,0.0,2.0
9203206,60,28,32,52,60,0,0,207,10.0,10.0,0.0,0.0,10.0,0.0,0.0,60,60,0,4.0,4.0,0.0
9310243,10,5,5,11,9,1,1,93,5.0,2.0,3.0,5.0,5.0,0.0,0.0,11,10,1,3.0,2.0,1.0
9607481,11,6,5,11,5,6,6,48,1.0,1.0,0.0,0.0,1.0,0.0,0.0,12,11,1,1.0,0.0,1.0
9408346,83,12,71,331,31,52,99,13,39.0,4.0,35.0,206.0,13.0,26.0,38.0,95,83,12,24.0,22.0,2.0
11336,57,13,44,225,1,56,218,193,28.0,1.0,27.0,163.0,7.0,21.0,31.0,83,57,26,27.0,26.0,1.0
9603448,52,8,44,216,0,52,315,6,38.0,5.0,33.0,158.0,0.0,38.0,260.0,66,52,14,22.0,21.0,1.0
9805337,16,5,11,29,8,8,31,1,12.0,1.0,11.0,29.0,6.0,6.0,20.0,33,16,17,12.0,8.0,4.0
9806204,9,2,7,23,0,9,20,34,9.0,2.0,7.0,23.0,0.0,9.0,20.0,14,9,5,2.0,2.0,0.0
9912201,2,2,0,0,0,2,3,1,1.0,1.0,0.0,0.0,0.0,1.0,1.0,14,2,12,1.0,0.0,1.0
102310,8,4,4,7,0,8,72,1,4.0,2.0,2.0,3.0,0.0,4.0,28.0,46,8,38,16.0,3.0,13.0
9906374,59,3,56,269,0,59,307,32,36.0,3.0,33.0,143.0,0.0,36.0,163.0,91,59,32,18.0,15.0,3.0
9404241,18,2,16,43,7,11,19,48,9.0,1.0,8.0,15.0,8.0,1.0,1.0,25,18,7,8.0,7.0,1.0
9810288,8,5,3,3,2,6,14,168,2.0,1.0,1.0,1.0,0.0,2.0,5.0,19,8,11,6.0,2.0,4.0
9511205,50,15,35,125,50,0,0,31,27.0,8.0,19.0,74.0,27.0,0.0,0.0,50,50,0,14.0,14.0,0.0
9602232,41,6,35,118,5,36,128,40,5.0,3.0,2.0,2.0,0.0,5.0,29.0,54,41,13,8.0,8.0,0.0
9711504,22,7,15,31,1,21,88,12,13.0,6.0,7.0,12.0,0.0,13.0,64.0,38,22,16,16.0,8.0,8.0
9311228,58,20,38,138,0,58,225,75,17.0,9.0,8.0,17.0,0.0,17.0,91.0,68,58,10,27.0,20.0,7.0
9711362,30,6,24,86,4,26,145,7,8.0,3.0,5.0,12.0,0.0,8.0,62.0,59,30,29,19.0,7.0,12.0
9904267,108,6,102,586,1,107,678,2,63.0,7.0,56.0,309.0,0.0,63.0,454.0,120,108,12,29.0,20.0,9.0
9206266,60,9,51,565,60,0,0,15,45.0,4.0,41.0,503.0,45.0,0.0,0.0,60,60,0,38.0,38.0,0.0
9504265,18,3,15,44,1,17,121,15,16.0,2.0,14.0,43.0,1.0,15.0,115.0,38,18,20,7.0,0.0,7.0
9504349,42,8,34,105,42,0,0,76,16.0,2.0,14.0,40.0,16.0,0.0,0.0,42,42,0,15.0,15.0,0.0
9308245,3,2,1,1,3,0,0,371,2.0,2.0,0.0,0.0,2.0,0.0,0.0,3,3,0,1.0,1.0,0.0
9503494,10,2,8,16,9,1,1,76,6.0,2.0,4.0,6.0,6.0,0.0,0.0,11,10,1,4.0,4.0,0.0
9707349,1,1,0,0,0,1,2,19,0.0,0.0,0.0,0.0,0.0,0.0,0.0,12,1,11,7.0,0.0,7.0
9410401,25,7,18,44,5,20,27,62,13.0,2.0,11.0,27.0,1.0,12.0,12.0,33,25,8,10.0,9.0,1.0
9306236,9,3,6,11,9,0,0,235,5.0,2.0,3.0,5.0,5.0,0.0,0.0,10,9,1,4.0,4.0,0.0
9711292,28,2,26,118,0,28,72,24,20.0,2.0,18.0,85.0,0.0,20.0,56.0,34,28,6,22.0,17.0,5.0
9405338,77,21,56,127,49,28,33,11,18.0,4.0,14.0,20.0,18.0,0.0,0.0,79,77,2,11.0,11.0,0.0
9601211,39,3,36,190,24,15,23,16,23.0,2.0,21.0,106.0,14.0,9.0,10.0,43,39,4,19.0,19.0,0.0
9712519,13,9,4,4,6,7,8,47,2.0,2.0,0.0,0.0,1.0,1.0,1.0,16,13,3,2.0,1.0,1.0
9710500,13,8,5,13,0,13,38,16,5.0,3.0,2.0,2.0,0.0,5.0,14.0,19,13,6,8.0,5.0,3.0
9807489,8,2,6,9,0,8,58,151,3.0,1.0,2.0,3.0,0.0,3.0,24.0,23,8,15,11.0,3.0,8.0
9411310,17,10,7,11,10,7,15,24,4.0,2.0,2.0,5.0,4.0,0.0,0.0,20,17,3,3.0,3.0,0.0
9703359,22,2,20,90,3,19,68,151,18.0,1.0,17.0,73.0,2.0,16.0,34.0,55,22,33,21.0,18.0,3.0
9603270,9,4,5,10,3,6,8,30,3.0,1.0,2.0,2.0,0.0,3.0,3.0,13,9,4,5.0,4.0,1.0
9311261,14,7,7,11,12,2,2,86,7.0,4.0,3.0,4.0,7.0,0.0,0.0,15,14,1,5.0,4.0,1.0
9312274,16,5,11,21,16,0,0,86,7.0,1.0,6.0,11.0,7.0,0.0,0.0,16,16,0,6.0,6.0,0.0
9607215,33,10,23,54,5,28,57,59,15.0,3.0,12.0,32.0,4.0,11.0,11.0,41,33,8,9.0,8.0,1.0
9708372,36,5,31,110,0,36,150,6,13.0,2.0,11.0,28.0,0.0,13.0,68.0,53,36,17,6.0,3.0,3.0
9610445,44,15,29,77,19,25,53,113,16.0,3.0,13.0,39.0,4.0,12.0,27.0,56,44,12,15.0,12.0,3.0
9801397,81,7,74,626,20,61,265,24,62.0,4.0,58.0,536.0,11.0,51.0,187.0,96,81,15,45.0,38.0,7.0
9609380,8,7,1,1,2,6,24,6,2.0,2.0,0.0,0.0,1.0,1.0,2.0,32,8,24,5.0,1.0,4.0
9708486,5,2,3,3,0,5,44,87,5.0,2.0,3.0,3.0,0.0,5.0,31.0,21,5,16,11.0,4.0,7.0
9903224,58,7,51,213,2,56,452,2,26.0,3.0,23.0,67.0,0.0,26.0,298.0,81,58,23,16.0,12.0,4.0
9501381,6,4,2,2,3,3,6,14,0.0,0.0,0.0,0.0,0.0,0.0,0.0,17,6,11,5.0,0.0,5.0
9902443,56,11,45,136,13,43,164,4,15.0,1.0,14.0,60.0,1.0,14.0,37.0,104,56,48,5.0,1.0,4.0
9507380,87,6,81,449,14,73,236,38,62.0,3.0,59.0,359.0,7.0,55.0,181.0,96,87,9,39.0,33.0,6.0
6200,16,4,12,21,14,2,3,64,12.0,2.0,10.0,19.0,11.0,1.0,2.0,22,16,6,6.0,6.0,0.0
9807247,10,3,7,9,2,8,15,45,2.0,1.0,1.0,1.0,2.0,0.0,0.0,13,10,3,3.0,2.0,1.0
9203211,33,10,23,99,33,0,0,22,19.0,4.0,15.0,54.0,19.0,0.0,0.0,33,33,0,5.0,5.0,0.0
9204216,76,16,60,215,76,0,0,22,11.0,4.0,7.0,16.0,11.0,0.0,0.0,76,76,0,5.0,5.0,0.0
9707342,40,12,28,64,4,36,115,22,17.0,6.0,11.0,21.0,0.0,17.0,52.0,52,40,12,13.0,8.0,5.0
9908323,25,4,21,83,0,25,146,38,21.0,2.0,19.0,78.0,0.0,21.0,134.0,35,25,10,25.0,15.0,10.0
9608482,6,5,1,2,6,0,0,184,4.0,3.0,1.0,2.0,4.0,0.0,0.0,7,6,1,4.0,4.0,0.0
9704360,5,3,2,3,2,3,3,51,2.0,2.0,0.0,0.0,0.0,2.0,2.0,11,5,6,1.0,0.0,1.0
9906287,23,1,22,107,0,23,95,21,22.0,1.0,21.0,102.0,0.0,22.0,92.0,29,23,6,25.0,19.0,6.0
9703354,21,5,16,53,3,18,115,21,15.0,2.0,13.0,46.0,0.0,15.0,102.0,36,21,15,23.0,12.0,11.0
9907512,44,22,22,53,13,31,90,39,11.0,2.0,9.0,20.0,9.0,2.0,2.0,73,44,29,5.0,5.0,0.0
9701256,42,17,25,54,4,38,123,39,17.0,7.0,10.0,22.0,0.0,17.0,47.0,52,42,10,17.0,13.0,4.0
9810389,39,2,37,326,0,39,221,19,34.0,2.0,32.0,298.0,0.0,34.0,203.0,54,39,15,30.0,27.0,3.0
9907472,63,6,57,316,3,60,300,19,23.0,2.0,21.0,90.0,1.0,22.0,64.0,86,63,23,19.0,15.0,4.0
9604432,13,6,7,15,2,11,25,61,4.0,2.0,2.0,2.0,0.0,4.0,9.0,20,13,7,7.0,4.0,3.0
9308229,14,3,11,26,11,3,3,39,6.0,1.0,5.0,13.0,6.0,0.0,0.0,15,14,1,6.0,6.0,0.0
1095,41,3,38,216,0,41,434,20,40.0,3.0,37.0,212.0,0.0,40.0,429.0,59,41,18,48.0,31.0,17.0
201059,9,3,6,17,0,9,85,20,9.0,3.0,6.0,17.0,0.0,9.0,85.0,27,9,18,12.0,6.0,6.0
9609428,46,12,34,120,2,44,69,31,24.0,5.0,19.0,77.0,0.0,24.0,40.0,49,46,3,18.0,15.0,3.0
9302307,115,20,95,648,104,11,11,17,51.0,5.0,46.0,350.0,41.0,10.0,10.0,116,115,1,14.0,14.0,0.0
9411210,12,5,7,12,4,8,19,29,6.0,3.0,3.0,4.0,2.0,4.0,12.0,17,12,5,3.0,2.0,1.0
9908360,30,15,15,27,9,21,219,20,11.0,3.0,8.0,18.0,0.0,11.0,171.0,62,30,32,29.0,6.0,23.0
9911223,14,3,11,40,0,14,295,20,13.0,2.0,11.0,40.0,0.0,13.0,285.0,53,14,39,47.0,12.0,35.0
4159,11,7,4,5,1,10,40,22,3.0,3.0,0.0,0.0,1.0,2.0,6.0,35,11,24,8.0,4.0,4.0
108210,15,5,10,14,0,15,67,20,12.0,4.0,8.0,10.0,0.0,12.0,62.0,30,15,15,7.0,6.0,1.0
204222,5,2,3,5,1,4,6,80,0.0,0.0,0.0,0.0,0.0,0.0,0.0,14,5,9,1.0,0.0,1.0
9502391,30,8,22,45,12,18,31,78,10.0,2.0,8.0,16.0,5.0,5.0,5.0,39,30,9,5.0,4.0,1.0
9405392,18,10,8,12,18,0,0,49,7.0,4.0,3.0,3.0,7.0,0.0,0.0,20,18,2,5.0,4.0,1.0
9905215,75,5,70,436,1,74,270,32,55.0,3.0,52.0,356.0,0.0,55.0,197.0,91,75,16,37.0,33.0,4.0
9510327,39,16,23,66,3,36,146,10,7.0,4.0,3.0,5.0,0.0,7.0,14.0,55,39,16,7.0,6.0,1.0
9810410,104,5,99,626,8,96,442,2,47.0,2.0,45.0,345.0,0.0,47.0,292.0,116,104,12,30.0,23.0,7.0
9806236,96,4,92,845,3,93,278,32,65.0,4.0,61.0,659.0,0.0,65.0,173.0,119,96,23,51.0,47.0,4.0
9803380,68,4,64,344,6,62,227,73,56.0,1.0,55.0,325.0,3.0,53.0,181.0,83,68,15,41.0,35.0,6.0
9712212,39,4,35,152,1,38,130,73,35.0,2.0,33.0,148.0,0.0,35.0,116.0,48,39,9,31.0,26.0,5.0
9801235,22,15,7,11,5,17,120,5,7.0,3.0,4.0,7.0,0.0,7.0,46.0,94,22,72,17.0,6.0,11.0
9301278,19,5,14,30,19,0,0,85,3.0,1.0,2.0,3.0,3.0,0.0,0.0,19,19,0,4.0,4.0,0.0
9403347,42,14,28,69,23,19,21,19,9.0,3.0,6.0,10.0,9.0,0.0,0.0,44,42,2,5.0,4.0,1.0
9412374,40,9,31,100,30,10,14,5,4.0,2.0,2.0,2.0,2.0,2.0,2.0,47,40,7,5.0,5.0,0.0
9606206,2,2,0,0,0,2,2,98,,,,,,,,3,2,1,,,
9608416,7,3,4,6,2,5,8,71,0.0,0.0,0.0,0.0,0.0,0.0,0.0,23,7,16,6.0,1.0,5.0
9603210,22,9,13,24,2,20,79,48,8.0,4.0,4.0,6.0,1.0,7.0,27.0,45,22,23,9.0,4.0,5.0
9907207,4,4,0,0,1,3,25,4,1.0,1.0,0.0,0.0,0.0,1.0,10.0,45,4,41,8.0,0.0,8.0
9908504,42,4,38,189,0,42,425,70,36.0,1.0,35.0,172.0,0.0,36.0,413.0,56,42,14,43.0,30.0,13.0
9602306,33,15,18,34,25,8,8,107,8.0,6.0,2.0,4.0,3.0,5.0,5.0,35,33,2,6.0,6.0,0.0
9903261,14,6,8,13,0,14,94,0,7.0,3.0,4.0,6.0,0.0,7.0,60.0,47,14,33,18.0,5.0,13.0
9606316,8,6,2,2,4,4,11,4,1.0,1.0,0.0,0.0,0.0,1.0,5.0,23,8,15,6.0,1.0,5.0
9405223,16,5,11,17,3,13,45,81,12.0,4.0,8.0,14.0,1.0,11.0,39.0,24,16,8,12.0,8.0,4.0
9404323,12,5,7,12,9,3,11,41,3.0,1.0,2.0,3.0,1.0,2.0,4.0,18,12,6,8.0,4.0,4.0
9706331,45,20,25,40,16,29,85,26,1.0,1.0,0.0,0.0,0.0,1.0,3.0,68,45,23,3.0,3.0,0.0
9411301,64,4,60,202,61,3,3,84,35.0,1.0,34.0,134.0,35.0,0.0,0.0,65,64,1,18.0,18.0,0.0
9504313,18,3,15,59,2,16,46,49,14.0,2.0,12.0,47.0,7.0,7.0,7.0,29,18,11,14.0,12.0,2.0
9405204,36,6,30,81,35,1,1,6,17.0,1.0,16.0,46.0,17.0,0.0,0.0,37,36,1,3.0,3.0,0.0
9805222,16,6,10,19,0,16,125,6,8.0,3.0,5.0,8.0,0.0,8.0,84.0,54,16,38,17.0,6.0,11.0
106025,54,9,45,136,6,48,204,23,22.0,1.0,21.0,55.0,1.0,21.0,118.0,71,54,17,26.0,16.0,10.0
111309,6,6,0,0,2,4,13,59,1.0,1.0,0.0,0.0,0.0,1.0,5.0,25,6,19,2.0,1.0,1.0
9512254,5,4,1,1,2,3,10,74,0.0,0.0,0.0,0.0,0.0,0.0,0.0,12,5,7,,,
9301265,28,13,15,38,28,0,0,93,11.0,5.0,6.0,11.0,11.0,0.0,0.0,28,28,0,7.0,7.0,0.0
9805367,44,7,37,140,0,44,226,55,32.0,3.0,29.0,116.0,1.0,31.0,164.0,58,44,14,29.0,21.0,8.0
9903479,50,7,43,259,0,50,721,2,43.0,5.0,38.0,233.0,0.0,43.0,652.0,83,50,33,36.0,25.0,11.0
2117,2,2,0,0,2,0,0,377,1.0,1.0,0.0,0.0,1.0,0.0,0.0,17,2,15,2.0,0.0,2.0
9808410,23,4,19,57,0,23,119,55,18.0,2.0,16.0,46.0,0.0,18.0,105.0,40,23,17,17.0,7.0,10.0
9912482,28,8,20,45,3,25,105,3,7.0,5.0,2.0,3.0,0.0,7.0,38.0,77,28,49,17.0,2.0,15.0
9703367,29,13,16,43,7,22,52,31,17.0,7.0,10.0,28.0,2.0,15.0,31.0,34,29,5,15.0,12.0,3.0
1005,63,9,54,233,8,55,220,18,35.0,4.0,31.0,143.0,1.0,34.0,141.0,86,63,23,14.0,11.0,3.0
9811489,43,3,40,181,3,40,290,5,13.0,2.0,11.0,32.0,0.0,13.0,78.0,92,43,49,20.0,8.0,12.0
102131,29,3,26,184,21,8,9,23,25.0,1.0,24.0,176.0,18.0,7.0,8.0,31,29,2,19.0,19.0,0.0
9602236,64,21,43,106,42,22,53,27,14.0,6.0,8.0,17.0,3.0,11.0,28.0,75,64,11,9.0,7.0,2.0
8296,6,2,4,5,6,0,0,314,1.0,1.0,0.0,0.0,1.0,0.0,0.0,6,6,0,2.0,2.0,0.0
9401325,22,11,11,20,5,17,50,75,6.0,3.0,3.0,5.0,0.0,6.0,20.0,37,22,15,9.0,4.0,5.0
8061,6,3,3,4,1,5,86,5,3.0,2.0,1.0,1.0,0.0,3.0,25.0,56,6,50,20.0,2.0,18.0
105267,53,14,39,143,4,49,212,23,18.0,1.0,17.0,53.0,0.0,18.0,108.0,71,53,18,26.0,14.0,12.0
9306325,17,7,10,42,10,7,7,18,10.0,4.0,6.0,20.0,10.0,0.0,0.0,18,17,1,8.0,8.0,0.0
8145,10,3,7,18,10,0,0,107,7.0,2.0,5.0,13.0,7.0,0.0,0.0,10,10,0,3.0,3.0,0.0
9811284,5,1,4,4,0,5,22,18,1.0,1.0,0.0,0.0,0.0,1.0,3.0,22,5,17,1.0,1.0,0.0
11245,23,10,13,45,0,23,132,0,10.0,3.0,7.0,18.0,0.0,10.0,50.0,52,23,29,11.0,4.0,7.0
9912211,6,1,5,9,0,6,129,0,6.0,1.0,5.0,9.0,0.0,6.0,124.0,46,6,40,37.0,5.0,32.0
9504353,24,4,20,39,24,0,0,111,16.0,2.0,14.0,29.0,16.0,0.0,0.0,24,24,0,12.0,12.0,0.0
9504335,8,3,5,8,0,8,11,4,3.0,1.0,2.0,3.0,3.0,0.0,0.0,10,8,2,3.0,3.0,0.0
9705425,5,3,2,2,0,5,13,118,5.0,3.0,2.0,2.0,0.0,5.0,13.0,8,5,3,5.0,3.0,2.0
9810530,11,2,9,18,2,9,12,118,6.0,2.0,4.0,8.0,0.0,6.0,9.0,13,11,2,8.0,6.0,2.0
9508358,2,2,0,0,0,2,9,8,0.0,0.0,0.0,0.0,0.0,0.0,0.0,38,2,36,3.0,0.0,3.0
9806228,36,4,32,116,0,36,151,16,21.0,2.0,19.0,78.0,0.0,21.0,81.0,50,36,14,19.0,15.0,4.0
9910545,13,4,9,17,1,12,41,19,8.0,2.0,6.0,14.0,1.0,7.0,17.0,20,13,7,9.0,6.0,3.0
9708343,12,4,8,12,1,11,45,62,1.0,1.0,0.0,0.0,0.0,1.0,7.0,31,12,19,12.0,1.0,11.0
9407293,19,3,16,89,3,16,16,43,15.0,2.0,13.0,67.0,3.0,12.0,12.0,20,19,1,14.0,13.0,1.0
9908391,10,1,9,11,3,7,45,2,2.0,1.0,1.0,1.0,0.0,2.0,10.0,45,10,35,5.0,2.0,3.0
9905251,4,2,2,3,0,4,25,52,3.0,1.0,2.0,3.0,0.0,3.0,19.0,24,4,20,13.0,3.0,10.0
9506226,28,6,22,56,4,24,53,39,18.0,4.0,14.0,33.0,1.0,17.0,26.0,37,28,9,15.0,13.0,2.0
9707387,27,13,14,25,2,25,93,36,9.0,3.0,6.0,10.0,0.0,9.0,18.0,40,27,13,11.0,7.0,4.0
9911349,25,5,20,48,0,25,201,2,15.0,3.0,12.0,33.0,0.0,15.0,37.0,50,25,25,22.0,14.0,8.0
6190,5,5,0,0,1,4,63,2,1.0,1.0,0.0,0.0,0.0,1.0,28.0,85,5,80,24.0,1.0,23.0
9905417,23,2,21,42,1,22,47,2,8.0,1.0,7.0,16.0,4.0,4.0,4.0,28,23,5,7.0,7.0,0.0
9607210,43,10,33,123,14,29,41,11,15.0,3.0,12.0,65.0,15.0,0.0,0.0,50,43,7,15.0,14.0,1.0
9710506,14,9,5,7,3,11,19,44,3.0,2.0,1.0,1.0,1.0,2.0,2.0,25,14,11,7.0,2.0,5.0
8287,42,3,39,207,1,41,288,19,33.0,1.0,32.0,184.0,1.0,32.0,252.0,56,42,14,41.0,29.0,12.0
10080,25,13,12,24,2,23,176,43,7.0,5.0,2.0,2.0,0.0,7.0,67.0,74,25,49,18.0,3.0,15.0
205283,3,3,0,0,0,3,26,80,1.0,1.0,0.0,0.0,0.0,1.0,9.0,24,3,21,19.0,2.0,17.0
101232,20,8,12,28,5,15,22,80,4.0,4.0,0.0,0.0,0.0,4.0,4.0,29,20,9,6.0,1.0,5.0
9306280,3,3,0,0,1,2,2,1869,1.0,1.0,0.0,0.0,1.0,0.0,0.0,4,3,1,1.0,1.0,0.0
9210281,28,5,23,53,23,5,5,8,4.0,3.0,1.0,2.0,4.0,0.0,0.0,29,28,1,3.0,3.0,0.0
11097,17,3,14,55,0,17,159,28,13.0,2.0,11.0,46.0,0.0,13.0,43.0,44,17,27,11.0,5.0,6.0
11176,12,5,7,11,1,11,54,28,1.0,1.0,0.0,0.0,0.0,1.0,4.0,31,12,19,2.0,2.0,0.0
9912498,43,4,39,195,0,43,282,2,31.0,2.0,29.0,164.0,0.0,31.0,142.0,69,43,26,32.0,26.0,6.0
9812478,22,5,17,34,2,20,44,105,14.0,6.0,8.0,12.0,1.0,13.0,30.0,29,22,7,15.0,12.0,3.0
9606428,45,11,34,87,25,20,32,91,21.0,5.0,16.0,43.0,8.0,13.0,22.0,47,45,2,11.0,9.0,2.0
7267,7,3,4,8,0,7,46,2,7.0,3.0,4.0,8.0,1.0,6.0,6.0,27,7,20,8.0,6.0,2.0
103214,9,8,1,1,0,9,52,2,3.0,3.0,0.0,0.0,0.0,3.0,7.0,25,9,16,2.0,1.0,1.0
9912276,7,2,5,6,0,7,36,2,6.0,2.0,4.0,5.0,1.0,5.0,14.0,18,7,11,8.0,4.0,4.0
9908219,10,6,4,10,0,10,71,42,0.0,0.0,0.0,0.0,0.0,0.0,0.0,40,10,30,9.0,2.0,7.0
9712542,42,1,41,177,3,39,147,10,23.0,1.0,22.0,89.0,0.0,23.0,86.0,51,42,9,27.0,21.0,6.0
9509201,34,4,30,119,8,26,35,37,15.0,1.0,14.0,55.0,2.0,13.0,13.0,37,34,3,17.0,16.0,1.0
10035,2,2,0,0,0,2,6,32,0.0,0.0,0.0,0.0,0.0,0.0,0.0,32,2,30,3.0,0.0,3.0
9511422,33,11,22,48,29,4,5,197,18.0,1.0,17.0,42.0,18.0,0.0,0.0,36,33,3,11.0,11.0,0.0
2152,8,1,7,11,3,5,10,28,6.0,0.0,6.0,10.0,4.0,2.0,4.0,21,8,13,7.0,5.0,2.0
9512325,10,2,8,14,6,4,4,61,4.0,1.0,3.0,5.0,4.0,0.0,0.0,13,10,3,4.0,4.0,0.0
9511227,13,7,6,9,5,8,24,234,2.0,1.0,1.0,1.0,0.0,2.0,7.0,18,13,5,8.0,3.0,5.0
4068,9,4,5,11,0,9,48,86,6.0,2.0,4.0,6.0,0.0,6.0,24.0,22,9,13,8.0,1.0,7.0
9909386,7,5,2,3,1,6,32,4,4.0,4.0,0.0,0.0,0.0,4.0,9.0,25,7,18,5.0,3.0,2.0
9510442,2,1,1,1,0,2,3,1562,0.0,0.0,0.0,0.0,0.0,0.0,0.0,6,2,4,1.0,0.0,1.0
204101,17,3,14,49,0,17,367,1,12.0,2.0,10.0,26.0,0.0,12.0,232.0,83,17,66,39.0,7.0,32.0
6178,2,1,1,1,0,2,3,152,0.0,0.0,0.0,0.0,0.0,0.0,0.0,13,2,11,7.0,0.0,7.0
101081,3,2,1,1,0,3,58,7,2.0,2.0,0.0,0.0,0.0,2.0,13.0,47,3,44,8.0,1.0,7.0
9810523,3,1,2,2,0,3,9,58,0.0,0.0,0.0,0.0,0.0,0.0,0.0,13,3,10,5.0,0.0,5.0
9504369,5,4,1,1,2,3,10,75,1.0,1.0,0.0,0.0,0.0,1.0,7.0,13,5,8,2.0,2.0,0.0
9807245,2,2,0,0,0,2,2,79,2.0,2.0,0.0,0.0,2.0,0.0,0.0,4,2,2,1.0,1.0,0.0
9401328,124,28,96,419,101,23,23,14,22.0,5.0,17.0,77.0,16.0,6.0,6.0,127,124,3,13.0,13.0,0.0
9908337,29,6,23,92,0,29,215,9,26.0,5.0,21.0,79.0,0.0,26.0,197.0,53,29,24,33.0,14.0,19.0
9501314,19,10,9,22,9,10,10,11,6.0,2.0,4.0,4.0,0.0,6.0,6.0,20,19,1,2.0,2.0,0.0
9601276,118,6,112,666,4,114,373,17,93.0,2.0,91.0,591.0,0.0,93.0,320.0,128,118,10,57.0,51.0,6.0
9509355,39,7,32,82,0,39,180,17,34.0,6.0,28.0,72.0,0.0,34.0,170.0,48,39,9,30.0,23.0,7.0
9711253,4,3,1,1,1,3,5,114,0.0,0.0,0.0,0.0,0.0,0.0,0.0,18,4,14,4.0,0.0,4.0
9609340,4,4,0,0,4,0,0,1715,,,,,,,,4,4,0,,,
9712467,26,3,23,83,0,26,146,24,18.0,3.0,15.0,60.0,0.0,18.0,94.0,33,26,7,20.0,14.0,6.0
9709470,5,2,3,5,2,3,3,425,4.0,1.0,3.0,5.0,4.0,0.0,0.0,6,5,1,4.0,4.0,0.0
9601361,9,1,8,11,3,6,10,104,5.0,1.0,4.0,5.0,1.0,4.0,8.0,13,9,4,6.0,4.0,2.0
9212292,2,2,0,0,2,0,0,1587,,,,,,,,2,2,0,,,
9609527,15,6,9,20,0,15,106,21,11.0,4.0,7.0,13.0,0.0,11.0,80.0,27,15,12,2.0,1.0,1.0
110020,10,3,7,20,0,10,136,4,7.0,2.0,5.0,11.0,1.0,6.0,73.0,47,10,37,27.0,4.0,23.0
9706253,24,5,19,48,6,18,85,7,10.0,2.0,8.0,19.0,0.0,10.0,67.0,41,24,17,8.0,6.0,2.0
9810366,4,3,1,1,1,3,8,1,2.0,2.0,0.0,0.0,0.0,2.0,5.0,37,4,33,2.0,0.0,2.0
9801279,21,2,19,94,0,21,108,29,21.0,2.0,19.0,94.0,0.0,21.0,91.0,37,21,16,26.0,20.0,6.0
9307231,3,2,1,1,2,1,1,99,2.0,1.0,1.0,1.0,2.0,0.0,0.0,5,3,2,2.0,2.0,0.0
9803438,9,6,3,8,0,9,30,137,7.0,4.0,3.0,8.0,0.0,7.0,26.0,18,9,9,10.0,4.0,6.0
9709436,7,4,3,3,0,7,32,54,0.0,0.0,0.0,0.0,0.0,0.0,0.0,24,7,17,7.0,0.0,7.0
9809487,11,2,9,20,0,11,77,54,10.0,1.0,9.0,19.0,0.0,10.0,44.0,33,11,22,8.0,6.0,2.0
9805309,3,3,0,0,0,3,12,117,1.0,1.0,0.0,0.0,0.0,1.0,7.0,23,3,20,13.0,1.0,12.0
9911490,24,8,16,27,2,22,268,24,10.0,2.0,8.0,12.0,0.0,10.0,162.0,93,24,69,32.0,2.0,30.0
10334,21,4,17,43,3,18,142,24,8.0,2.0,6.0,14.0,0.0,8.0,67.0,43,21,22,10.0,6.0,4.0
9809456,5,4,1,2,3,2,2,224,3.0,3.0,0.0,0.0,3.0,0.0,0.0,11,5,6,5.0,2.0,3.0
9709487,3,3,0,0,1,2,8,88,1.0,1.0,0.0,0.0,0.0,1.0,2.0,11,3,8,3.0,0.0,3.0
5108,34,4,30,100,3,31,85,9,24.0,2.0,22.0,79.0,2.0,22.0,41.0,41,34,7,11.0,11.0,0.0
9901298,2,2,0,0,0,2,6,9,1.0,1.0,0.0,0.0,1.0,0.0,0.0,8,2,6,1.0,1.0,0.0
9510430,3,1,2,2,0,3,3,286,2.0,1.0,1.0,1.0,0.0,2.0,2.0,4,3,1,2.0,1.0,1.0
9602297,9,4,5,7,6,3,7,140,4.0,3.0,1.0,2.0,4.0,0.0,0.0,14,9,5,5.0,5.0,0.0
9703447,7,3,4,10,7,0,0,147,6.0,3.0,3.0,6.0,6.0,0.0,0.0,7,7,0,4.0,4.0,0.0
9605359,19,10,9,14,0,19,104,41,14.0,7.0,7.0,9.0,0.0,14.0,73.0,47,19,28,16.0,8.0,8.0
9903280,5,2,3,4,1,4,6,17,2.0,1.0,1.0,1.0,2.0,0.0,0.0,11,5,6,2.0,2.0,0.0
9802367,7,3,4,10,1,6,58,94,6.0,2.0,4.0,10.0,0.0,6.0,57.0,21,7,14,16.0,6.0,10.0
9710462,9,3,6,8,5,4,4,227,3.0,1.0,2.0,3.0,2.0,1.0,1.0,22,9,13,4.0,3.0,1.0
9608479,9,4,5,9,0,9,11,132,7.0,2.0,5.0,9.0,0.0,7.0,8.0,12,9,3,8.0,7.0,1.0
9901356,2,2,0,0,0,2,2,64,1.0,1.0,0.0,0.0,1.0,0.0,0.0,4,2,2,1.0,1.0,0.0
9611207,32,1,31,96,1,31,71,9,16.0,1.0,15.0,39.0,0.0,16.0,31.0,38,32,6,9.0,8.0,1.0
9707365,20,7,13,22,1,19,133,17,14.0,5.0,9.0,15.0,0.0,14.0,105.0,38,20,18,21.0,10.0,11.0
9401264,19,7,12,33,19,0,0,14,7.0,2.0,5.0,10.0,7.0,0.0,0.0,19,19,0,4.0,4.0,0.0
9610268,4,2,2,2,0,4,12,16,3.0,1.0,2.0,2.0,0.0,3.0,9.0,12,4,8,6.0,1.0,5.0
9602330,8,4,4,7,6,2,2,211,3.0,2.0,1.0,1.0,3.0,0.0,0.0,9,8,1,3.0,3.0,0.0
9706269,5,3,2,3,1,4,25,16,3.0,2.0,1.0,1.0,0.0,3.0,21.0,19,5,14,15.0,3.0,12.0
9710244,33,8,25,54,2,31,81,150,6.0,5.0,1.0,1.0,0.0,6.0,21.0,42,33,9,4.0,3.0,1.0
9306231,12,6,6,8,12,0,0,184,3.0,1.0,2.0,3.0,3.0,0.0,0.0,12,12,0,3.0,3.0,0.0
9411350,2,2,0,0,1,1,1,810,0.0,0.0,0.0,0.0,0.0,0.0,0.0,9,2,7,1.0,0.0,1.0
9610348,5,3,2,4,0,5,17,97,5.0,3.0,2.0,4.0,0.0,5.0,13.0,10,5,5,7.0,4.0,3.0
9612346,36,2,34,235,0,36,257,15,32.0,2.0,30.0,220.0,0.0,32.0,233.0,49,36,13,37.0,27.0,10.0
9401352,37,4,33,130,15,22,34,15,25.0,2.0,23.0,104.0,6.0,19.0,31.0,40,37,3,7.0,6.0,1.0
9503412,5,1,4,7,0,5,18,176,4.0,1.0,3.0,6.0,0.0,4.0,15.0,15,5,10,13.0,4.0,9.0
9505221,3,3,0,0,1,2,9,15,1.0,1.0,0.0,0.0,0.0,1.0,2.0,9,3,6,5.0,1.0,4.0
9409346,2,2,0,0,0,2,2,106,1.0,1.0,0.0,0.0,1.0,0.0,0.0,3,2,1,1.0,1.0,0.0
9306322,27,4,23,117,12,15,16,33,24.0,2.0,22.0,106.0,10.0,14.0,14.0,30,27,3,17.0,16.0,1.0
108148,8,2,6,8,3,5,9,0,7.0,2.0,5.0,6.0,5.0,2.0,2.0,13,8,5,1.0,0.0,1.0
9812307,9,3,6,11,3,6,10,0,2.0,1.0,1.0,1.0,2.0,0.0,0.0,13,9,4,2.0,2.0,0.0
9910508,6,2,4,9,0,6,20,120,6.0,2.0,4.0,9.0,0.0,6.0,20.0,12,6,6,11.0,6.0,5.0
3139,9,5,4,4,1,8,41,3,4.0,3.0,1.0,1.0,0.0,4.0,19.0,21,9,12,10.0,3.0,7.0
9604353,12,7,5,9,1,11,26,155,11.0,6.0,5.0,9.0,0.0,11.0,24.0,19,12,7,12.0,9.0,3.0
9907515,8,1,7,12,0,8,12,52,7.0,1.0,6.0,9.0,0.0,7.0,11.0,11,8,3,5.0,4.0,1.0
9409281,37,8,29,60,17,20,23,15,13.0,7.0,6.0,6.0,13.0,0.0,0.0,40,37,3,8.0,8.0,0.0
9603436,6,3,3,4,3,3,3,298,3.0,1.0,2.0,3.0,0.0,3.0,3.0,11,6,5,2.0,2.0,0.0
9812279,2,2,0,0,1,1,1,1,0.0,0.0,0.0,0.0,0.0,0.0,0.0,23,2,21,6.0,1.0,5.0
2221,6,4,2,3,0,6,26,120,5.0,3.0,2.0,3.0,0.0,5.0,18.0,20,6,14,12.0,4.0,8.0
9909376,20,3,17,74,0,20,173,5,13.0,1.0,12.0,50.0,0.0,13.0,100.0,62,20,42,22.0,14.0,8.0
9207242,10,8,2,2,10,0,0,367,6.0,5.0,1.0,1.0,6.0,0.0,0.0,10,10,0,3.0,3.0,0.0
9712451,23,7,16,39,5,18,41,29,9.0,2.0,7.0,15.0,0.0,9.0,22.0,28,23,5,11.0,8.0,3.0
106280,4,4,0,0,0,4,42,23,1.0,1.0,0.0,0.0,0.0,1.0,18.0,71,4,67,20.0,1.0,19.0
9806217,8,5,3,4,0,8,21,10,0.0,0.0,0.0,0.0,0.0,0.0,0.0,20,8,12,4.0,0.0,4.0
9301258,26,13,13,24,16,10,12,10,7.0,2.0,5.0,9.0,7.0,0.0,0.0,28,26,2,4.0,4.0,0.0
9705243,22,4,18,58,9,13,19,21,12.0,2.0,10.0,23.0,1.0,11.0,15.0,24,22,2,9.0,9.0,0.0
1274,22,4,18,80,0,22,118,15,18.0,1.0,17.0,76.0,0.0,18.0,80.0,49,22,27,13.0,10.0,3.0
3262,17,3,14,35,4,13,34,21,10.0,1.0,9.0,24.0,1.0,9.0,15.0,26,17,9,10.0,7.0,3.0
9309262,8,4,4,5,8,0,0,168,1.0,1.0,0.0,0.0,1.0,0.0,0.0,8,8,0,,,
9305223,22,8,14,53,19,3,3,33,12.0,3.0,9.0,34.0,12.0,0.0,0.0,23,22,1,12.0,12.0,0.0
9502412,8,4,4,10,8,0,0,44,1.0,1.0,0.0,0.0,1.0,0.0,0.0,8,8,0,1.0,1.0,0.0
9603362,13,8,5,7,5,8,17,71,1.0,1.0,0.0,0.0,0.0,1.0,7.0,24,13,11,4.0,2.0,2.0
9612390,27,6,21,76,5,22,36,109,15.0,1.0,14.0,61.0,0.0,15.0,15.0,40,27,13,16.0,15.0,1.0
2253,9,2,7,15,1,8,45,95,9.0,2.0,7.0,15.0,1.0,8.0,43.0,22,9,13,16.0,7.0,9.0
9609462,15,7,8,13,1,14,121,60,7.0,2.0,5.0,9.0,0.0,7.0,68.0,40,15,25,24.0,6.0,18.0
9510215,2,2,0,0,0,2,5,60,0.0,0.0,0.0,0.0,0.0,0.0,0.0,17,2,15,,,
104189,4,3,1,1,0,4,9,46,,,,,,,,7,4,3,1.0,1.0,0.0
9910456,14,4,10,18,4,10,32,2,7.0,4.0,3.0,5.0,0.0,7.0,22.0,21,14,7,3.0,3.0,0.0
9512338,16,6,10,21,16,0,0,52,6.0,1.0,5.0,11.0,6.0,0.0,0.0,16,16,0,5.0,5.0,0.0
9302259,5,4,1,1,4,1,1,479,3.0,3.0,0.0,0.0,3.0,0.0,0.0,7,5,2,3.0,2.0,1.0
9411384,37,6,31,143,11,26,30,8,25.0,2.0,23.0,115.0,2.0,23.0,23.0,39,37,2,21.0,20.0,1.0
9707367,14,3,11,22,2,12,41,8,4.0,2.0,2.0,2.0,0.0,4.0,4.0,23,14,9,5.0,4.0,1.0
107214,2,2,0,0,0,2,10,0,1.0,1.0,0.0,0.0,0.0,1.0,2.0,19,2,17,5.0,1.0,4.0
9307324,31,4,27,135,4,27,27,36,24.0,4.0,20.0,85.0,2.0,22.0,22.0,32,31,1,18.0,17.0,1.0
9511341,29,6,23,121,3,26,101,34,23.0,2.0,21.0,113.0,1.0,22.0,89.0,37,29,8,23.0,18.0,5.0
110078,14,10,4,5,1,13,75,7,5.0,4.0,1.0,1.0,0.0,5.0,10.0,25,14,11,7.0,4.0,3.0
206077,41,22,19,39,2,39,551,3,8.0,5.0,3.0,6.0,0.0,8.0,142.0,249,41,208,42.0,2.0,40.0
9411439,13,8,5,6,8,5,9,58,5.0,3.0,2.0,2.0,1.0,4.0,8.0,23,13,10,4.0,2.0,2.0
9806416,9,3,6,9,3,6,20,89,5.0,1.0,4.0,5.0,0.0,5.0,18.0,14,9,5,9.0,5.0,4.0
9812333,18,8,10,21,1,17,84,83,5.0,2.0,3.0,8.0,0.0,5.0,15.0,47,18,29,9.0,5.0,4.0
9507322,3,2,1,1,0,3,13,6,0.0,0.0,0.0,0.0,0.0,0.0,0.0,10,3,7,1.0,0.0,1.0
9606359,12,5,7,12,2,10,37,46,5.0,3.0,2.0,2.0,5.0,0.0,0.0,18,12,6,9.0,6.0,3.0
11159,12,2,10,22,0,12,49,21,10.0,2.0,8.0,18.0,0.0,10.0,40.0,20,12,8,4.0,4.0,0.0
9304314,12,3,9,18,11,1,1,124,3.0,2.0,1.0,1.0,3.0,0.0,0.0,14,12,2,3.0,2.0,1.0
9701345,12,3,9,22,4,8,9,255,9.0,1.0,8.0,21.0,2.0,7.0,8.0,14,12,2,6.0,4.0,2.0
9606208,7,4,3,6,0,7,14,21,6.0,3.0,3.0,6.0,0.0,6.0,12.0,10,7,3,,,
9702289,3,2,1,1,2,1,6,1,2.0,1.0,1.0,1.0,2.0,0.0,0.0,11,3,8,,,
9911534,8,4,4,4,0,8,57,1,2.0,2.0,0.0,0.0,0.0,2.0,2.0,20,8,12,4.0,3.0,1.0
9906459,8,2,6,14,0,8,59,34,7.0,1.0,6.0,14.0,0.0,7.0,21.0,28,8,20,11.0,7.0,4.0
9605356,14,7,7,11,8,6,11,57,8.0,3.0,5.0,9.0,8.0,0.0,0.0,18,14,4,6.0,6.0,0.0
9804439,7,3,4,4,0,7,25,154,7.0,3.0,4.0,4.0,0.0,7.0,24.0,15,7,8,7.0,5.0,2.0
108046,0,0,0,0,0,0,0,143,0.0,0.0,0.0,0.0,0.0,0.0,0.0,4,0,4,3.0,0.0,3.0
9701243,22,11,11,20,3,19,30,245,3.0,2.0,1.0,2.0,1.0,2.0,4.0,26,22,4,6.0,3.0,3.0
9602353,16,9,7,10,3,13,29,6,5.0,3.0,2.0,3.0,1.0,4.0,4.0,26,16,10,2.0,2.0,0.0
102253,7,4,3,4,2,5,27,24,1.0,1.0,0.0,0.0,0.0,1.0,9.0,22,7,15,2.0,2.0,0.0
9309260,8,5,3,5,8,0,0,29,3.0,3.0,0.0,0.0,3.0,0.0,0.0,8,8,0,2.0,2.0,0.0
2127,23,8,15,55,0,23,268,49,12.0,5.0,7.0,28.0,0.0,12.0,108.0,65,23,42,27.0,10.0,17.0
9611389,10,6,4,9,0,10,30,10,1.0,1.0,0.0,0.0,0.0,1.0,1.0,16,10,6,3.0,1.0,2.0
9608272,24,9,15,45,1,23,152,15,17.0,6.0,11.0,39.0,0.0,17.0,76.0,59,24,35,20.0,14.0,6.0
9911299,20,9,11,14,2,18,61,8,9.0,3.0,6.0,7.0,0.0,9.0,45.0,38,20,18,20.0,6.0,14.0
9406252,25,8,17,49,25,0,0,44,13.0,2.0,11.0,35.0,13.0,0.0,0.0,25,25,0,4.0,4.0,0.0
9503222,12,5,7,12,12,0,0,270,3.0,1.0,2.0,3.0,3.0,0.0,0.0,12,12,0,3.0,3.0,0.0
108008,1,1,0,0,0,1,2,21,1.0,1.0,0.0,0.0,0.0,1.0,2.0,12,1,11,1.0,1.0,0.0
111342,10,3,7,14,10,0,0,0,1.0,1.0,0.0,0.0,1.0,0.0,0.0,10,10,0,1.0,1.0,0.0
107082,19,11,8,14,8,11,37,3,4.0,2.0,2.0,2.0,4.0,0.0,0.0,28,19,9,1.0,1.0,0.0
9610342,1,1,0,0,0,1,3,200,1.0,1.0,0.0,0.0,0.0,1.0,3.0,7,1,6,5.0,1.0,4.0
9211305,9,3,6,11,9,0,0,135,7.0,3.0,4.0,8.0,7.0,0.0,0.0,9,9,0,2.0,2.0,0.0
4197,14,7,7,19,2,12,96,3,10.0,5.0,5.0,11.0,0.0,10.0,94.0,55,14,41,10.0,5.0,5.0
105129,16,3,13,24,1,15,76,19,8.0,2.0,6.0,9.0,1.0,7.0,23.0,29,16,13,6.0,5.0,1.0
9712321,2,2,0,0,0,2,5,12,0.0,0.0,0.0,0.0,0.0,0.0,0.0,9,2,7,,,
209263,2,2,0,0,0,2,8,2,1.0,1.0,0.0,0.0,1.0,0.0,0.0,30,2,28,3.0,0.0,3.0
7266,20,8,12,28,0,20,123,12,12.0,4.0,8.0,19.0,0.0,12.0,52.0,51,20,31,13.0,1.0,12.0
10245,14,7,7,11,0,14,59,3,7.0,3.0,4.0,6.0,0.0,7.0,28.0,40,14,26,7.0,1.0,6.0
9911334,2,2,0,0,0,2,4,127,1.0,1.0,0.0,0.0,0.0,1.0,1.0,20,2,18,6.0,1.0,5.0
9406225,1,1,0,0,0,1,1,783,0.0,0.0,0.0,0.0,0.0,0.0,0.0,9,1,8,1.0,0.0,1.0
9512298,11,5,6,8,6,5,12,235,5.0,1.0,4.0,6.0,2.0,3.0,4.0,26,11,15,7.0,4.0,3.0
9709305,9,5,4,5,0,9,18,59,3.0,1.0,2.0,3.0,0.0,3.0,4.0,23,9,14,8.0,3.0,5.0
9308296,6,3,3,5,6,0,0,63,3.0,1.0,2.0,3.0,3.0,0.0,0.0,6,6,0,1.0,1.0,0.0
103223,14,4,10,35,1,13,196,23,10.0,3.0,7.0,28.0,0.0,10.0,134.0,56,14,42,16.0,5.0,11.0
9401232,15,6,9,24,13,2,2,53,3.0,1.0,2.0,2.0,3.0,0.0,0.0,16,15,1,3.0,3.0,0.0
9309258,3,3,0,0,3,0,0,206,1.0,1.0,0.0,0.0,1.0,0.0,0.0,3,3,0,,,
9504274,19,3,16,38,1,18,70,56,18.0,2.0,16.0,38.0,0.0,18.0,70.0,24,19,5,19.0,14.0,5.0
9608418,1,1,0,0,0,1,2,33,0.0,0.0,0.0,0.0,0.0,0.0,0.0,11,1,10,,,
9603267,20,4,16,39,9,11,21,25,8.0,1.0,7.0,15.0,1.0,7.0,14.0,26,20,6,8.0,7.0,1.0
9802329,27,6,21,68,6,21,95,92,15.0,2.0,13.0,34.0,1.0,14.0,40.0,49,27,22,19.0,15.0,4.0
9904240,30,9,21,53,5,25,61,25,10.0,1.0,9.0,26.0,0.0,10.0,25.0,49,30,19,10.0,7.0,3.0
9803303,0,0,0,0,0,0,0,99,0.0,0.0,0.0,0.0,0.0,0.0,0.0,7,0,7,1.0,0.0,1.0
201151,14,4,10,35,0,14,48,3,5.0,2.0,3.0,5.0,0.0,5.0,14.0,27,14,13,10.0,4.0,6.0
9912429,8,5,3,8,0,8,41,32,1.0,1.0,0.0,0.0,0.0,1.0,9.0,47,8,39,4.0,0.0,4.0
9711410,6,5,1,1,1,5,25,4,2.0,1.0,1.0,1.0,0.0,2.0,10.0,47,6,41,5.0,3.0,2.0
9211242,4,2,2,3,4,0,0,176,4.0,2.0,2.0,3.0,4.0,0.0,0.0,4,4,0,,,
9607389,47,4,43,223,14,33,90,7,17.0,4.0,13.0,34.0,1.0,16.0,23.0,56,47,9,14.0,14.0,0.0
9806360,12,5,7,13,4,8,33,7,1.0,1.0,0.0,0.0,0.0,1.0,3.0,29,12,17,7.0,2.0,5.0
3100,8,4,4,6,0,8,32,19,2.0,1.0,1.0,1.0,0.0,2.0,6.0,19,8,11,2.0,0.0,2.0
9709394,10,4,6,12,0,10,35,27,3.0,3.0,0.0,0.0,0.0,3.0,7.0,27,10,17,3.0,2.0,1.0
202210,24,7,17,49,1,23,130,46,15.0,3.0,12.0,33.0,0.0,15.0,87.0,42,24,18,18.0,10.0,8.0
205241,83,11,72,286,4,79,377,0,27.0,1.0,26.0,106.0,0.0,27.0,151.0,111,83,28,33.0,19.0,14.0
101181,4,3,1,1,0,4,17,181,1.0,1.0,0.0,0.0,0.0,1.0,5.0,26,4,22,12.0,1.0,11.0
9607305,2,2,0,0,2,0,0,370,1.0,1.0,0.0,0.0,1.0,0.0,0.0,4,2,2,,,
112060,25,10,15,41,2,23,132,0,11.0,4.0,7.0,22.0,1.0,10.0,44.0,74,25,49,16.0,6.0,10.0
9512444,2,2,0,0,1,1,1,522,1.0,1.0,0.0,0.0,1.0,0.0,0.0,7,2,5,1.0,1.0,0.0
11081,16,6,10,18,1,15,33,60,3.0,2.0,1.0,1.0,0.0,3.0,3.0,26,16,10,5.0,5.0,0.0
9909448,11,6,5,13,0,11,99,60,6.0,3.0,3.0,6.0,0.0,6.0,62.0,50,11,39,23.0,4.0,19.0
105145,15,5,10,28,0,15,69,47,10.0,3.0,7.0,20.0,0.0,10.0,57.0,32,15,17,19.0,10.0,9.0
9805413,3,3,0,0,3,0,0,493,2.0,2.0,0.0,0.0,2.0,0.0,0.0,7,3,4,2.0,2.0,0.0
111133,11,4,7,14,0,11,94,3,5.0,3.0,2.0,2.0,0.0,5.0,25.0,31,11,20,13.0,7.0,6.0
109277,8,5,3,5,7,1,1,0,0.0,0.0,0.0,0.0,0.0,0.0,0.0,9,8,1,1.0,1.0,0.0
9701299,6,4,2,2,0,6,26,87,3.0,2.0,1.0,1.0,0.0,3.0,9.0,18,6,12,3.0,1.0,2.0
9311247,49,15,34,150,49,0,0,65,29.0,5.0,24.0,97.0,29.0,0.0,0.0,49,49,0,15.0,15.0,0.0
112337,3,2,1,2,0,3,19,2,1.0,1.0,0.0,0.0,0.0,1.0,3.0,27,3,24,9.0,2.0,7.0
9506287,12,6,6,6,8,4,5,58,6.0,3.0,3.0,3.0,3.0,3.0,4.0,14,12,2,5.0,5.0,0.0
9510425,9,1,8,16,0,9,35,100,9.0,1.0,8.0,16.0,0.0,9.0,35.0,17,9,8,14.0,6.0,8.0
9806489,14,7,7,16,8,6,7,48,5.0,4.0,1.0,2.0,0.0,5.0,5.0,17,14,3,5.0,4.0,1.0
10262,1,1,0,0,0,1,4,54,1.0,1.0,0.0,0.0,0.0,1.0,3.0,18,1,17,7.0,0.0,7.0
107114,11,2,9,21,0,11,127,11,11.0,2.0,9.0,21.0,0.0,11.0,121.0,34,11,23,24.0,9.0,15.0
7112,31,11,20,55,6,25,125,13,16.0,7.0,9.0,27.0,0.0,16.0,110.0,45,31,14,9.0,9.0,0.0
5253,14,5,9,12,2,12,55,89,4.0,1.0,3.0,3.0,0.0,4.0,16.0,34,14,20,9.0,3.0,6.0
9411417,2,2,0,0,1,1,1,67,1.0,1.0,0.0,0.0,1.0,0.0,0.0,3,2,1,1.0,1.0,0.0
9501405,48,11,37,97,15,33,47,84,26.0,5.0,21.0,58.0,6.0,20.0,31.0,51,48,3,10.0,10.0,0.0
9606282,8,1,7,15,2,6,19,15,1.0,1.0,0.0,0.0,0.0,1.0,1.0,13,8,5,9.0,6.0,3.0
9702206,5,3,2,2,1,4,27,35,3.0,2.0,1.0,1.0,0.0,3.0,14.0,21,5,16,9.0,3.0,6.0
9611324,11,9,2,2,1,10,102,17,7.0,5.0,2.0,2.0,0.0,7.0,74.0,45,11,34,27.0,3.0,24.0
9806331,3,3,0,0,0,3,11,4,0.0,0.0,0.0,0.0,0.0,0.0,0.0,21,3,18,2.0,0.0,2.0
9411355,8,7,1,1,8,0,0,318,3.0,3.0,0.0,0.0,3.0,0.0,0.0,12,8,4,2.0,1.0,1.0
9907297,3,3,0,0,0,3,16,101,3.0,3.0,0.0,0.0,0.0,3.0,7.0,18,3,15,3.0,1.0,2.0
9209208,3,3,0,0,1,2,2,99,2.0,2.0,0.0,0.0,1.0,1.0,1.0,5,3,2,1.0,1.0,0.0
9710357,10,3,7,16,0,10,33,17,4.0,1.0,3.0,6.0,4.0,0.0,0.0,25,10,15,4.0,4.0,0.0
9405331,4,4,0,0,3,1,1,222,1.0,1.0,0.0,0.0,1.0,0.0,0.0,5,4,1,1.0,1.0,0.0
9712512,6,4,2,3,2,4,12,33,4.0,2.0,2.0,3.0,0.0,4.0,7.0,21,6,15,4.0,4.0,0.0
9403300,15,9,6,12,7,8,8,40,13.0,7.0,6.0,12.0,5.0,8.0,8.0,16,15,1,2.0,2.0,0.0
9709250,19,10,9,18,8,11,17,60,3.0,2.0,1.0,1.0,0.0,3.0,7.0,23,19,4,4.0,2.0,2.0
9805250,15,3,12,41,4,11,35,109,5.0,2.0,3.0,6.0,0.0,5.0,16.0,35,15,20,10.0,5.0,5.0
211044,0,0,0,0,0,0,0,26,0.0,0.0,0.0,0.0,0.0,0.0,0.0,12,0,12,3.0,0.0,3.0
9304292,7,4,3,3,7,0,0,220,2.0,2.0,0.0,0.0,2.0,0.0,0.0,7,7,0,3.0,3.0,0.0
9712360,8,2,6,9,2,6,8,157,8.0,2.0,6.0,9.0,2.0,6.0,8.0,11,8,3,4.0,3.0,1.0
9605382,39,7,32,103,23,16,25,103,25.0,5.0,20.0,75.0,15.0,10.0,10.0,47,39,8,10.0,10.0,0.0
9610255,8,3,5,6,1,7,16,7,7.0,4.0,3.0,4.0,0.0,7.0,14.0,19,8,11,3.0,2.0,1.0
103306,4,3,1,1,1,3,14,52,2.0,1.0,1.0,1.0,0.0,2.0,8.0,13,4,9,6.0,2.0,4.0
9907298,6,3,3,4,2,4,9,160,2.0,2.0,0.0,0.0,0.0,2.0,5.0,14,6,8,7.0,2.0,5.0
111287,3,3,0,0,0,3,7,37,2.0,2.0,0.0,0.0,0.0,2.0,4.0,9,3,6,3.0,1.0,2.0
112308,1,1,0,0,0,1,6,20,0.0,0.0,0.0,0.0,0.0,0.0,0.0,40,1,39,13.0,0.0,13.0
9601341,2,2,0,0,1,1,1,162,1.0,1.0,0.0,0.0,1.0,0.0,0.0,7,2,5,1.0,1.0,0.0
9610418,7,1,6,11,0,7,8,54,5.0,1.0,4.0,6.0,5.0,0.0,0.0,10,7,3,6.0,5.0,1.0
9611237,8,5,3,4,2,6,13,169,0.0,0.0,0.0,0.0,0.0,0.0,0.0,28,8,20,4.0,2.0,2.0
9709455,7,3,4,8,1,6,16,77,6.0,3.0,3.0,6.0,0.0,6.0,11.0,15,7,8,6.0,4.0,2.0
9712260,5,3,2,3,1,4,13,36,0.0,0.0,0.0,0.0,0.0,0.0,0.0,25,5,20,4.0,3.0,1.0
5204,8,6,2,2,0,8,27,3,0.0,0.0,0.0,0.0,0.0,0.0,0.0,48,8,40,2.0,2.0,0.0
9903431,2,2,0,0,1,1,4,8,1.0,1.0,0.0,0.0,0.0,1.0,4.0,10,2,8,1.0,0.0,1.0
9808449,12,2,10,41,0,12,81,9,12.0,2.0,10.0,41.0,0.0,12.0,69.0,25,12,13,1.0,1.0,0.0
105317,1,1,0,0,0,1,1,8,0.0,0.0,0.0,0.0,0.0,0.0,0.0,14,1,13,11.0,0.0,11.0
9312264,15,5,10,18,10,5,5,27,4.0,1.0,3.0,3.0,0.0,4.0,4.0,16,15,1,3.0,3.0,0.0
9910479,4,1,3,4,0,4,9,161,2.0,1.0,1.0,1.0,0.0,2.0,7.0,9,4,5,6.0,2.0,4.0
9705329,25,6,19,51,14,11,26,51,16.0,3.0,13.0,38.0,16.0,0.0,0.0,32,25,7,14.0,14.0,0.0
11257,11,5,6,8,0,11,74,11,3.0,2.0,1.0,1.0,0.0,3.0,22.0,37,11,26,5.0,4.0,1.0
9606326,4,4,0,0,1,3,3,335,2.0,2.0,0.0,0.0,1.0,1.0,1.0,8,4,4,2.0,1.0,1.0
9501267,9,5,4,7,9,0,0,30,9.0,5.0,4.0,7.0,9.0,0.0,0.0,10,9,1,2.0,2.0,0.0
209200,4,2,2,2,0,4,13,121,2.0,2.0,0.0,0.0,0.0,2.0,5.0,13,4,9,7.0,3.0,4.0
9709477,2,2,0,0,1,1,1,87,2.0,2.0,0.0,0.0,2.0,0.0,0.0,7,2,5,2.0,2.0,0.0
9705255,4,2,2,2,1,3,4,116,2.0,2.0,0.0,0.0,1.0,1.0,1.0,11,4,7,3.0,2.0,1.0
9605279,4,1,3,4,4,0,0,199,2.0,2.0,0.0,0.0,2.0,0.0,0.0,4,4,0,3.0,3.0,0.0
9805306,7,2,5,9,1,6,17,222,6.0,1.0,5.0,9.0,1.0,5.0,16.0,14,7,7,11.0,6.0,5.0
9611426,6,4,2,2,2,4,20,105,2.0,1.0,1.0,1.0,0.0,2.0,7.0,16,6,10,7.0,2.0,5.0
103304,2,2,0,0,0,2,7,321,2.0,2.0,0.0,0.0,0.0,2.0,5.0,7,2,5,5.0,2.0,3.0
9412373,11,8,3,8,1,10,67,53,7.0,4.0,3.0,8.0,0.0,7.0,56.0,23,11,12,14.0,5.0,9.0
9610292,7,3,4,5,1,6,10,103,4.0,2.0,2.0,3.0,0.0,4.0,4.0,11,7,4,3.0,3.0,0.0
9505362,1,1,0,0,1,0,0,921,,,,,,,,1,1,0,,,
9309317,1,1,0,0,1,0,0,253,1.0,1.0,0.0,0.0,1.0,0.0,0.0,2,1,1,,,
9709389,4,1,3,4,0,4,4,109,4.0,1.0,3.0,4.0,0.0,4.0,4.0,7,4,3,5.0,4.0,1.0
9409240,15,6,9,18,15,0,0,173,9.0,4.0,5.0,11.0,9.0,0.0,0.0,15,15,0,5.0,5.0,0.0
111267,14,4,10,12,2,12,54,14,5.0,2.0,3.0,4.0,0.0,5.0,33.0,34,14,20,16.0,3.0,13.0
9809439,7,5,2,2,0,7,20,36,2.0,2.0,0.0,0.0,0.0,2.0,4.0,28,7,21,9.0,3.0,6.0
2218,7,4,3,5,0,7,24,27,7.0,4.0,3.0,5.0,0.0,7.0,21.0,15,7,8,7.0,3.0,4.0
9905380,2,2,0,0,0,2,5,143,1.0,1.0,0.0,0.0,0.0,1.0,3.0,10,2,8,6.0,0.0,6.0
9811328,4,4,0,0,0,4,17,321,2.0,2.0,0.0,0.0,0.0,2.0,7.0,11,4,7,6.0,2.0,4.0
206019,1,1,0,0,0,1,19,56,1.0,1.0,0.0,0.0,0.0,1.0,18.0,27,1,26,19.0,1.0,18.0
9904483,18,3,15,26,10,8,10,184,11.0,2.0,9.0,15.0,4.0,7.0,9.0,21,18,3,10.0,8.0,2.0
9407322,1,1,0,0,1,0,0,901,,,,,,,,1,1,0,,,
9704256,6,4,2,2,0,6,18,245,1.0,1.0,0.0,0.0,0.0,1.0,1.0,11,6,5,2.0,1.0,1.0
1332,3,2,1,1,0,3,19,9,1.0,1.0,0.0,0.0,0.0,1.0,1.0,16,3,13,6.0,2.0,4.0
203271,3,3,0,0,0,3,16,38,0.0,0.0,0.0,0.0,0.0,0.0,0.0,48,3,45,20.0,0.0,20.0
9806402,21,2,19,53,3,18,44,25,10.0,2.0,8.0,20.0,1.0,9.0,11.0,35,21,14,11.0,10.0,1.0
9406330,2,2,0,0,0,2,2,190,1.0,1.0,0.0,0.0,0.0,1.0,1.0,4,2,2,3.0,1.0,2.0
207277,8,6,2,3,0,8,112,32,2.0,1.0,1.0,1.0,0.0,2.0,54.0,111,8,103,43.0,1.0,42.0
9811443,3,3,0,0,0,3,19,87,2.0,2.0,0.0,0.0,0.0,2.0,17.0,36,3,33,19.0,1.0,18.0
9901218,1,1,0,0,0,1,4,1,1.0,1.0,0.0,0.0,0.0,1.0,4.0,13,1,12,2.0,0.0,2.0
207221,1,1,0,0,0,1,10,2,0.0,0.0,0.0,0.0,0.0,0.0,0.0,23,1,22,3.0,0.0,3.0
9803407,10,2,8,13,0,10,86,6,1.0,1.0,0.0,0.0,0.0,1.0,9.0,30,10,20,12.0,8.0,4.0
9810449,3,2,1,2,0,3,19,142,3.0,2.0,1.0,2.0,0.0,3.0,19.0,15,3,12,13.0,3.0,10.0
4235,18,4,14,45,5,13,44,19,10.0,2.0,8.0,25.0,2.0,8.0,25.0,25,18,7,15.0,10.0,5.0
9607238,7,2,5,13,0,7,11,108,5.0,2.0,3.0,7.0,0.0,5.0,8.0,9,7,2,3.0,3.0,0.0
9608447,7,2,5,8,7,0,0,182,6.0,2.0,4.0,7.0,6.0,0.0,0.0,10,7,3,4.0,4.0,0.0
9912449,0,0,0,0,0,0,0,1069,0.0,0.0,0.0,0.0,0.0,0.0,0.0,1,0,1,1.0,0.0,1.0
103036,6,5,1,1,0,6,44,49,3.0,3.0,0.0,0.0,0.0,3.0,21.0,29,6,23,12.0,2.0,10.0
9911241,3,3,0,0,1,2,9,251,1.0,1.0,0.0,0.0,0.0,1.0,3.0,10,3,7,5.0,1.0,4.0
102068,6,1,5,7,0,6,20,74,5.0,1.0,4.0,6.0,0.0,5.0,14.0,20,6,14,12.0,5.0,7.0
211233,0,0,0,0,0,0,0,73,0.0,0.0,0.0,0.0,0.0,0.0,0.0,19,0,19,3.0,0.0,3.0
110318,1,1,0,0,0,1,11,2,1.0,1.0,0.0,0.0,0.0,1.0,9.0,33,1,32,3.0,0.0,3.0
202211,5,2,3,6,3,2,9,73,4.0,1.0,3.0,6.0,3.0,1.0,3.0,19,5,14,6.0,4.0,2.0
9709338,2,2,0,0,2,0,0,104,1.0,1.0,0.0,0.0,1.0,0.0,0.0,3,2,1,1.0,1.0,0.0
109213,4,2,2,2,0,4,8,13,1.0,1.0,0.0,0.0,0.0,1.0,1.0,11,4,7,2.0,1.0,1.0
9805299,1,1,0,0,0,1,6,16,,,,,,,,9,1,8,,,
9402245,2,2,0,0,2,0,0,555,1.0,1.0,0.0,0.0,1.0,0.0,0.0,2,2,0,1.0,1.0,0.0
1219,7,3,4,8,7,0,0,81,5.0,2.0,3.0,6.0,5.0,0.0,0.0,10,7,3,4.0,4.0,0.0
108050,3,2,1,2,1,2,7,28,2.0,1.0,1.0,1.0,1.0,1.0,1.0,7,3,4,3.0,2.0,1.0
9907290,3,1,2,2,2,1,1,206,1.0,1.0,0.0,0.0,0.0,1.0,1.0,8,3,5,4.0,1.0,3.0
203210,5,4,1,2,0,5,40,63,3.0,2.0,1.0,2.0,0.0,3.0,26.0,98,5,93,10.0,0.0,10.0
9811484,13,4,9,16,0,13,35,9,4.0,3.0,1.0,1.0,2.0,2.0,2.0,21,13,8,5.0,2.0,3.0
9605309,2,1,1,1,0,2,4,265,2.0,1.0,1.0,1.0,0.0,2.0,4.0,4,2,2,4.0,2.0,2.0
9607428,21,8,13,30,0,21,28,13,11.0,4.0,7.0,16.0,1.0,10.0,12.0,25,21,4,7.0,6.0,1.0
9805304,1,1,0,0,0,1,4,78,1.0,1.0,0.0,0.0,0.0,1.0,1.0,10,1,9,2.0,0.0,2.0
9710384,1,1,0,0,0,1,4,2004,,,,,,,,6,1,5,,,
101176,4,3,1,1,1,3,4,95,2.0,2.0,0.0,0.0,0.0,2.0,2.0,8,4,4,2.0,0.0,2.0
9411263,5,3,2,2,5,0,0,72,3.0,1.0,2.0,2.0,3.0,0.0,0.0,5,5,0,3.0,3.0,0.0
9801364,4,3,1,1,0,4,20,167,2.0,1.0,1.0,1.0,0.0,2.0,7.0,14,4,10,4.0,2.0,2.0
104168,3,3,0,0,1,2,11,11,1.0,1.0,0.0,0.0,0.0,1.0,8.0,43,3,40,9.0,0.0,9.0
9912229,0,0,0,0,0,0,0,22,,,,,,,,6,0,6,,,
9304235,6,5,1,2,4,2,5,75,5.0,4.0,1.0,2.0,3.0,2.0,5.0,9,6,3,7.0,4.0,3.0
9604369,5,5,0,0,2,3,5,51,1.0,1.0,0.0,0.0,0.0,1.0,1.0,14,5,9,2.0,1.0,1.0
12345,11,4,7,17,11,0,0,46,3.0,3.0,0.0,0.0,3.0,0.0,0.0,14,11,3,2.0,2.0,0.0
9903441,12,6,6,9,1,11,54,39,4.0,3.0,1.0,1.0,1.0,3.0,15.0,36,12,24,10.0,3.0,7.0
112222,3,3,0,0,0,3,11,28,2.0,2.0,0.0,0.0,0.0,2.0,8.0,23,3,20,8.0,1.0,7.0
9604286,2,2,0,0,0,2,2,122,1.0,1.0,0.0,0.0,1.0,0.0,0.0,4,2,2,1.0,1.0,0.0
9301264,1,1,0,0,1,0,0,318,1.0,1.0,0.0,0.0,1.0,0.0,0.0,1,1,0,1.0,1.0,0.0
111254,15,9,6,7,0,15,72,0,5.0,4.0,1.0,1.0,0.0,5.0,29.0,53,15,38,5.0,0.0,5.0
9708253,11,4,7,9,11,0,0,74,9.0,3.0,6.0,8.0,9.0,0.0,0.0,12,11,1,3.0,3.0,0.0
205282,1,1,0,0,0,1,1,424,0.0,0.0,0.0,0.0,0.0,0.0,0.0,4,1,3,2.0,0.0,2.0
9901285,0,0,0,0,0,0,0,1173,0.0,0.0,0.0,0.0,0.0,0.0,0.0,3,0,3,1.0,0.0,1.0
9706350,13,4,9,12,4,9,11,31,8.0,2.0,6.0,9.0,8.0,0.0,0.0,18,13,5,6.0,6.0,0.0
9404307,2,2,0,0,2,0,0,309,2.0,2.0,0.0,0.0,2.0,0.0,0.0,2,2,0,1.0,1.0,0.0
205038,7,3,4,11,0,7,107,3,5.0,1.0,4.0,8.0,0.0,5.0,71.0,54,7,47,18.0,4.0,14.0
208157,13,3,10,26,2,11,19,46,8.0,1.0,7.0,18.0,0.0,8.0,11.0,18,13,5,7.0,6.0,1.0
9511215,1,1,0,0,0,1,2,57,,,,,,,,3,1,2,1.0,1.0,0.0
9803336,8,4,4,5,3,5,10,354,2.0,2.0,0.0,0.0,0.0,2.0,2.0,27,8,19,4.0,3.0,1.0
3218,10,6,4,4,5,5,17,100,3.0,2.0,1.0,1.0,0.0,3.0,13.0,22,10,12,13.0,2.0,11.0
9706234,2,1,1,1,0,2,15,22,2.0,1.0,1.0,1.0,0.0,2.0,13.0,16,2,14,1.0,1.0,0.0
9707490,8,4,4,6,1,7,13,65,3.0,1.0,2.0,3.0,3.0,0.0,0.0,13,8,5,5.0,4.0,1.0
9409413,10,7,3,3,10,0,0,362,4.0,3.0,1.0,1.0,4.0,0.0,0.0,10,10,0,3.0,3.0,0.0
210044,5,3,2,2,1,4,17,6,3.0,2.0,1.0,1.0,0.0,3.0,16.0,20,5,15,8.0,3.0,5.0
209159,3,2,1,1,1,2,28,193,0.0,0.0,0.0,0.0,0.0,0.0,0.0,33,3,30,11.0,0.0,11.0
102338,7,3,4,5,0,7,24,59,6.0,3.0,3.0,4.0,0.0,6.0,22.0,17,7,10,11.0,3.0,8.0
101152,5,5,0,0,0,5,20,19,0.0,0.0,0.0,0.0,0.0,0.0,0.0,21,5,16,3.0,0.0,3.0
101046,2,2,0,0,0,2,14,5,1.0,1.0,0.0,0.0,0.0,1.0,12.0,33,2,31,17.0,0.0,17.0
109072,8,2,6,8,0,8,59,30,8.0,2.0,6.0,8.0,0.0,8.0,56.0,26,8,18,11.0,3.0,8.0
9303258,9,5,4,11,0,9,9,116,8.0,4.0,4.0,10.0,0.0,8.0,8.0,10,9,1,7.0,6.0,1.0
9604334,5,3,2,2,1,4,10,204,1.0,1.0,0.0,0.0,0.0,1.0,2.0,33,5,28,4.0,0.0,4.0
9508414,8,4,4,4,8,0,0,45,2.0,2.0,0.0,0.0,2.0,0.0,0.0,9,8,1,2.0,2.0,0.0
9506344,5,3,2,5,1,4,9,113,2.0,1.0,1.0,1.0,0.0,2.0,4.0,9,5,4,2.0,1.0,1.0
210004,5,5,0,0,0,5,17,2,2.0,2.0,0.0,0.0,0.0,2.0,4.0,18,5,13,4.0,1.0,3.0
205113,2,1,1,1,0,2,8,74,0.0,0.0,0.0,0.0,0.0,0.0,0.0,12,2,10,3.0,1.0,2.0
9503256,0,0,0,0,0,0,0,241,0.0,0.0,0.0,0.0,0.0,0.0,0.0,5,0,5,2.0,0.0,2.0
9208204,1,1,0,0,1,0,0,267,1.0,1.0,0.0,0.0,1.0,0.0,0.0,1,1,0,,,
201308,22,8,14,33,0,22,160,21,11.0,4.0,7.0,18.0,0.0,11.0,73.0,54,22,32,19.0,10.0,9.0
9811510,3,1,2,2,1,2,6,12,1.0,1.0,0.0,0.0,0.0,1.0,2.0,14,3,11,3.0,1.0,2.0
4015,5,4,1,1,3,2,3,495,2.0,1.0,1.0,1.0,0.0,2.0,2.0,7,5,2,3.0,2.0,1.0
9610411,12,5,7,11,9,3,3,145,6.0,2.0,4.0,5.0,5.0,1.0,1.0,16,12,4,4.0,3.0,1.0
11285,1,1,0,0,0,1,2,495,1.0,1.0,0.0,0.0,0.0,1.0,2.0,3,1,2,3.0,1.0,2.0
9606250,3,1,2,2,3,0,0,142,3.0,1.0,2.0,2.0,3.0,0.0,0.0,3,3,0,,,
9410362,4,2,2,2,2,2,2,151,3.0,1.0,2.0,2.0,1.0,2.0,2.0,5,4,1,2.0,1.0,1.0
9811254,0,0,0,0,0,0,0,36,0.0,0.0,0.0,0.0,0.0,0.0,0.0,36,0,36,23.0,0.0,23.0
210339,0,0,0,0,0,0,0,18,0.0,0.0,0.0,0.0,0.0,0.0,0.0,27,0,27,2.0,0.0,2.0
9311234,4,2,2,2,4,0,0,53,2.0,2.0,0.0,0.0,2.0,0.0,0.0,5,4,1,1.0,1.0,0.0
9912360,0,0,0,0,0,0,0,16,0.0,0.0,0.0,0.0,0.0,0.0,0.0,9,0,9,1.0,0.0,1.0
101277,5,5,0,0,2,3,23,27,3.0,3.0,0.0,0.0,0.0,3.0,18.0,38,5,33,6.0,3.0,3.0
9810338,13,8,5,7,3,10,38,29,6.0,4.0,2.0,4.0,0.0,6.0,29.0,39,13,26,11.0,4.0,7.0
211111,4,2,2,2,0,4,33,0,3.0,1.0,2.0,2.0,0.0,3.0,25.0,37,4,33,7.0,3.0,4.0
4137,13,2,11,37,6,7,18,181,10.0,2.0,8.0,17.0,5.0,5.0,14.0,22,13,9,10.0,9.0,1.0
205312,6,3,3,3,0,6,35,4,2.0,1.0,1.0,1.0,0.0,2.0,13.0,25,6,19,2.0,0.0,2.0
10128,11,4,7,8,0,11,42,130,5.0,3.0,2.0,2.0,0.0,5.0,24.0,30,11,19,8.0,3.0,5.0
9307278,8,6,2,2,8,0,0,159,5.0,3.0,2.0,2.0,5.0,0.0,0.0,8,8,0,4.0,4.0,0.0
9503452,4,3,1,1,2,2,2,243,2.0,1.0,1.0,1.0,0.0,2.0,2.0,5,4,1,3.0,2.0,1.0
9605397,5,2,3,5,2,3,3,49,0.0,0.0,0.0,0.0,0.0,0.0,0.0,16,5,11,6.0,1.0,5.0
9312304,16,8,8,10,0,16,41,29,10.0,4.0,6.0,8.0,0.0,10.0,29.0,25,16,9,6.0,3.0,3.0
9801447,4,2,2,2,0,4,15,1,4.0,2.0,2.0,2.0,0.0,4.0,15.0,8,4,4,2.0,2.0,0.0
9909375,3,3,0,0,2,1,1,22,1.0,1.0,0.0,0.0,0.0,1.0,1.0,10,3,7,1.0,1.0,0.0
9703415,4,1,3,5,0,4,9,113,3.0,1.0,2.0,2.0,0.0,3.0,3.0,9,4,5,4.0,3.0,1.0
103310,1,1,0,0,1,0,0,7,0.0,0.0,0.0,0.0,0.0,0.0,0.0,27,1,26,15.0,0.0,15.0
9502403,7,5,2,2,7,0,0,115,3.0,3.0,0.0,0.0,3.0,0.0,0.0,7,7,0,2.0,2.0,0.0
2061,11,5,6,8,0,11,49,7,6.0,1.0,5.0,7.0,0.0,6.0,8.0,30,11,19,5.0,4.0,1.0
9411436,2,2,0,0,0,2,4,48,0.0,0.0,0.0,0.0,0.0,0.0,0.0,11,2,9,1.0,0.0,1.0
9509296,4,4,0,0,1,3,7,8,1.0,1.0,0.0,0.0,1.0,0.0,0.0,11,4,7,2.0,1.0,1.0
9704387,4,1,3,3,4,0,0,221,1.0,1.0,0.0,0.0,1.0,0.0,0.0,4,4,0,,,
9307340,2,1,1,1,2,0,0,44,,,,,,,,2,2,0,,,
9903285,6,1,5,7,1,5,12,113,2.0,1.0,1.0,1.0,2.0,0.0,0.0,10,6,4,5.0,3.0,2.0
9511423,4,2,2,2,4,0,0,197,3.0,2.0,1.0,1.0,3.0,0.0,0.0,4,4,0,3.0,3.0,0.0
9406424,11,2,9,16,10,1,3,173,7.0,1.0,6.0,11.0,7.0,0.0,0.0,14,11,3,3.0,3.0,0.0
205310,2,2,0,0,0,2,6,5,,,,,,,,11,2,9,,,
9303248,10,5,5,10,10,0,0,440,5.0,3.0,2.0,2.0,5.0,0.0,0.0,10,10,0,4.0,4.0,0.0
9712324,3,3,0,0,1,2,3,313,2.0,2.0,0.0,0.0,2.0,0.0,0.0,8,3,5,1.0,1.0,0.0
9310225,3,2,1,1,3,0,0,359,2.0,2.0,0.0,0.0,2.0,0.0,0.0,3,3,0,1.0,1.0,0.0
6234,3,3,0,0,1,2,4,11,0.0,0.0,0.0,0.0,0.0,0.0,0.0,32,3,29,3.0,0.0,3.0
3260,13,5,8,11,0,13,79,33,7.0,2.0,5.0,5.0,0.0,7.0,60.0,35,13,22,21.0,5.0,16.0
12177,4,3,1,1,1,3,6,133,2.0,2.0,0.0,0.0,2.0,0.0,0.0,8,4,4,2.0,1.0,1.0
9310282,1,1,0,0,1,0,0,1941,1.0,1.0,0.0,0.0,1.0,0.0,0.0,1,1,0,,,
9907303,0,0,0,0,0,0,0,118,0.0,0.0,0.0,0.0,0.0,0.0,0.0,3,0,3,2.0,0.0,2.0
9510357,14,4,10,14,1,13,15,84,6.0,2.0,4.0,4.0,0.0,6.0,7.0,19,14,5,6.0,5.0,1.0
111137,8,2,6,16,1,7,22,0,7.0,1.0,6.0,15.0,0.0,7.0,18.0,17,8,9,9.0,6.0,3.0
9709340,1,1,0,0,0,1,5,136,1.0,1.0,0.0,0.0,0.0,1.0,5.0,10,1,9,9.0,1.0,8.0
9504243,1,1,0,0,1,0,0,265,1.0,1.0,0.0,0.0,1.0,0.0,0.0,2,1,1,1.0,1.0,0.0
1143,5,2,3,4,0,5,17,2,4.0,2.0,2.0,3.0,4.0,0.0,0.0,17,5,12,3.0,3.0,0.0
9810543,16,4,12,28,1,15,117,82,13.0,2.0,11.0,27.0,0.0,13.0,109.0,46,16,30,24.0,9.0,15.0
109111,0,0,0,0,0,0,0,477,0.0,0.0,0.0,0.0,0.0,0.0,0.0,4,0,4,3.0,0.0,3.0
106037,7,2,5,6,2,5,34,9,0.0,0.0,0.0,0.0,0.0,0.0,0.0,40,7,33,9.0,1.0,8.0
203012,2,2,0,0,1,1,1,145,0.0,0.0,0.0,0.0,0.0,0.0,0.0,9,2,7,2.0,0.0,2.0
9504411,5,4,1,1,3,2,3,96,1.0,1.0,0.0,0.0,0.0,1.0,1.0,10,5,5,2.0,2.0,0.0
9407239,6,5,1,1,6,0,0,374,2.0,2.0,0.0,0.0,2.0,0.0,0.0,7,6,1,1.0,1.0,0.0
9711399,3,3,0,0,0,3,24,114,1.0,1.0,0.0,0.0,0.0,1.0,7.0,37,3,34,16.0,2.0,14.0
9509276,2,1,1,1,0,2,2,1876,1.0,1.0,0.0,0.0,1.0,0.0,0.0,5,2,3,,,
302060,0,0,0,0,0,0,0,0,0.0,0.0,0.0,0.0,0.0,0.0,0.0,10,0,10,2.0,0.0,2.0
9706355,1,1,0,0,1,0,0,140,,,,,,,,3,1,2,,,
3316,2,2,0,0,0,2,5,12,1.0,1.0,0.0,0.0,0.0,1.0,1.0,16,2,14,1.0,0.0,1.0
106198,11,3,8,13,0,11,38,95,8.0,3.0,5.0,10.0,0.0,8.0,18.0,26,11,15,12.0,8.0,4.0
109283,4,3,1,1,0,4,16,4,0.0,0.0,0.0,0.0,0.0,0.0,0.0,25,4,21,2.0,1.0,1.0
212291,1,1,0,0,0,1,4,49,1.0,1.0,0.0,0.0,0.0,1.0,3.0,12,1,11,4.0,0.0,4.0
205273,2,1,1,1,0,2,18,49,2.0,1.0,1.0,1.0,0.0,2.0,14.0,30,2,28,5.0,0.0,5.0
4223,14,7,7,9,1,13,72,33,10.0,4.0,6.0,8.0,0.0,10.0,66.0,42,14,28,24.0,5.0,19.0
9803358,4,3,1,1,2,2,6,35,2.0,1.0,1.0,1.0,1.0,1.0,5.0,11,4,7,2.0,0.0,2.0
111051,0,0,0,0,0,0,0,261,0.0,0.0,0.0,0.0,0.0,0.0,0.0,3,0,3,,,
9707394,4,3,1,1,1,3,6,13,2.0,2.0,0.0,0.0,2.0,0.0,0.0,8,4,4,2.0,2.0,0.0
8320,3,2,1,1,0,3,7,18,0.0,0.0,0.0,0.0,0.0,0.0,0.0,13,3,10,1.0,0.0,1.0
9208257,3,3,0,0,3,0,0,295,1.0,1.0,0.0,0.0,1.0,0.0,0.0,3,3,0,1.0,1.0,0.0
10144,2,2,0,0,0,2,10,753,2.0,2.0,0.0,0.0,0.0,2.0,10.0,9,2,7,1.0,1.0,0.0
9403324,7,2,5,9,0,7,18,90,6.0,1.0,5.0,9.0,0.0,6.0,13.0,15,7,8,4.0,3.0,1.0
9606309,4,4,0,0,4,0,0,388,2.0,2.0,0.0,0.0,2.0,0.0,0.0,4,4,0,2.0,2.0,0.0
9512436,5,4,1,2,5,0,0,434,4.0,3.0,1.0,2.0,4.0,0.0,0.0,6,5,1,5.0,4.0,1.0
111205,8,2,6,10,0,8,89,3,6.0,1.0,5.0,7.0,0.0,6.0,37.0,45,8,37,15.0,7.0,8.0
202053,3,3,0,0,1,2,8,52,1.0,1.0,0.0,0.0,0.0,1.0,4.0,15,3,12,3.0,1.0,2.0
210003,1,1,0,0,0,1,2,24,0.0,0.0,0.0,0.0,0.0,0.0,0.0,14,1,13,2.0,0.0,2.0
101009,15,10,5,6,2,13,49,99,4.0,3.0,1.0,1.0,0.0,4.0,15.0,39,15,24,12.0,3.0,9.0
9312321,1,1,0,0,1,0,0,385,1.0,1.0,0.0,0.0,1.0,0.0,0.0,2,1,1,1.0,1.0,0.0
9902378,1,1,0,0,0,1,1,1,1.0,1.0,0.0,0.0,0.0,1.0,1.0,17,1,16,7.0,0.0,7.0
9709441,3,3,0,0,0,3,6,2037,0.0,0.0,0.0,0.0,0.0,0.0,0.0,9,3,6,2.0,1.0,1.0
9607247,3,2,1,1,0,3,8,8,2.0,1.0,1.0,1.0,0.0,2.0,2.0,19,3,16,1.0,0.0,1.0
202195,9,3,6,16,0,9,59,52,6.0,1.0,5.0,12.0,0.0,6.0,52.0,23,9,14,19.0,6.0,13.0
1227,4,2,2,2,1,3,4,65,2.0,1.0,1.0,1.0,1.0,1.0,1.0,12,4,8,4.0,1.0,3.0
9702267,3,2,1,1,0,3,10,91,1.0,1.0,0.0,0.0,0.0,1.0,5.0,14,3,11,6.0,1.0,5.0
9901216,5,2,3,4,0,5,32,27,5.0,2.0,3.0,4.0,0.0,5.0,32.0,15,5,10,6.0,3.0,3.0
9702402,3,3,0,0,3,0,0,269,1.0,1.0,0.0,0.0,1.0,0.0,0.0,4,3,1,2.0,1.0,1.0
9608212,4,2,2,3,4,0,0,230,4.0,2.0,2.0,3.0,4.0,0.0,0.0,4,4,0,3.0,3.0,0.0
12086,1,1,0,0,0,1,2,49,0.0,0.0,0.0,0.0,0.0,0.0,0.0,12,1,11,1.0,0.0,1.0
204233,1,1,0,0,0,1,1,33,0.0,0.0,0.0,0.0,0.0,0.0,0.0,10,1,9,4.0,0.0,4.0
9708389,3,3,0,0,1,2,4,264,1.0,1.0,0.0,0.0,0.0,1.0,3.0,6,3,3,1.0,1.0,0.0
111117,1,1,0,0,1,0,0,472,1.0,1.0,0.0,0.0,1.0,0.0,0.0,2,1,1,1.0,1.0,0.0
112340,2,1,1,1,1,1,1,181,2.0,1.0,1.0,1.0,1.0,1.0,1.0,8,2,6,1.0,1.0,0.0
9901296,2,2,0,0,0,2,9,40,1.0,1.0,0.0,0.0,0.0,1.0,1.0,15,2,13,4.0,2.0,2.0
9808256,9,5,4,8,0,9,31,56,9.0,5.0,4.0,8.0,0.0,9.0,31.0,19,9,10,5.0,3.0,2.0
108091,2,1,1,1,1,1,1,126,2.0,1.0,1.0,1.0,1.0,1.0,1.0,4,2,2,4.0,2.0,2.0
111084,5,3,2,2,4,1,1,126,3.0,2.0,1.0,1.0,2.0,1.0,1.0,8,5,3,3.0,2.0,1.0
211326,1,1,0,0,0,1,2,27,0.0,0.0,0.0,0.0,0.0,0.0,0.0,15,1,14,8.0,0.0,8.0
210123,3,3,0,0,0,3,17,28,1.0,1.0,0.0,0.0,0.0,1.0,7.0,30,3,27,22.0,1.0,21.0
3191,2,1,1,1,0,2,9,125,2.0,1.0,1.0,1.0,0.0,2.0,7.0,13,2,11,7.0,2.0,5.0
9909215,3,3,0,0,2,1,1,2010,1.0,1.0,0.0,0.0,1.0,0.0,0.0,5,3,2,1.0,1.0,0.0
9902210,2,2,0,0,0,2,2,336,1.0,1.0,0.0,0.0,1.0,0.0,0.0,3,2,1,3.0,2.0,1.0
11076,7,2,5,7,0,7,12,20,5.0,1.0,4.0,5.0,0.0,5.0,8.0,11,7,4,6.0,4.0,2.0
3278,8,3,5,10,0,8,54,50,5.0,1.0,4.0,8.0,0.0,5.0,23.0,23,8,15,16.0,6.0,10.0
6213,6,3,3,4,6,0,0,410,3.0,2.0,1.0,1.0,3.0,0.0,0.0,6,6,0,2.0,2.0,0.0
9703385,6,4,2,3,0,6,11,144,6.0,4.0,2.0,3.0,0.0,6.0,11.0,11,6,5,8.0,5.0,3.0
9909295,3,1,2,2,0,3,16,115,3.0,1.0,2.0,2.0,0.0,3.0,16.0,13,3,10,3.0,3.0,0.0
11235,1,1,0,0,0,1,4,180,1.0,1.0,0.0,0.0,0.0,1.0,2.0,6,1,5,4.0,1.0,3.0
212293,0,0,0,0,0,0,0,386,0.0,0.0,0.0,0.0,0.0,0.0,0.0,1,0,1,,,
106175,9,1,8,30,0,9,87,66,8.0,1.0,7.0,23.0,0.0,8.0,70.0,29,9,20,17.0,8.0,9.0
3112,2,2,0,0,2,0,0,219,1.0,1.0,0.0,0.0,1.0,0.0,0.0,3,2,1,1.0,1.0,0.0
104001,3,2,1,1,0,3,17,64,2.0,1.0,1.0,1.0,0.0,2.0,12.0,26,3,23,9.0,2.0,7.0
9602240,3,3,0,0,0,3,10,52,3.0,3.0,0.0,0.0,0.0,3.0,10.0,11,3,8,7.0,2.0,5.0
9322,3,3,0,0,0,3,7,97,2.0,2.0,0.0,0.0,0.0,2.0,6.0,14,3,11,4.0,2.0,2.0
204183,0,0,0,0,0,0,0,7,0.0,0.0,0.0,0.0,0.0,0.0,0.0,13,0,13,2.0,0.0,2.0
9307250,9,3,6,11,9,0,0,138,9.0,3.0,6.0,11.0,9.0,0.0,0.0,9,9,0,6.0,6.0,0.0
9705420,3,1,2,3,2,1,1,75,3.0,1.0,2.0,3.0,2.0,1.0,1.0,14,3,11,5.0,0.0,5.0
9805280,1,1,0,0,0,1,1,110,0.0,0.0,0.0,0.0,0.0,0.0,0.0,6,1,5,1.0,0.0,1.0
9908264,16,1,15,38,0,16,153,16,15.0,1.0,14.0,36.0,0.0,15.0,149.0,42,16,26,14.0,11.0,3.0
9704350,1,1,0,0,0,1,5,7,0.0,0.0,0.0,0.0,0.0,0.0,0.0,18,1,17,14.0,0.0,14.0
205100,0,0,0,0,0,0,0,7,0.0,0.0,0.0,0.0,0.0,0.0,0.0,49,0,49,8.0,0.0,8.0
10337,4,3,1,1,2,2,2,84,3.0,2.0,1.0,1.0,1.0,2.0,2.0,6,4,2,2.0,2.0,0.0
302238,0,0,0,0,0,0,0,139,0.0,0.0,0.0,0.0,0.0,0.0,0.0,4,0,4,2.0,0.0,2.0
9705478,4,4,0,0,0,4,6,168,1.0,1.0,0.0,0.0,1.0,0.0,0.0,10,4,6,1.0,0.0,1.0
9605304,4,3,1,2,1,3,8,115,2.0,2.0,0.0,0.0,0.0,2.0,5.0,7,4,3,5.0,2.0,3.0
205272,5,3,2,3,3,2,5,9,2.0,1.0,1.0,1.0,2.0,0.0,0.0,14,5,9,3.0,3.0,0.0
7284,3,3,0,0,2,1,1,398,2.0,2.0,0.0,0.0,2.0,0.0,0.0,5,3,2,3.0,3.0,0.0
9807379,5,3,2,4,1,4,9,44,4.0,2.0,2.0,4.0,1.0,3.0,4.0,12,5,7,2.0,0.0,2.0
9903263,3,3,0,0,2,1,1,131,0.0,0.0,0.0,0.0,0.0,0.0,0.0,4,3,1,2.0,1.0,1.0
9801334,2,2,0,0,1,1,1,141,,,,,,,,8,2,6,1.0,0.0,1.0
112320,5,2,3,5,1,4,13,165,5.0,2.0,3.0,5.0,1.0,4.0,13.0,10,5,5,9.0,4.0,5.0
202254,10,5,5,6,1,9,42,74,2.0,1.0,1.0,1.0,0.0,2.0,6.0,42,10,32,6.0,2.0,4.0
5219,3,1,2,3,0,3,6,112,3.0,1.0,2.0,3.0,0.0,3.0,5.0,11,3,8,5.0,3.0,2.0
112115,6,3,3,8,0,6,50,7,3.0,2.0,1.0,1.0,0.0,3.0,17.0,27,6,21,9.0,1.0,8.0
9210206,8,4,4,6,8,0,0,171,5.0,1.0,4.0,6.0,5.0,0.0,0.0,8,8,0,3.0,3.0,0.0
9812217,2,2,0,0,1,1,1,1120,,,,,,,,4,2,2,1.0,1.0,0.0
12258,1,1,0,0,0,1,4,32,0.0,0.0,0.0,0.0,0.0,0.0,0.0,14,1,13,2.0,1.0,1.0
9407385,1,1,0,0,0,1,2,99,0.0,0.0,0.0,0.0,0.0,0.0,0.0,6,1,5,1.0,0.0,1.0
9503364,2,2,0,0,2,0,0,160,1.0,1.0,0.0,0.0,1.0,0.0,0.0,2,2,0,1.0,1.0,0.0
9410206,1,1,0,0,1,0,0,346,1.0,1.0,0.0,0.0,1.0,0.0,0.0,2,1,1,,,
9904424,1,1,0,0,1,0,0,663,0.0,0.0,0.0,0.0,0.0,0.0,0.0,2,1,1,1.0,0.0,1.0
208071,2,2,0,0,1,1,3,131,1.0,1.0,0.0,0.0,0.0,1.0,3.0,7,2,5,4.0,1.0,3.0
5164,6,5,1,1,0,6,26,31,5.0,4.0,1.0,1.0,0.0,5.0,14.0,20,6,14,4.0,2.0,2.0
8260,14,10,4,7,0,14,78,11,3.0,2.0,1.0,1.0,0.0,3.0,7.0,46,14,32,3.0,0.0,3.0
9028,0,0,0,0,0,0,0,14,0.0,0.0,0.0,0.0,0.0,0.0,0.0,11,0,11,2.0,0.0,2.0
3166,1,1,0,0,0,1,2,131,0.0,0.0,0.0,0.0,0.0,0.0,0.0,7,1,6,3.0,0.0,3.0
9608348,2,2,0,0,1,1,2,78,1.0,1.0,0.0,0.0,1.0,0.0,0.0,9,2,7,5.0,1.0,4.0
7173,2,2,0,0,0,2,7,154,1.0,1.0,0.0,0.0,1.0,0.0,0.0,6,2,4,1.0,1.0,0.0
104179,4,2,2,4,0,4,13,4,3.0,1.0,2.0,3.0,0.0,3.0,12.0,13,4,9,5.0,2.0,3.0
209194,4,1,3,5,0,4,11,1,2.0,1.0,1.0,1.0,1.0,1.0,2.0,11,4,7,8.0,3.0,5.0
9704211,1,1,0,0,1,0,0,366,0.0,0.0,0.0,0.0,0.0,0.0,0.0,11,1,10,2.0,0.0,2.0
9907271,4,2,2,3,0,4,17,175,4.0,2.0,2.0,3.0,0.0,4.0,17.0,16,4,12,10.0,4.0,6.0
102057,0,0,0,0,0,0,0,457,0.0,0.0,0.0,0.0,0.0,0.0,0.0,5,0,5,5.0,0.0,5.0
102025,7,4,3,3,2,5,14,16,0.0,0.0,0.0,0.0,0.0,0.0,0.0,23,7,16,5.0,0.0,5.0
9503325,1,1,0,0,1,0,0,15,0.0,0.0,0.0,0.0,0.0,0.0,0.0,10,1,9,2.0,0.0,2.0
3085,3,2,1,1,0,3,8,56,2.0,1.0,1.0,1.0,1.0,1.0,2.0,10,3,7,4.0,2.0,2.0
3194,0,0,0,0,0,0,0,2114,0.0,0.0,0.0,0.0,0.0,0.0,0.0,1,0,1,,,
9309320,2,2,0,0,1,1,3,15,1.0,1.0,0.0,0.0,1.0,0.0,0.0,8,2,6,1.0,1.0,0.0
5014,5,2,3,5,0,5,9,29,2.0,1.0,1.0,1.0,0.0,2.0,2.0,12,5,7,4.0,3.0,1.0
11091,6,2,4,8,0,6,32,48,6.0,2.0,4.0,8.0,0.0,6.0,25.0,29,6,23,12.0,5.0,7.0
9507278,2,2,0,0,2,0,0,105,2.0,2.0,0.0,0.0,2.0,0.0,0.0,2,2,0,,,
206025,4,4,0,0,1,3,10,32,2.0,2.0,0.0,0.0,0.0,2.0,5.0,34,4,30,2.0,0.0,2.0
9809288,1,1,0,0,0,1,2,1,1.0,1.0,0.0,0.0,0.0,1.0,2.0,9,1,8,5.0,1.0,4.0
9810433,0,0,0,0,0,0,0,117,0.0,0.0,0.0,0.0,0.0,0.0,0.0,8,0,8,8.0,0.0,8.0
101112,1,1,0,0,1,0,0,1545,,,,,,,,1,1,0,,,
212103,0,0,0,0,0,0,0,1640,,,,,,,,1,0,1,,,
110363,5,5,0,0,0,5,92,10,3.0,3.0,0.0,0.0,0.0,3.0,43.0,61,5,56,11.0,3.0,8.0
9710554,2,1,1,1,1,1,1,89,,,,,,,,3,2,1,,,
211058,0,0,0,0,0,0,0,1713,0.0,0.0,0.0,0.0,0.0,0.0,0.0,2,0,2,,,
207202,1,1,0,0,1,0,0,303,0.0,0.0,0.0,0.0,0.0,0.0,0.0,7,1,6,4.0,0.0,4.0
1325,2,2,0,0,0,2,12,113,2.0,2.0,0.0,0.0,0.0,2.0,12.0,10,2,8,9.0,2.0,7.0
9905355,5,1,4,5,0,5,35,29,4.0,2.0,2.0,3.0,0.0,4.0,26.0,22,5,17,12.0,5.0,7.0
9912351,10,3,7,15,1,9,17,8,8.0,2.0,6.0,14.0,0.0,8.0,14.0,13,10,3,7.0,6.0,1.0
206093,1,1,0,0,0,1,5,17,1.0,1.0,0.0,0.0,0.0,1.0,1.0,12,1,11,2.0,1.0,1.0
204186,1,1,0,0,1,0,0,1,0.0,0.0,0.0,0.0,0.0,0.0,0.0,15,1,14,3.0,0.0,3.0
105119,3,3,0,0,1,2,10,0,2.0,2.0,0.0,0.0,0.0,2.0,7.0,17,3,14,8.0,2.0,6.0
9026,1,1,0,0,0,1,1,761,0.0,0.0,0.0,0.0,0.0,0.0,0.0,3,1,2,1.0,0.0,1.0
111005,4,1,3,4,0,4,7,23,0.0,0.0,0.0,0.0,0.0,0.0,0.0,15,4,11,1.0,1.0,0.0
9707361,1,1,0,0,0,1,1,72,1.0,1.0,0.0,0.0,1.0,0.0,0.0,9,1,8,2.0,1.0,1.0
102094,0,0,0,0,0,0,0,2,0.0,0.0,0.0,0.0,0.0,0.0,0.0,23,0,23,2.0,0.0,2.0
9401215,2,2,0,0,2,0,0,217,1.0,1.0,0.0,0.0,1.0,0.0,0.0,2,2,0,1.0,1.0,0.0
9908253,1,1,0,0,1,0,0,227,0.0,0.0,0.0,0.0,0.0,0.0,0.0,7,1,6,6.0,0.0,6.0
10028,2,1,1,1,0,2,9,38,2.0,1.0,1.0,1.0,0.0,2.0,8.0,7,2,5,,,
112280,2,2,0,0,0,2,13,18,1.0,1.0,0.0,0.0,0.0,1.0,1.0,22,2,20,2.0,1.0,1.0
204242,2,2,0,0,0,2,6,77,2.0,2.0,0.0,0.0,0.0,2.0,5.0,14,2,12,5.0,2.0,3.0
204005,2,1,1,1,0,2,6,53,0.0,0.0,0.0,0.0,0.0,0.0,0.0,6,2,4,3.0,1.0,2.0
1222,2,2,0,0,0,2,2,482,1.0,1.0,0.0,0.0,0.0,1.0,1.0,4,2,2,3.0,1.0,2.0
111473,5,3,2,2,0,5,33,11,2.0,2.0,0.0,0.0,0.0,2.0,4.0,55,5,50,12.0,0.0,12.0
9905504,8,3,5,12,0,8,12,7,3.0,1.0,2.0,3.0,0.0,3.0,3.0,14,8,6,4.0,1.0,3.0
107112,6,4,2,4,1,5,48,33,5.0,3.0,2.0,4.0,0.0,5.0,33.0,31,6,25,11.0,3.0,8.0
9902320,6,3,3,6,4,2,4,106,4.0,1.0,3.0,6.0,4.0,0.0,0.0,15,6,9,1.0,0.0,1.0
9503301,0,0,0,0,0,0,0,5,0.0,0.0,0.0,0.0,0.0,0.0,0.0,6,0,6,2.0,0.0,2.0
105303,2,2,0,0,0,2,8,120,1.0,1.0,0.0,0.0,0.0,1.0,3.0,27,2,25,16.0,0.0,16.0
9607264,1,1,0,0,1,0,0,172,0.0,0.0,0.0,0.0,0.0,0.0,0.0,4,1,3,1.0,1.0,0.0
202028,1,1,0,0,0,1,1,6,0.0,0.0,0.0,0.0,0.0,0.0,0.0,14,1,13,2.0,0.0,2.0
9605321,4,3,1,1,2,2,2,216,2.0,1.0,1.0,1.0,2.0,0.0,0.0,5,4,1,1.0,1.0,0.0
9611420,3,3,0,0,3,0,0,353,2.0,2.0,0.0,0.0,2.0,0.0,0.0,3,3,0,1.0,1.0,0.0
9212256,5,1,4,7,5,0,0,17,2.0,1.0,1.0,1.0,2.0,0.0,0.0,5,5,0,2.0,2.0,0.0
9810472,1,1,0,0,1,0,0,262,1.0,1.0,0.0,0.0,1.0,0.0,0.0,1,1,0,,,
9601290,6,5,1,2,1,5,5,340,4.0,3.0,1.0,2.0,0.0,4.0,4.0,8,6,2,4.0,3.0,1.0
9312305,8,7,1,1,8,0,0,189,7.0,6.0,1.0,1.0,7.0,0.0,0.0,9,8,1,4.0,4.0,0.0
9906554,1,1,0,0,0,1,6,21,1.0,1.0,0.0,0.0,0.0,1.0,5.0,12,1,11,10.0,1.0,9.0
211024,3,3,0,0,0,3,28,37,1.0,1.0,0.0,0.0,0.0,1.0,10.0,30,3,27,9.0,1.0,8.0
9803243,0,0,0,0,0,0,0,834,0.0,0.0,0.0,0.0,0.0,0.0,0.0,3,0,3,,,
201150,7,5,2,2,0,7,46,27,6.0,4.0,2.0,2.0,0.0,6.0,34.0,31,7,24,17.0,5.0,12.0
103003,4,3,1,1,1,3,8,240,0.0,0.0,0.0,0.0,0.0,0.0,0.0,16,4,12,6.0,0.0,6.0
9908211,2,1,1,1,0,2,5,234,1.0,1.0,0.0,0.0,0.0,1.0,2.0,9,2,7,4.0,2.0,2.0
9906494,0,0,0,0,0,0,0,84,0.0,0.0,0.0,0.0,0.0,0.0,0.0,11,0,11,8.0,0.0,8.0
9310255,0,0,0,0,0,0,0,75,,,,,,,,4,0,4,,,
9310218,1,1,0,0,0,1,3,75,1.0,1.0,0.0,0.0,1.0,0.0,0.0,7,1,6,1.0,1.0,0.0
7291,6,2,4,7,0,6,59,10,2.0,1.0,1.0,1.0,0.0,2.0,18.0,39,6,33,18.0,2.0,16.0
111087,1,1,0,0,0,1,7,29,1.0,1.0,0.0,0.0,0.0,1.0,2.0,15,1,14,1.0,0.0,1.0
211430,1,1,0,0,0,1,4,202,1.0,1.0,0.0,0.0,0.0,1.0,4.0,9,1,8,7.0,1.0,6.0
9153,1,1,0,0,1,0,0,259,0.0,0.0,0.0,0.0,0.0,0.0,0.0,10,1,9,1.0,0.0,1.0
9803482,2,1,1,1,0,2,2,159,2.0,1.0,1.0,1.0,0.0,2.0,2.0,4,2,2,3.0,2.0,1.0
9407320,1,1,0,0,1,0,0,1331,,,,,,,,1,1,0,,,
9805332,7,3,4,9,0,7,48,1,5.0,1.0,4.0,9.0,0.0,5.0,10.0,27,7,20,8.0,5.0,3.0
212344,0,0,0,0,0,0,0,180,0.0,0.0,0.0,0.0,0.0,0.0,0.0,5,0,5,1.0,0.0,1.0
104031,6,2,4,5,2,4,8,38,4.0,1.0,3.0,4.0,2.0,2.0,2.0,11,6,5,4.0,2.0,2.0
4198,5,3,2,3,5,0,0,166,4.0,2.0,2.0,3.0,4.0,0.0,0.0,5,5,0,3.0,3.0,0.0
9912280,1,1,0,0,1,0,0,251,0.0,0.0,0.0,0.0,0.0,0.0,0.0,4,1,3,2.0,0.0,2.0
9706263,0,0,0,0,0,0,0,8,,,,,,,,7,0,7,,,
206247,0,0,0,0,0,0,0,89,0.0,0.0,0.0,0.0,0.0,0.0,0.0,7,0,7,5.0,0.0,5.0
9805255,4,4,0,0,1,3,5,123,2.0,2.0,0.0,0.0,1.0,1.0,1.0,10,4,6,4.0,2.0,2.0
9710343,2,2,0,0,0,2,2,123,1.0,1.0,0.0,0.0,0.0,1.0,1.0,6,2,4,2.0,1.0,1.0
103145,2,2,0,0,1,1,4,62,1.0,1.0,0.0,0.0,0.0,1.0,4.0,12,2,10,2.0,0.0,2.0
9705387,2,1,1,1,2,0,0,66,,,,,,,,2,2,0,,,
9804362,2,2,0,0,2,0,0,94,0.0,0.0,0.0,0.0,0.0,0.0,0.0,6,2,4,1.0,1.0,0.0
9710490,1,1,0,0,1,0,0,279,1.0,1.0,0.0,0.0,1.0,0.0,0.0,3,1,2,1.0,1.0,0.0
11276,5,2,3,3,1,4,17,30,2.0,1.0,1.0,1.0,0.0,2.0,8.0,15,5,10,2.0,1.0,1.0
208121,3,2,1,1,0,3,27,20,3.0,2.0,1.0,1.0,0.0,3.0,27.0,26,3,23,11.0,3.0,8.0
12365,7,3,4,9,1,6,9,106,6.0,2.0,4.0,9.0,2.0,4.0,4.0,10,7,3,6.0,5.0,1.0
9312362,1,1,0,0,1,0,0,1417,,,,,,,,1,1,0,,,
9503212,4,4,0,0,4,0,0,97,3.0,3.0,0.0,0.0,3.0,0.0,0.0,4,4,0,,,
9510433,0,0,0,0,0,0,0,1818,,,,,,,,1,0,1,,,
9059,2,2,0,0,1,1,1,1217,1.0,1.0,0.0,0.0,1.0,0.0,0.0,5,2,3,1.0,1.0,0.0
212305,0,0,0,0,0,0,0,46,0.0,0.0,0.0,0.0,0.0,0.0,0.0,100,0,100,18.0,0.0,18.0
101313,0,0,0,0,0,0,0,143,0.0,0.0,0.0,0.0,0.0,0.0,0.0,7,0,7,1.0,0.0,1.0
9708424,1,1,0,0,1,0,0,174,0.0,0.0,0.0,0.0,0.0,0.0,0.0,2,1,1,1.0,0.0,1.0
301183,1,1,0,0,0,1,7,20,0.0,0.0,0.0,0.0,0.0,0.0,0.0,17,1,16,7.0,0.0,7.0
9311300,4,2,2,2,1,3,3,81,3.0,2.0,1.0,1.0,3.0,0.0,0.0,5,4,1,2.0,2.0,0.0
209199,1,1,0,0,0,1,3,80,0.0,0.0,0.0,0.0,0.0,0.0,0.0,4,1,3,3.0,1.0,2.0
9811336,3,2,1,1,1,2,2,315,0.0,0.0,0.0,0.0,0.0,0.0,0.0,6,3,3,3.0,2.0,1.0
9911344,1,1,0,0,0,1,1,95,0.0,0.0,0.0,0.0,0.0,0.0,0.0,3,1,2,,,
210431,1,1,0,0,0,1,13,31,1.0,1.0,0.0,0.0,0.0,1.0,12.0,43,1,42,23.0,1.0,22.0
9701207,4,4,0,0,0,4,8,51,3.0,3.0,0.0,0.0,0.0,3.0,6.0,6,4,2,2.0,2.0,0.0
206288,6,3,3,4,0,6,42,9,5.0,3.0,2.0,3.0,0.0,5.0,21.0,31,6,25,10.0,2.0,8.0
203185,0,0,0,0,0,0,0,247,0.0,0.0,0.0,0.0,0.0,0.0,0.0,6,0,6,5.0,0.0,5.0
9906255,3,1,2,2,3,0,0,221,3.0,1.0,2.0,2.0,3.0,0.0,0.0,3,3,0,3.0,3.0,0.0
9805354,1,1,0,0,0,1,1,273,1.0,1.0,0.0,0.0,0.0,1.0,1.0,2,1,1,2.0,1.0,1.0
212348,2,2,0,0,0,2,24,37,1.0,1.0,0.0,0.0,0.0,1.0,9.0,54,2,52,21.0,1.0,20.0
9912368,2,1,1,1,1,1,6,44,2.0,1.0,1.0,1.0,1.0,1.0,4.0,11,2,9,3.0,0.0,3.0
205054,1,1,0,0,0,1,1,54,0.0,0.0,0.0,0.0,0.0,0.0,0.0,15,1,14,2.0,1.0,1.0
9909201,1,1,0,0,0,1,3,84,1.0,1.0,0.0,0.0,0.0,1.0,3.0,30,1,29,7.0,0.0,7.0
9708202,3,3,0,0,3,0,0,273,0.0,0.0,0.0,0.0,0.0,0.0,0.0,8,3,5,3.0,0.0,3.0
11116,2,1,1,1,0,2,13,8,1.0,1.0,0.0,0.0,0.0,1.0,3.0,20,2,18,7.0,0.0,7.0
103160,1,1,0,0,0,1,3,26,1.0,1.0,0.0,0.0,0.0,1.0,2.0,6,1,5,3.0,1.0,2.0
211160,1,1,0,0,0,1,10,9,1.0,1.0,0.0,0.0,0.0,1.0,10.0,26,1,25,9.0,0.0,9.0
210316,1,1,0,0,0,1,6,390,1.0,1.0,0.0,0.0,0.0,1.0,6.0,7,1,6,7.0,1.0,6.0
109225,2,2,0,0,1,1,2,153,1.0,1.0,0.0,0.0,0.0,1.0,2.0,5,2,3,3.0,1.0,2.0
208189,4,4,0,0,1,3,25,71,3.0,3.0,0.0,0.0,0.0,3.0,15.0,19,4,15,1.0,1.0,0.0
209297,1,1,0,0,0,1,7,102,1.0,1.0,0.0,0.0,0.0,1.0,5.0,11,1,10,8.0,1.0,7.0
9311302,1,1,0,0,1,0,0,329,0.0,0.0,0.0,0.0,0.0,0.0,0.0,7,1,6,2.0,1.0,1.0
301018,0,0,0,0,0,0,0,27,0.0,0.0,0.0,0.0,0.0,0.0,0.0,25,0,25,10.0,0.0,10.0
9901422,2,2,0,0,1,1,1,77,1.0,1.0,0.0,0.0,0.0,1.0,1.0,10,2,8,3.0,1.0,2.0
9806225,3,2,1,1,0,3,6,44,2.0,1.0,1.0,1.0,0.0,2.0,2.0,5,3,2,3.0,2.0,1.0
3132,3,1,2,2,0,3,3,110,0.0,0.0,0.0,0.0,0.0,0.0,0.0,12,3,9,2.0,0.0,2.0
106285,0,0,0,0,0,0,0,11,0.0,0.0,0.0,0.0,0.0,0.0,0.0,45,0,45,8.0,0.0,8.0
203141,3,3,0,0,1,2,3,328,1.0,1.0,0.0,0.0,0.0,1.0,2.0,7,3,4,3.0,1.0,2.0
9804264,5,4,1,2,3,2,2,139,3.0,3.0,0.0,0.0,3.0,0.0,0.0,6,5,1,2.0,2.0,0.0
9802210,0,0,0,0,0,0,0,42,0.0,0.0,0.0,0.0,0.0,0.0,0.0,10,0,10,2.0,0.0,2.0
101220,2,2,0,0,0,2,4,51,2.0,2.0,0.0,0.0,0.0,2.0,4.0,4,2,2,4.0,2.0,2.0
2056,1,1,0,0,1,0,0,101,1.0,1.0,0.0,0.0,1.0,0.0,0.0,2,1,1,,,
10019,4,4,0,0,3,1,2,347,2.0,2.0,0.0,0.0,1.0,1.0,2.0,7,4,3,4.0,2.0,2.0
9710201,1,1,0,0,0,1,1,595,1.0,1.0,0.0,0.0,1.0,0.0,0.0,4,1,3,1.0,1.0,0.0
201110,0,0,0,0,0,0,0,26,0.0,0.0,0.0,0.0,0.0,0.0,0.0,16,0,16,2.0,0.0,2.0
9701211,1,1,0,0,1,0,0,63,0.0,0.0,0.0,0.0,0.0,0.0,0.0,26,1,25,9.0,0.0,9.0
109020,1,1,0,0,0,1,1,752,1.0,1.0,0.0,0.0,0.0,1.0,1.0,2,1,1,2.0,1.0,1.0
103216,1,1,0,0,0,1,4,44,0.0,0.0,0.0,0.0,0.0,0.0,0.0,6,1,5,1.0,0.0,1.0
9912404,2,1,1,1,1,1,1,220,2.0,1.0,1.0,1.0,1.0,1.0,1.0,5,2,3,2.0,2.0,0.0
112333,0,0,0,0,0,0,0,1218,,,,,,,,2,0,2,,,
9906427,0,0,0,0,0,0,0,128,0.0,0.0,0.0,0.0,0.0,0.0,0.0,6,0,6,4.0,0.0,4.0
4132,0,0,0,0,0,0,0,98,0.0,0.0,0.0,0.0,0.0,0.0,0.0,6,0,6,2.0,0.0,2.0
9708273,0,0,0,0,0,0,0,57,0.0,0.0,0.0,0.0,0.0,0.0,0.0,13,0,13,9.0,0.0,9.0
9609296,3,1,2,3,0,3,4,51,2.0,1.0,1.0,1.0,0.0,2.0,2.0,8,3,5,5.0,3.0,2.0
9406377,4,2,2,2,2,2,2,58,2.0,1.0,1.0,1.0,0.0,2.0,2.0,6,4,2,5.0,4.0,1.0
301049,0,0,0,0,0,0,0,89,0.0,0.0,0.0,0.0,0.0,0.0,0.0,21,0,21,10.0,0.0,10.0
9609366,1,1,0,0,0,1,2,21,1.0,1.0,0.0,0.0,1.0,0.0,0.0,5,1,4,1.0,1.0,0.0
107278,4,3,1,2,1,3,24,201,3.0,3.0,0.0,0.0,0.0,3.0,21.0,18,4,14,12.0,3.0,9.0
1153,0,0,0,0,0,0,0,1579,0.0,0.0,0.0,0.0,0.0,0.0,0.0,1,0,1,1.0,0.0,1.0
2087,1,1,0,0,1,0,0,270,0.0,0.0,0.0,0.0,0.0,0.0,0.0,4,1,3,2.0,0.0,2.0
206294,3,1,2,2,3,0,0,167,3.0,1.0,2.0,2.0,3.0,0.0,0.0,6,3,3,3.0,3.0,0.0
9505206,2,2,0,0,0,2,5,186,1.0,1.0,0.0,0.0,0.0,1.0,2.0,6,2,4,3.0,1.0,2.0
102330,0,0,0,0,0,0,0,72,0.0,0.0,0.0,0.0,0.0,0.0,0.0,7,0,7,4.0,0.0,4.0
9012,2,1,1,1,0,2,2,143,2.0,1.0,1.0,1.0,0.0,2.0,2.0,5,2,3,3.0,2.0,1.0
208165,1,1,0,0,0,1,1,257,0.0,0.0,0.0,0.0,0.0,0.0,0.0,4,1,3,,,
6231,4,1,3,3,3,1,5,2,1.0,1.0,0.0,0.0,0.0,1.0,5.0,19,4,15,3.0,3.0,0.0
204034,3,3,0,0,0,3,8,11,1.0,1.0,0.0,0.0,0.0,1.0,1.0,16,3,13,7.0,1.0,6.0
9910510,2,2,0,0,0,2,4,501,2.0,2.0,0.0,0.0,0.0,2.0,2.0,5,2,3,3.0,2.0,1.0
9801315,2,2,0,0,2,0,0,313,1.0,1.0,0.0,0.0,1.0,0.0,0.0,5,2,3,2.0,1.0,1.0
6176,1,1,0,0,1,0,0,135,1.0,1.0,0.0,0.0,1.0,0.0,0.0,3,1,2,2.0,0.0,2.0
301160,0,0,0,0,0,0,0,29,0.0,0.0,0.0,0.0,0.0,0.0,0.0,10,0,10,5.0,0.0,5.0
9911497,0,0,0,0,0,0,0,1867,,,,,,,,3,0,3,,,
210321,1,1,0,0,1,0,0,268,0.0,0.0,0.0,0.0,0.0,0.0,0.0,2,1,1,,,
9612371,0,0,0,0,0,0,0,748,0.0,0.0,0.0,0.0,0.0,0.0,0.0,6,0,6,1.0,0.0,1.0
9311252,1,1,0,0,0,1,1,10,0.0,0.0,0.0,0.0,0.0,0.0,0.0,12,1,11,1.0,0.0,1.0
8123,3,2,1,1,0,3,10,13,3.0,2.0,1.0,1.0,0.0,3.0,10.0,10,3,7,2.0,2.0,0.0
209349,0,0,0,0,0,0,0,351,0.0,0.0,0.0,0.0,0.0,0.0,0.0,7,0,7,3.0,0.0,3.0
111038,0,0,0,0,0,0,0,384,0.0,0.0,0.0,0.0,0.0,0.0,0.0,9,0,9,3.0,0.0,3.0
101003,1,1,0,0,0,1,26,16,1.0,1.0,0.0,0.0,0.0,1.0,26.0,29,1,28,13.0,1.0,12.0
3322,2,2,0,0,1,1,6,0,1.0,1.0,0.0,0.0,0.0,1.0,3.0,13,2,11,1.0,1.0,0.0
106231,1,1,0,0,1,0,0,8,0.0,0.0,0.0,0.0,0.0,0.0,0.0,12,1,11,1.0,1.0,0.0
9412371,1,1,0,0,1,0,0,535,1.0,1.0,0.0,0.0,1.0,0.0,0.0,1,1,0,1.0,1.0,0.0
9811220,0,0,0,0,0,0,0,9,0.0,0.0,0.0,0.0,0.0,0.0,0.0,11,0,11,1.0,0.0,1.0
206215,3,1,2,3,0,3,13,9,2.0,1.0,1.0,1.0,0.0,2.0,12.0,12,3,9,4.0,2.0,2.0
9708339,1,1,0,0,1,0,0,23,0.0,0.0,0.0,0.0,0.0,0.0,0.0,48,1,47,9.0,0.0,9.0
9910384,1,1,0,0,0,1,10,30,1.0,1.0,0.0,0.0,0.0,1.0,9.0,11,1,10,3.0,1.0,2.0
9805363,4,3,1,1,1,3,12,100,3.0,2.0,1.0,1.0,0.0,3.0,12.0,11,4,7,9.0,3.0,6.0
9407383,0,0,0,0,0,0,0,691,0.0,0.0,0.0,0.0,0.0,0.0,0.0,1,0,1,1.0,0.0,1.0
110295,1,1,0,0,1,0,0,97,0.0,0.0,0.0,0.0,0.0,0.0,0.0,13,1,12,8.0,0.0,8.0
9705434,2,2,0,0,1,1,1,396,1.0,1.0,0.0,0.0,0.0,1.0,1.0,4,2,2,2.0,1.0,1.0
209375,0,0,0,0,0,0,0,31,0.0,0.0,0.0,0.0,0.0,0.0,0.0,6,0,6,5.0,0.0,5.0
105083,0,0,0,0,0,0,0,2,0.0,0.0,0.0,0.0,0.0,0.0,0.0,7,0,7,2.0,0.0,2.0
2179,1,1,0,0,1,0,0,692,1.0,1.0,0.0,0.0,1.0,0.0,0.0,1,1,0,1.0,1.0,0.0
103277,2,1,1,1,2,0,0,18,0.0,0.0,0.0,0.0,0.0,0.0,0.0,5,2,3,1.0,1.0,0.0
206311,1,1,0,0,0,1,11,4,1.0,1.0,0.0,0.0,0.0,1.0,8.0,43,1,42,9.0,0.0,9.0
9709385,0,0,0,0,0,0,0,194,0.0,0.0,0.0,0.0,0.0,0.0,0.0,5,0,5,3.0,0.0,3.0
110342,1,1,0,0,0,1,2,38,1.0,1.0,0.0,0.0,0.0,1.0,2.0,12,1,11,1.0,1.0,0.0
109192,1,1,0,0,1,0,0,295,1.0,1.0,0.0,0.0,1.0,0.0,0.0,2,1,1,2.0,1.0,1.0
7210,3,2,1,1,0,3,4,429,3.0,2.0,1.0,1.0,1.0,2.0,3.0,9,3,6,5.0,3.0,2.0
9806406,1,1,0,0,0,1,1,209,,,,,,,,4,1,3,,,
9910502,2,2,0,0,0,2,6,254,2.0,2.0,0.0,0.0,0.0,2.0,4.0,7,2,5,5.0,2.0,3.0
9510451,0,0,0,0,0,0,0,1214,,,,,,,,3,0,3,,,
9509326,1,1,0,0,1,0,0,693,1.0,1.0,0.0,0.0,1.0,0.0,0.0,1,1,0,1.0,1.0,0.0
9905362,2,1,1,1,1,1,3,91,1.0,1.0,0.0,0.0,1.0,0.0,0.0,5,2,3,1.0,0.0,1.0
210392,2,1,1,1,0,2,7,219,2.0,1.0,1.0,1.0,0.0,2.0,4.0,13,2,11,6.0,2.0,4.0
301233,0,0,0,0,0,0,0,157,0.0,0.0,0.0,0.0,0.0,0.0,0.0,15,0,15,4.0,0.0,4.0
9507324,0,0,0,0,0,0,0,206,0.0,0.0,0.0,0.0,0.0,0.0,0.0,3,0,3,2.0,0.0,2.0
9909426,2,1,1,1,0,2,3,199,2.0,1.0,1.0,1.0,0.0,2.0,2.0,5,2,3,3.0,2.0,1.0
206275,0,0,0,0,0,0,0,103,0.0,0.0,0.0,0.0,0.0,0.0,0.0,5,0,5,3.0,0.0,3.0
9908518,0,0,0,0,0,0,0,128,0.0,0.0,0.0,0.0,0.0,0.0,0.0,9,0,9,5.0,0.0,5.0
9412377,0,0,0,0,0,0,0,1486,,,,,,,,1,0,1,,,
9911538,1,1,0,0,1,0,0,115,1.0,1.0,0.0,0.0,1.0,0.0,0.0,3,1,2,1.0,0.0,1.0
9907568,0,0,0,0,0,0,0,9,0.0,0.0,0.0,0.0,0.0,0.0,0.0,29,0,29,4.0,0.0,4.0
9712525,1,1,0,0,0,1,21,13,1.0,1.0,0.0,0.0,0.0,1.0,15.0,29,1,28,10.0,1.0,9.0
209144,2,1,1,1,0,2,2,37,1.0,1.0,0.0,0.0,0.0,1.0,1.0,13,2,11,1.0,0.0,1.0
9802246,2,2,0,0,1,1,1,271,1.0,1.0,0.0,0.0,1.0,0.0,0.0,9,2,7,1.0,1.0,0.0
108011,0,0,0,0,0,0,0,163,0.0,0.0,0.0,0.0,0.0,0.0,0.0,10,0,10,2.0,0.0,2.0
211454,0,0,0,0,0,0,0,27,0.0,0.0,0.0,0.0,0.0,0.0,0.0,16,0,16,12.0,0.0,12.0
301004,0,0,0,0,0,0,0,185,0.0,0.0,0.0,0.0,0.0,0.0,0.0,5,0,5,2.0,0.0,2.0
207100,0,0,0,0,0,0,0,120,0.0,0.0,0.0,0.0,0.0,0.0,0.0,17,0,17,7.0,0.0,7.0
9130,2,2,0,0,0,2,4,153,1.0,1.0,0.0,0.0,0.0,1.0,2.0,4,2,2,4.0,2.0,2.0
108053,2,2,0,0,2,0,0,113,1.0,1.0,0.0,0.0,1.0,0.0,0.0,6,2,4,2.0,1.0,1.0
211294,0,0,0,0,0,0,0,66,0.0,0.0,0.0,0.0,0.0,0.0,0.0,11,0,11,3.0,0.0,3.0
9602388,0,0,0,0,0,0,0,38,0.0,0.0,0.0,0.0,0.0,0.0,0.0,5,0,5,2.0,0.0,2.0
9504328,1,1,0,0,0,1,1,53,0.0,0.0,0.0,0.0,0.0,0.0,0.0,14,1,13,2.0,1.0,1.0
12237,1,1,0,0,1,0,0,545,0.0,0.0,0.0,0.0,0.0,0.0,0.0,4,1,3,1.0,0.0,1.0
208148,1,1,0,0,1,0,0,297,0.0,0.0,0.0,0.0,0.0,0.0,0.0,8,1,7,6.0,0.0,6.0
104094,0,0,0,0,0,0,0,1265,,,,,,,,2,0,2,,,
105314,1,1,0,0,0,1,1,108,,,,,,,,2,1,1,,,
9908491,1,1,0,0,0,1,10,5,0.0,0.0,0.0,0.0,0.0,0.0,0.0,44,1,43,7.0,0.0,7.0
9007,1,1,0,0,0,1,1,31,,,,,,,,4,1,3,1.0,0.0,1.0
9502242,0,0,0,0,0,0,0,153,0.0,0.0,0.0,0.0,0.0,0.0,0.0,2,0,2,2.0,0.0,2.0
104204,2,2,0,0,0,2,11,195,2.0,2.0,0.0,0.0,0.0,2.0,8.0,9,2,7,6.0,2.0,4.0
9810518,0,0,0,0,0,0,0,550,0.0,0.0,0.0,0.0,0.0,0.0,0.0,2,0,2,1.0,0.0,1.0
9710537,0,0,0,0,0,0,0,1286,,,,,,,,1,0,1,,,
9410379,0,0,0,0,0,0,0,164,0.0,0.0,0.0,0.0,0.0,0.0,0.0,13,0,13,9.0,0.0,9.0
102267,1,1,0,0,0,1,2,197,1.0,1.0,0.0,0.0,0.0,1.0,1.0,10,1,9,1.0,1.0,0.0
9701318,0,0,0,0,0,0,0,18,0.0,0.0,0.0,0.0,0.0,0.0,0.0,7,0,7,5.0,0.0,5.0
9409394,0,0,0,0,0,0,0,75,,,,,,,,7,0,7,,,
9605450,0,0,0,0,0,0,0,77,0.0,0.0,0.0,0.0,0.0,0.0,0.0,3,0,3,3.0,0.0,3.0
12210,2,2,0,0,0,2,6,244,2.0,2.0,0.0,0.0,0.0,2.0,6.0,12,2,10,8.0,1.0,7.0
207028,0,0,0,0,0,0,0,73,0.0,0.0,0.0,0.0,0.0,0.0,0.0,43,0,43,14.0,0.0,14.0
212080,0,0,0,0,0,0,0,205,0.0,0.0,0.0,0.0,0.0,0.0,0.0,2,0,2,,,
1258,1,1,0,0,0,1,6,100,1.0,1.0,0.0,0.0,0.0,1.0,6.0,10,1,9,9.0,1.0,8.0
9707414,0,0,0,0,0,0,0,453,0.0,0.0,0.0,0.0,0.0,0.0,0.0,10,0,10,5.0,0.0,5.0
9801396,1,1,0,0,1,0,0,204,1.0,1.0,0.0,0.0,1.0,0.0,0.0,3,1,2,1.0,1.0,0.0
11084,1,1,0,0,1,0,0,2075,,,,,,,,3,1,2,,,
302016,0,0,0,0,0,0,0,18,0.0,0.0,0.0,0.0,0.0,0.0,0.0,5,0,5,3.0,0.0,3.0
9512323,1,1,0,0,1,0,0,1412,,,,,,,,2,1,1,,,
204214,2,1,1,1,1,1,2,405,2.0,1.0,1.0,1.0,1.0,1.0,1.0,7,2,5,3.0,2.0,1.0
10202,0,0,0,0,0,0,0,73,0.0,0.0,0.0,0.0,0.0,0.0,0.0,9,0,9,,,
12206,0,0,0,0,0,0,0,18,0.0,0.0,0.0,0.0,0.0,0.0,0.0,11,0,11,1.0,0.0,1.0
9410277,0,0,0,0,0,0,0,250,0.0,0.0,0.0,0.0,0.0,0.0,0.0,2,0,2,,,
7124,0,0,0,0,0,0,0,22,0.0,0.0,0.0,0.0,0.0,0.0,0.0,5,0,5,,,
9811468,0,0,0,0,0,0,0,151,0.0,0.0,0.0,0.0,0.0,0.0,0.0,21,0,21,8.0,0.0,8.0
9906556,2,2,0,0,2,0,0,2,,,,,,,,14,2,12,,,
9903521,1,1,0,0,1,0,0,809,,,,,,,,1,1,0,,,
202252,0,0,0,0,0,0,0,206,0.0,0.0,0.0,0.0,0.0,0.0,0.0,8,0,8,1.0,0.0,1.0
209251,0,0,0,0,0,0,0,70,0.0,0.0,0.0,0.0,0.0,0.0,0.0,26,0,26,25.0,0.0,25.0
9501255,0,0,0,0,0,0,0,87,,,,,,,,2,0,2,,,
3145,0,0,0,0,0,0,0,123,,,,,,,,1,0,1,1.0,0.0,1.0
104207,0,0,0,0,0,0,0,24,0.0,0.0,0.0,0.0,0.0,0.0,0.0,10,0,10,6.0,0.0,6.0
9247,1,1,0,0,0,1,1,1880,0.0,0.0,0.0,0.0,0.0,0.0,0.0,5,1,4,,,
211424,0,0,0,0,0,0,0,309,0.0,0.0,0.0,0.0,0.0,0.0,0.0,3,0,3,2.0,0.0,2.0
9811374,0,0,0,0,0,0,0,114,0.0,0.0,0.0,0.0,0.0,0.0,0.0,13,0,13,3.0,0.0,3.0
111459,0,0,0,0,0,0,0,97,0.0,0.0,0.0,0.0,0.0,0.0,0.0,8,0,8,3.0,0.0,3.0
9310277,0,0,0,0,0,0,0,190,,,,,,,,1,0,1,,,
9912427,0,0,0,0,0,0,0,2119,,,,,,,,6,0,6,,,
7045,1,1,0,0,0,1,2,137,1.0,1.0,0.0,0.0,0.0,1.0,1.0,4,1,3,3.0,1.0,2.0
9904487,0,0,0,0,0,0,0,77,0.0,0.0,0.0,0.0,0.0,0.0,0.0,7,0,7,2.0,0.0,2.0
109141,1,1,0,0,0,1,3,51,1.0,1.0,0.0,0.0,0.0,1.0,2.0,9,1,8,3.0,1.0,2.0
9602202,1,1,0,0,1,0,0,488,1.0,1.0,0.0,0.0,1.0,0.0,0.0,1,1,0,1.0,1.0,0.0
210074,1,1,0,0,0,1,3,13,1.0,1.0,0.0,0.0,0.0,1.0,1.0,6,1,5,5.0,1.0,4.0
208082,1,1,0,0,0,1,2,8,0.0,0.0,0.0,0.0,0.0,0.0,0.0,17,1,16,,,
105301,0,0,0,0,0,0,0,713,0.0,0.0,0.0,0.0,0.0,0.0,0.0,1,0,1,1.0,0.0,1.0
210088,0,0,0,0,0,0,0,279,0.0,0.0,0.0,0.0,0.0,0.0,0.0,15,0,15,3.0,0.0,3.0
9910378,0,0,0,0,0,0,0,66,0.0,0.0,0.0,0.0,0.0,0.0,0.0,7,0,7,,,
9307229,0,0,0,0,0,0,0,205,0.0,0.0,0.0,0.0,0.0,0.0,0.0,1,0,1,,,
101177,1,1,0,0,0,1,6,86,1.0,1.0,0.0,0.0,0.0,1.0,2.0,26,1,25,7.0,0.0,7.0
9409247,0,0,0,0,0,0,0,6,0.0,0.0,0.0,0.0,0.0,0.0,0.0,15,0,15,,,
210012,1,1,0,0,0,1,1,350,1.0,1.0,0.0,0.0,0.0,1.0,1.0,4,1,3,1.0,0.0,1.0
9407243,0,0,0,0,0,0,0,1033,,,,,,,,5,0,5,,,
9711445,0,0,0,0,0,0,0,491,0.0,0.0,0.0,0.0,0.0,0.0,0.0,3,0,3,2.0,0.0,2.0
9911282,0,0,0,0,0,0,0,11,0.0,0.0,0.0,0.0,0.0,0.0,0.0,13,0,13,1.0,0.0,1.0
209030,1,1,0,0,0,1,2,33,0.0,0.0,0.0,0.0,0.0,0.0,0.0,24,1,23,7.0,0.0,7.0
210355,0,0,0,0,0,0,0,90,,,,,,,,5,0,5,,,
5252,0,0,0,0,0,0,0,24,0.0,0.0,0.0,0.0,0.0,0.0,0.0,19,0,19,4.0,0.0,4.0
9910362,0,0,0,0,0,0,0,26,0.0,0.0,0.0,0.0,0.0,0.0,0.0,9,0,9,1.0,0.0,1.0
9512422,0,0,0,0,0,0,0,492,0.0,0.0,0.0,0.0,0.0,0.0,0.0,1,0,1,1.0,0.0,1.0
9907287,0,0,0,0,0,0,0,38,0.0,0.0,0.0,0.0,0.0,0.0,0.0,10,0,10,,,
9315,0,0,0,0,0,0,0,1163,,,,,,,,2,0,2,,,
3065,0,0,0,0,0,0,0,173,0.0,0.0,0.0,0.0,0.0,0.0,0.0,8,0,8,3.0,0.0,3.0
204304,0,0,0,0,0,0,0,103,0.0,0.0,0.0,0.0,0.0,0.0,0.0,1,0,1,,,
209218,0,0,0,0,0,0,0,107,0.0,0.0,0.0,0.0,0.0,0.0,0.0,14,0,14,1.0,0.0,1.0
9909280,1,1,0,0,0,1,5,5,,,,,,,,6,1,5,,,
301048,0,0,0,0,0,0,0,189,0.0,0.0,0.0,0.0,0.0,0.0,0.0,3,0,3,1.0,0.0,1.0
9911356,0,0,0,0,0,0,0,29,0.0,0.0,0.0,0.0,0.0,0.0,0.0,12,0,12,3.0,0.0,3.0
9808266,0,0,0,0,0,0,0,362,0.0,0.0,0.0,0.0,0.0,0.0,0.0,5,0,5,2.0,0.0,2.0
9709482,0,0,0,0,0,0,0,15,0.0,0.0,0.0,0.0,0.0,0.0,0.0,13,0,13,6.0,0.0,6.0
210269,0,0,0,0,0,0,0,300,0.0,0.0,0.0,0.0,0.0,0.0,0.0,13,0,13,9.0,0.0,9.0
212189,0,0,0,0,0,0,0,97,0.0,0.0,0.0,0.0,0.0,0.0,0.0,6,0,6,,,
9306202,0,0,0,0,0,0,0,176,0.0,0.0,0.0,0.0,0.0,0.0,0.0,4,0,4,2.0,0.0,2.0
9706381,0,0,0,0,0,0,0,1785,,,,,,,,1,0,1,,,
206257,1,1,0,0,0,1,6,28,1.0,1.0,0.0,0.0,0.0,1.0,4.0,14,1,13,3.0,0.0,3.0
9509295,0,0,0,0,0,0,0,548,0.0,0.0,0.0,0.0,0.0,0.0,0.0,1,0,1,1.0,0.0,1.0
9204,0,0,0,0,0,0,0,153,0.0,0.0,0.0,0.0,0.0,0.0,0.0,3,0,3,3.0,0.0,3.0
9911402,0,0,0,0,0,0,0,175,0.0,0.0,0.0,0.0,0.0,0.0,0.0,11,0,11,9.0,0.0,9.0
212318,0,0,0,0,0,0,0,1,0.0,0.0,0.0,0.0,0.0,0.0,0.0,51,0,51,16.0,0.0,16.0
205152,0,0,0,0,0,0,0,19,0.0,0.0,0.0,0.0,0.0,0.0,0.0,10,0,10,8.0,0.0,8.0
209108,1,1,0,0,1,0,0,127,,,,,,,,1,1,0,,,
9510380,1,1,0,0,1,0,0,266,1.0,1.0,0.0,0.0,1.0,0.0,0.0,2,1,1,2.0,1.0,1.0
11170,0,0,0,0,0,0,0,182,0.0,0.0,0.0,0.0,0.0,0.0,0.0,16,0,16,2.0,0.0,2.0
9410207,0,0,0,0,0,0,0,77,0.0,0.0,0.0,0.0,0.0,0.0,0.0,3,0,3,3.0,0.0,3.0
9709368,0,0,0,0,0,0,0,1416,0.0,0.0,0.0,0.0,0.0,0.0,0.0,3,0,3,1.0,0.0,1.0
205089,1,1,0,0,0,1,10,14,1.0,1.0,0.0,0.0,0.0,1.0,10.0,24,1,23,17.0,1.0,16.0
301190,0,0,0,0,0,0,0,17,0.0,0.0,0.0,0.0,0.0,0.0,0.0,4,0,4,3.0,0.0,3.0
111404,1,1,0,0,0,1,1,45,0.0,0.0,0.0,0.0,0.0,0.0,0.0,21,1,20,11.0,0.0,11.0
302183,0,0,0,0,0,0,0,122,0.0,0.0,0.0,0.0,0.0,0.0,0.0,19,0,19,7.0,0.0,7.0
9809514,1,1,0,0,0,1,2,197,1.0,1.0,0.0,0.0,0.0,1.0,2.0,3,1,2,1.0,1.0,0.0
111248,0,0,0,0,0,0,0,417,0.0,0.0,0.0,0.0,0.0,0.0,0.0,3,0,3,1.0,0.0,1.0
9906217,0,0,0,0,0,0,0,27,,,,,,,,3,0,3,,,
9602244,0,0,0,0,0,0,0,100,0.0,0.0,0.0,0.0,0.0,0.0,0.0,3,0,3,,,
209102,0,0,0,0,0,0,0,11,0.0,0.0,0.0,0.0,0.0,0.0,0.0,4,0,4,3.0,0.0,3.0
101332,1,1,0,0,0,1,22,20,1.0,1.0,0.0,0.0,0.0,1.0,22.0,35,1,34,26.0,1.0,25.0
9508266,0,0,0,0,0,0,0,208,0.0,0.0,0.0,0.0,0.0,0.0,0.0,3,0,3,1.0,0.0,1.0
9509434,0,0,0,0,0,0,0,10,0.0,0.0,0.0,0.0,0.0,0.0,0.0,6,0,6,3.0,0.0,3.0
209212,1,1,0,0,0,1,3,316,1.0,1.0,0.0,0.0,0.0,1.0,3.0,4,1,3,4.0,1.0,3.0
9406223,0,0,0,0,0,0,0,90,0.0,0.0,0.0,0.0,0.0,0.0,0.0,1,0,1,1.0,0.0,1.0
9310237,0,0,0,0,0,0,0,217,0.0,0.0,0.0,0.0,0.0,0.0,0.0,1,0,1,,,
9609485,0,0,0,0,0,0,0,47,0.0,0.0,0.0,0.0,0.0,0.0,0.0,5,0,5,1.0,0.0,1.0
9802263,0,0,0,0,0,0,0,42,0.0,0.0,0.0,0.0,0.0,0.0,0.0,6,0,6,1.0,0.0,1.0
201013,0,0,0,0,0,0,0,197,,,,,,,,2,0,2,,,
12048,0,0,0,0,0,0,0,286,0.0,0.0,0.0,0.0,0.0,0.0,0.0,4,0,4,1.0,0.0,1.0
202108,0,0,0,0,0,0,0,558,0.0,0.0,0.0,0.0,0.0,0.0,0.0,4,0,4,2.0,0.0,2.0
9604201,0,0,0,0,0,0,0,1181,,,,,,,,1,0,1,,,
111111,0,0,0,0,0,0,0,3,0.0,0.0,0.0,0.0,0.0,0.0,0.0,16,0,16,2.0,0.0,2.0
209198,0,0,0,0,0,0,0,259,0.0,0.0,0.0,0.0,0.0,0.0,0.0,1,0,1,,,
202187,0,0,0,0,0,0,0,72,0.0,0.0,0.0,0.0,0.0,0.0,0.0,4,0,4,2.0,0.0,2.0
302253,1,1,0,0,0,1,2,42,1.0,1.0,0.0,0.0,0.0,1.0,2.0,8,1,7,1.0,1.0,0.0
9607282,0,0,0,0,0,0,0,126,,,,,,,,1,0,1,,,
9608337,0,0,0,0,0,0,0,53,0.0,0.0,0.0,0.0,0.0,0.0,0.0,6,0,6,2.0,0.0,2.0
6095,1,1,0,0,1,0,0,400,0.0,0.0,0.0,0.0,0.0,0.0,0.0,8,1,7,3.0,0.0,3.0
11015,0,0,0,0,0,0,0,90,0.0,0.0,0.0,0.0,0.0,0.0,0.0,5,0,5,2.0,0.0,2.0
211176,0,0,0,0,0,0,0,521,0.0,0.0,0.0,0.0,0.0,0.0,0.0,3,0,3,3.0,0.0,3.0
9311377,0,0,0,0,0,0,0,577,0.0,0.0,0.0,0.0,0.0,0.0,0.0,1,0,1,1.0,0.0,1.0
207150,1,1,0,0,0,1,10,87,0.0,0.0,0.0,0.0,0.0,0.0,0.0,16,1,15,4.0,0.0,4.0
9711497,0,0,0,0,0,0,0,27,0.0,0.0,0.0,0.0,0.0,0.0,0.0,13,0,13,2.0,0.0,2.0
206129,0,0,0,0,0,0,0,11,0.0,0.0,0.0,0.0,0.0,0.0,0.0,15,0,15,1.0,0.0,1.0
3193,0,0,0,0,0,0,0,39,0.0,0.0,0.0,0.0,0.0,0.0,0.0,6,0,6,,,
9912252,0,0,0,0,0,0,0,23,0.0,0.0,0.0,0.0,0.0,0.0,0.0,14,0,14,6.0,0.0,6.0
108211,0,0,0,0,0,0,0,445,0.0,0.0,0.0,0.0,0.0,0.0,0.0,3,0,3,1.0,0.0,1.0
9903266,0,0,0,0,0,0,0,9,0.0,0.0,0.0,0.0,0.0,0.0,0.0,38,0,38,20.0,0.0,20.0
9505382,0,0,0,0,0,0,0,17,0.0,0.0,0.0,0.0,0.0,0.0,0.0,16,0,16,3.0,0.0,3.0
210300,0,0,0,0,0,0,0,165,0.0,0.0,0.0,0.0,0.0,0.0,0.0,8,0,8,8.0,0.0,8.0
9708379,0,0,0,0,0,0,0,510,0.0,0.0,0.0,0.0,0.0,0.0,0.0,3,0,3,2.0,0.0,2.0
9807532,0,0,0,0,0,0,0,19,0.0,0.0,0.0,0.0,0.0,0.0,0.0,7,0,7,1.0,0.0,1.0
9236,0,0,0,0,0,0,0,1364,,,,,,,,5,0,5,,,
210141,0,0,0,0,0,0,0,68,0.0,0.0,0.0,0.0,0.0,0.0,0.0,16,0,16,4.0,0.0,4.0
7106,0,0,0,0,0,0,0,309,0.0,0.0,0.0,0.0,0.0,0.0,0.0,2,0,2,1.0,0.0,1.0
211410,0,0,0,0,0,0,0,65,0.0,0.0,0.0,0.0,0.0,0.0,0.0,21,0,21,13.0,0.0,13.0
212185,0,0,0,0,0,0,0,118,0.0,0.0,0.0,0.0,0.0,0.0,0.0,2,0,2,2.0,0.0,2.0
9801393,0,0,0,0,0,0,0,51,0.0,0.0,0.0,0.0,0.0,0.0,0.0,6,0,6,3.0,0.0,3.0
104157,0,0,0,0,0,0,0,1,0.0,0.0,0.0,0.0,0.0,0.0,0.0,8,0,8,2.0,0.0,2.0
210086,0,0,0,0,0,0,0,41,0.0,0.0,0.0,0.0,0.0,0.0,0.0,17,0,17,11.0,0.0,11.0
1331,0,0,0,0,0,0,0,18,0.0,0.0,0.0,0.0,0.0,0.0,0.0,6,0,6,1.0,0.0,1.0
9811324,0,0,0,0,0,0,0,1661,,,,,,,,1,0,1,,,
9512257,0,0,0,0,0,0,0,196,0.0,0.0,0.0,0.0,0.0,0.0,0.0,3,0,3,1.0,0.0,1.0
9912348,0,0,0,0,0,0,0,120,0.0,0.0,0.0,0.0,0.0,0.0,0.0,7,0,7,3.0,0.0,3.0
9604389,0,0,0,0,0,0,0,976,,,,,,,,6,0,6,,,
209291,0,0,0,0,0,0,0,26,0.0,0.0,0.0,0.0,0.0,0.0,0.0,31,0,31,4.0,0.0,4.0
211117,0,0,0,0,0,0,0,1,0.0,0.0,0.0,0.0,0.0,0.0,0.0,15,0,15,3.0,0.0,3.0
12181,0,0,0,0,0,0,0,5,0.0,0.0,0.0,0.0,0.0,0.0,0.0,9,0,9,,,
210203,0,0,0,0,0,0,0,153,0.0,0.0,0.0,0.0,0.0,0.0,0.0,4,0,4,4.0,0.0,4.0
9809299,0,0,0,0,0,0,0,8,0.0,0.0,0.0,0.0,0.0,0.0,0.0,13,0,13,4.0,0.0,4.0
9609332,0,0,0,0,0,0,0,1,0.0,0.0,0.0,0.0,0.0,0.0,0.0,12,0,12,3.0,0.0,3.0
301241,0,0,0,0,0,0,0,109,0.0,0.0,0.0,0.0,0.0,0.0,0.0,48,0,48,38.0,0.0,38.0
204336,0,0,0,0,0,0,0,420,0.0,0.0,0.0,0.0,0.0,0.0,0.0,2,0,2,,,
210138,0,0,0,0,0,0,0,0,0.0,0.0,0.0,0.0,0.0,0.0,0.0,14,0,14,,,
111088,0,0,0,0,0,0,0,35,0.0,0.0,0.0,0.0,0.0,0.0,0.0,9,0,9,8.0,0.0,8.0
9609446,0,0,0,0,0,0,0,150,0.0,0.0,0.0,0.0,0.0,0.0,0.0,6,0,6,2.0,0.0,2.0
9911445,0,0,0,0,0,0,0,866,0.0,0.0,0.0,0.0,0.0,0.0,0.0,2,0,2,,,
10242,0,0,0,0,0,0,0,745,0.0,0.0,0.0,0.0,0.0,0.0,0.0,1,0,1,1.0,0.0,1.0
9809516,0,0,0,0,0,0,0,22,0.0,0.0,0.0,0.0,0.0,0.0,0.0,14,0,14,7.0,0.0,7.0
9508273,0,0,0,0,0,0,0,256,,,,,,,,1,0,1,,,
106182,0,0,0,0,0,0,0,40,0.0,0.0,0.0,0.0,0.0,0.0,0.0,9,0,9,6.0,0.0,6.0
9610453,1,1,0,0,1,0,0,1731,,,,,,,,2,1,1,,,
9908432,13,9,4,6,6,7,43,6,2.0,1.0,1.0,1.0,0.0,2.0,16.0,74,13,61,12.0,0.0,12.0
8255,85,7,78,367,7,78,332,7,27.0,3.0,24.0,100.0,2.0,25.0,63.0,102,85,17,14.0,13.0,1.0
9802394,126,13,113,563,56,70,235,1,43.0,5.0,38.0,238.0,30.0,13.0,13.0,145,126,19,22.0,15.0,7.0
9303270,228,35,193,1399,228,0,0,75,39.0,10.0,29.0,132.0,39.0,0.0,0.0,228,228,0,31.0,31.0,0.0
9406203,49,8,41,160,0,49,96,7,26.0,5.0,21.0,81.0,0.0,26.0,44.0,54,49,5,11.0,10.0,1.0
9510323,3,2,1,1,0,3,20,34,1.0,1.0,0.0,0.0,1.0,0.0,0.0,18,3,15,2.0,1.0,1.0
9805303,169,29,140,666,16,153,1105,7,51.0,8.0,43.0,222.0,1.0,50.0,488.0,217,169,48,46.0,28.0,18.0
9701278,34,5,29,129,7,27,147,34,14.0,1.0,13.0,49.0,0.0,14.0,98.0,46,34,12,21.0,11.0,10.0
105084,22,6,16,63,2,20,62,2,10.0,1.0,9.0,29.0,0.0,10.0,17.0,34,22,12,14.0,11.0,3.0
9209291,67,15,52,154,67,0,0,74,27.0,2.0,25.0,86.0,27.0,0.0,0.0,67,67,0,17.0,17.0,0.0
203079,35,19,16,19,9,26,181,26,5.0,5.0,0.0,0.0,0.0,5.0,65.0,181,35,146,29.0,3.0,26.0
9501362,40,10,30,128,24,16,29,114,16.0,3.0,13.0,45.0,3.0,13.0,24.0,44,40,4,18.0,15.0,3.0
9805244,26,6,20,69,5,21,110,4,11.0,2.0,9.0,19.0,1.0,10.0,19.0,45,26,19,10.0,7.0,3.0
9611239,44,27,17,24,33,11,33,61,0.0,0.0,0.0,0.0,0.0,0.0,0.0,89,44,45,3.0,3.0,0.0
9906218,44,3,41,165,5,39,164,4,24.0,1.0,23.0,89.0,0.0,24.0,90.0,61,44,17,21.0,11.0,10.0
104105,3,2,1,1,0,3,6,33,3.0,2.0,1.0,1.0,0.0,3.0,6.0,11,3,8,2.0,0.0,2.0
9409312,2,2,0,0,0,2,5,43,1.0,1.0,0.0,0.0,0.0,1.0,1.0,5,2,3,1.0,1.0,0.0
9609279,127,23,104,353,33,94,267,48,34.0,4.0,30.0,92.0,6.0,28.0,92.0,148,127,21,18.0,12.0,6.0
9706545,41,8,33,79,2,39,144,19,11.0,2.0,9.0,27.0,0.0,11.0,39.0,60,41,19,8.0,4.0,4.0
9806401,14,8,6,10,1,13,102,33,4.0,4.0,0.0,0.0,0.0,4.0,36.0,48,14,34,15.0,3.0,12.0
9906268,19,5,14,42,1,18,110,48,13.0,3.0,10.0,29.0,1.0,12.0,49.0,48,19,29,14.0,8.0,6.0
208014,5,3,2,4,0,5,61,4,1.0,1.0,0.0,0.0,0.0,1.0,5.0,47,5,42,13.0,2.0,11.0
101123,3,3,0,0,0,3,25,26,3.0,3.0,0.0,0.0,0.0,3.0,21.0,20,3,17,6.0,2.0,4.0
9309293,88,22,66,248,23,65,151,10,43.0,14.0,29.0,117.0,10.0,33.0,86.0,93,88,5,19.0,15.0,4.0
9702381,45,18,27,79,5,40,133,26,18.0,6.0,12.0,34.0,1.0,17.0,79.0,99,45,54,16.0,9.0,7.0
9812377,24,6,18,53,0,24,116,26,13.0,4.0,9.0,23.0,0.0,13.0,78.0,45,24,21,21.0,11.0,10.0
9902308,62,5,57,285,14,48,125,32,28.0,1.0,27.0,182.0,0.0,28.0,68.0,70,62,8,28.0,25.0,3.0
9905311,72,7,65,369,1,71,676,2,41.0,4.0,37.0,226.0,0.0,41.0,494.0,104,72,32,40.0,22.0,18.0
12109,9,3,6,15,2,7,12,4,1.0,1.0,0.0,0.0,0.0,1.0,2.0,19,9,10,4.0,2.0,2.0
9807423,116,4,112,779,7,109,655,4,66.0,1.0,65.0,562.0,0.0,66.0,440.0,134,116,18,58.0,47.0,11.0
9912459,8,7,1,2,3,5,9,4,0.0,0.0,0.0,0.0,0.0,0.0,0.0,43,8,35,4.0,0.0,4.0
106029,39,18,21,44,5,34,65,121,6.0,1.0,5.0,10.0,0.0,6.0,6.0,65,39,26,4.0,3.0,1.0
202233,42,20,22,50,6,36,223,4,11.0,3.0,8.0,16.0,0.0,11.0,72.0,87,42,45,8.0,4.0,4.0
9502336,258,88,170,477,184,74,85,16,26.0,9.0,17.0,50.0,3.0,23.0,27.0,262,258,4,14.0,13.0,1.0
9503228,31,7,24,65,5,26,43,63,18.0,2.0,16.0,40.0,4.0,14.0,18.0,40,31,9,9.0,8.0,1.0
9502370,7,3,4,6,4,3,3,149,4.0,2.0,2.0,3.0,4.0,0.0,0.0,8,7,1,3.0,3.0,0.0
9412201,50,19,31,122,21,29,63,102,23.0,7.0,16.0,83.0,4.0,19.0,42.0,53,50,3,20.0,17.0,3.0
9505350,66,4,62,227,8,58,207,61,28.0,4.0,24.0,76.0,0.0,28.0,86.0,79,66,13,24.0,20.0,4.0
9406204,61,6,55,210,41,20,20,71,34.0,2.0,32.0,155.0,15.0,19.0,19.0,62,61,1,25.0,24.0,1.0
9507453,149,24,125,754,50,99,196,73,59.0,3.0,56.0,458.0,38.0,21.0,21.0,161,149,12,35.0,34.0,1.0
9308325,101,26,75,352,101,0,0,99,32.0,3.0,29.0,130.0,32.0,0.0,0.0,101,101,0,19.0,19.0,0.0
9407324,4,2,2,2,0,4,10,36,1.0,1.0,0.0,0.0,0.0,1.0,2.0,8,4,4,,,
9408234,56,12,44,177,32,24,54,0,10.0,5.0,5.0,11.0,3.0,7.0,18.0,65,56,9,10.0,10.0,0.0
6235,15,10,5,5,4,11,84,0,1.0,1.0,0.0,0.0,0.0,1.0,13.0,102,15,87,26.0,0.0,26.0
9711415,33,4,29,168,29,4,7,0,23.0,3.0,20.0,129.0,20.0,3.0,3.0,36,33,3,19.0,19.0,0.0
9810505,19,7,12,24,1,18,81,0,11.0,2.0,9.0,16.0,0.0,11.0,38.0,33,19,14,15.0,9.0,6.0
9802328,13,4,9,15,4,9,21,3,0.0,0.0,0.0,0.0,0.0,0.0,0.0,24,13,11,4.0,0.0,4.0
9611465,39,21,18,31,19,20,88,0,9.0,2.0,7.0,15.0,9.0,0.0,0.0,86,39,47,7.0,1.0,6.0
9207213,69,38,31,104,68,1,1,0,21.0,5.0,16.0,41.0,21.0,0.0,0.0,70,69,1,10.0,10.0,0.0
9808269,34,4,30,118,3,31,104,3,21.0,1.0,20.0,65.0,1.0,20.0,41.0,54,34,20,5.0,0.0,5.0
9906368,12,5,7,15,0,12,104,3,10.0,4.0,6.0,14.0,0.0,10.0,94.0,38,12,26,3.0,1.0,2.0
9810501,31,5,26,118,2,29,59,0,13.0,2.0,11.0,33.0,0.0,13.0,34.0,38,31,7,15.0,14.0,1.0
9710371,43,18,25,75,18,25,57,3,6.0,2.0,4.0,7.0,0.0,6.0,12.0,58,43,15,8.0,6.0,2.0
9708301,12,5,7,11,0,12,29,0,1.0,1.0,0.0,0.0,1.0,0.0,0.0,18,12,6,3.0,2.0,1.0
9809531,56,9,47,211,15,41,124,0,21.0,1.0,20.0,72.0,7.0,14.0,30.0,72,56,16,18.0,16.0,2.0
9811282,22,1,21,82,6,16,41,3,2.0,1.0,1.0,1.0,0.0,2.0,4.0,36,22,14,14.0,12.0,2.0
9909501,20,4,16,63,7,13,45,0,13.0,2.0,11.0,36.0,6.0,7.0,7.0,25,20,5,15.0,10.0,5.0
9311227,16,9,7,11,4,12,32,10,4.0,3.0,1.0,2.0,0.0,4.0,10.0,25,16,9,6.0,4.0,2.0
9707542,18,5,13,23,0,18,47,288,5.0,2.0,3.0,5.0,0.0,5.0,12.0,23,18,5,11.0,7.0,4.0
9810493,4,3,1,1,0,4,27,0,0.0,0.0,0.0,0.0,0.0,0.0,0.0,36,4,32,6.0,1.0,5.0
9702421,42,12,30,147,15,27,58,12,18.0,1.0,17.0,80.0,18.0,0.0,0.0,53,42,11,8.0,6.0,2.0
9306255,3,2,1,1,3,0,0,81,1.0,1.0,0.0,0.0,1.0,0.0,0.0,3,3,0,2.0,2.0,0.0
9612400,6,5,1,1,4,2,6,81,2.0,1.0,1.0,1.0,0.0,2.0,6.0,13,6,7,5.0,2.0,3.0
9606260,81,3,78,466,21,60,161,21,44.0,2.0,42.0,236.0,3.0,41.0,124.0,88,81,7,24.0,20.0,4.0
9311360,9,2,7,14,3,6,16,256,5.0,2.0,3.0,3.0,2.0,3.0,8.0,16,9,7,10.0,6.0,4.0
9310248,14,5,9,31,13,1,1,46,10.0,1.0,9.0,27.0,10.0,0.0,0.0,16,14,2,8.0,8.0,0.0
9411373,1,1,0,0,0,1,2,0,0.0,0.0,0.0,0.0,0.0,0.0,0.0,12,1,11,5.0,0.0,5.0
9612237,26,6,20,56,2,24,143,71,16.0,2.0,14.0,43.0,0.0,16.0,119.0,49,26,23,29.0,12.0,17.0
9605224,41,4,37,116,11,30,133,3,19.0,1.0,18.0,63.0,4.0,15.0,61.0,55,41,14,20.0,14.0,6.0
9401337,14,6,8,21,6,8,8,37,5.0,1.0,4.0,8.0,5.0,0.0,0.0,15,14,1,5.0,5.0,0.0
9506325,26,3,23,96,4,22,27,42,13.0,2.0,11.0,44.0,1.0,12.0,12.0,28,26,2,12.0,11.0,1.0
9406224,88,22,66,218,65,23,29,10,15.0,2.0,13.0,53.0,15.0,0.0,0.0,90,88,2,9.0,9.0,0.0
9302317,59,16,43,169,48,11,11,18,19.0,4.0,15.0,62.0,19.0,0.0,0.0,60,59,1,11.0,11.0,0.0
9511473,36,9,27,105,5,31,121,12,9.0,6.0,3.0,7.0,0.0,9.0,38.0,51,36,15,7.0,6.0,1.0
9704214,27,6,21,61,9,18,18,36,20.0,3.0,17.0,51.0,5.0,15.0,15.0,31,27,4,17.0,16.0,1.0
9302202,63,11,52,279,31,32,32,69,35.0,5.0,30.0,182.0,13.0,22.0,22.0,64,63,1,23.0,22.0,1.0
9503418,30,5,25,57,5,25,50,9,9.0,2.0,7.0,17.0,2.0,7.0,10.0,42,30,12,5.0,5.0,0.0
1293,10,3,7,10,2,8,30,34,1.0,1.0,0.0,0.0,0.0,1.0,11.0,38,10,28,3.0,1.0,2.0
9911392,22,1,21,69,0,22,257,34,19.0,1.0,18.0,62.0,0.0,19.0,227.0,64,22,42,32.0,13.0,19.0
9705304,99,6,93,519,6,93,203,1,57.0,1.0,56.0,320.0,2.0,55.0,88.0,107,99,8,37.0,35.0,2.0
103256,49,8,41,153,0,49,449,23,22.0,7.0,15.0,51.0,0.0,22.0,269.0,84,49,35,28.0,17.0,11.0
102287,7,1,6,8,0,7,30,34,3.0,2.0,1.0,1.0,0.0,3.0,17.0,22,7,15,5.0,4.0,1.0
9810482,34,2,32,118,0,34,427,1,28.0,2.0,26.0,108.0,0.0,28.0,380.0,61,34,27,40.0,22.0,18.0
9405345,43,12,31,142,8,35,43,5,23.0,2.0,21.0,122.0,1.0,22.0,28.0,46,43,3,12.0,12.0,0.0
9611229,25,8,17,52,2,23,103,5,16.0,3.0,13.0,41.0,0.0,16.0,67.0,38,25,13,17.0,11.0,6.0
9705307,56,13,43,180,5,51,329,5,29.0,5.0,24.0,126.0,0.0,29.0,235.0,77,56,21,25.0,19.0,6.0
9305271,5,5,0,0,5,0,0,312,3.0,3.0,0.0,0.0,3.0,0.0,0.0,5,5,0,2.0,2.0,0.0
9311293,35,5,30,95,35,0,0,231,10.0,2.0,8.0,20.0,10.0,0.0,0.0,36,35,1,9.0,9.0,0.0
9608357,8,3,5,10,1,7,21,69,0.0,0.0,0.0,0.0,0.0,0.0,0.0,12,8,4,4.0,0.0,4.0
9601236,20,4,16,34,12,8,16,83,7.0,2.0,5.0,14.0,7.0,0.0,0.0,23,20,3,5.0,3.0,2.0
101089,14,6,8,15,0,14,40,1,4.0,2.0,2.0,3.0,4.0,0.0,0.0,28,14,14,4.0,4.0,0.0
9609341,34,7,27,95,1,33,169,6,23.0,5.0,18.0,62.0,0.0,23.0,135.0,48,34,14,13.0,12.0,1.0
9806358,40,12,28,83,11,29,61,9,18.0,11.0,7.0,10.0,0.0,18.0,38.0,46,40,6,15.0,13.0,2.0
9908232,17,3,14,54,0,17,151,34,16.0,3.0,13.0,52.0,0.0,16.0,141.0,33,17,16,23.0,11.0,12.0
9205221,85,17,68,265,85,0,0,1,17.0,3.0,14.0,42.0,17.0,0.0,0.0,85,85,0,6.0,6.0,0.0
9402348,14,4,10,30,14,0,0,1,1.0,1.0,0.0,0.0,1.0,0.0,0.0,20,14,6,2.0,1.0,1.0
9908255,43,1,42,189,0,43,258,32,24.0,1.0,23.0,86.0,0.0,24.0,92.0,77,43,34,17.0,13.0,4.0
9505240,23,9,14,20,22,1,3,4,4.0,2.0,2.0,3.0,4.0,0.0,0.0,28,23,5,3.0,3.0,0.0
9811234,15,9,6,8,8,7,9,210,2.0,2.0,0.0,0.0,2.0,0.0,0.0,21,15,6,2.0,2.0,0.0
9707377,26,10,16,26,6,20,38,31,12.0,7.0,5.0,5.0,1.0,11.0,11.0,34,26,8,4.0,4.0,0.0
9602235,65,26,39,81,31,34,90,40,5.0,4.0,1.0,1.0,0.0,5.0,31.0,99,65,34,8.0,8.0,0.0
9802401,20,4,16,40,1,19,112,7,5.0,1.0,4.0,5.0,0.0,5.0,47.0,58,20,38,19.0,1.0,18.0
9312272,240,43,197,1003,61,179,663,18,45.0,5.0,40.0,228.0,4.0,41.0,84.0,270,240,30,21.0,16.0,5.0
9812272,14,7,7,14,1,13,85,7,8.0,4.0,4.0,8.0,0.0,8.0,36.0,36,14,22,13.0,4.0,9.0
9211309,122,7,115,836,122,0,0,2,55.0,1.0,54.0,428.0,55.0,0.0,0.0,122,122,0,22.0,22.0,0.0
9303317,86,11,75,858,17,69,132,15,68.0,1.0,67.0,801.0,12.0,56.0,109.0,91,86,5,53.0,49.0,4.0
9504427,32,4,28,142,4,28,141,15,25.0,2.0,23.0,131.0,3.0,22.0,127.0,42,32,10,27.0,19.0,8.0
9509213,35,10,25,72,6,29,72,76,23.0,3.0,20.0,59.0,1.0,22.0,62.0,42,35,7,22.0,18.0,4.0
9310245,19,6,13,21,5,14,14,40,14.0,2.0,12.0,18.0,1.0,13.0,13.0,20,19,1,6.0,6.0,0.0
9712434,28,15,13,18,7,21,96,40,16.0,8.0,8.0,9.0,0.0,16.0,89.0,43,28,15,20.0,10.0,10.0
9710333,22,5,17,36,7,15,29,19,0.0,0.0,0.0,0.0,0.0,0.0,0.0,29,22,7,1.0,0.0,1.0
9504295,20,3,17,53,2,18,34,62,15.0,3.0,12.0,36.0,0.0,15.0,22.0,24,20,4,15.0,13.0,2.0
9311303,11,6,5,11,11,0,0,151,6.0,3.0,3.0,5.0,6.0,0.0,0.0,11,11,0,2.0,2.0,0.0
9711391,124,14,110,791,32,92,251,24,57.0,4.0,53.0,516.0,10.0,47.0,135.0,139,124,15,46.0,41.0,5.0
9501254,17,9,8,14,1,16,24,106,4.0,4.0,0.0,0.0,0.0,4.0,4.0,22,17,5,2.0,2.0,0.0
9602287,90,9,81,497,82,8,8,16,45.0,1.0,44.0,320.0,41.0,4.0,4.0,91,90,1,25.0,25.0,0.0
9610276,75,28,47,147,43,32,54,16,11.0,4.0,7.0,20.0,3.0,8.0,9.0,94,75,19,8.0,8.0,0.0
9403363,14,9,5,7,11,3,3,16,3.0,3.0,0.0,0.0,3.0,0.0,0.0,15,14,1,4.0,4.0,0.0
9811465,5,2,3,3,0,5,41,151,2.0,1.0,1.0,1.0,0.0,2.0,20.0,22,5,17,13.0,2.0,11.0
9404338,20,8,12,30,20,0,0,30,8.0,5.0,3.0,6.0,8.0,0.0,0.0,21,20,1,8.0,8.0,0.0
9705295,24,6,18,63,0,24,82,151,15.0,4.0,11.0,37.0,0.0,15.0,58.0,33,24,9,19.0,13.0,6.0
9609468,13,4,9,15,6,7,16,30,4.0,3.0,1.0,2.0,2.0,2.0,4.0,17,13,4,5.0,3.0,2.0
9312228,36,10,26,70,36,0,0,86,10.0,1.0,9.0,20.0,10.0,0.0,0.0,36,36,0,7.0,7.0,0.0
9403291,12,4,8,14,2,10,22,35,1.0,1.0,0.0,0.0,0.0,1.0,3.0,22,12,10,6.0,1.0,5.0
9611222,4,4,0,0,4,0,0,480,1.0,1.0,0.0,0.0,1.0,0.0,0.0,4,4,0,1.0,1.0,0.0
9711287,85,8,77,694,22,63,149,24,66.0,5.0,61.0,608.0,14.0,52.0,109.0,95,85,10,31.0,29.0,2.0
9904494,9,6,3,3,3,6,8,84,5.0,3.0,2.0,2.0,0.0,5.0,6.0,18,9,9,3.0,3.0,0.0
9802379,65,2,63,496,1,64,176,24,53.0,1.0,52.0,425.0,1.0,52.0,128.0,71,65,6,36.0,32.0,4.0
9212289,13,6,7,17,13,0,0,6,2.0,1.0,1.0,1.0,2.0,0.0,0.0,13,13,0,2.0,2.0,0.0
9211249,35,6,29,146,35,0,0,69,22.0,3.0,19.0,94.0,22.0,0.0,0.0,35,35,0,17.0,17.0,0.0
9903239,13,6,7,15,0,13,141,2,11.0,4.0,7.0,14.0,0.0,11.0,138.0,37,13,24,18.0,4.0,14.0
9503411,74,7,67,361,26,48,64,8,24.0,1.0,23.0,98.0,5.0,19.0,25.0,79,74,5,18.0,17.0,1.0
9906446,32,5,27,66,3,29,182,55,15.0,4.0,11.0,25.0,0.0,15.0,113.0,55,32,23,20.0,10.0,10.0
9508406,46,3,43,169,3,43,177,38,27.0,1.0,26.0,118.0,1.0,26.0,111.0,57,46,11,30.0,23.0,7.0
9171,9,5,4,5,1,8,27,40,4.0,2.0,2.0,2.0,1.0,3.0,3.0,30,9,21,7.0,1.0,6.0
9807396,9,2,7,17,0,9,41,45,7.0,2.0,5.0,12.0,0.0,7.0,31.0,16,9,7,12.0,7.0,5.0
9204210,28,10,18,57,28,0,0,22,12.0,4.0,8.0,21.0,12.0,0.0,0.0,28,28,0,3.0,3.0,0.0
9209252,12,7,5,7,12,0,0,418,6.0,3.0,3.0,4.0,6.0,0.0,0.0,12,12,0,4.0,4.0,0.0
9710436,53,4,49,228,1,52,328,22,33.0,1.0,32.0,159.0,1.0,32.0,183.0,74,53,21,35.0,25.0,10.0
9909516,9,2,7,13,1,8,14,38,7.0,2.0,5.0,10.0,7.0,0.0,0.0,15,9,6,6.0,5.0,1.0
9609229,12,7,5,5,10,2,2,271,5.0,3.0,2.0,2.0,5.0,0.0,0.0,17,12,5,4.0,4.0,0.0
9502278,19,12,7,11,19,0,0,156,14.0,9.0,5.0,9.0,14.0,0.0,0.0,19,19,0,9.0,9.0,0.0
9909482,19,6,13,51,0,19,108,21,17.0,6.0,11.0,47.0,0.0,17.0,100.0,35,19,16,25.0,13.0,12.0
9708313,6,2,4,5,1,5,32,21,4.0,2.0,2.0,3.0,0.0,4.0,30.0,17,6,11,14.0,4.0,10.0
9912439,31,8,23,100,7,24,54,66,18.0,2.0,16.0,71.0,6.0,12.0,17.0,42,31,11,19.0,17.0,2.0
9704258,39,4,35,171,10,29,49,43,14.0,2.0,12.0,34.0,8.0,6.0,6.0,45,39,6,7.0,5.0,2.0
9810409,49,5,44,340,0,49,310,19,35.0,2.0,33.0,289.0,0.0,35.0,233.0,73,49,24,30.0,26.0,4.0
9907523,28,2,26,164,1,27,30,19,27.0,2.0,25.0,159.0,1.0,26.0,28.0,35,28,7,22.0,21.0,1.0
9605269,7,3,4,4,3,4,8,62,1.0,1.0,0.0,0.0,1.0,0.0,0.0,10,7,3,2.0,1.0,1.0
9310321,13,9,4,6,13,0,0,101,3.0,3.0,0.0,0.0,3.0,0.0,0.0,13,13,0,2.0,2.0,0.0
1104,31,4,27,118,0,31,589,20,29.0,4.0,25.0,112.0,0.0,29.0,555.0,89,31,58,63.0,22.0,41.0
9512365,20,5,15,35,7,13,23,20,3.0,2.0,1.0,1.0,0.0,3.0,3.0,28,20,8,4.0,3.0,1.0
9704358,11,5,6,16,0,11,63,124,7.0,2.0,5.0,15.0,0.0,7.0,50.0,35,11,24,27.0,7.0,20.0
9303205,137,18,119,1161,117,20,20,17,87.0,6.0,81.0,916.0,71.0,16.0,16.0,138,137,1,39.0,39.0,0.0
9411303,80,4,76,536,22,58,204,17,63.0,3.0,60.0,476.0,14.0,49.0,168.0,88,80,8,40.0,36.0,4.0
2148,5,2,3,3,0,5,16,20,3.0,1.0,2.0,2.0,0.0,3.0,5.0,19,5,14,6.0,2.0,4.0
9912419,5,3,2,3,0,5,27,20,5.0,3.0,2.0,3.0,0.0,5.0,27.0,11,5,6,,,
9208233,31,7,24,58,31,0,0,123,13.0,5.0,8.0,24.0,13.0,0.0,0.0,31,31,0,8.0,8.0,0.0
108260,13,4,9,25,0,13,72,20,11.0,4.0,7.0,20.0,0.0,11.0,68.0,23,13,10,9.0,8.0,1.0
205106,12,9,3,3,0,12,121,2,2.0,1.0,1.0,1.0,0.0,2.0,20.0,89,12,77,5.0,0.0,5.0
9508242,3,3,0,0,0,3,8,6,1.0,1.0,0.0,0.0,0.0,1.0,3.0,14,3,11,7.0,1.0,6.0
9409358,4,3,1,1,3,1,2,6,2.0,1.0,1.0,1.0,2.0,0.0,0.0,8,4,4,1.0,1.0,0.0
9908309,70,5,65,263,18,52,200,18,12.0,2.0,10.0,23.0,4.0,8.0,57.0,92,70,22,20.0,8.0,12.0
9511289,27,4,23,53,11,16,21,4,11.0,1.0,10.0,29.0,11.0,0.0,0.0,37,27,10,2.0,1.0,1.0
9810535,63,10,53,232,1,62,297,2,28.0,1.0,27.0,122.0,0.0,28.0,186.0,80,63,17,5.0,4.0,1.0
9806413,37,4,33,147,1,36,125,32,25.0,1.0,24.0,99.0,1.0,24.0,71.0,48,37,11,26.0,21.0,5.0
9804237,31,3,28,117,0,31,194,73,29.0,1.0,28.0,114.0,0.0,29.0,173.0,55,31,24,29.0,20.0,9.0
9807269,31,7,24,87,1,30,153,73,27.0,5.0,22.0,84.0,0.0,27.0,123.0,43,31,12,28.0,22.0,6.0
9801448,15,7,8,9,0,15,39,15,3.0,3.0,0.0,0.0,1.0,2.0,5.0,37,15,22,4.0,1.0,3.0
9404207,29,8,21,61,26,3,3,74,11.0,2.0,9.0,27.0,11.0,0.0,0.0,30,29,1,12.0,12.0,0.0
9406385,77,20,57,257,19,58,58,16,30.0,6.0,24.0,101.0,2.0,28.0,28.0,78,77,1,10.0,9.0,1.0
9501382,29,4,25,98,24,5,5,5,14.0,1.0,13.0,55.0,14.0,0.0,0.0,30,29,1,14.0,14.0,0.0
9509424,29,4,25,75,18,11,11,61,11.0,1.0,10.0,29.0,3.0,8.0,8.0,30,29,1,3.0,3.0,0.0
9611362,28,7,21,53,6,22,45,87,15.0,3.0,12.0,30.0,3.0,12.0,24.0,33,28,5,10.0,6.0,4.0
9603410,25,8,17,45,22,3,4,92,7.0,4.0,3.0,7.0,4.0,3.0,3.0,27,25,2,3.0,3.0,0.0
9907482,17,5,12,30,0,17,93,4,13.0,3.0,10.0,22.0,0.0,13.0,56.0,27,17,10,18.0,12.0,6.0
9501341,71,4,67,626,67,4,4,70,58.0,1.0,57.0,602.0,58.0,0.0,0.0,73,71,2,44.0,44.0,0.0
9612357,25,6,19,60,9,16,31,107,11.0,3.0,8.0,33.0,11.0,0.0,0.0,31,25,6,11.0,11.0,0.0
9903487,2,2,0,0,1,1,1,159,0.0,0.0,0.0,0.0,0.0,0.0,0.0,5,2,3,1.0,0.0,1.0
9703317,60,8,52,180,13,47,190,41,26.0,3.0,23.0,75.0,1.0,25.0,94.0,88,60,28,23.0,20.0,3.0
9601365,33,3,30,97,3,30,243,60,10.0,1.0,9.0,30.0,0.0,10.0,97.0,66,33,33,26.0,10.0,16.0
9404362,16,4,12,32,13,3,3,41,4.0,3.0,1.0,1.0,1.0,3.0,3.0,17,16,1,5.0,4.0,1.0
9707334,20,2,18,37,4,16,58,36,10.0,1.0,9.0,13.0,0.0,10.0,35.0,30,20,10,4.0,4.0,0.0
9412301,31,8,23,77,3,28,28,84,21.0,3.0,18.0,65.0,2.0,19.0,19.0,32,31,1,15.0,14.0,1.0
9505238,23,12,11,27,11,12,93,6,8.0,4.0,4.0,12.0,0.0,8.0,73.0,46,23,23,23.0,7.0,16.0
9707402,9,5,4,8,4,5,5,10,6.0,3.0,3.0,4.0,6.0,0.0,0.0,11,9,2,6.0,5.0,1.0
9805452,9,5,4,5,2,7,18,78,3.0,2.0,1.0,1.0,0.0,3.0,8.0,16,9,7,6.0,3.0,3.0
107154,16,3,13,32,0,16,127,23,14.0,2.0,12.0,29.0,0.0,14.0,103.0,47,16,31,20.0,8.0,12.0
9508356,5,4,1,1,1,4,4,316,3.0,2.0,1.0,1.0,0.0,3.0,3.0,8,5,3,4.0,3.0,1.0
9609430,10,6,4,4,2,8,80,1,2.0,2.0,0.0,0.0,0.0,2.0,56.0,42,10,32,26.0,2.0,24.0
9302230,6,2,4,11,6,0,0,93,4.0,2.0,2.0,4.0,4.0,0.0,0.0,6,6,0,1.0,1.0,0.0
9810291,56,11,45,282,3,53,219,55,24.0,2.0,22.0,118.0,0.0,24.0,96.0,88,56,32,25.0,18.0,7.0
9904211,124,10,114,753,8,116,547,2,51.0,3.0,48.0,360.0,16.0,35.0,35.0,137,124,13,47.0,44.0,3.0
2141,19,5,14,47,2,17,118,55,13.0,4.0,9.0,30.0,0.0,13.0,82.0,33,19,14,18.0,10.0,8.0
9904335,9,5,4,7,0,9,66,12,5.0,2.0,3.0,5.0,0.0,5.0,30.0,27,9,18,3.0,2.0,1.0
9602385,52,13,39,137,44,8,8,116,19.0,1.0,18.0,65.0,14.0,5.0,5.0,53,52,1,17.0,17.0,0.0
9801415,19,6,13,35,3,16,65,31,9.0,2.0,7.0,24.0,0.0,9.0,51.0,36,19,17,14.0,8.0,6.0
4043,83,7,76,411,7,76,570,18,54.0,4.0,50.0,259.0,0.0,54.0,371.0,129,83,46,34.0,24.0,10.0
9912460,19,1,18,108,0,19,78,23,17.0,1.0,16.0,92.0,0.0,17.0,65.0,33,19,14,20.0,16.0,4.0
102176,17,2,15,81,1,16,18,23,17.0,2.0,15.0,81.0,1.0,16.0,16.0,20,17,3,14.0,14.0,0.0
9702281,28,6,22,87,1,27,97,27,24.0,3.0,21.0,86.0,0.0,24.0,84.0,47,28,19,12.0,9.0,3.0
11233,25,10,15,38,0,25,212,18,13.0,5.0,8.0,19.0,0.0,13.0,147.0,102,25,77,13.0,2.0,11.0
9408265,36,9,27,114,6,30,136,5,18.0,6.0,12.0,44.0,6.0,12.0,19.0,47,36,11,14.0,13.0,1.0
102156,8,4,4,7,1,7,103,5,2.0,1.0,1.0,1.0,0.0,2.0,11.0,68,8,60,13.0,2.0,11.0
106034,21,9,12,21,4,17,124,13,6.0,3.0,3.0,3.0,0.0,6.0,48.0,66,21,45,15.0,5.0,10.0
9309218,44,7,37,210,15,29,51,18,30.0,3.0,27.0,166.0,8.0,22.0,39.0,48,44,4,18.0,17.0,1.0
9711461,1,1,0,0,0,1,3,18,,,,,,,,5,1,4,,,
9609300,2,2,0,0,0,2,11,18,1.0,1.0,0.0,0.0,0.0,1.0,6.0,16,2,14,1.0,0.0,1.0
103179,65,21,44,157,25,40,141,0,19.0,1.0,18.0,69.0,1.0,18.0,77.0,87,65,22,12.0,3.0,9.0
9912282,9,4,5,6,0,9,51,0,5.0,3.0,2.0,3.0,0.0,5.0,27.0,36,9,27,1.0,1.0,0.0
9510422,11,5,6,11,0,11,12,111,7.0,2.0,5.0,8.0,0.0,7.0,8.0,14,11,3,7.0,6.0,1.0
9506393,25,9,16,27,0,25,94,10,9.0,5.0,4.0,4.0,0.0,9.0,53.0,38,25,13,8.0,5.0,3.0
9803406,3,2,1,1,0,3,10,118,3.0,2.0,1.0,1.0,0.0,3.0,9.0,12,3,9,4.0,1.0,3.0
9902232,12,2,10,31,0,12,31,118,10.0,2.0,8.0,22.0,0.0,10.0,19.0,17,12,5,13.0,10.0,3.0
9511399,24,10,14,28,10,14,27,16,2.0,1.0,1.0,1.0,2.0,0.0,0.0,30,24,6,4.0,2.0,2.0
9806357,15,3,12,27,0,15,63,16,10.0,2.0,8.0,14.0,0.0,10.0,35.0,22,15,7,2.0,2.0,0.0
9911358,6,1,5,8,2,4,18,252,4.0,1.0,3.0,4.0,1.0,3.0,6.0,17,6,11,5.0,3.0,2.0
1192,12,3,9,28,6,6,6,19,9.0,3.0,6.0,21.0,7.0,2.0,2.0,17,12,5,1.0,1.0,0.0
9411294,13,3,10,48,3,10,10,43,11.0,2.0,9.0,43.0,2.0,9.0,9.0,14,13,1,12.0,11.0,1.0
9908482,8,4,4,4,2,6,22,5,1.0,1.0,0.0,0.0,1.0,0.0,0.0,14,8,6,1.0,1.0,0.0
9211255,9,4,5,11,9,0,0,196,2.0,1.0,1.0,1.0,2.0,0.0,0.0,9,9,0,5.0,5.0,0.0
9608213,22,2,20,48,1,21,61,39,14.0,2.0,12.0,26.0,0.0,14.0,43.0,32,22,10,15.0,10.0,5.0
9708282,3,3,0,0,1,2,6,39,0.0,0.0,0.0,0.0,0.0,0.0,0.0,12,3,9,9.0,1.0,8.0
9306332,28,6,22,67,28,0,0,42,12.0,1.0,11.0,37.0,12.0,0.0,0.0,28,28,0,12.0,12.0,0.0
6340,12,7,5,7,0,12,74,2,6.0,2.0,4.0,6.0,0.0,6.0,22.0,28,12,16,14.0,6.0,8.0
9906356,7,2,5,6,1,6,13,63,0.0,0.0,0.0,0.0,0.0,0.0,0.0,14,7,7,5.0,4.0,1.0
9609234,1,1,0,0,0,1,1,138,0.0,0.0,0.0,0.0,0.0,0.0,0.0,5,1,4,1.0,1.0,0.0
9710539,25,5,20,58,3,22,42,11,14.0,1.0,13.0,43.0,4.0,10.0,10.0,31,25,6,16.0,14.0,2.0
10075,43,1,42,357,1,42,535,19,37.0,1.0,36.0,330.0,0.0,37.0,496.0,79,43,36,56.0,37.0,19.0
106298,19,5,14,55,0,19,178,109,18.0,5.0,13.0,54.0,0.0,18.0,163.0,42,19,23,30.0,17.0,13.0
206194,14,7,7,9,0,14,136,19,9.0,3.0,6.0,6.0,0.0,9.0,82.0,69,14,55,10.0,2.0,8.0
102237,5,3,2,2,0,5,24,43,0.0,0.0,0.0,0.0,0.0,0.0,0.0,24,5,19,8.0,1.0,7.0
9309216,39,16,23,64,27,12,12,164,12.0,8.0,4.0,5.0,1.0,11.0,11.0,40,39,1,13.0,12.0,1.0
9801380,14,5,9,24,2,12,28,201,11.0,2.0,9.0,24.0,5.0,6.0,6.0,22,14,8,8.0,5.0,3.0
11374,3,2,1,1,0,3,7,2,,,,,,,,13,3,10,2.0,0.0,2.0
102290,17,9,8,12,0,17,121,2,5.0,5.0,0.0,0.0,0.0,5.0,47.0,34,17,17,8.0,7.0,1.0
9912552,18,7,11,22,1,17,121,2,7.0,3.0,4.0,7.0,1.0,6.0,27.0,35,18,17,12.0,6.0,6.0
9903520,30,11,19,42,2,28,120,9,17.0,6.0,11.0,21.0,0.0,17.0,58.0,45,30,15,11.0,8.0,3.0
9701214,5,3,2,2,0,5,6,91,5.0,3.0,2.0,2.0,0.0,5.0,5.0,7,5,2,2.0,2.0,0.0
8333,16,7,9,14,0,16,194,2,6.0,3.0,3.0,5.0,0.0,6.0,94.0,110,16,94,28.0,1.0,27.0
9911305,7,2,5,8,2,5,5,128,4.0,1.0,3.0,3.0,2.0,2.0,2.0,10,7,3,5.0,4.0,1.0
7022,3,3,0,0,1,2,25,54,2.0,2.0,0.0,0.0,0.0,2.0,11.0,28,3,25,12.0,2.0,10.0
9401313,1,1,0,0,0,1,1,96,0.0,0.0,0.0,0.0,0.0,0.0,0.0,3,1,2,1.0,0.0,1.0
9802267,33,2,31,122,0,33,220,10,18.0,2.0,16.0,70.0,0.0,18.0,96.0,54,33,21,25.0,17.0,8.0
9602439,20,3,17,53,1,19,50,37,10.0,1.0,9.0,24.0,0.0,10.0,26.0,26,20,6,16.0,12.0,4.0
9404217,25,12,13,20,0,25,111,10,10.0,5.0,5.0,6.0,0.0,10.0,50.0,42,25,17,11.0,5.0,6.0
9602419,36,5,31,96,36,0,0,264,20.0,1.0,19.0,58.0,20.0,0.0,0.0,36,36,0,10.0,10.0,0.0
4191,9,1,8,15,0,9,44,28,8.0,1.0,7.0,13.0,0.0,8.0,28.0,23,9,14,13.0,6.0,7.0
9601279,11,3,8,17,4,7,7,61,5.0,1.0,4.0,6.0,2.0,3.0,3.0,12,11,1,6.0,5.0,1.0
9209299,25,8,17,47,9,16,16,234,13.0,4.0,9.0,24.0,3.0,10.0,10.0,27,25,2,12.0,11.0,1.0
8127,13,3,10,23,0,13,175,4,5.0,1.0,4.0,6.0,0.0,5.0,43.0,89,13,76,17.0,5.0,12.0
9502262,40,9,31,84,40,0,0,14,9.0,1.0,8.0,18.0,9.0,0.0,0.0,41,40,1,5.0,5.0,0.0
9612365,3,2,1,1,0,3,4,1944,1.0,1.0,0.0,0.0,0.0,1.0,1.0,7,3,4,,,
8021,14,6,8,24,2,12,25,1,2.0,2.0,0.0,0.0,2.0,0.0,0.0,17,14,3,1.0,1.0,0.0
6240,15,2,13,32,0,15,68,34,12.0,1.0,11.0,30.0,0.0,12.0,56.0,32,15,17,5.0,3.0,2.0
101092,18,9,9,17,0,18,125,32,6.0,2.0,4.0,7.0,0.0,6.0,29.0,60,18,42,7.0,3.0,4.0
9903242,19,4,15,50,2,17,65,34,7.0,1.0,6.0,15.0,0.0,7.0,28.0,36,19,17,8.0,8.0,0.0
9408328,54,26,28,49,51,3,3,8,7.0,5.0,2.0,5.0,7.0,0.0,0.0,55,54,1,4.0,4.0,0.0
9807500,21,2,19,37,2,19,66,79,14.0,1.0,13.0,23.0,0.0,14.0,23.0,36,21,15,15.0,13.0,2.0
9402214,52,19,33,104,17,35,59,68,23.0,10.0,13.0,34.0,0.0,23.0,44.0,57,52,5,15.0,14.0,1.0
9809232,2,2,0,0,1,1,3,79,1.0,1.0,0.0,0.0,0.0,1.0,3.0,6,2,4,5.0,1.0,4.0
9509303,28,8,20,61,27,1,2,115,15.0,3.0,12.0,44.0,15.0,0.0,0.0,31,28,3,12.0,12.0,0.0
9601298,63,4,59,295,0,63,209,17,53.0,3.0,50.0,268.0,0.0,53.0,164.0,72,63,9,39.0,35.0,4.0
9510202,46,6,40,123,3,43,126,17,31.0,1.0,30.0,104.0,0.0,31.0,94.0,55,46,9,8.0,6.0,2.0
9401340,10,6,4,4,6,4,5,134,5.0,4.0,1.0,1.0,2.0,3.0,3.0,12,10,2,1.0,1.0,0.0
9610376,3,1,2,2,1,2,4,240,2.0,2.0,0.0,0.0,0.0,2.0,2.0,6,3,3,2.0,1.0,1.0
9809230,14,4,10,35,0,14,60,24,5.0,1.0,4.0,7.0,0.0,5.0,9.0,22,14,8,13.0,10.0,3.0
9710352,4,4,0,0,1,3,3,67,1.0,1.0,0.0,0.0,1.0,0.0,0.0,9,4,5,2.0,0.0,2.0
9601373,9,2,7,11,1,8,17,104,4.0,1.0,3.0,4.0,0.0,4.0,8.0,16,9,7,6.0,4.0,2.0
9407343,21,5,16,44,14,7,11,8,11.0,2.0,9.0,26.0,11.0,0.0,0.0,28,21,7,5.0,5.0,0.0
9309257,28,7,21,77,12,16,23,90,23.0,4.0,19.0,74.0,17.0,6.0,6.0,34,28,6,17.0,17.0,0.0
111256,3,2,1,2,0,3,40,2,0.0,0.0,0.0,0.0,0.0,0.0,0.0,23,3,20,1.0,1.0,0.0
9708382,18,5,13,29,4,14,72,7,5.0,1.0,4.0,7.0,0.0,5.0,46.0,37,18,19,8.0,6.0,2.0
9812372,3,3,0,0,3,0,0,1304,,,,,,,,5,3,2,,,
9901252,19,5,14,40,2,17,74,29,13.0,4.0,9.0,31.0,0.0,13.0,60.0,28,19,9,19.0,13.0,6.0
9403217,6,2,4,6,2,4,4,99,3.0,1.0,2.0,2.0,0.0,3.0,3.0,8,6,2,2.0,2.0,0.0
7158,15,4,11,34,1,14,55,28,11.0,2.0,9.0,29.0,0.0,11.0,41.0,23,15,8,11.0,9.0,2.0
9710270,87,10,77,505,6,81,404,9,57.0,2.0,55.0,400.0,0.0,57.0,285.0,104,87,17,43.0,33.0,10.0
9909432,13,6,7,19,0,13,71,54,8.0,2.0,6.0,16.0,0.0,8.0,15.0,30,13,17,7.0,6.0,1.0
9806491,16,7,9,19,2,14,29,110,8.0,2.0,6.0,15.0,7.0,1.0,1.0,35,16,19,8.0,7.0,1.0
9502390,4,2,2,2,4,0,0,193,,,,,,,,4,4,0,1.0,1.0,0.0
2250,30,4,26,85,0,30,250,24,17.0,2.0,15.0,47.0,0.0,17.0,152.0,54,30,24,17.0,10.0,7.0
9810281,16,13,3,3,8,8,14,88,0.0,0.0,0.0,0.0,0.0,0.0,0.0,63,16,47,5.0,3.0,2.0
9711344,9,3,6,8,0,9,13,64,4.0,1.0,3.0,4.0,1.0,3.0,3.0,12,9,3,3.0,3.0,0.0
7036,2,2,0,0,0,2,5,9,0.0,0.0,0.0,0.0,0.0,0.0,0.0,11,2,9,,,
9705378,6,6,0,0,2,4,10,138,0.0,0.0,0.0,0.0,0.0,0.0,0.0,21,6,15,5.0,3.0,2.0
9604204,6,3,3,3,0,6,18,14,4.0,1.0,3.0,3.0,2.0,2.0,3.0,15,6,9,5.0,3.0,2.0
9602373,13,9,4,9,4,9,14,140,5.0,4.0,1.0,1.0,1.0,4.0,4.0,16,13,3,4.0,3.0,1.0
9706251,11,4,7,16,1,10,21,14,1.0,1.0,0.0,0.0,0.0,1.0,1.0,29,11,18,5.0,4.0,1.0
9605456,74,9,65,343,11,63,115,68,34.0,2.0,32.0,206.0,3.0,31.0,63.0,81,74,7,30.0,27.0,3.0
9905511,4,3,1,1,2,2,2,14,1.0,1.0,0.0,0.0,0.0,1.0,1.0,6,4,2,2.0,1.0,1.0
9811412,21,6,15,35,0,21,111,73,16.0,5.0,11.0,27.0,0.0,16.0,81.0,31,21,10,19.0,13.0,6.0
9711447,3,1,2,3,3,0,0,454,2.0,1.0,1.0,1.0,2.0,0.0,0.0,3,3,0,3.0,3.0,0.0
211313,1,1,0,0,0,1,13,45,1.0,1.0,0.0,0.0,0.0,1.0,1.0,15,1,14,2.0,1.0,1.0
9903536,9,6,3,5,3,6,36,11,4.0,2.0,2.0,3.0,0.0,4.0,34.0,24,9,15,6.0,3.0,3.0
9710427,38,1,37,214,0,38,307,9,37.0,1.0,36.0,208.0,0.0,37.0,298.0,55,38,17,44.0,29.0,15.0
9709376,27,9,18,61,0,27,281,17,24.0,7.0,17.0,59.0,0.0,24.0,253.0,67,27,40,31.0,7.0,24.0
9408363,11,7,4,6,10,1,1,14,2.0,2.0,0.0,0.0,2.0,0.0,0.0,12,11,1,3.0,3.0,0.0
9604363,26,6,20,90,13,13,22,8,18.0,2.0,16.0,78.0,11.0,7.0,7.0,30,26,4,17.0,16.0,1.0
9603361,7,6,1,2,2,5,14,16,2.0,2.0,0.0,0.0,0.0,2.0,2.0,15,7,8,3.0,1.0,2.0
9706314,2,2,0,0,0,2,5,115,0.0,0.0,0.0,0.0,0.0,0.0,0.0,6,2,4,3.0,0.0,3.0
9710252,3,2,1,1,1,2,11,16,1.0,1.0,0.0,0.0,0.0,1.0,5.0,15,3,12,3.0,0.0,3.0
9906337,5,5,0,0,2,3,8,66,0.0,0.0,0.0,0.0,0.0,0.0,0.0,15,5,10,1.0,0.0,1.0
9508254,24,10,14,25,9,15,28,18,13.0,5.0,8.0,13.0,9.0,4.0,4.0,36,24,12,7.0,6.0,1.0
9612351,12,4,8,16,12,0,0,97,7.0,1.0,6.0,11.0,7.0,0.0,0.0,13,12,1,6.0,6.0,0.0
9612364,77,6,71,589,1,76,573,15,58.0,1.0,57.0,497.0,1.0,57.0,439.0,112,77,35,46.0,30.0,16.0
9402204,22,4,18,58,22,0,0,15,6.0,1.0,5.0,10.0,6.0,0.0,0.0,22,22,0,11.0,11.0,0.0
9504389,3,3,0,0,2,1,2,90,0.0,0.0,0.0,0.0,0.0,0.0,0.0,8,3,5,2.0,0.0,2.0
9510230,3,3,0,0,0,3,18,15,0.0,0.0,0.0,0.0,0.0,0.0,0.0,14,3,11,2.0,0.0,2.0
9812429,5,4,1,2,0,5,8,106,0.0,0.0,0.0,0.0,0.0,0.0,0.0,11,5,6,1.0,0.0,1.0
9509299,28,6,22,129,2,26,103,33,25.0,5.0,20.0,119.0,2.0,23.0,98.0,36,28,8,25.0,20.0,5.0
108166,10,3,7,12,2,8,26,0,7.0,3.0,4.0,7.0,0.0,7.0,22.0,17,10,7,4.0,2.0,2.0
9905327,1,1,0,0,0,1,3,283,1.0,1.0,0.0,0.0,0.0,1.0,2.0,9,1,8,,,
10240,47,5,42,157,7,40,86,0,17.0,2.0,15.0,78.0,0.0,17.0,36.0,54,47,7,20.0,17.0,3.0
5179,1,1,0,0,0,1,10,3,1.0,1.0,0.0,0.0,0.0,1.0,6.0,14,1,13,9.0,1.0,8.0
9604402,9,2,7,13,1,8,32,52,8.0,2.0,6.0,9.0,1.0,7.0,29.0,14,9,5,11.0,6.0,5.0
9909257,4,4,0,0,2,2,2,249,2.0,2.0,0.0,0.0,0.0,2.0,2.0,7,4,3,4.0,2.0,2.0
9410235,23,5,18,26,4,19,74,112,15.0,5.0,10.0,13.0,1.0,14.0,33.0,35,23,12,15.0,11.0,4.0
9810524,12,5,7,14,12,0,0,2,3.0,3.0,0.0,0.0,3.0,0.0,0.0,13,12,1,2.0,2.0,0.0
9902313,13,4,9,14,1,12,28,1,7.0,3.0,4.0,6.0,3.0,4.0,4.0,19,13,6,12.0,9.0,3.0
5220,5,3,2,3,1,4,4,120,4.0,2.0,2.0,3.0,1.0,3.0,3.0,6,5,1,5.0,4.0,1.0
9912390,35,5,30,143,0,35,263,5,20.0,1.0,19.0,89.0,0.0,20.0,113.0,68,35,33,27.0,20.0,7.0
9708380,0,0,0,0,0,0,0,40,0.0,0.0,0.0,0.0,0.0,0.0,0.0,9,0,9,1.0,0.0,1.0
9802372,7,4,3,5,0,7,35,8,3.0,2.0,1.0,2.0,0.0,3.0,9.0,20,7,13,1.0,0.0,1.0
107220,7,2,5,10,0,7,129,3,4.0,1.0,3.0,6.0,0.0,4.0,101.0,129,7,122,44.0,2.0,42.0
9911264,13,3,10,31,1,12,96,3,0.0,0.0,0.0,0.0,0.0,0.0,0.0,41,13,28,13.0,4.0,9.0
9409342,2,2,0,0,0,2,7,10,1.0,1.0,0.0,0.0,0.0,1.0,4.0,43,2,41,10.0,0.0,10.0
9711411,8,3,5,7,5,3,3,123,3.0,1.0,2.0,2.0,1.0,2.0,2.0,9,8,1,5.0,4.0,1.0
2050,20,5,15,58,1,19,241,15,17.0,3.0,14.0,55.0,0.0,17.0,224.0,58,20,38,21.0,10.0,11.0
6333,6,1,5,10,0,6,18,21,6.0,1.0,5.0,10.0,0.0,6.0,18.0,15,6,9,8.0,6.0,2.0
9408407,19,2,17,79,4,15,25,49,17.0,1.0,16.0,78.0,3.0,14.0,17.0,23,19,4,15.0,14.0,1.0
9310312,21,7,14,27,21,0,0,93,6.0,2.0,4.0,12.0,6.0,0.0,0.0,21,21,0,6.0,6.0,0.0
9605297,29,3,26,106,7,22,30,44,24.0,1.0,23.0,90.0,5.0,19.0,24.0,33,29,4,11.0,10.0,1.0
9702208,10,6,4,5,5,5,6,411,3.0,1.0,2.0,3.0,0.0,3.0,3.0,16,10,6,4.0,3.0,1.0
9612409,22,8,14,26,10,12,40,30,9.0,6.0,3.0,6.0,3.0,6.0,22.0,33,22,11,9.0,4.0,5.0
3272,7,5,2,3,0,7,30,69,3.0,1.0,2.0,3.0,0.0,3.0,9.0,19,7,12,8.0,2.0,6.0
9807503,12,5,7,14,1,11,29,60,0.0,0.0,0.0,0.0,0.0,0.0,0.0,35,12,23,7.0,4.0,3.0
9511207,20,15,5,9,6,14,51,26,2.0,2.0,0.0,0.0,0.0,2.0,5.0,49,20,29,8.0,0.0,8.0
9806235,5,2,3,3,4,1,3,188,0.0,0.0,0.0,0.0,0.0,0.0,0.0,26,5,21,2.0,1.0,1.0
103012,21,3,18,77,3,18,225,23,16.0,1.0,15.0,63.0,1.0,15.0,214.0,45,21,24,23.0,10.0,13.0
9601237,26,8,18,31,4,22,65,13,11.0,6.0,5.0,6.0,0.0,11.0,33.0,34,26,8,9.0,6.0,3.0
9510210,3,2,1,1,1,2,5,41,2.0,1.0,1.0,1.0,0.0,2.0,4.0,8,3,5,2.0,1.0,1.0
9502280,8,3,5,9,3,5,10,135,4.0,1.0,3.0,6.0,0.0,4.0,9.0,12,8,4,7.0,4.0,3.0
9802411,28,3,25,88,1,27,139,9,16.0,3.0,13.0,51.0,1.0,15.0,94.0,44,28,16,22.0,12.0,10.0
112228,6,2,4,7,0,6,22,12,2.0,2.0,0.0,0.0,2.0,0.0,0.0,19,6,13,5.0,4.0,1.0
9404321,17,8,9,33,6,11,12,36,12.0,7.0,5.0,19.0,2.0,10.0,10.0,19,17,2,11.0,10.0,1.0
9704354,6,1,5,13,0,6,30,34,5.0,1.0,4.0,9.0,0.0,5.0,25.0,17,6,11,2.0,0.0,2.0
9504239,29,11,18,44,10,19,82,10,6.0,3.0,3.0,5.0,0.0,6.0,26.0,47,29,18,7.0,6.0,1.0
206300,14,3,11,26,0,14,167,46,11.0,1.0,10.0,25.0,0.0,11.0,114.0,68,14,54,26.0,7.0,19.0
9607255,6,5,1,2,4,2,2,218,1.0,1.0,0.0,0.0,1.0,0.0,0.0,11,6,5,2.0,1.0,1.0
9806539,5,4,1,1,0,5,15,13,1.0,1.0,0.0,0.0,0.0,1.0,2.0,18,5,13,3.0,1.0,2.0
9909356,8,5,3,6,0,8,94,24,4.0,1.0,3.0,4.0,0.0,4.0,58.0,34,8,26,10.0,2.0,8.0
9508227,10,4,6,11,9,1,3,29,2.0,1.0,1.0,1.0,1.0,1.0,3.0,24,10,14,6.0,0.0,6.0
9610221,5,5,0,0,0,5,23,46,1.0,1.0,0.0,0.0,1.0,0.0,0.0,22,5,17,7.0,1.0,6.0
12097,18,6,12,26,0,18,76,21,8.0,5.0,3.0,7.0,5.0,3.0,3.0,36,18,18,16.0,12.0,4.0
9306269,15,7,8,20,15,0,0,10,4.0,2.0,2.0,2.0,4.0,0.0,0.0,15,15,0,3.0,3.0,0.0
9705263,13,2,11,26,2,11,22,255,10.0,2.0,8.0,16.0,1.0,9.0,19.0,16,13,3,9.0,6.0,3.0
9212221,2,1,1,1,2,0,0,275,,,,,,,,2,2,0,2.0,2.0,0.0
2271,5,3,2,2,2,3,8,178,3.0,1.0,2.0,2.0,0.0,3.0,7.0,13,5,8,8.0,3.0,5.0
9610549,40,7,33,118,12,28,37,83,22.0,1.0,21.0,84.0,17.0,5.0,5.0,45,40,5,10.0,9.0,1.0
9608403,6,2,4,7,4,2,8,52,2.0,1.0,1.0,1.0,0.0,2.0,4.0,18,6,12,5.0,0.0,5.0
9602362,6,4,2,2,6,0,0,105,1.0,1.0,0.0,0.0,1.0,0.0,0.0,9,6,3,2.0,2.0,0.0
9806372,3,3,0,0,0,3,12,154,3.0,3.0,0.0,0.0,0.0,3.0,12.0,7,3,4,5.0,2.0,3.0
3305,6,6,0,0,0,6,14,143,5.0,5.0,0.0,0.0,0.0,5.0,11.0,10,6,4,6.0,4.0,2.0
9708355,2,2,0,0,1,1,1,432,1.0,1.0,0.0,0.0,1.0,0.0,0.0,4,2,2,,,
9707410,3,2,1,1,0,3,8,2065,1.0,1.0,0.0,0.0,0.0,1.0,2.0,10,3,7,2.0,1.0,1.0
103259,7,3,4,4,0,7,50,24,2.0,2.0,0.0,0.0,0.0,2.0,28.0,37,7,30,20.0,1.0,19.0
9703244,6,4,2,2,0,6,14,29,2.0,2.0,0.0,0.0,0.0,2.0,4.0,18,6,12,5.0,1.0,4.0
5019,8,4,4,11,0,8,120,49,7.0,3.0,4.0,11.0,0.0,7.0,98.0,51,8,43,25.0,6.0,19.0
9702442,4,2,2,2,0,4,32,61,1.0,1.0,0.0,0.0,0.0,1.0,11.0,24,4,20,11.0,0.0,11.0
203009,6,3,3,5,1,5,26,8,3.0,2.0,1.0,1.0,0.0,3.0,11.0,17,6,11,9.0,4.0,5.0
9809247,23,4,19,69,2,21,202,8,18.0,3.0,15.0,59.0,0.0,18.0,183.0,45,23,22,33.0,16.0,17.0
9505351,5,5,0,0,4,1,1,394,1.0,1.0,0.0,0.0,1.0,0.0,0.0,6,5,1,1.0,1.0,0.0
9507341,4,2,2,3,0,4,7,355,3.0,1.0,2.0,2.0,0.0,3.0,6.0,8,4,4,6.0,3.0,3.0
3172,21,6,15,34,1,20,170,21,16.0,3.0,13.0,32.0,0.0,16.0,152.0,46,21,25,30.0,12.0,18.0
112138,7,4,3,6,0,7,40,0,4.0,2.0,2.0,3.0,0.0,4.0,21.0,34,7,27,14.0,1.0,13.0
109257,9,4,5,13,3,6,6,239,7.0,2.0,5.0,13.0,3.0,4.0,4.0,11,9,2,8.0,7.0,1.0
9510462,2,1,1,1,0,2,5,200,2.0,1.0,1.0,1.0,0.0,2.0,5.0,5,2,3,5.0,2.0,3.0
9308267,1,1,0,0,1,0,0,2140,,,,,,,,1,1,0,,,
5064,16,6,10,26,2,14,98,3,11.0,4.0,7.0,21.0,0.0,11.0,88.0,40,16,24,12.0,3.0,9.0
106049,2,2,0,0,0,2,15,19,1.0,1.0,0.0,0.0,0.0,1.0,9.0,16,2,14,6.0,1.0,5.0
104164,4,1,3,4,4,0,0,30,,,,,,,,6,4,2,,,
11143,8,3,5,10,1,7,70,2,6.0,2.0,4.0,8.0,0.0,6.0,52.0,38,8,30,15.0,4.0,11.0
10299,10,7,3,4,2,8,37,0,2.0,2.0,0.0,0.0,2.0,0.0,0.0,33,10,23,2.0,2.0,0.0
10353,19,1,18,42,0,19,228,2,17.0,1.0,16.0,39.0,0.0,17.0,117.0,42,19,23,29.0,16.0,13.0
9610387,0,0,0,0,0,0,0,135,,,,,,,,3,0,3,,,
9309313,5,2,3,3,5,0,0,281,1.0,1.0,0.0,0.0,1.0,0.0,0.0,5,5,0,1.0,1.0,0.0
202107,15,2,13,16,0,15,64,37,10.0,2.0,8.0,9.0,0.0,10.0,30.0,29,15,14,9.0,7.0,2.0
9902217,18,6,12,23,1,17,47,8,11.0,6.0,5.0,9.0,6.0,5.0,12.0,29,18,11,9.0,3.0,6.0
9506471,16,4,12,24,8,8,23,87,3.0,1.0,2.0,2.0,1.0,2.0,6.0,23,16,7,5.0,5.0,0.0
103247,3,1,2,2,1,2,2,56,0.0,0.0,0.0,0.0,0.0,0.0,0.0,11,3,8,1.0,0.0,1.0
9405431,34,7,27,135,4,30,208,53,26.0,3.0,23.0,122.0,0.0,26.0,190.0,47,34,13,31.0,22.0,9.0
9912399,0,0,0,0,0,0,0,98,0.0,0.0,0.0,0.0,0.0,0.0,0.0,9,0,9,1.0,0.0,1.0
9207264,87,7,80,498,1,86,86,56,72.0,4.0,68.0,391.0,0.0,72.0,72.0,88,87,1,37.0,36.0,1.0
9607413,5,2,3,3,0,5,9,114,0.0,0.0,0.0,0.0,0.0,0.0,0.0,11,5,6,3.0,1.0,2.0
9610285,5,3,2,2,0,5,19,25,5.0,3.0,2.0,2.0,0.0,5.0,17.0,12,5,7,2.0,1.0,1.0
9804208,15,3,12,26,3,12,32,92,8.0,2.0,6.0,14.0,3.0,5.0,11.0,39,15,24,4.0,3.0,1.0
9912528,3,3,0,0,2,1,2,70,0.0,0.0,0.0,0.0,0.0,0.0,0.0,19,3,16,15.0,0.0,15.0
9409302,3,3,0,0,2,1,1,103,1.0,1.0,0.0,0.0,1.0,0.0,0.0,4,3,1,2.0,1.0,1.0
202034,20,5,15,55,0,20,134,107,13.0,5.0,8.0,37.0,0.0,13.0,67.0,41,20,21,19.0,13.0,6.0
11070,4,3,1,1,1,3,14,182,1.0,1.0,0.0,0.0,0.0,1.0,8.0,22,4,18,12.0,1.0,11.0
9802312,11,4,7,8,0,11,39,22,5.0,2.0,3.0,3.0,1.0,4.0,13.0,31,11,20,7.0,2.0,5.0
9212252,5,3,2,3,0,5,5,176,4.0,2.0,2.0,3.0,0.0,4.0,4.0,6,5,1,,,
9803366,36,1,35,161,4,32,139,7,14.0,2.0,12.0,56.0,14.0,0.0,0.0,55,36,19,14.0,10.0,4.0
9602231,1,1,0,0,0,1,10,10,0.0,0.0,0.0,0.0,0.0,0.0,0.0,21,1,20,6.0,0.0,6.0
9707269,10,5,5,9,1,9,60,135,5.0,2.0,3.0,4.0,0.0,5.0,32.0,41,10,31,14.0,5.0,9.0
9710247,25,4,21,40,0,25,91,68,7.0,3.0,4.0,5.0,0.0,7.0,22.0,37,25,12,11.0,6.0,5.0
203237,18,8,10,19,0,18,133,3,5.0,3.0,2.0,4.0,0.0,5.0,48.0,58,18,40,16.0,5.0,11.0
205349,17,7,10,21,1,16,102,46,13.0,5.0,8.0,19.0,0.0,13.0,82.0,39,17,22,20.0,7.0,13.0
101350,16,7,9,13,0,16,175,3,9.0,4.0,5.0,7.0,0.0,9.0,91.0,77,16,61,14.0,2.0,12.0
9608477,23,9,14,34,2,21,33,3,7.0,3.0,4.0,7.0,0.0,7.0,7.0,27,23,4,8.0,7.0,1.0
202095,6,4,2,2,1,5,12,0,4.0,2.0,2.0,2.0,0.0,4.0,8.0,17,6,11,6.0,2.0,4.0
9801303,2,2,0,0,0,2,5,12,0.0,0.0,0.0,0.0,0.0,0.0,0.0,15,2,13,,,
111057,6,4,2,3,0,6,27,60,0.0,0.0,0.0,0.0,0.0,0.0,0.0,34,6,28,4.0,1.0,3.0
9410236,11,4,7,9,2,9,26,1,0.0,0.0,0.0,0.0,0.0,0.0,0.0,24,11,13,3.0,3.0,0.0
9701419,22,7,15,65,2,20,47,47,17.0,4.0,13.0,59.0,1.0,16.0,30.0,36,22,14,19.0,14.0,5.0
9312346,2,2,0,0,2,0,0,493,2.0,2.0,0.0,0.0,2.0,0.0,0.0,2,2,0,1.0,1.0,0.0
9702253,5,2,3,4,5,0,0,1076,,,,,,,,7,5,2,2.0,2.0,0.0
110061,3,1,2,2,3,0,0,283,,,,,,,,3,3,0,,,
9707258,7,3,4,5,6,1,1,309,1.0,1.0,0.0,0.0,0.0,1.0,1.0,14,7,7,3.0,1.0,2.0
9506366,1,1,0,0,1,0,0,156,0.0,0.0,0.0,0.0,0.0,0.0,0.0,3,1,2,1.0,0.0,1.0
203223,11,2,9,22,0,11,227,28,11.0,2.0,9.0,22.0,0.0,11.0,180.0,58,11,47,32.0,10.0,22.0
9901340,5,3,2,5,5,0,0,70,4.0,2.0,2.0,5.0,4.0,0.0,0.0,5,5,0,3.0,3.0,0.0
9510435,4,4,0,0,3,1,1,100,2.0,2.0,0.0,0.0,1.0,1.0,1.0,5,4,1,1.0,1.0,0.0
9405412,12,9,3,3,8,4,9,35,3.0,3.0,0.0,0.0,3.0,0.0,0.0,17,12,5,2.0,2.0,0.0
9902372,22,7,15,48,1,21,43,68,14.0,3.0,11.0,41.0,1.0,13.0,18.0,35,22,13,14.0,12.0,2.0
108239,9,3,6,10,0,9,93,11,8.0,3.0,5.0,9.0,0.0,8.0,85.0,30,9,21,22.0,7.0,15.0
12023,13,5,8,15,2,11,48,13,5.0,1.0,4.0,5.0,0.0,5.0,24.0,30,13,17,9.0,7.0,2.0
9702327,13,4,9,22,3,10,17,82,8.0,2.0,6.0,17.0,0.0,8.0,15.0,16,13,3,10.0,8.0,2.0
9608287,0,0,0,0,0,0,0,327,0.0,0.0,0.0,0.0,0.0,0.0,0.0,1,0,1,1.0,0.0,1.0
9507407,10,8,2,4,1,9,19,84,6.0,4.0,2.0,4.0,1.0,5.0,10.0,19,10,9,5.0,3.0,2.0
11055,33,9,24,61,0,33,425,15,14.0,3.0,11.0,25.0,0.0,14.0,257.0,114,33,81,50.0,3.0,47.0
9607301,11,7,4,5,9,2,5,231,4.0,4.0,0.0,0.0,3.0,1.0,2.0,14,11,3,3.0,1.0,2.0
9705445,8,4,4,6,0,8,30,17,7.0,3.0,4.0,6.0,0.0,7.0,29.0,19,8,11,2.0,0.0,2.0
9510296,9,4,5,7,8,1,2,63,0.0,0.0,0.0,0.0,0.0,0.0,0.0,11,9,2,4.0,3.0,1.0
110309,3,2,1,1,0,3,15,2,2.0,2.0,0.0,0.0,0.0,2.0,8.0,11,3,8,1.0,1.0,0.0
9908280,5,5,0,0,0,5,20,39,2.0,2.0,0.0,0.0,0.0,2.0,4.0,23,5,18,3.0,0.0,3.0
9508310,2,2,0,0,1,1,1,5,0.0,0.0,0.0,0.0,0.0,0.0,0.0,8,2,6,2.0,0.0,2.0
9803254,12,6,6,10,3,9,49,8,5.0,1.0,4.0,6.0,0.0,5.0,35.0,23,12,11,2.0,2.0,0.0
9411428,6,4,2,2,1,5,6,203,2.0,1.0,1.0,1.0,1.0,1.0,1.0,8,6,2,6.0,4.0,2.0
9712540,1,1,0,0,0,1,2,299,0.0,0.0,0.0,0.0,0.0,0.0,0.0,12,1,11,5.0,0.0,5.0
302087,0,0,0,0,0,0,0,128,0.0,0.0,0.0,0.0,0.0,0.0,0.0,13,0,13,7.0,0.0,7.0
106063,1,1,0,0,1,0,0,60,0.0,0.0,0.0,0.0,0.0,0.0,0.0,5,1,4,1.0,0.0,1.0
9501279,21,11,10,17,7,14,49,35,5.0,1.0,4.0,4.0,0.0,5.0,16.0,28,21,7,7.0,5.0,2.0
105128,10,3,7,10,3,7,42,32,2.0,1.0,1.0,1.0,2.0,0.0,0.0,23,10,13,3.0,3.0,0.0
9312203,8,5,3,5,8,0,0,220,2.0,2.0,0.0,0.0,2.0,0.0,0.0,8,8,0,3.0,3.0,0.0
9712383,5,3,2,2,2,3,3,157,2.0,1.0,1.0,1.0,2.0,0.0,0.0,6,5,1,2.0,1.0,1.0
9701376,1,1,0,0,0,1,5,21,,,,,,,,7,1,6,,,
9604394,3,2,1,1,3,0,0,231,1.0,1.0,0.0,0.0,1.0,0.0,0.0,3,3,0,2.0,2.0,0.0
201306,1,1,0,0,0,1,2,19,1.0,1.0,0.0,0.0,0.0,1.0,2.0,6,1,5,6.0,1.0,5.0
9907380,15,4,11,19,1,14,47,2,2.0,2.0,0.0,0.0,2.0,0.0,0.0,22,15,7,1.0,1.0,0.0
111288,3,3,0,0,0,3,11,23,2.0,2.0,0.0,0.0,0.0,2.0,3.0,16,3,13,2.0,1.0,1.0
203088,1,1,0,0,1,0,0,26,0.0,0.0,0.0,0.0,0.0,0.0,0.0,14,1,13,2.0,1.0,1.0
9609522,3,2,1,1,1,2,2,6,0.0,0.0,0.0,0.0,0.0,0.0,0.0,27,3,24,5.0,0.0,5.0
9706537,6,3,3,5,0,6,13,54,4.0,2.0,2.0,2.0,0.0,4.0,4.0,11,6,5,6.0,4.0,2.0
9611266,1,1,0,0,1,0,0,552,0.0,0.0,0.0,0.0,0.0,0.0,0.0,3,1,2,1.0,0.0,1.0
9812322,25,8,17,25,6,19,76,77,7.0,2.0,5.0,8.0,3.0,4.0,8.0,40,25,15,10.0,6.0,4.0
9906480,4,4,0,0,0,4,49,2,3.0,3.0,0.0,0.0,0.0,3.0,39.0,42,4,38,16.0,0.0,16.0
9704234,12,6,6,9,2,10,60,75,3.0,2.0,1.0,1.0,0.0,3.0,17.0,36,12,24,14.0,3.0,11.0
9906304,3,2,1,1,0,3,8,8,2.0,1.0,1.0,1.0,0.0,2.0,7.0,9,3,6,3.0,1.0,2.0
9901315,3,1,2,3,0,3,12,9,2.0,1.0,1.0,1.0,1.0,1.0,1.0,10,3,7,5.0,2.0,3.0
3242,10,6,4,9,0,10,53,8,6.0,3.0,3.0,6.0,0.0,6.0,36.0,25,10,15,16.0,6.0,10.0
9405426,7,4,3,4,7,0,0,27,4.0,2.0,2.0,3.0,4.0,0.0,0.0,7,7,0,3.0,3.0,0.0
9911381,10,4,6,7,0,10,43,9,6.0,2.0,4.0,4.0,0.0,6.0,33.0,21,10,11,3.0,1.0,2.0
9710338,7,7,0,0,3,4,6,273,1.0,1.0,0.0,0.0,0.0,1.0,3.0,13,7,6,2.0,0.0,2.0
101142,8,3,5,6,0,8,50,11,0.0,0.0,0.0,0.0,0.0,0.0,0.0,30,8,22,5.0,3.0,2.0
9612266,1,1,0,0,1,0,0,1802,0.0,0.0,0.0,0.0,0.0,0.0,0.0,4,1,3,,,
9505324,7,5,2,2,0,7,14,36,5.0,4.0,1.0,1.0,0.0,5.0,8.0,12,7,5,6.0,5.0,1.0
209316,4,2,2,2,1,3,10,121,1.0,1.0,0.0,0.0,0.0,1.0,5.0,13,4,9,7.0,2.0,5.0
9212318,4,2,2,3,0,4,6,207,1.0,1.0,0.0,0.0,0.0,1.0,2.0,8,4,4,1.0,0.0,1.0
9707218,5,2,3,3,1,4,6,6,3.0,1.0,2.0,2.0,2.0,1.0,1.0,13,5,8,5.0,3.0,2.0
9607407,1,1,0,0,0,1,2,613,0.0,0.0,0.0,0.0,0.0,0.0,0.0,6,1,5,1.0,0.0,1.0
9611322,8,3,5,16,0,8,9,222,8.0,3.0,5.0,16.0,0.0,8.0,9.0,11,8,3,8.0,7.0,1.0
9611442,5,5,0,0,5,0,0,591,2.0,2.0,0.0,0.0,2.0,0.0,0.0,9,5,4,4.0,3.0,1.0
4038,6,3,3,5,2,4,14,321,4.0,2.0,2.0,4.0,0.0,4.0,7.0,17,6,11,6.0,4.0,2.0
9509371,11,5,6,10,2,9,43,53,6.0,3.0,3.0,6.0,0.0,6.0,40.0,23,11,12,14.0,4.0,10.0
9705302,8,4,4,6,0,8,10,103,5.0,3.0,2.0,2.0,1.0,4.0,4.0,13,8,5,4.0,4.0,0.0
9603393,9,2,7,12,9,0,0,255,8.0,1.0,7.0,12.0,8.0,0.0,0.0,9,9,0,6.0,6.0,0.0
9708295,2,2,0,0,0,2,4,230,2.0,2.0,0.0,0.0,2.0,0.0,0.0,6,2,4,2.0,2.0,0.0
9812270,0,0,0,0,0,0,0,39,0.0,0.0,0.0,0.0,0.0,0.0,0.0,19,0,19,5.0,0.0,5.0
2038,17,7,10,25,3,14,41,29,7.0,3.0,4.0,10.0,2.0,5.0,8.0,34,17,17,8.0,8.0,0.0
9710423,9,7,2,3,2,7,27,36,2.0,2.0,0.0,0.0,0.0,2.0,7.0,24,9,15,5.0,1.0,4.0
9703228,12,3,9,12,1,11,19,47,7.0,1.0,6.0,8.0,4.0,3.0,3.0,21,12,9,6.0,5.0,1.0
5081,2,2,0,0,0,2,24,27,2.0,2.0,0.0,0.0,0.0,2.0,24.0,17,2,15,11.0,2.0,9.0
9905525,3,2,1,1,0,3,13,143,1.0,1.0,0.0,0.0,0.0,1.0,6.0,16,3,13,6.0,0.0,6.0
9712332,1,1,0,0,0,1,2,51,1.0,1.0,0.0,0.0,0.0,1.0,2.0,5,1,4,4.0,1.0,3.0
9307265,3,1,2,3,0,3,8,56,3.0,1.0,2.0,3.0,0.0,3.0,8.0,7,3,4,,,
9908508,17,9,8,16,3,14,35,184,7.0,3.0,4.0,5.0,0.0,7.0,16.0,27,17,10,10.0,6.0,4.0
9407323,2,2,0,0,1,1,1,223,0.0,0.0,0.0,0.0,0.0,0.0,0.0,8,2,6,1.0,0.0,1.0
9702226,11,6,5,6,0,11,37,13,8.0,4.0,4.0,4.0,0.0,8.0,21.0,18,11,7,5.0,2.0,3.0
9610302,2,2,0,0,1,1,1,77,1.0,1.0,0.0,0.0,0.0,1.0,1.0,3,2,1,1.0,1.0,0.0
2048,11,5,6,7,1,10,59,38,5.0,1.0,4.0,5.0,0.0,5.0,40.0,27,11,16,14.0,5.0,9.0
9903412,14,5,9,18,0,14,46,25,7.0,3.0,4.0,6.0,0.0,7.0,14.0,26,14,12,9.0,7.0,2.0
9512201,6,4,2,2,1,5,7,190,1.0,1.0,0.0,0.0,0.0,1.0,1.0,16,6,10,5.0,0.0,5.0
9703274,3,3,0,0,1,2,2,74,1.0,1.0,0.0,0.0,0.0,1.0,1.0,5,3,2,3.0,1.0,2.0
9802388,6,5,1,1,1,5,23,87,4.0,4.0,0.0,0.0,0.0,4.0,19.0,13,6,7,9.0,2.0,7.0
9903335,4,4,0,0,0,4,23,1,4.0,4.0,0.0,0.0,0.0,4.0,23.0,12,4,8,,,
9911327,10,7,3,5,2,8,73,12,8.0,5.0,3.0,5.0,0.0,8.0,72.0,33,10,23,15.0,3.0,12.0
9702358,12,6,6,12,2,10,30,7,1.0,1.0,0.0,0.0,0.0,1.0,1.0,18,12,6,6.0,5.0,1.0
9811487,2,1,1,1,2,0,0,142,1.0,1.0,0.0,0.0,1.0,0.0,0.0,2,2,0,1.0,1.0,0.0
102076,0,0,0,0,0,0,0,0,0.0,0.0,0.0,0.0,0.0,0.0,0.0,10,0,10,6.0,0.0,6.0
9610213,10,4,6,11,0,10,31,108,6.0,3.0,3.0,6.0,0.0,6.0,24.0,17,10,7,9.0,4.0,5.0
9703242,1,1,0,0,1,0,0,1151,1.0,1.0,0.0,0.0,1.0,0.0,0.0,2,1,1,,,
9209224,5,4,1,1,5,0,0,325,4.0,3.0,1.0,1.0,4.0,0.0,0.0,5,5,0,2.0,2.0,0.0
104080,10,6,4,6,3,7,28,301,5.0,2.0,3.0,5.0,0.0,5.0,16.0,17,10,7,12.0,5.0,7.0
9911313,5,1,4,8,1,4,18,49,4.0,1.0,3.0,6.0,1.0,3.0,13.0,16,5,11,2.0,1.0,1.0
103022,7,5,2,2,2,5,13,212,4.0,4.0,0.0,0.0,1.0,3.0,9.0,15,7,8,4.0,1.0,3.0
2004,14,5,9,23,0,14,104,21,4.0,3.0,1.0,1.0,0.0,4.0,16.0,36,14,22,12.0,4.0,8.0
112360,6,2,4,7,0,6,55,2,1.0,1.0,0.0,0.0,0.0,1.0,12.0,40,6,34,5.0,0.0,5.0
203062,5,2,3,6,0,5,66,73,5.0,2.0,3.0,6.0,0.0,5.0,62.0,29,5,24,15.0,1.0,14.0
9809270,2,2,0,0,0,2,2,422,0.0,0.0,0.0,0.0,0.0,0.0,0.0,6,2,4,1.0,0.0,1.0
9708435,7,4,3,3,3,4,6,203,4.0,2.0,2.0,2.0,2.0,2.0,2.0,11,7,4,3.0,3.0,0.0
9812304,5,2,3,4,0,5,33,16,3.0,1.0,2.0,2.0,0.0,3.0,21.0,22,5,17,14.0,3.0,11.0
9410217,1,1,0,0,1,0,0,555,1.0,1.0,0.0,0.0,1.0,0.0,0.0,1,1,0,1.0,1.0,0.0
211307,0,0,0,0,0,0,0,50,0.0,0.0,0.0,0.0,0.0,0.0,0.0,8,0,8,2.0,0.0,2.0
108064,1,1,0,0,0,1,18,0,1.0,1.0,0.0,0.0,0.0,1.0,9.0,38,1,37,4.0,0.0,4.0
9907398,3,2,1,1,0,3,4,91,1.0,1.0,0.0,0.0,0.0,1.0,1.0,10,3,7,4.0,0.0,4.0
9702342,7,3,4,10,4,3,6,333,5.0,1.0,4.0,10.0,2.0,3.0,6.0,10,7,3,6.0,4.0,2.0
9902393,10,4,6,13,1,9,17,130,6.0,2.0,4.0,9.0,1.0,5.0,7.0,14,10,4,1.0,1.0,0.0
9605364,2,2,0,0,0,2,2,265,2.0,2.0,0.0,0.0,0.0,2.0,2.0,3,2,1,2.0,1.0,1.0
9810376,7,2,5,10,1,6,12,13,6.0,1.0,5.0,10.0,0.0,6.0,12.0,14,7,7,3.0,0.0,3.0
9303220,4,3,1,1,4,0,0,85,3.0,3.0,0.0,0.0,3.0,0.0,0.0,8,4,4,2.0,2.0,0.0
9806296,1,1,0,0,1,0,0,101,0.0,0.0,0.0,0.0,0.0,0.0,0.0,4,1,3,1.0,0.0,1.0
1034,6,3,3,6,2,4,15,95,4.0,2.0,2.0,3.0,1.0,3.0,13.0,16,6,10,4.0,2.0,2.0
9708270,6,3,3,4,2,4,4,351,3.0,1.0,2.0,2.0,2.0,1.0,1.0,9,6,3,2.0,2.0,0.0
9602405,39,12,27,52,21,18,29,40,10.0,5.0,5.0,8.0,0.0,10.0,14.0,44,39,5,6.0,6.0,0.0
9309225,5,2,3,3,5,0,0,91,1.0,1.0,0.0,0.0,1.0,0.0,0.0,6,5,1,1.0,1.0,0.0
9704250,24,9,15,38,4,20,82,40,14.0,4.0,10.0,27.0,1.0,13.0,65.0,35,24,11,6.0,6.0,0.0
2231,0,0,0,0,0,0,0,51,0.0,0.0,0.0,0.0,0.0,0.0,0.0,7,0,7,2.0,0.0,2.0
9706486,5,2,3,3,0,5,26,17,1.0,1.0,0.0,0.0,0.0,1.0,14.0,29,5,24,7.0,2.0,5.0
4096,1,1,0,0,0,1,3,3,0.0,0.0,0.0,0.0,0.0,0.0,0.0,14,1,13,7.0,0.0,7.0
9610206,4,1,3,5,3,1,1,593,1.0,1.0,0.0,0.0,1.0,0.0,0.0,6,4,2,2.0,2.0,0.0
112249,2,2,0,0,0,2,7,28,1.0,1.0,0.0,0.0,0.0,1.0,2.0,19,2,17,2.0,0.0,2.0
9711276,7,5,2,3,3,4,6,144,5.0,4.0,1.0,2.0,3.0,2.0,3.0,10,7,3,4.0,3.0,1.0
104227,4,3,1,1,1,3,5,70,0.0,0.0,0.0,0.0,0.0,0.0,0.0,31,4,27,23.0,0.0,23.0
106232,4,3,1,1,0,4,13,0,0.0,0.0,0.0,0.0,0.0,0.0,0.0,11,4,7,2.0,0.0,2.0
9709203,12,4,8,15,5,7,34,179,3.0,1.0,2.0,2.0,2.0,1.0,3.0,22,12,10,6.0,3.0,3.0
9904311,5,1,4,4,1,4,13,1,4.0,1.0,3.0,3.0,4.0,0.0,0.0,13,5,8,4.0,4.0,0.0
9411443,3,2,1,1,0,3,8,265,2.0,2.0,0.0,0.0,0.0,2.0,5.0,8,3,5,4.0,1.0,3.0
9411351,3,2,1,1,3,0,0,188,2.0,2.0,0.0,0.0,2.0,0.0,0.0,3,3,0,1.0,1.0,0.0
9512405,4,3,1,2,2,2,2,309,3.0,2.0,1.0,2.0,2.0,1.0,1.0,5,4,1,2.0,2.0,0.0
205228,20,4,16,27,0,20,111,107,9.0,2.0,7.0,11.0,0.0,9.0,53.0,45,20,25,17.0,3.0,14.0
209020,11,4,7,19,0,11,63,46,8.0,3.0,5.0,14.0,0.0,8.0,58.0,22,11,11,5.0,4.0,1.0
9410317,7,1,6,12,4,3,3,57,7.0,1.0,6.0,12.0,4.0,3.0,3.0,8,7,1,7.0,7.0,0.0
9508294,4,2,2,3,4,0,0,6,3.0,1.0,2.0,3.0,3.0,0.0,0.0,11,4,7,,,
101166,2,2,0,0,0,2,6,100,1.0,1.0,0.0,0.0,0.0,1.0,5.0,9,2,7,8.0,1.0,7.0
9708229,1,1,0,0,0,1,3,1864,,,,,,,,5,1,4,,,
9610245,3,2,1,1,3,0,0,47,0.0,0.0,0.0,0.0,0.0,0.0,0.0,30,3,27,3.0,0.0,3.0
9611412,6,2,4,6,0,6,14,136,6.0,2.0,4.0,6.0,0.0,6.0,14.0,10,6,4,8.0,5.0,3.0
210286,1,1,0,0,0,1,9,7,0.0,0.0,0.0,0.0,0.0,0.0,0.0,18,1,17,7.0,1.0,6.0
209189,2,2,0,0,0,2,5,17,1.0,1.0,0.0,0.0,0.0,1.0,2.0,13,2,11,4.0,1.0,3.0
9906448,4,1,3,3,0,4,12,59,4.0,1.0,3.0,3.0,0.0,4.0,12.0,11,4,7,7.0,3.0,4.0
101260,10,8,2,2,1,9,71,25,3.0,2.0,1.0,1.0,0.0,3.0,39.0,43,10,33,18.0,2.0,16.0
9802422,8,5,3,3,0,8,56,5,6.0,3.0,3.0,3.0,0.0,6.0,53.0,30,8,22,3.0,2.0,1.0
9605457,9,6,3,3,1,8,19,30,7.0,5.0,2.0,2.0,0.0,7.0,18.0,14,9,5,5.0,2.0,3.0
9306237,14,3,11,36,1,13,13,116,13.0,2.0,11.0,36.0,1.0,12.0,12.0,15,14,1,13.0,12.0,1.0
9311240,1,1,0,0,1,0,0,246,0.0,0.0,0.0,0.0,0.0,0.0,0.0,6,1,5,1.0,0.0,1.0
6263,1,1,0,0,1,0,0,57,0.0,0.0,0.0,0.0,0.0,0.0,0.0,6,1,5,,,
9506422,15,4,11,22,14,1,1,54,8.0,4.0,4.0,4.0,8.0,0.0,0.0,16,15,1,4.0,3.0,1.0
210207,4,3,1,1,1,3,12,3,0.0,0.0,0.0,0.0,0.0,0.0,0.0,17,4,13,4.0,0.0,4.0
108144,10,4,6,14,0,10,46,7,6.0,3.0,3.0,5.0,0.0,6.0,19.0,25,10,15,13.0,4.0,9.0
9909416,1,1,0,0,0,1,11,87,1.0,1.0,0.0,0.0,0.0,1.0,3.0,12,1,11,1.0,0.0,1.0
9706223,13,9,4,8,1,12,48,29,5.0,3.0,2.0,3.0,0.0,5.0,15.0,29,13,16,7.0,3.0,4.0
9803300,2,2,0,0,0,2,9,38,1.0,1.0,0.0,0.0,0.0,1.0,8.0,13,2,11,,,
9708315,3,2,1,1,0,3,9,42,1.0,1.0,0.0,0.0,0.0,1.0,1.0,16,3,13,3.0,2.0,1.0
9712489,3,1,2,3,0,3,9,229,0.0,0.0,0.0,0.0,0.0,0.0,0.0,20,3,17,5.0,0.0,5.0
9703272,2,2,0,0,2,0,0,213,1.0,1.0,0.0,0.0,1.0,0.0,0.0,5,2,3,1.0,0.0,1.0
112082,7,5,2,2,6,1,2,495,1.0,1.0,0.0,0.0,0.0,1.0,1.0,10,7,3,2.0,1.0,1.0
9702254,1,1,0,0,0,1,1,15,0.0,0.0,0.0,0.0,0.0,0.0,0.0,21,1,20,6.0,0.0,6.0
9601277,12,3,9,17,2,10,21,133,5.0,3.0,2.0,2.0,1.0,4.0,9.0,18,12,6,6.0,3.0,3.0
9808288,1,1,0,0,0,1,11,36,1.0,1.0,0.0,0.0,0.0,1.0,8.0,17,1,16,12.0,1.0,11.0
208078,14,8,6,11,0,14,159,7,7.0,5.0,2.0,2.0,0.0,7.0,60.0,79,14,65,19.0,7.0,12.0
9411279,11,2,9,17,11,0,0,110,10.0,2.0,8.0,15.0,10.0,0.0,0.0,12,11,1,5.0,5.0,0.0
9810237,3,3,0,0,3,0,0,216,1.0,1.0,0.0,0.0,1.0,0.0,0.0,9,3,6,4.0,1.0,3.0
101300,9,4,5,11,0,9,90,27,0.0,0.0,0.0,0.0,0.0,0.0,0.0,65,9,56,12.0,6.0,6.0
9303288,9,7,2,4,7,2,2,248,5.0,3.0,2.0,4.0,5.0,0.0,0.0,14,9,5,5.0,4.0,1.0
111108,1,1,0,0,0,1,1,0,0.0,0.0,0.0,0.0,0.0,0.0,0.0,12,1,11,5.0,0.0,5.0
11062,12,3,9,25,1,11,20,181,9.0,3.0,6.0,8.0,1.0,8.0,10.0,20,12,8,9.0,8.0,1.0
205320,1,1,0,0,0,1,3,121,0.0,0.0,0.0,0.0,0.0,0.0,0.0,13,1,12,5.0,0.0,5.0
10150,8,1,7,21,0,8,117,9,8.0,1.0,7.0,21.0,0.0,8.0,106.0,36,8,28,10.0,5.0,5.0
9706364,4,4,0,0,4,0,0,486,2.0,2.0,0.0,0.0,2.0,0.0,0.0,5,4,1,2.0,2.0,0.0
9502373,6,2,4,6,3,3,8,33,2.0,2.0,0.0,0.0,0.0,2.0,4.0,11,6,5,2.0,2.0,0.0
9908501,5,4,1,1,0,5,9,289,2.0,1.0,1.0,1.0,0.0,2.0,4.0,10,5,5,4.0,2.0,2.0
9408294,6,2,4,6,2,4,13,78,3.0,2.0,1.0,1.0,0.0,3.0,3.0,11,6,5,4.0,3.0,1.0
9807398,6,3,3,4,0,6,25,1,5.0,3.0,2.0,2.0,0.0,5.0,18.0,16,6,10,2.0,1.0,1.0
204206,3,3,0,0,0,3,8,68,1.0,1.0,0.0,0.0,0.0,1.0,3.0,40,3,37,21.0,0.0,21.0
9712441,3,2,1,1,1,2,6,113,1.0,1.0,0.0,0.0,0.0,1.0,2.0,7,3,4,3.0,1.0,2.0
103345,2,2,0,0,1,1,4,74,0.0,0.0,0.0,0.0,0.0,0.0,0.0,11,2,9,5.0,0.0,5.0
3070,3,2,1,1,0,3,30,11,2.0,1.0,1.0,1.0,0.0,2.0,27.0,28,3,25,2.0,0.0,2.0
9706313,5,3,2,3,0,5,9,7,3.0,2.0,1.0,1.0,0.0,3.0,3.0,7,5,2,1.0,1.0,0.0
9508234,4,3,1,1,0,4,8,162,2.0,1.0,1.0,1.0,0.0,2.0,6.0,8,4,4,5.0,2.0,3.0
9802262,10,4,6,11,3,7,30,25,5.0,3.0,2.0,2.0,1.0,4.0,19.0,20,10,10,12.0,5.0,7.0
9810384,6,3,3,6,6,0,0,28,1.0,1.0,0.0,0.0,1.0,0.0,0.0,6,6,0,2.0,2.0,0.0
9905554,9,4,5,12,2,7,18,16,4.0,1.0,3.0,6.0,0.0,4.0,8.0,14,9,5,7.0,4.0,3.0
9806226,19,8,11,20,3,16,47,113,11.0,2.0,9.0,17.0,0.0,11.0,38.0,29,19,10,16.0,10.0,6.0
9805459,2,2,0,0,0,2,2,197,1.0,1.0,0.0,0.0,0.0,1.0,1.0,4,2,2,2.0,1.0,1.0
9609518,10,2,8,10,2,8,35,4,4.0,3.0,1.0,1.0,0.0,4.0,12.0,21,10,11,5.0,1.0,4.0
9609352,7,3,4,7,1,6,45,6,6.0,2.0,4.0,7.0,1.0,5.0,14.0,23,7,16,9.0,4.0,5.0
9902418,7,6,1,1,5,2,5,27,3.0,2.0,1.0,1.0,3.0,0.0,0.0,14,7,7,2.0,2.0,0.0
102150,4,1,3,3,1,3,23,49,3.0,1.0,2.0,2.0,1.0,2.0,15.0,16,4,12,4.0,1.0,3.0
9407319,3,1,2,2,1,2,2,124,1.0,1.0,0.0,0.0,0.0,1.0,1.0,4,3,1,3.0,2.0,1.0
1270,11,6,5,7,1,10,23,127,7.0,3.0,4.0,5.0,2.0,5.0,5.0,19,11,8,9.0,7.0,2.0
5098,3,2,1,1,0,3,15,26,2.0,1.0,1.0,1.0,0.0,2.0,10.0,16,3,13,10.0,2.0,8.0
9801225,3,2,1,1,0,3,9,133,1.0,1.0,0.0,0.0,0.0,1.0,1.0,13,3,10,3.0,1.0,2.0
9401263,1,1,0,0,1,0,0,2024,,,,,,,,1,1,0,,,
212037,1,1,0,0,1,0,0,4,0.0,0.0,0.0,0.0,0.0,0.0,0.0,42,1,41,24.0,0.0,24.0
9510358,3,2,1,1,0,3,5,84,0.0,0.0,0.0,0.0,0.0,0.0,0.0,7,3,4,3.0,1.0,2.0
111138,9,3,6,14,1,8,27,0,6.0,2.0,4.0,9.0,0.0,6.0,21.0,23,9,14,10.0,6.0,4.0
4006,0,0,0,0,0,0,0,39,0.0,0.0,0.0,0.0,0.0,0.0,0.0,19,0,19,18.0,0.0,18.0
109042,1,1,0,0,1,0,0,344,0.0,0.0,0.0,0.0,0.0,0.0,0.0,5,1,4,2.0,0.0,2.0
12090,3,3,0,0,0,3,8,2,1.0,1.0,0.0,0.0,0.0,1.0,2.0,17,3,14,11.0,0.0,11.0
9909332,13,6,7,15,0,13,63,82,10.0,3.0,7.0,15.0,0.0,10.0,60.0,23,13,10,15.0,6.0,9.0
104247,2,2,0,0,1,1,1,477,1.0,1.0,0.0,0.0,1.0,0.0,0.0,5,2,3,1.0,1.0,0.0
106181,6,6,0,0,2,4,33,16,1.0,1.0,0.0,0.0,0.0,1.0,13.0,41,6,35,19.0,1.0,18.0
101146,3,2,1,1,1,2,8,236,1.0,1.0,0.0,0.0,0.0,1.0,5.0,11,3,8,6.0,1.0,5.0
9506433,6,3,3,4,2,4,5,103,4.0,2.0,2.0,2.0,4.0,0.0,0.0,10,6,4,3.0,2.0,1.0
9312254,2,1,1,1,1,1,1,409,2.0,1.0,1.0,1.0,1.0,1.0,1.0,3,2,1,3.0,2.0,1.0
9209290,16,9,7,14,16,0,0,170,7.0,6.0,1.0,2.0,7.0,0.0,0.0,16,16,0,3.0,3.0,0.0
9408317,22,8,14,34,22,0,0,178,12.0,6.0,6.0,18.0,12.0,0.0,0.0,22,22,0,8.0,8.0,0.0
212146,18,5,13,38,3,15,86,0,6.0,1.0,5.0,11.0,0.0,6.0,41.0,38,18,20,21.0,5.0,16.0
9609317,0,0,0,0,0,0,0,15,0.0,0.0,0.0,0.0,0.0,0.0,0.0,6,0,6,5.0,0.0,5.0
9906517,1,1,0,0,0,1,7,61,0.0,0.0,0.0,0.0,0.0,0.0,0.0,96,1,95,15.0,0.0,15.0
9912263,1,1,0,0,0,1,13,4,1.0,1.0,0.0,0.0,0.0,1.0,13.0,18,1,17,18.0,1.0,17.0
110241,1,1,0,0,0,1,7,69,0.0,0.0,0.0,0.0,0.0,0.0,0.0,11,1,10,3.0,0.0,3.0
7169,13,5,8,20,0,13,74,49,5.0,1.0,4.0,6.0,0.0,5.0,28.0,34,13,21,12.0,4.0,8.0
209125,2,1,1,1,0,2,25,49,2.0,1.0,1.0,1.0,0.0,2.0,21.0,34,2,32,7.0,0.0,7.0
9249,2,2,0,0,1,1,1,30,0.0,0.0,0.0,0.0,0.0,0.0,0.0,21,2,19,1.0,0.0,1.0
9804216,1,1,0,0,1,0,0,1189,1.0,1.0,0.0,0.0,1.0,0.0,0.0,4,1,3,1.0,1.0,0.0
8252,4,2,2,3,1,3,5,261,4.0,2.0,2.0,3.0,1.0,3.0,3.0,7,4,3,4.0,3.0,1.0
9801366,8,7,1,1,0,8,28,13,2.0,2.0,0.0,0.0,1.0,1.0,2.0,18,8,10,3.0,2.0,1.0
10036,4,3,1,1,0,4,7,18,1.0,1.0,0.0,0.0,1.0,0.0,0.0,12,4,8,1.0,1.0,0.0
9401327,7,3,4,6,5,2,4,179,5.0,2.0,3.0,5.0,3.0,2.0,4.0,10,7,3,5.0,4.0,1.0
101014,4,2,2,2,1,3,8,215,2.0,1.0,1.0,1.0,0.0,2.0,5.0,8,4,4,6.0,2.0,4.0
9212265,10,6,4,6,10,0,0,90,4.0,2.0,2.0,3.0,4.0,0.0,0.0,10,10,0,3.0,3.0,0.0
209072,1,1,0,0,0,1,5,22,1.0,1.0,0.0,0.0,0.0,1.0,5.0,15,1,14,8.0,0.0,8.0
9802375,3,2,1,1,3,0,0,218,1.0,1.0,0.0,0.0,1.0,0.0,0.0,3,3,0,1.0,1.0,0.0
202050,8,6,2,4,0,8,76,3,6.0,5.0,1.0,2.0,0.0,6.0,45.0,25,8,17,18.0,7.0,11.0
9509363,13,4,9,22,3,10,10,161,8.0,1.0,7.0,18.0,8.0,0.0,0.0,16,13,3,7.0,7.0,0.0
206100,3,3,0,0,0,3,3,24,2.0,2.0,0.0,0.0,2.0,0.0,0.0,13,3,10,3.0,3.0,0.0
9707405,6,5,1,1,1,5,7,42,0.0,0.0,0.0,0.0,0.0,0.0,0.0,12,6,6,1.0,1.0,0.0
9406277,1,1,0,0,1,0,0,22,0.0,0.0,0.0,0.0,0.0,0.0,0.0,6,1,5,1.0,0.0,1.0
9605256,3,2,1,1,0,3,17,6,1.0,1.0,0.0,0.0,0.0,1.0,9.0,21,3,18,2.0,2.0,0.0
9801349,12,4,8,12,2,10,11,152,11.0,3.0,8.0,12.0,2.0,9.0,9.0,14,12,2,10.0,9.0,1.0
212393,0,0,0,0,0,0,0,91,0.0,0.0,0.0,0.0,0.0,0.0,0.0,12,0,12,5.0,0.0,5.0
202202,8,3,5,9,0,8,53,52,7.0,2.0,5.0,9.0,0.0,7.0,51.0,21,8,13,19.0,6.0,13.0
106026,4,3,1,1,0,4,8,65,2.0,2.0,0.0,0.0,0.0,2.0,2.0,11,4,7,2.0,1.0,1.0
9712455,2,1,1,1,0,2,8,288,2.0,1.0,1.0,1.0,0.0,2.0,5.0,9,2,7,7.0,2.0,5.0
9902384,1,1,0,0,0,1,5,130,0.0,0.0,0.0,0.0,0.0,0.0,0.0,14,1,13,6.0,0.0,6.0
9803216,9,5,4,7,5,4,9,198,6.0,2.0,4.0,6.0,3.0,3.0,3.0,17,9,8,5.0,5.0,0.0
9703396,2,1,1,1,0,2,4,230,2.0,1.0,1.0,1.0,0.0,2.0,2.0,5,2,3,3.0,2.0,1.0
9709211,10,4,6,16,1,9,60,94,8.0,2.0,6.0,16.0,0.0,8.0,56.0,19,10,9,16.0,8.0,8.0
210120,1,1,0,0,0,1,5,92,0.0,0.0,0.0,0.0,0.0,0.0,0.0,22,1,21,7.0,0.0,7.0
9902360,2,1,1,1,0,2,18,24,0.0,0.0,0.0,0.0,0.0,0.0,0.0,17,2,15,8.0,1.0,7.0
6279,1,1,0,0,1,0,0,472,1.0,1.0,0.0,0.0,1.0,0.0,0.0,2,1,1,1.0,0.0,1.0
9408338,1,1,0,0,0,1,1,156,1.0,1.0,0.0,0.0,0.0,1.0,1.0,2,1,1,,,
9908376,7,3,4,9,0,7,31,40,7.0,3.0,4.0,9.0,0.0,7.0,30.0,14,7,7,7.0,4.0,3.0
11324,3,3,0,0,0,3,6,278,1.0,1.0,0.0,0.0,0.0,1.0,2.0,14,3,11,4.0,1.0,3.0
205245,2,1,1,1,0,2,2,126,2.0,1.0,1.0,1.0,0.0,2.0,2.0,5,2,3,4.0,2.0,2.0
9306266,2,1,1,1,2,0,0,126,2.0,1.0,1.0,1.0,2.0,0.0,0.0,2,2,0,2.0,2.0,0.0
201061,7,6,1,2,0,7,22,27,4.0,4.0,0.0,0.0,0.0,4.0,15.0,16,7,9,8.0,2.0,6.0
109177,5,4,1,1,2,3,7,28,0.0,0.0,0.0,0.0,0.0,0.0,0.0,16,5,11,3.0,1.0,2.0
9910229,8,2,6,13,0,8,31,125,6.0,1.0,5.0,9.0,0.0,6.0,22.0,17,8,9,10.0,5.0,5.0
5235,5,3,2,2,0,5,38,2,2.0,1.0,1.0,1.0,0.0,2.0,14.0,28,5,23,12.0,1.0,11.0
9903310,4,4,0,0,3,1,1,336,2.0,2.0,0.0,0.0,1.0,1.0,1.0,8,4,4,5.0,1.0,4.0
9407267,9,1,8,24,9,0,0,90,9.0,1.0,8.0,24.0,9.0,0.0,0.0,9,9,0,2.0,2.0,0.0
5238,3,2,1,1,0,3,28,50,2.0,1.0,1.0,1.0,0.0,2.0,11.0,25,3,22,12.0,3.0,9.0
109053,4,3,1,1,0,4,12,0,1.0,1.0,0.0,0.0,0.0,1.0,5.0,23,4,19,4.0,1.0,3.0
9806396,3,3,0,0,1,2,8,144,2.0,2.0,0.0,0.0,0.0,2.0,8.0,7,3,4,5.0,2.0,3.0
9609293,2,2,0,0,1,1,5,115,1.0,1.0,0.0,0.0,0.0,1.0,4.0,9,2,7,1.0,0.0,1.0
9812368,10,1,9,17,6,4,7,180,7.0,1.0,6.0,11.0,3.0,4.0,7.0,13,10,3,10.0,7.0,3.0
9907334,2,2,0,0,1,1,1,386,2.0,2.0,0.0,0.0,1.0,1.0,1.0,5,2,3,3.0,1.0,2.0
107135,7,2,5,11,0,7,92,16,4.0,1.0,3.0,5.0,0.0,4.0,39.0,48,7,41,10.0,4.0,6.0
9507356,0,0,0,0,0,0,0,13,,,,,,,,5,0,5,1.0,0.0,1.0
105152,1,1,0,0,0,1,4,64,1.0,1.0,0.0,0.0,0.0,1.0,4.0,14,1,13,7.0,1.0,6.0
9710507,1,1,0,0,0,1,2,214,0.0,0.0,0.0,0.0,0.0,0.0,0.0,5,1,4,3.0,1.0,2.0
11060,1,1,0,0,1,0,0,1209,1.0,1.0,0.0,0.0,1.0,0.0,0.0,1,1,0,,,
6110,6,3,3,4,0,6,44,1,5.0,3.0,2.0,3.0,0.0,5.0,17.0,51,6,45,8.0,2.0,6.0
3263,0,0,0,0,0,0,0,276,0.0,0.0,0.0,0.0,0.0,0.0,0.0,1,0,1,1.0,0.0,1.0
210094,1,1,0,0,0,1,5,47,1.0,1.0,0.0,0.0,0.0,1.0,5.0,15,1,14,15.0,1.0,14.0
9502333,1,1,0,0,1,0,0,341,0.0,0.0,0.0,0.0,0.0,0.0,0.0,6,1,5,3.0,0.0,3.0
9908265,19,7,12,40,0,19,178,16,18.0,7.0,11.0,39.0,0.0,18.0,174.0,47,19,28,16.0,11.0,5.0
102060,2,1,1,1,0,2,15,3,2.0,1.0,1.0,1.0,0.0,2.0,15.0,37,2,35,9.0,0.0,9.0
7242,3,3,0,0,0,3,14,7,1.0,1.0,0.0,0.0,0.0,1.0,1.0,27,3,24,2.0,0.0,2.0
9306203,3,3,0,0,3,0,0,323,3.0,3.0,0.0,0.0,3.0,0.0,0.0,3,3,0,2.0,2.0,0.0
9809281,2,2,0,0,1,1,1,139,1.0,1.0,0.0,0.0,0.0,1.0,1.0,4,2,2,3.0,1.0,2.0
9610289,0,0,0,0,0,0,0,1414,,,,,,,,2,0,2,,,
1201,4,3,1,1,0,4,12,33,0.0,0.0,0.0,0.0,0.0,0.0,0.0,11,4,7,3.0,0.0,3.0
209178,4,2,2,3,0,4,53,9,4.0,2.0,2.0,3.0,0.0,4.0,51.0,29,4,25,13.0,4.0,9.0
9303,1,1,0,0,0,1,1,136,1.0,1.0,0.0,0.0,0.0,1.0,1.0,12,1,11,4.0,0.0,4.0
9903331,3,1,2,3,0,3,15,44,3.0,1.0,2.0,3.0,0.0,3.0,6.0,12,3,9,6.0,3.0,3.0
9908521,4,4,0,0,1,3,3,128,3.0,3.0,0.0,0.0,0.0,3.0,3.0,6,4,2,2.0,2.0,0.0
9611209,3,3,0,0,1,2,4,141,2.0,2.0,0.0,0.0,0.0,2.0,4.0,5,3,2,2.0,2.0,0.0
3223,2,1,1,1,0,2,4,70,0.0,0.0,0.0,0.0,0.0,0.0,0.0,19,2,17,17.0,0.0,17.0
101215,9,5,4,9,0,9,113,29,3.0,2.0,1.0,1.0,0.0,3.0,22.0,38,9,29,6.0,3.0,3.0
9812292,6,2,4,7,3,3,3,112,4.0,1.0,3.0,6.0,2.0,2.0,2.0,12,6,6,5.0,4.0,1.0
203041,4,1,3,4,0,4,78,7,2.0,1.0,1.0,1.0,0.0,2.0,12.0,32,4,28,12.0,3.0,9.0
9503282,8,1,7,14,0,8,32,90,8.0,1.0,7.0,14.0,0.0,8.0,26.0,18,8,10,11.0,8.0,3.0
9205241,1,1,0,0,1,0,0,1382,1.0,1.0,0.0,0.0,1.0,0.0,0.0,1,1,0,,,
12288,5,3,2,2,1,4,23,10,0.0,0.0,0.0,0.0,0.0,0.0,0.0,51,5,46,5.0,0.0,5.0
9809310,13,2,11,26,0,13,49,42,11.0,2.0,9.0,20.0,0.0,11.0,20.0,24,13,11,12.0,10.0,2.0
9707446,2,1,1,1,2,0,0,160,1.0,1.0,0.0,0.0,1.0,0.0,0.0,4,2,2,2.0,2.0,0.0
9708242,0,0,0,0,0,0,0,211,0.0,0.0,0.0,0.0,0.0,0.0,0.0,16,0,16,2.0,0.0,2.0
1045,7,2,5,7,4,3,7,167,5.0,1.0,4.0,6.0,5.0,0.0,0.0,12,7,5,5.0,5.0,0.0
110280,2,1,1,1,0,2,6,131,2.0,1.0,1.0,1.0,0.0,2.0,6.0,6,2,4,4.0,2.0,2.0
8188,13,6,7,15,1,12,47,31,11.0,5.0,6.0,14.0,0.0,11.0,26.0,31,13,18,9.0,7.0,2.0
205081,0,0,0,0,0,0,0,80,0.0,0.0,0.0,0.0,0.0,0.0,0.0,3,0,3,2.0,0.0,2.0
9608463,4,2,2,2,2,2,4,14,2.0,1.0,1.0,1.0,2.0,0.0,0.0,9,4,5,2.0,2.0,0.0
104030,6,2,4,9,1,5,10,187,5.0,1.0,4.0,9.0,0.0,5.0,10.0,8,6,2,7.0,5.0,2.0
9408303,6,5,1,1,2,4,5,79,1.0,1.0,0.0,0.0,0.0,1.0,1.0,10,6,4,2.0,1.0,1.0
108173,6,4,2,4,0,6,60,20,4.0,2.0,2.0,3.0,0.0,4.0,41.0,41,6,35,24.0,1.0,23.0
104243,9,4,5,8,0,9,53,4,3.0,1.0,2.0,2.0,0.0,3.0,13.0,30,9,21,7.0,3.0,4.0
210433,5,2,3,5,0,5,24,1,1.0,1.0,0.0,0.0,0.0,1.0,2.0,18,5,13,11.0,2.0,9.0
1132,4,2,2,2,1,3,12,267,3.0,1.0,2.0,2.0,0.0,3.0,12.0,19,4,15,7.0,3.0,4.0
9801347,8,1,7,15,5,3,4,175,8.0,1.0,7.0,15.0,5.0,3.0,3.0,10,8,2,9.0,8.0,1.0
101001,3,2,1,1,2,1,1,457,2.0,1.0,1.0,1.0,2.0,0.0,0.0,4,3,1,2.0,2.0,0.0
202077,4,4,0,0,0,4,19,105,1.0,1.0,0.0,0.0,0.0,1.0,4.0,30,4,26,8.0,1.0,7.0
3019,5,4,1,1,0,5,23,20,0.0,0.0,0.0,0.0,0.0,0.0,0.0,14,5,9,1.0,1.0,0.0
5045,2,2,0,0,0,2,4,107,1.0,1.0,0.0,0.0,0.0,1.0,2.0,12,2,10,5.0,1.0,4.0
9901249,0,0,0,0,0,0,0,39,0.0,0.0,0.0,0.0,0.0,0.0,0.0,12,0,12,3.0,0.0,3.0
9507312,2,1,1,1,0,2,9,112,2.0,1.0,1.0,1.0,0.0,2.0,7.0,26,2,24,10.0,2.0,8.0
7059,3,1,2,2,0,3,9,29,2.0,1.0,1.0,1.0,0.0,2.0,6.0,23,3,20,4.0,3.0,1.0
101206,1,1,0,0,0,1,5,4,0.0,0.0,0.0,0.0,0.0,0.0,0.0,33,1,32,5.0,0.0,5.0
105030,3,3,0,0,0,3,10,115,0.0,0.0,0.0,0.0,0.0,0.0,0.0,25,3,22,9.0,0.0,9.0
208257,2,2,0,0,1,1,5,32,0.0,0.0,0.0,0.0,0.0,0.0,0.0,28,2,26,4.0,0.0,4.0
9910281,0,0,0,0,0,0,0,126,0.0,0.0,0.0,0.0,0.0,0.0,0.0,5,0,5,1.0,0.0,1.0
9804461,3,3,0,0,0,3,24,117,3.0,3.0,0.0,0.0,0.0,3.0,21.0,15,3,12,12.0,3.0,9.0
9712298,2,2,0,0,0,2,15,17,2.0,2.0,0.0,0.0,0.0,2.0,15.0,20,2,18,18.0,1.0,17.0
9804314,0,0,0,0,0,0,0,363,0.0,0.0,0.0,0.0,0.0,0.0,0.0,5,0,5,,,
9511415,6,3,3,3,0,6,31,10,4.0,2.0,2.0,2.0,0.0,4.0,24.0,24,6,18,10.0,4.0,6.0
9711376,1,1,0,0,0,1,1,31,0.0,0.0,0.0,0.0,0.0,0.0,0.0,4,1,3,2.0,0.0,2.0
210348,1,1,0,0,0,1,5,21,1.0,1.0,0.0,0.0,0.0,1.0,2.0,6,1,5,6.0,1.0,5.0
302098,0,0,0,0,0,0,0,38,0.0,0.0,0.0,0.0,0.0,0.0,0.0,9,0,9,3.0,0.0,3.0
2252,15,5,10,25,12,3,6,166,9.0,2.0,7.0,14.0,9.0,0.0,0.0,24,15,9,7.0,7.0,0.0
8195,9,3,6,10,0,9,14,51,7.0,2.0,5.0,9.0,0.0,7.0,8.0,18,9,9,7.0,6.0,1.0
9407220,3,2,1,1,1,2,2,795,1.0,1.0,0.0,0.0,1.0,0.0,0.0,4,3,1,2.0,2.0,0.0
207318,1,1,0,0,0,1,12,17,1.0,1.0,0.0,0.0,0.0,1.0,3.0,14,1,13,4.0,1.0,3.0
3148,2,2,0,0,0,2,4,59,2.0,2.0,0.0,0.0,0.0,2.0,3.0,7,2,5,4.0,2.0,2.0
9804279,3,3,0,0,0,3,11,69,0.0,0.0,0.0,0.0,0.0,0.0,0.0,15,3,12,3.0,1.0,2.0
11268,1,1,0,0,1,0,0,977,0.0,0.0,0.0,0.0,0.0,0.0,0.0,2,1,1,,,
111060,3,1,2,2,0,3,47,30,2.0,1.0,1.0,1.0,0.0,2.0,26.0,55,3,52,11.0,2.0,9.0
110371,5,4,1,1,3,2,10,102,2.0,2.0,0.0,0.0,0.0,2.0,9.0,16,5,11,6.0,2.0,4.0
9704292,3,1,2,3,2,1,2,41,3.0,1.0,2.0,3.0,2.0,1.0,2.0,11,3,8,2.0,0.0,2.0
9405306,1,1,0,0,1,0,0,665,0.0,0.0,0.0,0.0,0.0,0.0,0.0,3,1,2,1.0,0.0,1.0
9809331,3,1,2,2,1,2,4,84,3.0,1.0,2.0,2.0,1.0,2.0,4.0,6,3,3,5.0,3.0,2.0
203008,5,3,2,2,0,5,21,38,1.0,1.0,0.0,0.0,0.0,1.0,3.0,15,5,10,4.0,1.0,3.0
206178,4,3,1,1,2,2,8,18,2.0,2.0,0.0,0.0,2.0,0.0,0.0,11,4,7,2.0,2.0,0.0
211239,4,3,1,1,2,2,6,77,2.0,1.0,1.0,1.0,2.0,0.0,0.0,13,4,9,1.0,1.0,0.0
9512430,3,1,2,3,0,3,3,53,1.0,1.0,0.0,0.0,0.0,1.0,1.0,4,3,1,3.0,2.0,1.0
9199,2,2,0,0,0,2,12,34,1.0,1.0,0.0,0.0,0.0,1.0,6.0,16,2,14,9.0,1.0,8.0
9086,16,8,8,13,0,16,95,9,6.0,5.0,1.0,1.0,0.0,6.0,28.0,45,16,29,8.0,3.0,5.0
9911267,1,1,0,0,0,1,1,233,1.0,1.0,0.0,0.0,0.0,1.0,1.0,2,1,1,2.0,1.0,1.0
107252,5,4,1,1,2,3,8,47,0.0,0.0,0.0,0.0,0.0,0.0,0.0,15,5,10,2.0,1.0,1.0
7067,8,5,3,5,0,8,17,127,3.0,2.0,1.0,1.0,0.0,3.0,9.0,15,8,7,5.0,3.0,2.0
9908420,4,3,1,1,0,4,18,1,1.0,1.0,0.0,0.0,0.0,1.0,8.0,26,4,22,1.0,0.0,1.0
107183,3,2,1,2,0,3,20,82,3.0,2.0,1.0,2.0,0.0,3.0,20.0,11,3,8,10.0,2.0,8.0
9503305,2,2,0,0,2,0,0,51,1.0,1.0,0.0,0.0,1.0,0.0,0.0,4,2,2,1.0,1.0,0.0
9904360,7,3,4,5,1,6,19,303,5.0,2.0,3.0,4.0,1.0,4.0,9.0,15,7,8,7.0,4.0,3.0
6017,2,2,0,0,0,2,2,540,2.0,2.0,0.0,0.0,0.0,2.0,2.0,3,2,1,3.0,2.0,1.0
110314,0,0,0,0,0,0,0,0,0.0,0.0,0.0,0.0,0.0,0.0,0.0,31,0,31,4.0,0.0,4.0
9308261,4,1,3,6,1,3,5,17,1.0,1.0,0.0,0.0,0.0,1.0,2.0,6,4,2,3.0,1.0,2.0
9903222,9,3,6,9,1,8,9,262,6.0,1.0,5.0,8.0,0.0,6.0,6.0,12,9,3,7.0,6.0,1.0
9509400,1,1,0,0,0,1,2,190,1.0,1.0,0.0,0.0,0.0,1.0,2.0,5,1,4,2.0,0.0,2.0
9612234,0,0,0,0,0,0,0,88,0.0,0.0,0.0,0.0,0.0,0.0,0.0,3,0,3,2.0,0.0,2.0
9507435,0,0,0,0,0,0,0,322,0.0,0.0,0.0,0.0,0.0,0.0,0.0,1,0,1,1.0,0.0,1.0
9511230,1,1,0,0,1,0,0,3,0.0,0.0,0.0,0.0,0.0,0.0,0.0,14,1,13,4.0,0.0,4.0
9901230,2,2,0,0,2,0,0,932,,,,,,,,2,2,0,1.0,1.0,0.0
206042,1,1,0,0,1,0,0,130,0.0,0.0,0.0,0.0,0.0,0.0,0.0,9,1,8,3.0,0.0,3.0
9708373,0,0,0,0,0,0,0,86,0.0,0.0,0.0,0.0,0.0,0.0,0.0,7,0,7,4.0,0.0,4.0
9710452,6,1,5,8,4,2,3,234,4.0,1.0,3.0,4.0,4.0,0.0,0.0,8,6,2,5.0,5.0,0.0
9807391,4,4,0,0,3,1,1,343,2.0,2.0,0.0,0.0,2.0,0.0,0.0,6,4,2,1.0,1.0,0.0
9804312,0,0,0,0,0,0,0,235,0.0,0.0,0.0,0.0,0.0,0.0,0.0,2,0,2,1.0,0.0,1.0
9902422,1,1,0,0,0,1,2,38,0.0,0.0,0.0,0.0,0.0,0.0,0.0,8,1,7,1.0,0.0,1.0
10301,3,2,1,2,0,3,10,5,1.0,1.0,0.0,0.0,0.0,1.0,5.0,27,3,24,13.0,1.0,12.0
206237,7,4,3,4,0,7,17,29,2.0,2.0,0.0,0.0,1.0,1.0,1.0,23,7,16,3.0,2.0,1.0
301112,1,1,0,0,0,1,2,202,1.0,1.0,0.0,0.0,0.0,1.0,2.0,9,1,8,2.0,0.0,2.0
9809335,0,0,0,0,0,0,0,307,0.0,0.0,0.0,0.0,0.0,0.0,0.0,3,0,3,2.0,0.0,2.0
9812531,4,1,3,3,3,1,2,159,4.0,1.0,3.0,3.0,4.0,0.0,0.0,10,4,6,2.0,2.0,0.0
9508381,2,1,1,1,1,1,2,105,1.0,1.0,0.0,0.0,1.0,0.0,0.0,5,2,3,1.0,1.0,0.0
9907370,5,2,3,5,1,4,49,1,4.0,1.0,3.0,5.0,0.0,4.0,12.0,30,5,25,8.0,4.0,4.0
9701298,1,1,0,0,0,1,11,0,1.0,1.0,0.0,0.0,0.0,1.0,10.0,23,1,22,1.0,0.0,1.0
207343,4,3,1,1,0,4,4,415,3.0,2.0,1.0,1.0,0.0,3.0,3.0,15,4,11,3.0,0.0,3.0
11202,3,2,1,1,3,0,0,53,3.0,2.0,1.0,1.0,3.0,0.0,0.0,9,3,6,3.0,3.0,0.0
301158,0,0,0,0,0,0,0,22,0.0,0.0,0.0,0.0,0.0,0.0,0.0,11,0,11,4.0,0.0,4.0
9806532,0,0,0,0,0,0,0,8,0.0,0.0,0.0,0.0,0.0,0.0,0.0,7,0,7,4.0,0.0,4.0
5284,1,1,0,0,0,1,1,89,1.0,1.0,0.0,0.0,1.0,0.0,0.0,4,1,3,1.0,0.0,1.0
9801401,0,0,0,0,0,0,0,40,0.0,0.0,0.0,0.0,0.0,0.0,0.0,4,0,4,1.0,0.0,1.0
9503336,2,2,0,0,2,0,0,1573,1.0,1.0,0.0,0.0,1.0,0.0,0.0,2,2,0,1.0,1.0,0.0
205328,2,2,0,0,0,2,7,4,0.0,0.0,0.0,0.0,0.0,0.0,0.0,15,2,13,1.0,0.0,1.0
12211,1,1,0,0,0,1,2,24,0.0,0.0,0.0,0.0,0.0,0.0,0.0,32,1,31,18.0,0.0,18.0
103176,1,1,0,0,1,0,0,91,0.0,0.0,0.0,0.0,0.0,0.0,0.0,6,1,5,1.0,1.0,0.0
12163,0,0,0,0,0,0,0,456,0.0,0.0,0.0,0.0,0.0,0.0,0.0,4,0,4,3.0,0.0,3.0
101139,3,1,2,2,0,3,10,30,0.0,0.0,0.0,0.0,0.0,0.0,0.0,12,3,9,1.0,1.0,0.0
206065,1,1,0,0,0,1,16,20,1.0,1.0,0.0,0.0,0.0,1.0,15.0,39,1,38,26.0,0.0,26.0
206214,2,2,0,0,0,2,3,106,1.0,1.0,0.0,0.0,1.0,0.0,0.0,4,2,2,1.0,1.0,0.0
9904453,0,0,0,0,0,0,0,148,,,,,,,,1,0,1,,,
108027,1,1,0,0,0,1,21,14,1.0,1.0,0.0,0.0,0.0,1.0,13.0,22,1,21,13.0,1.0,12.0
9702279,2,2,0,0,1,1,12,10,1.0,1.0,0.0,0.0,0.0,1.0,2.0,16,2,14,4.0,1.0,3.0
9607373,0,0,0,0,0,0,0,236,,,,,,,,4,0,4,,,
208191,2,2,0,0,0,2,15,46,2.0,2.0,0.0,0.0,0.0,2.0,10.0,20,2,18,1.0,0.0,1.0
9812473,3,2,1,1,1,2,6,91,2.0,1.0,1.0,1.0,0.0,2.0,6.0,8,3,5,2.0,1.0,1.0
210243,0,0,0,0,0,0,0,1866,,,,,,,,6,0,6,,,
9610286,2,2,0,0,2,0,0,57,,,,,,,,5,2,3,,,
9404261,2,2,0,0,0,2,3,81,2.0,2.0,0.0,0.0,1.0,1.0,1.0,6,2,4,3.0,2.0,1.0
9503472,1,1,0,0,1,0,0,2012,1.0,1.0,0.0,0.0,1.0,0.0,0.0,1,1,0,,,
9406384,1,1,0,0,0,1,1,54,1.0,1.0,0.0,0.0,1.0,0.0,0.0,2,1,1,1.0,1.0,0.0
9911387,2,2,0,0,0,2,6,31,1.0,1.0,0.0,0.0,0.0,1.0,4.0,9,2,7,1.0,1.0,0.0
203042,4,4,0,0,0,4,9,31,2.0,2.0,0.0,0.0,0.0,2.0,5.0,8,4,4,1.0,1.0,0.0
9706403,3,3,0,0,3,0,0,1482,,,,,,,,3,3,0,2.0,2.0,0.0
9901338,5,3,2,2,2,3,6,155,1.0,1.0,0.0,0.0,0.0,1.0,4.0,9,5,4,5.0,1.0,4.0
9701331,1,1,0,0,1,0,0,247,1.0,1.0,0.0,0.0,1.0,0.0,0.0,1,1,0,1.0,1.0,0.0
9912485,2,2,0,0,0,2,4,221,2.0,2.0,0.0,0.0,0.0,2.0,4.0,5,2,3,5.0,2.0,3.0
9412264,1,1,0,0,0,1,1,402,1.0,1.0,0.0,0.0,0.0,1.0,1.0,2,1,1,2.0,1.0,1.0
301015,2,2,0,0,0,2,24,10,0.0,0.0,0.0,0.0,0.0,0.0,0.0,32,2,30,10.0,1.0,9.0
9708274,3,1,2,2,1,2,5,44,2.0,1.0,1.0,1.0,1.0,1.0,3.0,7,3,4,,,
206008,1,1,0,0,1,0,0,2,0.0,0.0,0.0,0.0,0.0,0.0,0.0,33,1,32,2.0,0.0,2.0
9808228,2,1,1,1,1,1,5,84,1.0,1.0,0.0,0.0,1.0,0.0,0.0,8,2,6,1.0,1.0,0.0
202015,5,5,0,0,2,3,10,68,2.0,2.0,0.0,0.0,0.0,2.0,7.0,13,5,8,6.0,2.0,4.0
9503324,1,1,0,0,0,1,1,155,1.0,1.0,0.0,0.0,0.0,1.0,1.0,4,1,3,3.0,1.0,2.0
211385,0,0,0,0,0,0,0,229,0.0,0.0,0.0,0.0,0.0,0.0,0.0,6,0,6,2.0,0.0,2.0
9709391,1,1,0,0,1,0,0,211,1.0,1.0,0.0,0.0,1.0,0.0,0.0,6,1,5,4.0,0.0,4.0
9910452,2,1,1,1,0,2,4,390,2.0,1.0,1.0,1.0,0.0,2.0,4.0,4,2,2,4.0,2.0,2.0
5217,4,2,2,2,4,0,0,153,3.0,2.0,1.0,1.0,3.0,0.0,0.0,4,4,0,2.0,2.0,0.0
8275,0,0,0,0,0,0,0,1254,,,,,,,,1,0,1,,,
203220,6,3,3,5,0,6,18,102,5.0,2.0,3.0,4.0,0.0,5.0,13.0,13,6,7,9.0,4.0,5.0
209121,6,3,3,3,0,6,106,11,6.0,3.0,3.0,3.0,0.0,6.0,94.0,45,6,39,29.0,4.0,25.0
108214,2,2,0,0,0,2,9,9,1.0,1.0,0.0,0.0,0.0,1.0,7.0,14,2,12,5.0,1.0,4.0
9710243,2,2,0,0,0,2,2,77,1.0,1.0,0.0,0.0,1.0,0.0,0.0,3,2,1,1.0,1.0,0.0
111305,2,1,1,1,0,2,9,65,2.0,1.0,1.0,1.0,0.0,2.0,5.0,8,2,6,5.0,2.0,3.0
6181,5,3,2,3,0,5,11,166,3.0,3.0,0.0,0.0,0.0,3.0,5.0,9,5,4,3.0,2.0,1.0
9608419,0,0,0,0,0,0,0,149,0.0,0.0,0.0,0.0,0.0,0.0,0.0,7,0,7,6.0,0.0,6.0
110240,3,2,1,1,1,2,2,328,2.0,1.0,1.0,1.0,0.0,2.0,2.0,4,3,1,3.0,2.0,1.0
9811494,1,1,0,0,0,1,1,139,0.0,0.0,0.0,0.0,0.0,0.0,0.0,2,1,1,1.0,0.0,1.0
9904403,2,2,0,0,1,1,1,70,1.0,1.0,0.0,0.0,1.0,0.0,0.0,6,2,4,,,
3264,1,1,0,0,1,0,0,224,1.0,1.0,0.0,0.0,1.0,0.0,0.0,5,1,4,1.0,0.0,1.0
9712402,0,0,0,0,0,0,0,2100,,,,,,,,2,0,2,,,
9610346,0,0,0,0,0,0,0,802,0.0,0.0,0.0,0.0,0.0,0.0,0.0,2,0,2,1.0,0.0,1.0
9708361,2,2,0,0,0,2,6,55,2.0,2.0,0.0,0.0,0.0,2.0,4.0,18,2,16,2.0,2.0,0.0
9804435,2,2,0,0,1,1,1,211,1.0,1.0,0.0,0.0,0.0,1.0,1.0,5,2,3,,,
210116,0,0,0,0,0,0,0,244,0.0,0.0,0.0,0.0,0.0,0.0,0.0,5,0,5,3.0,0.0,3.0
9510353,1,1,0,0,1,0,0,169,0.0,0.0,0.0,0.0,0.0,0.0,0.0,4,1,3,1.0,1.0,0.0
9907251,1,1,0,0,0,1,5,44,1.0,1.0,0.0,0.0,0.0,1.0,3.0,8,1,7,,,
9807548,0,0,0,0,0,0,0,2021,,,,,,,,1,0,1,,,
9705310,0,0,0,0,0,0,0,17,,,,,,,,11,0,11,2.0,0.0,2.0
211029,0,0,0,0,0,0,0,89,0.0,0.0,0.0,0.0,0.0,0.0,0.0,12,0,12,1.0,0.0,1.0
9901335,1,1,0,0,1,0,0,446,1.0,1.0,0.0,0.0,1.0,0.0,0.0,3,1,2,1.0,1.0,0.0
6347,1,1,0,0,1,0,0,50,0.0,0.0,0.0,0.0,0.0,0.0,0.0,26,1,25,14.0,0.0,14.0
9707344,3,2,1,1,1,2,16,51,0.0,0.0,0.0,0.0,0.0,0.0,0.0,24,3,21,4.0,2.0,2.0
9809382,0,0,0,0,0,0,0,38,0.0,0.0,0.0,0.0,0.0,0.0,0.0,5,0,5,,,
9809316,0,0,0,0,0,0,0,6,0.0,0.0,0.0,0.0,0.0,0.0,0.0,21,0,21,5.0,0.0,5.0
9901291,0,0,0,0,0,0,0,333,0.0,0.0,0.0,0.0,0.0,0.0,0.0,6,0,6,5.0,0.0,5.0
9703297,0,0,0,0,0,0,0,367,0.0,0.0,0.0,0.0,0.0,0.0,0.0,2,0,2,1.0,0.0,1.0
9238,0,0,0,0,0,0,0,53,0.0,0.0,0.0,0.0,0.0,0.0,0.0,9,0,9,1.0,0.0,1.0
9807388,2,2,0,0,0,2,5,172,1.0,1.0,0.0,0.0,0.0,1.0,3.0,13,2,11,5.0,1.0,4.0
9811394,0,0,0,0,0,0,0,782,0.0,0.0,0.0,0.0,0.0,0.0,0.0,6,0,6,1.0,0.0,1.0
210215,0,0,0,0,0,0,0,146,0.0,0.0,0.0,0.0,0.0,0.0,0.0,4,0,4,1.0,0.0,1.0
203160,1,1,0,0,0,1,7,1,0.0,0.0,0.0,0.0,0.0,0.0,0.0,30,1,29,9.0,1.0,8.0
107166,1,1,0,0,0,1,8,143,1.0,1.0,0.0,0.0,0.0,1.0,4.0,12,1,11,6.0,1.0,5.0
107077,2,2,0,0,1,1,3,257,2.0,2.0,0.0,0.0,1.0,1.0,3.0,6,2,4,4.0,1.0,3.0
302075,0,0,0,0,0,0,0,46,0.0,0.0,0.0,0.0,0.0,0.0,0.0,65,0,65,23.0,0.0,23.0
205231,1,1,0,0,0,1,4,77,0.0,0.0,0.0,0.0,0.0,0.0,0.0,7,1,6,6.0,0.0,6.0
9607410,1,1,0,0,0,1,3,39,1.0,1.0,0.0,0.0,0.0,1.0,3.0,4,1,3,,,
9710449,0,0,0,0,0,0,0,1348,,,,,,,,1,0,1,,,
9807352,0,0,0,0,0,0,0,217,0.0,0.0,0.0,0.0,0.0,0.0,0.0,5,0,5,1.0,0.0,1.0
6195,0,0,0,0,0,0,0,1295,0.0,0.0,0.0,0.0,0.0,0.0,0.0,3,0,3,1.0,0.0,1.0
9509246,0,0,0,0,0,0,0,1477,,,,,,,,1,0,1,,,
7156,0,0,0,0,0,0,0,11,,,,,,,,9,0,9,,,
7143,0,0,0,0,0,0,0,337,0.0,0.0,0.0,0.0,0.0,0.0,0.0,3,0,3,2.0,0.0,2.0
107321,2,2,0,0,1,1,2,121,1.0,1.0,0.0,0.0,0.0,1.0,2.0,7,2,5,3.0,1.0,2.0
9901400,0,0,0,0,0,0,0,42,0.0,0.0,0.0,0.0,0.0,0.0,0.0,14,0,14,3.0,0.0,3.0
102004,1,1,0,0,1,0,0,102,0.0,0.0,0.0,0.0,0.0,0.0,0.0,8,1,7,,,
9905213,3,3,0,0,3,0,0,48,0.0,0.0,0.0,0.0,0.0,0.0,0.0,12,3,9,1.0,1.0,0.0
9411313,0,0,0,0,0,0,0,229,0.0,0.0,0.0,0.0,0.0,0.0,0.0,9,0,9,2.0,0.0,2.0
3005,3,2,1,1,0,3,7,72,2.0,1.0,1.0,1.0,1.0,1.0,2.0,6,3,3,3.0,3.0,0.0
12276,1,1,0,0,0,1,5,118,1.0,1.0,0.0,0.0,0.0,1.0,5.0,12,1,11,7.0,1.0,6.0
9503243,1,1,0,0,1,0,0,535,1.0,1.0,0.0,0.0,1.0,0.0,0.0,1,1,0,1.0,1.0,0.0
5119,0,0,0,0,0,0,0,1629,,,,,,,,3,0,3,1.0,0.0,1.0
210165,2,1,1,1,0,2,14,9,1.0,1.0,0.0,0.0,0.0,1.0,12.0,21,2,19,4.0,0.0,4.0
9712308,1,1,0,0,1,0,0,582,1.0,1.0,0.0,0.0,1.0,0.0,0.0,3,1,2,1.0,1.0,0.0
9612224,1,1,0,0,1,0,0,273,1.0,1.0,0.0,0.0,1.0,0.0,0.0,4,1,3,,,
9702316,3,1,2,3,0,3,12,100,3.0,1.0,2.0,3.0,0.0,3.0,12.0,9,3,6,7.0,3.0,4.0
9404363,1,1,0,0,1,0,0,691,1.0,1.0,0.0,0.0,1.0,0.0,0.0,1,1,0,1.0,1.0,0.0
11218,1,1,0,0,0,1,2,97,1.0,1.0,0.0,0.0,0.0,1.0,2.0,4,1,3,1.0,0.0,1.0
206041,1,1,0,0,1,0,0,979,,,,,,,,2,1,1,1.0,0.0,1.0
9807357,1,1,0,0,0,1,11,113,1.0,1.0,0.0,0.0,0.0,1.0,5.0,13,1,12,1.0,0.0,1.0
9511304,0,0,0,0,0,0,0,211,0.0,0.0,0.0,0.0,0.0,0.0,0.0,10,0,10,2.0,0.0,2.0
9507223,1,1,0,0,0,1,1,199,0.0,0.0,0.0,0.0,0.0,0.0,0.0,5,1,4,2.0,0.0,2.0
112238,3,3,0,0,0,3,54,18,2.0,2.0,0.0,0.0,0.0,2.0,33.0,53,3,50,20.0,1.0,19.0
9503409,1,1,0,0,0,1,3,93,0.0,0.0,0.0,0.0,0.0,0.0,0.0,9,1,8,8.0,0.0,8.0
210437,0,0,0,0,0,0,0,309,0.0,0.0,0.0,0.0,0.0,0.0,0.0,3,0,3,1.0,0.0,1.0
204223,2,2,0,0,0,2,7,38,0.0,0.0,0.0,0.0,0.0,0.0,0.0,17,2,15,8.0,0.0,8.0
9609254,1,1,0,0,1,0,0,295,1.0,1.0,0.0,0.0,1.0,0.0,0.0,2,1,1,1.0,1.0,0.0
9502253,3,1,2,2,3,0,0,429,3.0,1.0,2.0,2.0,3.0,0.0,0.0,3,3,0,3.0,3.0,0.0
107237,0,0,0,0,0,0,0,111,0.0,0.0,0.0,0.0,0.0,0.0,0.0,5,0,5,4.0,0.0,4.0
9502277,0,0,0,0,0,0,0,156,,,,,,,,1,0,1,,,
9707246,0,0,0,0,0,0,0,21,0.0,0.0,0.0,0.0,0.0,0.0,0.0,10,0,10,,,
209343,0,0,0,0,0,0,0,26,0.0,0.0,0.0,0.0,0.0,0.0,0.0,15,0,15,4.0,0.0,4.0
9805428,1,1,0,0,1,0,0,694,0.0,0.0,0.0,0.0,0.0,0.0,0.0,2,1,1,1.0,0.0,1.0
210301,1,1,0,0,0,1,6,112,1.0,1.0,0.0,0.0,0.0,1.0,6.0,10,1,9,10.0,1.0,9.0
9807259,1,1,0,0,0,1,1,35,0.0,0.0,0.0,0.0,0.0,0.0,0.0,7,1,6,,,
105249,0,0,0,0,0,0,0,18,0.0,0.0,0.0,0.0,0.0,0.0,0.0,18,0,18,4.0,0.0,4.0
201220,0,0,0,0,0,0,0,348,0.0,0.0,0.0,0.0,0.0,0.0,0.0,12,0,12,5.0,0.0,5.0
301115,0,0,0,0,0,0,0,252,0.0,0.0,0.0,0.0,0.0,0.0,0.0,2,0,2,1.0,0.0,1.0
9910265,2,2,0,0,0,2,10,26,1.0,1.0,0.0,0.0,0.0,1.0,5.0,24,2,22,4.0,0.0,4.0
9506390,0,0,0,0,0,0,0,1738,0.0,0.0,0.0,0.0,0.0,0.0,0.0,3,0,3,,,
9710483,2,1,1,1,2,0,0,115,0.0,0.0,0.0,0.0,0.0,0.0,0.0,14,2,12,3.0,2.0,1.0
9802435,0,0,0,0,0,0,0,334,0.0,0.0,0.0,0.0,0.0,0.0,0.0,3,0,3,3.0,0.0,3.0
9707461,3,2,1,1,1,2,5,13,0.0,0.0,0.0,0.0,0.0,0.0,0.0,26,3,23,5.0,0.0,5.0
9807291,0,0,0,0,0,0,0,409,0.0,0.0,0.0,0.0,0.0,0.0,0.0,2,0,2,2.0,0.0,2.0
9710235,2,2,0,0,2,0,0,202,2.0,2.0,0.0,0.0,2.0,0.0,0.0,4,2,2,,,
9710474,1,1,0,0,0,1,2,163,1.0,1.0,0.0,0.0,0.0,1.0,1.0,8,1,7,2.0,1.0,1.0
9810276,0,0,0,0,0,0,0,13,0.0,0.0,0.0,0.0,0.0,0.0,0.0,21,0,21,3.0,0.0,3.0
9610519,0,0,0,0,0,0,0,237,0.0,0.0,0.0,0.0,0.0,0.0,0.0,5,0,5,5.0,0.0,5.0
201272,4,2,2,2,0,4,16,120,4.0,2.0,2.0,2.0,0.0,4.0,7.0,24,4,20,9.0,3.0,6.0
9164,1,1,0,0,0,1,3,153,0.0,0.0,0.0,0.0,0.0,0.0,0.0,5,1,4,1.0,0.0,1.0
1240,2,2,0,0,2,0,0,113,2.0,2.0,0.0,0.0,2.0,0.0,0.0,5,2,3,3.0,0.0,3.0
9806459,1,1,0,0,0,1,1,391,1.0,1.0,0.0,0.0,1.0,0.0,0.0,3,1,2,1.0,1.0,0.0
9305203,0,0,0,0,0,0,0,1055,,,,,,,,1,0,1,,,
111096,0,0,0,0,0,0,0,51,0.0,0.0,0.0,0.0,0.0,0.0,0.0,7,0,7,6.0,0.0,6.0
9307258,0,0,0,0,0,0,0,441,0.0,0.0,0.0,0.0,0.0,0.0,0.0,2,0,2,2.0,0.0,2.0
9608493,1,1,0,0,0,1,1,72,1.0,1.0,0.0,0.0,1.0,0.0,0.0,3,1,2,1.0,1.0,0.0
9704254,0,0,0,0,0,0,0,310,0.0,0.0,0.0,0.0,0.0,0.0,0.0,3,0,3,3.0,0.0,3.0
9812359,3,3,0,0,0,3,11,108,3.0,3.0,0.0,0.0,0.0,3.0,11.0,12,3,9,7.0,0.0,7.0
207368,0,0,0,0,0,0,0,53,0.0,0.0,0.0,0.0,0.0,0.0,0.0,4,0,4,3.0,0.0,3.0
10155,1,1,0,0,1,0,0,324,1.0,1.0,0.0,0.0,1.0,0.0,0.0,8,1,7,2.0,0.0,2.0
9908502,0,0,0,0,0,0,0,2082,,,,,,,,2,0,2,,,
104083,0,0,0,0,0,0,0,1495,0.0,0.0,0.0,0.0,0.0,0.0,0.0,1,0,1,1.0,0.0,1.0
9812324,0,0,0,0,0,0,0,442,0.0,0.0,0.0,0.0,0.0,0.0,0.0,1,0,1,,,
9901372,0,0,0,0,0,0,0,58,0.0,0.0,0.0,0.0,0.0,0.0,0.0,7,0,7,4.0,0.0,4.0
9809448,0,0,0,0,0,0,0,104,,,,,,,,1,0,1,,,
211208,0,0,0,0,0,0,0,96,0.0,0.0,0.0,0.0,0.0,0.0,0.0,25,0,25,9.0,0.0,9.0
9406207,3,3,0,0,0,3,3,49,3.0,3.0,0.0,0.0,0.0,3.0,3.0,4,3,1,3.0,2.0,1.0
203153,0,0,0,0,0,0,0,278,0.0,0.0,0.0,0.0,0.0,0.0,0.0,5,0,5,,,
10200,0,0,0,0,0,0,0,9,0.0,0.0,0.0,0.0,0.0,0.0,0.0,19,0,19,1.0,0.0,1.0
9411401,0,0,0,0,0,0,0,1692,,,,,,,,1,0,1,,,
10324,1,1,0,0,0,1,8,184,1.0,1.0,0.0,0.0,0.0,1.0,4.0,17,1,16,4.0,1.0,3.0
212248,0,0,0,0,0,0,0,130,0.0,0.0,0.0,0.0,0.0,0.0,0.0,21,0,21,8.0,0.0,8.0
301150,0,0,0,0,0,0,0,536,0.0,0.0,0.0,0.0,0.0,0.0,0.0,6,0,6,2.0,0.0,2.0
9706340,1,1,0,0,0,1,5,453,1.0,1.0,0.0,0.0,0.0,1.0,5.0,12,1,11,4.0,1.0,3.0
204078,1,1,0,0,1,0,0,10,0.0,0.0,0.0,0.0,0.0,0.0,0.0,17,1,16,1.0,1.0,0.0
111204,1,1,0,0,1,0,0,257,0.0,0.0,0.0,0.0,0.0,0.0,0.0,5,1,4,1.0,0.0,1.0
9804220,0,0,0,0,0,0,0,344,0.0,0.0,0.0,0.0,0.0,0.0,0.0,4,0,4,1.0,0.0,1.0
9703339,1,1,0,0,1,0,0,319,1.0,1.0,0.0,0.0,1.0,0.0,0.0,1,1,0,1.0,1.0,0.0
109054,2,1,1,1,0,2,2,24,2.0,1.0,1.0,1.0,2.0,0.0,0.0,8,2,6,3.0,2.0,1.0
208147,0,0,0,0,0,0,0,26,0.0,0.0,0.0,0.0,0.0,0.0,0.0,27,0,27,7.0,0.0,7.0
8266,0,0,0,0,0,0,0,171,0.0,0.0,0.0,0.0,0.0,0.0,0.0,2,0,2,,,
212225,2,1,1,1,0,2,9,23,2.0,1.0,1.0,1.0,0.0,2.0,9.0,20,2,18,13.0,1.0,12.0
210384,0,0,0,0,0,0,0,181,0.0,0.0,0.0,0.0,0.0,0.0,0.0,5,0,5,1.0,0.0,1.0
212135,0,0,0,0,0,0,0,71,0.0,0.0,0.0,0.0,0.0,0.0,0.0,11,0,11,3.0,0.0,3.0
207331,0,0,0,0,0,0,0,21,0.0,0.0,0.0,0.0,0.0,0.0,0.0,13,0,13,1.0,0.0,1.0
105264,1,1,0,0,0,1,1,188,1.0,1.0,0.0,0.0,1.0,0.0,0.0,5,1,4,,,
9805333,0,0,0,0,0,0,0,112,0.0,0.0,0.0,0.0,0.0,0.0,0.0,12,0,12,5.0,0.0,5.0
210071,0,0,0,0,0,0,0,74,0.0,0.0,0.0,0.0,0.0,0.0,0.0,8,0,8,3.0,0.0,3.0
108099,0,0,0,0,0,0,0,135,0.0,0.0,0.0,0.0,0.0,0.0,0.0,48,0,48,4.0,0.0,4.0
9901391,2,2,0,0,1,1,2,123,1.0,1.0,0.0,0.0,0.0,1.0,2.0,6,2,4,3.0,1.0,2.0
9406327,0,0,0,0,0,0,0,242,,,,,,,,1,0,1,,,
107258,0,0,0,0,0,0,0,148,0.0,0.0,0.0,0.0,0.0,0.0,0.0,2,0,2,1.0,0.0,1.0
9811516,0,0,0,0,0,0,0,328,0.0,0.0,0.0,0.0,0.0,0.0,0.0,1,0,1,,,
9902421,0,0,0,0,0,0,0,78,0.0,0.0,0.0,0.0,0.0,0.0,0.0,11,0,11,1.0,0.0,1.0
9409424,0,0,0,0,0,0,0,1567,,,,,,,,1,0,1,,,
211037,0,0,0,0,0,0,0,107,0.0,0.0,0.0,0.0,0.0,0.0,0.0,10,0,10,2.0,0.0,2.0
211269,0,0,0,0,0,0,0,278,0.0,0.0,0.0,0.0,0.0,0.0,0.0,13,0,13,6.0,0.0,6.0
9907527,0,0,0,0,0,0,0,2041,0.0,0.0,0.0,0.0,0.0,0.0,0.0,2,0,2,,,
9508333,1,1,0,0,1,0,0,91,0.0,0.0,0.0,0.0,0.0,0.0,0.0,2,1,1,1.0,0.0,1.0
9812237,0,0,0,0,0,0,0,138,0.0,0.0,0.0,0.0,0.0,0.0,0.0,4,0,4,1.0,0.0,1.0
9307234,1,1,0,0,1,0,0,1509,,,,,,,,1,1,0,1.0,1.0,0.0
9906477,0,0,0,0,0,0,0,233,0.0,0.0,0.0,0.0,0.0,0.0,0.0,4,0,4,2.0,0.0,2.0
110171,1,1,0,0,0,1,1,201,0.0,0.0,0.0,0.0,0.0,0.0,0.0,12,1,11,8.0,0.0,8.0
9804272,1,1,0,0,1,0,0,713,1.0,1.0,0.0,0.0,1.0,0.0,0.0,1,1,0,1.0,1.0,0.0
111468,2,2,0,0,0,2,3,252,1.0,1.0,0.0,0.0,1.0,0.0,0.0,6,2,4,3.0,0.0,3.0
110018,0,0,0,0,0,0,0,137,0.0,0.0,0.0,0.0,0.0,0.0,0.0,4,0,4,1.0,0.0,1.0
9610340,0,0,0,0,0,0,0,10,0.0,0.0,0.0,0.0,0.0,0.0,0.0,48,0,48,10.0,0.0,10.0
4164,0,0,0,0,0,0,0,58,0.0,0.0,0.0,0.0,0.0,0.0,0.0,9,0,9,2.0,0.0,2.0
9908302,0,0,0,0,0,0,0,52,,,,,,,,2,0,2,,,
201065,0,0,0,0,0,0,0,27,0.0,0.0,0.0,0.0,0.0,0.0,0.0,25,0,25,11.0,0.0,11.0
9812468,0,0,0,0,0,0,0,438,0.0,0.0,0.0,0.0,0.0,0.0,0.0,4,0,4,1.0,0.0,1.0
212067,0,0,0,0,0,0,0,57,0.0,0.0,0.0,0.0,0.0,0.0,0.0,14,0,14,3.0,0.0,3.0
206031,0,0,0,0,0,0,0,68,0.0,0.0,0.0,0.0,0.0,0.0,0.0,7,0,7,1.0,0.0,1.0
109059,1,1,0,0,0,1,10,33,1.0,1.0,0.0,0.0,0.0,1.0,7.0,25,1,24,8.0,1.0,7.0
9401289,0,0,0,0,0,0,0,274,0.0,0.0,0.0,0.0,0.0,0.0,0.0,1,0,1,1.0,0.0,1.0
301247,0,0,0,0,0,0,0,125,0.0,0.0,0.0,0.0,0.0,0.0,0.0,3,0,3,1.0,0.0,1.0
9602413,0,0,0,0,0,0,0,156,0.0,0.0,0.0,0.0,0.0,0.0,0.0,2,0,2,,,
210164,0,0,0,0,0,0,0,322,0.0,0.0,0.0,0.0,0.0,0.0,0.0,2,0,2,,,
9503379,0,0,0,0,0,0,0,289,0.0,0.0,0.0,0.0,0.0,0.0,0.0,5,0,5,2.0,0.0,2.0
9609412,0,0,0,0,0,0,0,572,0.0,0.0,0.0,0.0,0.0,0.0,0.0,1,0,1,1.0,0.0,1.0
207218,0,0,0,0,0,0,0,9,0.0,0.0,0.0,0.0,0.0,0.0,0.0,13,0,13,1.0,0.0,1.0
111397,0,0,0,0,0,0,0,1893,,,,,,,,1,0,1,1.0,0.0,1.0
9412386,0,0,0,0,0,0,0,75,0.0,0.0,0.0,0.0,0.0,0.0,0.0,20,0,20,11.0,0.0,11.0
8203,0,0,0,0,0,0,0,3,0.0,0.0,0.0,0.0,0.0,0.0,0.0,21,0,21,,,
9909227,0,0,0,0,0,0,0,10,0.0,0.0,0.0,0.0,0.0,0.0,0.0,19,0,19,3.0,0.0,3.0
302042,0,0,0,0,0,0,0,117,0.0,0.0,0.0,0.0,0.0,0.0,0.0,34,0,34,11.0,0.0,11.0
9803231,1,1,0,0,1,0,0,161,1.0,1.0,0.0,0.0,1.0,0.0,0.0,5,1,4,4.0,0.0,4.0
201279,0,0,0,0,0,0,0,576,0.0,0.0,0.0,0.0,0.0,0.0,0.0,3,0,3,2.0,0.0,2.0
102058,0,0,0,0,0,0,0,4,0.0,0.0,0.0,0.0,0.0,0.0,0.0,25,0,25,6.0,0.0,6.0
9911355,0,0,0,0,0,0,0,7,0.0,0.0,0.0,0.0,0.0,0.0,0.0,28,0,28,8.0,0.0,8.0
9305301,1,1,0,0,0,1,2,176,1.0,1.0,0.0,0.0,0.0,1.0,2.0,3,1,2,1.0,1.0,0.0
9406314,0,0,0,0,0,0,0,75,0.0,0.0,0.0,0.0,0.0,0.0,0.0,9,0,9,,,
8187,0,0,0,0,0,0,0,525,0.0,0.0,0.0,0.0,0.0,0.0,0.0,3,0,3,2.0,0.0,2.0
9707306,0,0,0,0,0,0,0,60,0.0,0.0,0.0,0.0,0.0,0.0,0.0,5,0,5,,,
9711498,0,0,0,0,0,0,0,98,,,,,,,,1,0,1,,,
9609336,0,0,0,0,0,0,0,39,0.0,0.0,0.0,0.0,0.0,0.0,0.0,9,0,9,2.0,0.0,2.0
9411222,0,0,0,0,0,0,0,1522,,,,,,,,1,0,1,,,
302141,0,0,0,0,0,0,0,2,0.0,0.0,0.0,0.0,0.0,0.0,0.0,23,0,23,2.0,0.0,2.0
110027,0,0,0,0,0,0,0,421,0.0,0.0,0.0,0.0,0.0,0.0,0.0,7,0,7,4.0,0.0,4.0
107296,0,0,0,0,0,0,0,54,0.0,0.0,0.0,0.0,0.0,0.0,0.0,21,0,21,7.0,0.0,7.0
212394,0,0,0,0,0,0,0,148,0.0,0.0,0.0,0.0,0.0,0.0,0.0,7,0,7,,,
107033,1,1,0,0,0,1,2,301,0.0,0.0,0.0,0.0,0.0,0.0,0.0,20,1,19,8.0,0.0,8.0
209097,0,0,0,0,0,0,0,1146,,,,,,,,4,0,4,,,
211113,1,1,0,0,0,1,2,66,0.0,0.0,0.0,0.0,0.0,0.0,0.0,23,1,22,15.0,0.0,15.0
2026,0,0,0,0,0,0,0,91,0.0,0.0,0.0,0.0,0.0,0.0,0.0,6,0,6,,,
107283,0,0,0,0,0,0,0,394,0.0,0.0,0.0,0.0,0.0,0.0,0.0,3,0,3,2.0,0.0,2.0
301277,0,0,0,0,0,0,0,47,0.0,0.0,0.0,0.0,0.0,0.0,0.0,10,0,10,2.0,0.0,2.0
210248,0,0,0,0,0,0,0,6,0.0,0.0,0.0,0.0,0.0,0.0,0.0,13,0,13,3.0,0.0,3.0
3128,0,0,0,0,0,0,0,204,0.0,0.0,0.0,0.0,0.0,0.0,0.0,8,0,8,6.0,0.0,6.0
203176,1,1,0,0,0,1,1,63,0.0,0.0,0.0,0.0,0.0,0.0,0.0,3,1,2,2.0,1.0,1.0
9508215,0,0,0,0,0,0,0,1315,,,,,,,,1,0,1,,,
9310334,0,0,0,0,0,0,0,819,,,,,,,,1,0,1,,,
208190,0,0,0,0,0,0,0,178,0.0,0.0,0.0,0.0,0.0,0.0,0.0,5,0,5,3.0,0.0,3.0
211302,0,0,0,0,0,0,0,109,0.0,0.0,0.0,0.0,0.0,0.0,0.0,11,0,11,1.0,0.0,1.0
9302282,0,0,0,0,0,0,0,69,0.0,0.0,0.0,0.0,0.0,0.0,0.0,4,0,4,1.0,0.0,1.0
204284,0,0,0,0,0,0,0,290,0.0,0.0,0.0,0.0,0.0,0.0,0.0,7,0,7,2.0,0.0,2.0
9807387,0,0,0,0,0,0,0,53,,,,,,,,6,0,6,1.0,0.0,1.0
9904503,0,0,0,0,0,0,0,43,,,,,,,,8,0,8,1.0,0.0,1.0
302099,0,0,0,0,0,0,0,16,0.0,0.0,0.0,0.0,0.0,0.0,0.0,18,0,18,7.0,0.0,7.0
9611287,0,0,0,0,0,0,0,10,0.0,0.0,0.0,0.0,0.0,0.0,0.0,6,0,6,4.0,0.0,4.0
106303,0,0,0,0,0,0,0,97,0.0,0.0,0.0,0.0,0.0,0.0,0.0,15,0,15,6.0,0.0,6.0
205091,0,0,0,0,0,0,0,730,0.0,0.0,0.0,0.0,0.0,0.0,0.0,1,0,1,1.0,0.0,1.0
10183,0,0,0,0,0,0,0,8,0.0,0.0,0.0,0.0,0.0,0.0,0.0,17,0,17,,,
210426,0,0,0,0,0,0,0,1198,0.0,0.0,0.0,0.0,0.0,0.0,0.0,2,0,2,,,
9906472,0,0,0,0,0,0,0,346,0.0,0.0,0.0,0.0,0.0,0.0,0.0,14,0,14,1.0,0.0,1.0
9901279,0,0,0,0,0,0,0,356,0.0,0.0,0.0,0.0,0.0,0.0,0.0,7,0,7,3.0,0.0,3.0
9611381,0,0,0,0,0,0,0,199,0.0,0.0,0.0,0.0,0.0,0.0,0.0,2,0,2,1.0,0.0,1.0
9810503,0,0,0,0,0,0,0,12,0.0,0.0,0.0,0.0,0.0,0.0,0.0,20,0,20,11.0,0.0,11.0
9709220,0,0,0,0,0,0,0,38,0.0,0.0,0.0,0.0,0.0,0.0,0.0,5,0,5,,,
112220,1,1,0,0,0,1,5,152,1.0,1.0,0.0,0.0,0.0,1.0,2.0,17,1,16,3.0,1.0,2.0
9611382,0,0,0,0,0,0,0,450,0.0,0.0,0.0,0.0,0.0,0.0,0.0,8,0,8,3.0,0.0,3.0
212145,0,0,0,0,0,0,0,63,0.0,0.0,0.0,0.0,0.0,0.0,0.0,18,0,18,1.0,0.0,1.0
211087,0,0,0,0,0,0,0,5,,,,,,,,6,0,6,3.0,0.0,3.0
10351,0,0,0,0,0,0,0,62,0.0,0.0,0.0,0.0,0.0,0.0,0.0,6,0,6,4.0,0.0,4.0
9705212,0,0,0,0,0,0,0,243,0.0,0.0,0.0,0.0,0.0,0.0,0.0,1,0,1,,,
203247,0,0,0,0,0,0,0,82,,,,,,,,13,0,13,2.0,0.0,2.0
9505381,0,0,0,0,0,0,0,74,,,,,,,,5,0,5,,,
302122,0,0,0,0,0,0,0,1236,0.0,0.0,0.0,0.0,0.0,0.0,0.0,1,0,1,,,
9502203,0,0,0,0,0,0,0,134,0.0,0.0,0.0,0.0,0.0,0.0,0.0,4,0,4,,,
105127,0,0,0,0,0,0,0,28,0.0,0.0,0.0,0.0,0.0,0.0,0.0,17,0,17,6.0,0.0,6.0
9710475,1,1,0,0,0,1,1,57,0.0,0.0,0.0,0.0,0.0,0.0,0.0,8,1,7,5.0,0.0,5.0
302211,0,0,0,0,0,0,0,321,0.0,0.0,0.0,0.0,0.0,0.0,0.0,9,0,9,5.0,0.0,5.0
205339,0,0,0,0,0,0,0,158,0.0,0.0,0.0,0.0,0.0,0.0,0.0,13,0,13,9.0,0.0,9.0
9301210,1,1,0,0,1,0,0,510,1.0,1.0,0.0,0.0,1.0,0.0,0.0,1,1,0,1.0,1.0,0.0
9407205,0,0,0,0,0,0,0,302,0.0,0.0,0.0,0.0,0.0,0.0,0.0,3,0,3,1.0,0.0,1.0
9902373,1,1,0,0,0,1,4,38,1.0,1.0,0.0,0.0,0.0,1.0,2.0,5,1,4,,,
106215,1,1,0,0,1,0,0,1677,,,,,,,,1,1,0,,,
207233,0,0,0,0,0,0,0,54,0.0,0.0,0.0,0.0,0.0,0.0,0.0,21,0,21,14.0,0.0,14.0
9406323,0,0,0,0,0,0,0,149,,,,,,,,1,0,1,1.0,0.0,1.0
9610459,0,0,0,0,0,0,0,13,0.0,0.0,0.0,0.0,0.0,0.0,0.0,13,0,13,1.0,0.0,1.0
9801259,0,0,0,0,0,0,0,18,0.0,0.0,0.0,0.0,0.0,0.0,0.0,33,0,33,6.0,0.0,6.0
9501234,0,0,0,0,0,0,0,1724,,,,,,,,2,0,2,,,
9804457,0,0,0,0,0,0,0,231,0.0,0.0,0.0,0.0,0.0,0.0,0.0,3,0,3,2.0,0.0,2.0
301236,0,0,0,0,0,0,0,27,0.0,0.0,0.0,0.0,0.0,0.0,0.0,15,0,15,11.0,0.0,11.0
205119,0,0,0,0,0,0,0,247,0.0,0.0,0.0,0.0,0.0,0.0,0.0,13,0,13,6.0,0.0,6.0
9110,0,0,0,0,0,0,0,251,0.0,0.0,0.0,0.0,0.0,0.0,0.0,12,0,12,7.0,0.0,7.0
201276,0,0,0,0,0,0,0,14,0.0,0.0,0.0,0.0,0.0,0.0,0.0,15,0,15,1.0,0.0,1.0
102294,0,0,0,0,0,0,0,924,,,,,,,,3,0,3,,,
9706236,0,0,0,0,0,0,0,9,0.0,0.0,0.0,0.0,0.0,0.0,0.0,12,0,12,,,
9901435,0,0,0,0,0,0,0,18,0.0,0.0,0.0,0.0,0.0,0.0,0.0,5,0,5,3.0,0.0,3.0
211035,0,0,0,0,0,0,0,24,0.0,0.0,0.0,0.0,0.0,0.0,0.0,21,0,21,1.0,0.0,1.0
9903529,0,0,0,0,0,0,0,799,0.0,0.0,0.0,0.0,0.0,0.0,0.0,7,0,7,1.0,0.0,1.0
9706471,0,0,0,0,0,0,0,71,0.0,0.0,0.0,0.0,0.0,0.0,0.0,11,0,11,1.0,0.0,1.0
9506337,0,0,0,0,0,0,0,6,0.0,0.0,0.0,0.0,0.0,0.0,0.0,16,0,16,1.0,0.0,1.0
9706532,0,0,0,0,0,0,0,169,0.0,0.0,0.0,0.0,0.0,0.0,0.0,6,0,6,6.0,0.0,6.0
111455,0,0,0,0,0,0,0,57,0.0,0.0,0.0,0.0,0.0,0.0,0.0,15,0,15,6.0,0.0,6.0
9609483,0,0,0,0,0,0,0,49,0.0,0.0,0.0,0.0,0.0,0.0,0.0,20,0,20,8.0,0.0,8.0
110039,0,0,0,0,0,0,0,145,0.0,0.0,0.0,0.0,0.0,0.0,0.0,3,0,3,3.0,0.0,3.0
9503250,0,0,0,0,0,0,0,17,0.0,0.0,0.0,0.0,0.0,0.0,0.0,8,0,8,2.0,0.0,2.0
9305285,0,0,0,0,0,0,0,96,0.0,0.0,0.0,0.0,0.0,0.0,0.0,4,0,4,4.0,0.0,4.0
1265,1,1,0,0,1,0,0,745,1.0,1.0,0.0,0.0,1.0,0.0,0.0,1,1,0,1.0,1.0,0.0
302208,0,0,0,0,0,0,0,146,0.0,0.0,0.0,0.0,0.0,0.0,0.0,6,0,6,6.0,0.0,6.0
204241,0,0,0,0,0,0,0,12,0.0,0.0,0.0,0.0,0.0,0.0,0.0,18,0,18,2.0,0.0,2.0
301250,0,0,0,0,0,0,0,121,0.0,0.0,0.0,0.0,0.0,0.0,0.0,6,0,6,4.0,0.0,4.0
9706487,17,4,13,38,1,16,27,89,9.0,1.0,8.0,18.0,0.0,9.0,12.0,25,17,8,10.0,8.0,2.0
9911280,32,5,27,166,6,26,84,1,19.0,2.0,17.0,75.0,6.0,13.0,13.0,44,32,12,17.0,16.0,1.0
8273,44,6,38,174,3,41,313,1,20.0,7.0,13.0,38.0,1.0,19.0,109.0,68,44,24,31.0,20.0,11.0
9802433,75,4,71,599,1,74,643,1,59.0,1.0,58.0,476.0,0.0,59.0,486.0,100,75,25,54.0,43.0,11.0
9304225,338,42,296,3124,338,0,0,6,151.0,17.0,134.0,1633.0,151.0,0.0,0.0,338,338,0,49.0,49.0,0.0
9406239,72,23,49,197,20,52,180,7,19.0,1.0,18.0,86.0,6.0,13.0,25.0,85,72,13,6.0,6.0,0.0
9510378,65,15,50,156,16,49,180,7,2.0,2.0,0.0,0.0,0.0,2.0,4.0,123,65,58,3.0,0.0,3.0
9806230,10,7,3,6,10,0,0,278,1.0,1.0,0.0,0.0,1.0,0.0,0.0,10,10,0,,,
9706260,75,5,70,474,4,71,412,34,50.0,2.0,48.0,369.0,1.0,49.0,329.0,97,75,22,49.0,34.0,15.0
105177,7,5,2,3,1,6,11,37,3.0,1.0,2.0,3.0,0.0,3.0,8.0,23,7,16,5.0,3.0,2.0
9301212,45,16,29,78,5,40,40,74,22.0,6.0,16.0,40.0,1.0,21.0,21.0,46,45,1,13.0,12.0,1.0
203229,4,4,0,0,0,4,22,4,0.0,0.0,0.0,0.0,0.0,0.0,0.0,131,4,127,20.0,0.0,20.0
9502376,18,4,14,45,0,18,50,114,13.0,2.0,11.0,34.0,1.0,12.0,30.0,24,18,6,16.0,12.0,4.0
9806351,27,3,24,117,2,25,94,4,13.0,1.0,12.0,37.0,1.0,12.0,21.0,35,27,8,20.0,17.0,3.0
9611316,22,9,13,25,3,19,112,35,12.0,4.0,8.0,16.0,0.0,12.0,62.0,50,22,28,15.0,9.0,6.0
9906395,17,10,7,13,1,16,63,4,7.0,4.0,3.0,5.0,0.0,7.0,25.0,33,17,16,11.0,5.0,6.0
105318,3,1,2,2,0,3,18,33,2.0,1.0,1.0,1.0,0.0,2.0,16.0,28,3,25,17.0,1.0,16.0
9410230,36,4,32,172,35,1,1,48,26.0,2.0,24.0,128.0,26.0,0.0,0.0,38,36,2,20.0,20.0,0.0
9609311,9,4,5,5,1,8,26,33,5.0,2.0,3.0,3.0,0.0,5.0,17.0,16,9,7,12.0,5.0,7.0
9707223,43,9,34,101,0,43,332,17,23.0,4.0,19.0,59.0,0.0,23.0,266.0,87,43,44,39.0,9.0,30.0
9806467,62,4,58,351,9,53,262,43,41.0,3.0,38.0,234.0,1.0,40.0,206.0,81,62,19,34.0,20.0,14.0
9906273,19,10,9,21,1,18,49,25,3.0,3.0,0.0,0.0,0.0,3.0,4.0,30,19,11,4.0,2.0,2.0
209326,6,3,3,4,0,6,35,4,2.0,1.0,1.0,1.0,0.0,2.0,8.0,22,6,16,6.0,1.0,5.0
103159,4,2,2,2,1,3,5,26,2.0,1.0,1.0,1.0,0.0,2.0,2.0,10,4,6,3.0,2.0,1.0
9311320,20,9,11,23,13,7,17,26,10.0,6.0,4.0,9.0,6.0,4.0,8.0,27,20,7,6.0,2.0,4.0
9704455,28,10,18,51,2,26,116,26,19.0,4.0,15.0,43.0,0.0,19.0,101.0,36,28,8,16.0,9.0,7.0
9903287,4,2,2,3,0,4,18,34,3.0,1.0,2.0,3.0,0.0,3.0,12.0,32,4,28,7.0,3.0,4.0
9902371,133,17,116,944,6,127,989,32,74.0,4.0,70.0,654.0,0.0,74.0,479.0,206,133,73,64.0,52.0,12.0
9905386,26,2,24,61,3,23,40,163,6.0,1.0,5.0,9.0,2.0,4.0,6.0,41,26,15,6.0,4.0,2.0
101083,25,8,17,47,6,19,104,4,4.0,3.0,1.0,1.0,1.0,3.0,26.0,46,25,21,9.0,3.0,6.0
9807465,20,5,15,32,6,14,35,30,6.0,2.0,4.0,8.0,3.0,3.0,4.0,38,20,18,4.0,4.0,0.0
9306270,80,23,57,192,52,28,30,93,25.0,4.0,21.0,73.0,12.0,13.0,13.0,83,80,3,17.0,16.0,1.0
106116,29,9,20,43,2,27,366,4,14.0,3.0,11.0,19.0,0.0,14.0,249.0,99,29,70,34.0,8.0,26.0
202255,9,7,2,2,5,4,11,26,0.0,0.0,0.0,0.0,0.0,0.0,0.0,55,9,46,20.0,0.0,20.0
9405264,1,1,0,0,1,0,0,511,1.0,1.0,0.0,0.0,1.0,0.0,0.0,1,1,0,1.0,1.0,0.0
9207221,105,20,85,455,105,0,0,12,29.0,2.0,27.0,131.0,29.0,0.0,0.0,105,105,0,18.0,18.0,0.0
9503268,4,1,3,3,0,4,7,149,4.0,1.0,3.0,3.0,0.0,4.0,7.0,9,4,5,9.0,4.0,5.0
9412380,13,3,10,12,7,6,7,25,5.0,1.0,4.0,5.0,1.0,4.0,4.0,15,13,2,1.0,1.0,0.0
9505405,59,1,58,322,40,19,23,23,36.0,1.0,35.0,176.0,22.0,14.0,14.0,63,59,4,25.0,24.0,1.0
9406271,42,5,37,227,22,20,20,71,36.0,2.0,34.0,220.0,17.0,19.0,19.0,43,42,1,29.0,28.0,1.0
9508296,69,10,59,217,7,62,184,5,36.0,5.0,31.0,117.0,0.0,36.0,106.0,79,69,10,26.0,23.0,3.0
9404334,16,5,11,27,15,1,1,99,5.0,1.0,4.0,8.0,5.0,0.0,0.0,17,16,1,1.0,1.0,0.0
9408275,59,12,47,108,36,23,23,60,9.0,5.0,4.0,5.0,9.0,0.0,0.0,61,59,2,4.0,4.0,0.0
9408304,29,10,19,55,11,18,25,0,13.0,7.0,6.0,14.0,2.0,11.0,17.0,31,29,2,12.0,10.0,2.0
1009,5,4,1,1,3,2,4,1750,,,,,,,,11,5,6,1.0,1.0,0.0
9711444,16,2,14,64,4,12,27,0,11.0,2.0,9.0,40.0,2.0,9.0,12.0,36,16,20,2.0,2.0,0.0
9811352,23,4,19,38,1,22,94,0,6.0,2.0,4.0,4.0,0.0,6.0,17.0,37,23,14,12.0,5.0,7.0
9806376,33,8,25,91,4,29,193,0,6.0,5.0,1.0,2.0,0.0,6.0,47.0,67,33,34,3.0,0.0,3.0
9411315,3,2,1,1,3,0,0,317,0.0,0.0,0.0,0.0,0.0,0.0,0.0,7,3,4,1.0,0.0,1.0
9212204,34,11,23,72,34,0,0,0,19.0,6.0,13.0,40.0,19.0,0.0,0.0,34,34,0,13.0,13.0,0.0
9808304,61,5,56,282,1,60,325,12,33.0,2.0,31.0,138.0,0.0,33.0,216.0,84,61,23,15.0,14.0,1.0
9906375,72,13,59,282,13,59,109,3,23.0,1.0,22.0,60.0,14.0,9.0,9.0,75,72,3,17.0,17.0,0.0
9903424,33,6,27,82,1,32,107,0,7.0,2.0,5.0,7.0,0.0,7.0,23.0,51,33,18,18.0,13.0,5.0
9711311,13,6,7,8,3,10,50,0,5.0,2.0,3.0,4.0,0.0,5.0,33.0,35,13,22,17.0,4.0,13.0
9709438,24,3,21,96,3,21,61,0,5.0,1.0,4.0,5.0,0.0,5.0,9.0,34,24,10,6.0,6.0,0.0
9810510,19,3,16,42,1,18,71,119,14.0,1.0,13.0,29.0,0.0,14.0,53.0,30,19,11,18.0,11.0,7.0
9812426,47,2,45,307,16,31,66,3,42.0,2.0,40.0,269.0,16.0,26.0,51.0,55,47,8,26.0,26.0,0.0
9910428,38,7,31,121,2,36,268,0,26.0,2.0,24.0,108.0,0.0,26.0,190.0,73,38,35,37.0,21.0,16.0
9403268,7,5,2,2,1,6,25,10,2.0,1.0,1.0,1.0,0.0,2.0,6.0,21,7,14,5.0,3.0,2.0
9708213,18,3,15,47,3,15,57,0,6.0,2.0,4.0,6.0,0.0,6.0,12.0,33,18,15,6.0,1.0,5.0
9811267,50,17,33,83,26,24,48,0,12.0,2.0,10.0,26.0,5.0,7.0,9.0,94,50,44,8.0,7.0,1.0
9807568,3,1,2,3,1,2,17,0,0.0,0.0,0.0,0.0,0.0,0.0,0.0,35,3,32,22.0,1.0,21.0
9502219,19,3,16,51,9,10,27,3,7.0,2.0,5.0,13.0,7.0,0.0,0.0,24,19,5,9.0,9.0,0.0
9806426,9,6,3,5,1,8,29,42,4.0,2.0,2.0,3.0,0.0,4.0,14.0,20,9,11,3.0,2.0,1.0
9606416,38,4,34,133,0,38,136,21,24.0,2.0,22.0,83.0,0.0,24.0,88.0,47,38,9,19.0,15.0,4.0
9402253,288,39,249,1418,142,146,299,10,44.0,4.0,40.0,245.0,44.0,0.0,0.0,294,288,6,17.0,12.0,5.0
9311257,17,6,11,27,8,9,22,63,9.0,2.0,7.0,17.0,7.0,2.0,2.0,24,17,7,3.0,3.0,0.0
9502397,28,12,16,51,11,17,45,10,13.0,6.0,7.0,25.0,13.0,0.0,0.0,41,28,13,8.0,8.0,0.0
9703215,15,5,10,13,2,13,25,63,5.0,2.0,3.0,5.0,0.0,5.0,12.0,22,15,7,8.0,3.0,5.0
9607363,8,3,5,11,0,8,49,10,1.0,1.0,0.0,0.0,0.0,1.0,4.0,27,8,19,10.0,3.0,7.0
9807502,12,1,11,39,0,12,79,10,4.0,1.0,3.0,4.0,1.0,3.0,17.0,46,12,34,13.0,10.0,3.0
9509365,19,5,14,39,7,12,16,42,10.0,2.0,8.0,21.0,2.0,8.0,8.0,28,19,9,3.0,0.0,3.0
9309252,46,20,26,81,46,0,0,10,9.0,4.0,5.0,6.0,9.0,0.0,0.0,46,46,0,6.0,6.0,0.0
9302318,104,22,82,558,104,0,0,18,44.0,2.0,42.0,315.0,44.0,0.0,0.0,104,104,0,13.0,13.0,0.0
9603219,20,5,15,34,4,16,28,12,8.0,6.0,2.0,4.0,8.0,0.0,0.0,26,20,6,3.0,2.0,1.0
9704221,62,6,56,399,1,61,590,36,50.0,3.0,47.0,362.0,0.0,50.0,527.0,86,62,24,55.0,41.0,14.0
9305282,39,5,34,124,6,33,89,69,29.0,3.0,26.0,96.0,5.0,24.0,70.0,43,39,4,23.0,19.0,4.0
9609357,30,10,20,46,9,21,61,1,12.0,5.0,7.0,17.0,4.0,8.0,28.0,38,30,8,3.0,2.0,1.0
3220,29,6,23,66,1,28,153,3,14.0,2.0,12.0,38.0,2.0,12.0,12.0,57,29,28,12.0,11.0,1.0
9209279,74,13,61,402,74,0,0,1,45.0,5.0,40.0,316.0,45.0,0.0,0.0,74,74,0,22.0,22.0,0.0
9705320,31,9,22,53,12,19,75,1,8.0,2.0,6.0,16.0,4.0,4.0,7.0,53,31,22,6.0,6.0,0.0
103280,78,12,66,309,0,78,1208,23,42.0,11.0,31.0,155.0,0.0,42.0,545.0,151,78,73,54.0,34.0,20.0
105253,19,5,14,36,1,18,152,67,11.0,3.0,8.0,24.0,0.0,11.0,105.0,45,19,26,28.0,9.0,19.0
9811335,17,2,15,45,1,16,212,1,16.0,1.0,15.0,45.0,0.0,16.0,210.0,42,17,25,30.0,14.0,16.0
9408384,444,15,429,4445,405,39,52,5,145.0,2.0,143.0,2071.0,136.0,9.0,9.0,448,444,4,66.0,66.0,0.0
9611243,28,7,21,68,0,28,176,5,14.0,2.0,12.0,45.0,0.0,14.0,115.0,44,28,16,24.0,12.0,12.0
9706235,30,3,27,78,8,22,102,5,13.0,1.0,12.0,36.0,0.0,13.0,59.0,42,30,12,9.0,5.0,4.0
9409421,67,31,36,79,30,37,44,48,8.0,6.0,2.0,3.0,4.0,4.0,4.0,70,67,3,6.0,4.0,2.0
9402235,1,1,0,0,1,0,0,626,0.0,0.0,0.0,0.0,0.0,0.0,0.0,2,1,1,1.0,0.0,1.0
9608364,15,8,7,11,6,9,18,93,3.0,2.0,1.0,1.0,1.0,2.0,2.0,26,15,11,4.0,1.0,3.0
9806423,24,6,18,32,4,20,62,1,3.0,1.0,2.0,3.0,0.0,3.0,11.0,38,24,14,3.0,2.0,1.0
102089,13,6,7,19,0,13,93,6,7.0,4.0,3.0,7.0,0.0,7.0,13.0,31,13,18,12.0,5.0,7.0
9703213,36,5,31,94,17,19,41,6,15.0,2.0,13.0,49.0,15.0,0.0,0.0,42,36,6,13.0,13.0,0.0
9812444,5,3,2,3,0,5,13,1,0.0,0.0,0.0,0.0,0.0,0.0,0.0,19,5,14,2.0,0.0,2.0
9911390,16,5,11,32,0,16,158,34,9.0,3.0,6.0,24.0,0.0,9.0,95.0,41,16,25,28.0,8.0,20.0
9308210,87,17,70,248,47,40,55,1,14.0,3.0,11.0,19.0,9.0,5.0,5.0,91,87,4,10.0,8.0,2.0
9603244,35,3,32,159,10,25,51,1,10.0,1.0,9.0,24.0,10.0,0.0,0.0,44,35,9,12.0,11.0,1.0
9908371,66,8,58,205,1,65,523,32,11.0,5.0,6.0,7.0,0.0,11.0,66.0,100,66,34,21.0,15.0,6.0
9707213,29,16,13,20,7,22,72,4,5.0,2.0,3.0,3.0,0.0,5.0,22.0,50,29,21,2.0,2.0,0.0
9802310,7,2,5,6,4,3,5,269,4.0,2.0,2.0,3.0,3.0,1.0,2.0,11,7,4,3.0,1.0,2.0
9811518,50,16,34,65,13,37,82,59,9.0,5.0,4.0,5.0,1.0,8.0,25.0,62,50,12,5.0,5.0,0.0
9603317,14,5,9,17,0,14,53,21,9.0,4.0,5.0,9.0,0.0,9.0,37.0,21,14,7,5.0,4.0,1.0
9803269,11,3,8,16,0,11,46,7,3.0,1.0,2.0,2.0,0.0,3.0,26.0,33,11,22,14.0,3.0,11.0
9403397,65,14,51,147,10,55,201,75,14.0,5.0,9.0,15.0,0.0,14.0,68.0,76,65,11,24.0,17.0,7.0
9711248,29,8,21,54,3,26,91,7,4.0,1.0,3.0,5.0,1.0,3.0,3.0,43,29,14,9.0,6.0,3.0
9710204,76,6,70,267,31,45,62,2,28.0,2.0,26.0,124.0,4.0,24.0,33.0,85,76,9,18.0,16.0,2.0
9305275,76,21,55,218,27,49,98,15,31.0,2.0,29.0,156.0,2.0,29.0,76.0,81,76,5,24.0,20.0,4.0
9506278,15,1,14,41,1,14,76,15,14.0,1.0,13.0,40.0,0.0,14.0,76.0,33,15,18,5.0,0.0,5.0
9710334,23,8,15,27,6,17,17,98,11.0,3.0,8.0,12.0,1.0,10.0,10.0,24,23,1,9.0,8.0,1.0
9311230,2,1,1,1,2,0,0,371,1.0,1.0,0.0,0.0,1.0,0.0,0.0,2,2,0,1.0,1.0,0.0
9811338,1,1,0,0,1,0,0,98,1.0,1.0,0.0,0.0,1.0,0.0,0.0,3,1,2,,,
9801350,30,6,24,137,1,29,231,8,25.0,1.0,24.0,134.0,2.0,23.0,195.0,50,30,20,33.0,19.0,14.0
9508292,14,7,7,12,2,12,22,62,10.0,5.0,5.0,9.0,0.0,10.0,18.0,16,14,2,12.0,10.0,2.0
9506425,64,14,50,212,52,12,14,8,27.0,2.0,25.0,135.0,27.0,0.0,0.0,69,64,5,23.0,23.0,0.0
9802365,39,3,36,233,0,39,240,24,27.0,1.0,26.0,181.0,0.0,27.0,168.0,61,39,22,26.0,18.0,8.0
9512329,50,14,36,143,18,32,53,11,11.0,2.0,9.0,20.0,11.0,0.0,0.0,56,50,6,14.0,14.0,0.0
9604250,34,1,33,159,19,15,20,16,23.0,2.0,21.0,100.0,14.0,9.0,9.0,36,34,2,18.0,18.0,0.0
9403242,20,7,13,35,20,0,0,57,12.0,2.0,10.0,30.0,12.0,0.0,0.0,20,20,0,10.0,10.0,0.0
9606375,15,9,6,10,11,4,4,16,6.0,3.0,3.0,5.0,6.0,0.0,0.0,18,15,3,3.0,3.0,0.0
9811478,3,2,1,1,0,3,8,98,0.0,0.0,0.0,0.0,0.0,0.0,0.0,16,3,13,5.0,3.0,2.0
9409291,19,9,10,28,15,4,7,30,10.0,7.0,3.0,6.0,10.0,0.0,0.0,23,19,4,9.0,9.0,0.0
9708350,29,5,24,69,2,27,137,151,15.0,4.0,11.0,34.0,0.0,15.0,68.0,49,29,20,18.0,12.0,6.0
9707260,1,1,0,0,1,0,0,30,,,,,,,,4,1,3,,,
9402302,15,6,9,13,15,0,0,139,11.0,4.0,7.0,10.0,11.0,0.0,0.0,16,15,1,7.0,7.0,0.0
9403356,3,1,2,2,0,3,5,86,0.0,0.0,0.0,0.0,0.0,0.0,0.0,7,3,4,1.0,0.0,1.0
9612457,57,17,40,103,29,28,59,59,10.0,2.0,8.0,20.0,3.0,7.0,16.0,75,57,18,10.0,7.0,3.0
9804227,71,2,69,508,6,65,369,24,58.0,1.0,57.0,405.0,4.0,54.0,212.0,94,71,23,34.0,31.0,3.0
9410293,31,11,20,71,8,23,103,6,19.0,5.0,14.0,58.0,0.0,19.0,89.0,43,31,12,3.0,3.0,0.0
9405304,108,11,97,671,60,48,109,8,42.0,4.0,38.0,218.0,5.0,37.0,90.0,111,108,3,29.0,26.0,3.0
9207236,94,19,75,379,75,19,19,6,48.0,6.0,42.0,263.0,48.0,0.0,0.0,95,94,1,11.0,11.0,0.0
9212305,88,20,68,285,84,4,4,69,26.0,2.0,24.0,127.0,26.0,0.0,0.0,90,88,2,16.0,16.0,0.0
9401220,26,16,10,21,16,10,10,96,15.0,9.0,6.0,17.0,5.0,10.0,10.0,27,26,1,11.0,10.0,1.0
9612202,49,6,43,164,11,38,95,8,22.0,1.0,21.0,74.0,22.0,0.0,0.0,58,49,9,17.0,17.0,0.0
9909265,57,20,37,122,12,45,253,55,16.0,2.0,14.0,43.0,1.0,15.0,126.0,117,57,60,25.0,13.0,12.0
9510408,104,15,89,481,7,97,405,38,56.0,8.0,48.0,327.0,0.0,56.0,242.0,121,104,17,44.0,36.0,8.0
9605223,41,6,35,100,0,41,235,40,35.0,3.0,32.0,90.0,0.0,35.0,216.0,50,41,9,33.0,24.0,9.0
9808214,8,3,5,9,6,2,8,45,4.0,1.0,3.0,4.0,2.0,2.0,8.0,14,8,6,3.0,2.0,1.0
9205235,19,8,11,24,19,0,0,205,7.0,3.0,4.0,6.0,7.0,0.0,0.0,19,19,0,3.0,3.0,0.0
9212264,3,3,0,0,3,0,0,344,1.0,1.0,0.0,0.0,1.0,0.0,0.0,3,3,0,1.0,1.0,0.0
9803226,47,15,32,84,8,39,127,38,14.0,3.0,11.0,43.0,0.0,14.0,51.0,67,47,20,16.0,12.0,4.0
9910451,9,2,7,15,0,9,44,38,8.0,1.0,7.0,15.0,0.0,8.0,40.0,17,9,8,3.0,2.0,1.0
9610210,10,4,6,9,1,9,25,88,6.0,1.0,5.0,8.0,0.0,6.0,17.0,18,10,8,9.0,6.0,3.0
9809379,10,3,7,21,2,8,17,38,9.0,2.0,7.0,21.0,1.0,8.0,17.0,15,10,5,4.0,3.0,1.0
9912473,15,2,13,44,0,15,78,21,14.0,2.0,12.0,41.0,0.0,14.0,71.0,22,15,7,19.0,13.0,6.0
9801306,44,6,38,116,3,41,162,21,21.0,4.0,17.0,35.0,0.0,21.0,93.0,51,44,7,10.0,10.0,0.0
9501230,71,18,53,286,71,0,0,43,27.0,2.0,25.0,164.0,27.0,0.0,0.0,71,71,0,16.0,16.0,0.0
9704447,33,5,28,77,13,20,31,140,12.0,2.0,10.0,20.0,4.0,8.0,12.0,39,33,6,9.0,8.0,1.0
9811340,6,3,3,6,0,6,19,43,0.0,0.0,0.0,0.0,0.0,0.0,0.0,14,6,8,4.0,0.0,4.0
9908307,7,3,4,4,3,4,7,97,2.0,1.0,1.0,1.0,2.0,0.0,0.0,12,7,5,1.0,0.0,1.0
5025,48,26,22,58,5,43,392,19,6.0,1.0,5.0,11.0,0.0,6.0,72.0,330,48,282,29.0,0.0,29.0
9403236,13,5,8,15,2,11,11,39,5.0,1.0,4.0,8.0,0.0,5.0,5.0,14,13,1,6.0,5.0,1.0
2123,25,1,24,85,0,25,364,20,21.0,1.0,20.0,72.0,0.0,21.0,338.0,52,25,27,42.0,16.0,26.0
9605342,97,25,72,240,14,83,352,29,24.0,3.0,21.0,74.0,0.0,24.0,122.0,194,97,97,14.0,7.0,7.0
9804273,38,8,30,80,4,34,159,31,25.0,5.0,20.0,56.0,1.0,24.0,115.0,55,38,17,20.0,9.0,11.0
9303224,12,5,7,12,12,0,0,245,4.0,1.0,3.0,4.0,4.0,0.0,0.0,12,12,0,4.0,4.0,0.0
9411330,18,2,16,41,1,17,60,7,9.0,1.0,8.0,21.0,0.0,9.0,13.0,29,18,11,10.0,8.0,2.0
10223,5,4,1,1,0,5,11,153,3.0,2.0,1.0,1.0,1.0,2.0,4.0,14,5,9,6.0,1.0,5.0
9912475,10,8,2,2,3,7,21,20,0.0,0.0,0.0,0.0,0.0,0.0,0.0,19,10,9,1.0,1.0,0.0
9811426,13,6,7,11,1,12,19,123,7.0,3.0,4.0,5.0,0.0,7.0,14.0,17,13,4,9.0,7.0,2.0
109095,16,5,11,35,0,16,120,20,14.0,4.0,10.0,27.0,0.0,14.0,101.0,34,16,18,9.0,8.0,1.0
206124,9,5,4,6,3,6,19,239,5.0,2.0,3.0,5.0,0.0,5.0,17.0,16,9,7,11.0,5.0,6.0
9512363,18,3,15,33,2,16,70,6,10.0,2.0,8.0,17.0,1.0,9.0,39.0,30,18,12,14.0,7.0,7.0
9511264,3,3,0,0,1,2,3,14,0.0,0.0,0.0,0.0,0.0,0.0,0.0,9,3,6,1.0,0.0,1.0
9909334,82,17,65,243,8,74,402,18,11.0,4.0,7.0,15.0,0.0,11.0,49.0,130,82,48,21.0,8.0,13.0
9602279,7,4,3,4,2,5,10,92,0.0,0.0,0.0,0.0,0.0,0.0,0.0,14,7,7,1.0,1.0,0.0
9811323,110,9,101,832,4,106,508,2,62.0,2.0,60.0,562.0,0.0,62.0,351.0,130,110,20,45.0,38.0,7.0
9807501,134,5,129,1189,22,112,328,32,80.0,1.0,79.0,862.0,8.0,72.0,235.0,140,134,6,51.0,47.0,4.0
9905467,11,8,3,4,0,11,46,99,5.0,4.0,1.0,1.0,0.0,5.0,24.0,36,11,25,18.0,5.0,13.0
9304247,11,5,6,11,11,0,0,42,6.0,3.0,3.0,8.0,6.0,0.0,0.0,12,11,1,1.0,1.0,0.0
9801451,2,1,1,1,0,2,9,42,2.0,1.0,1.0,1.0,0.0,2.0,9.0,16,2,14,6.0,1.0,5.0
9405226,4,3,1,1,1,3,10,29,,,,,,,,8,4,4,1.0,1.0,0.0
9508321,100,9,91,682,9,91,294,18,57.0,5.0,52.0,401.0,2.0,55.0,109.0,119,100,19,33.0,32.0,1.0
9504299,4,3,1,1,4,0,0,102,,,,,,,,6,4,2,,,
9601292,9,7,2,2,4,5,6,30,2.0,2.0,0.0,0.0,1.0,1.0,1.0,13,9,4,2.0,0.0,2.0
9712271,37,3,34,120,14,23,80,4,19.0,2.0,17.0,68.0,9.0,10.0,38.0,47,37,10,17.0,12.0,5.0
9603423,51,9,42,169,3,48,88,4,15.0,2.0,13.0,63.0,8.0,7.0,7.0,59,51,8,3.0,3.0,0.0
9908385,27,2,25,107,0,27,117,4,20.0,2.0,18.0,75.0,0.0,20.0,82.0,36,27,9,23.0,18.0,5.0
9501372,64,2,62,631,58,6,6,70,56.0,1.0,55.0,610.0,56.0,0.0,0.0,65,64,1,45.0,45.0,0.0
9701273,8,2,6,8,1,7,8,12,4.0,3.0,1.0,1.0,0.0,4.0,4.0,11,8,3,6.0,5.0,1.0
9904340,1,1,0,0,0,1,1,82,1.0,1.0,0.0,0.0,0.0,1.0,1.0,8,1,7,,,
9704441,23,7,16,35,1,22,76,41,5.0,4.0,1.0,1.0,0.0,5.0,16.0,38,23,15,11.0,4.0,7.0
9604414,4,4,0,0,3,1,3,10,0.0,0.0,0.0,0.0,0.0,0.0,0.0,13,4,9,1.0,1.0,0.0
9411237,24,8,16,46,13,11,11,41,15.0,3.0,12.0,29.0,7.0,8.0,8.0,25,24,1,9.0,8.0,1.0
9603415,5,3,2,2,4,1,3,10,0.0,0.0,0.0,0.0,0.0,0.0,0.0,22,5,17,3.0,0.0,3.0
9607475,4,3,1,1,0,4,9,84,4.0,3.0,1.0,1.0,0.0,4.0,9.0,11,4,7,5.0,3.0,2.0
9507228,9,5,4,16,0,9,25,49,8.0,5.0,3.0,12.0,1.0,7.0,14.0,17,9,8,11.0,7.0,4.0
9606281,30,5,25,80,21,9,23,10,12.0,1.0,11.0,32.0,9.0,3.0,5.0,51,30,21,7.0,7.0,0.0
9809294,4,4,0,0,1,3,8,78,1.0,1.0,0.0,0.0,1.0,0.0,0.0,13,4,9,2.0,1.0,1.0
111058,116,7,109,494,43,73,343,23,37.0,1.0,36.0,173.0,1.0,36.0,202.0,142,116,26,38.0,24.0,14.0
9603345,12,6,6,10,7,5,10,58,5.0,3.0,2.0,5.0,0.0,5.0,10.0,15,12,3,4.0,2.0,2.0
9207225,20,6,14,35,20,0,0,1,3.0,1.0,2.0,2.0,3.0,0.0,0.0,20,20,0,2.0,2.0,0.0
9303268,31,12,19,45,31,0,0,33,8.0,1.0,7.0,17.0,8.0,0.0,0.0,31,31,0,6.0,6.0,0.0
9810479,96,13,83,546,6,90,413,55,56.0,5.0,51.0,310.0,0.0,56.0,294.0,111,96,15,45.0,36.0,9.0
9904504,38,6,32,133,0,38,482,2,31.0,4.0,27.0,116.0,0.0,31.0,405.0,77,38,39,33.0,23.0,10.0
2208,10,3,7,21,1,9,73,55,6.0,1.0,5.0,13.0,0.0,6.0,58.0,26,10,16,14.0,4.0,10.0
9310250,3,3,0,0,3,0,0,1095,1.0,1.0,0.0,0.0,1.0,0.0,0.0,3,3,0,1.0,1.0,0.0
9612267,15,4,11,34,0,15,21,116,12.0,3.0,9.0,29.0,0.0,12.0,16.0,18,15,3,13.0,12.0,1.0
9804399,7,2,5,8,0,7,35,31,7.0,2.0,5.0,8.0,0.0,7.0,33.0,18,7,11,12.0,5.0,7.0
7113,42,4,38,146,0,42,278,18,27.0,1.0,26.0,93.0,0.0,27.0,203.0,78,42,36,15.0,7.0,8.0
106084,12,4,8,21,1,11,38,23,8.0,1.0,7.0,19.0,0.0,8.0,30.0,19,12,7,12.0,6.0,6.0
102180,31,2,29,267,1,30,206,23,30.0,2.0,28.0,266.0,0.0,30.0,175.0,55,31,24,24.0,23.0,1.0
9704335,47,20,27,57,11,36,67,27,16.0,5.0,11.0,26.0,5.0,11.0,22.0,61,47,14,5.0,5.0,0.0
102276,13,5,8,14,2,11,25,107,3.0,1.0,2.0,3.0,1.0,2.0,2.0,20,13,7,2.0,2.0,0.0
106189,24,1,23,95,0,24,228,18,21.0,1.0,20.0,86.0,0.0,21.0,88.0,54,24,30,21.0,15.0,6.0
102324,37,5,32,159,0,37,584,23,27.0,3.0,24.0,116.0,0.0,27.0,340.0,92,37,55,36.0,21.0,15.0
107069,18,5,13,29,0,18,248,23,6.0,1.0,5.0,10.0,0.0,6.0,103.0,102,18,84,34.0,7.0,27.0
9402215,12,2,10,18,8,4,4,18,2.0,1.0,1.0,1.0,2.0,0.0,0.0,13,12,1,2.0,2.0,0.0
9308324,11,6,5,9,0,11,15,18,3.0,3.0,0.0,0.0,3.0,0.0,0.0,14,11,3,3.0,3.0,0.0
9404219,2,2,0,0,2,0,0,1297,1.0,1.0,0.0,0.0,1.0,0.0,0.0,4,2,2,,,
104166,15,4,11,39,0,15,59,0,12.0,2.0,10.0,35.0,0.0,12.0,51.0,28,15,13,10.0,2.0,8.0
6026,7,2,5,5,0,7,30,0,5.0,2.0,3.0,3.0,0.0,5.0,18.0,20,7,13,8.0,1.0,7.0
9604451,13,4,9,10,0,13,19,111,12.0,4.0,8.0,9.0,0.0,12.0,17.0,15,13,2,12.0,10.0,2.0
9503251,30,6,24,97,30,0,0,4,16.0,2.0,14.0,61.0,16.0,0.0,0.0,30,30,0,13.0,13.0,0.0
9812364,7,2,5,8,1,6,7,118,5.0,1.0,4.0,7.0,1.0,4.0,5.0,9,7,2,6.0,5.0,1.0
9903414,20,5,15,27,9,11,38,118,7.0,2.0,5.0,7.0,0.0,7.0,22.0,30,20,10,12.0,7.0,5.0
9512208,26,5,21,48,4,22,89,16,8.0,1.0,7.0,10.0,0.0,8.0,41.0,41,26,15,9.0,6.0,3.0
9806371,12,10,2,3,0,12,52,16,6.0,6.0,0.0,0.0,0.0,6.0,23.0,25,12,13,9.0,4.0,5.0
9911426,2,2,0,0,0,2,11,47,0.0,0.0,0.0,0.0,0.0,0.0,0.0,44,2,42,2.0,0.0,2.0
12176,2,1,1,1,0,2,8,19,,,,,,,,7,2,5,1.0,0.0,1.0
9502341,30,6,24,132,5,25,35,43,21.0,3.0,18.0,120.0,5.0,16.0,24.0,32,30,2,20.0,18.0,2.0
9910481,19,4,15,56,0,19,163,5,11.0,1.0,10.0,35.0,0.0,11.0,78.0,47,19,28,20.0,12.0,8.0
9805406,2,1,1,1,1,1,2,293,0.0,0.0,0.0,0.0,0.0,0.0,0.0,18,2,16,7.0,0.0,7.0
9610267,29,6,23,60,3,26,97,39,16.0,4.0,12.0,27.0,0.0,16.0,56.0,42,29,13,22.0,14.0,8.0
9709440,5,4,1,1,1,4,6,39,2.0,1.0,1.0,1.0,0.0,2.0,2.0,8,5,3,1.0,1.0,0.0
9409350,5,3,2,4,3,2,3,99,,,,,,,,8,5,3,1.0,1.0,0.0
9906228,2,1,1,1,0,2,4,82,0.0,0.0,0.0,0.0,0.0,0.0,0.0,34,2,32,2.0,0.0,2.0
9906542,21,7,14,34,1,20,93,2,8.0,2.0,6.0,10.0,0.0,8.0,19.0,31,21,10,9.0,6.0,3.0
9704372,7,6,1,2,7,0,0,309,0.0,0.0,0.0,0.0,0.0,0.0,0.0,10,7,3,1.0,1.0,0.0
9807236,17,4,13,37,1,16,40,44,13.0,3.0,10.0,32.0,7.0,6.0,7.0,25,17,8,13.0,12.0,1.0
10212,48,2,46,362,0,48,564,19,41.0,2.0,39.0,332.0,0.0,41.0,536.0,73,48,25,60.0,40.0,20.0
108273,11,2,9,21,1,10,70,19,8.0,3.0,5.0,12.0,1.0,7.0,49.0,35,11,24,13.0,7.0,6.0
207004,32,7,25,59,0,32,191,19,19.0,4.0,15.0,33.0,0.0,19.0,106.0,60,32,28,20.0,10.0,10.0
103089,6,3,3,6,0,6,15,43,0.0,0.0,0.0,0.0,0.0,0.0,0.0,20,6,14,7.0,1.0,6.0
9503340,14,3,11,32,11,3,3,16,4.0,1.0,3.0,6.0,4.0,0.0,0.0,15,14,1,4.0,3.0,1.0
207167,2,1,1,1,0,2,24,19,2.0,1.0,1.0,1.0,0.0,2.0,16.0,17,2,15,,,
12350,19,7,12,27,5,14,44,28,6.0,3.0,3.0,4.0,0.0,6.0,20.0,40,19,21,4.0,4.0,0.0
103207,8,1,7,13,0,8,32,28,2.0,1.0,1.0,1.0,1.0,1.0,1.0,21,8,13,3.0,2.0,1.0
5104,28,10,18,46,4,24,144,28,19.0,6.0,13.0,35.0,3.0,16.0,86.0,96,28,68,24.0,8.0,16.0
4238,0,0,0,0,0,0,0,26,0.0,0.0,0.0,0.0,0.0,0.0,0.0,9,0,9,3.0,0.0,3.0
9701311,18,7,11,17,7,11,23,91,7.0,1.0,6.0,9.0,0.0,7.0,17.0,25,18,7,11.0,8.0,3.0
106322,2,2,0,0,0,2,22,2,2.0,2.0,0.0,0.0,0.0,2.0,6.0,15,2,13,7.0,2.0,5.0
1335,17,6,11,17,0,17,131,2,12.0,5.0,7.0,9.0,0.0,12.0,99.0,38,17,21,5.0,4.0,1.0
7048,6,3,3,3,0,6,34,2,4.0,2.0,2.0,2.0,0.0,4.0,27.0,17,6,11,1.0,1.0,0.0
9212301,47,11,36,131,47,0,0,96,25.0,3.0,22.0,80.0,25.0,0.0,0.0,47,47,0,22.0,22.0,0.0
9806346,7,3,4,5,1,6,71,5,4.0,1.0,3.0,4.0,0.0,4.0,66.0,56,7,49,19.0,0.0,19.0
9608233,22,6,16,39,1,21,203,60,8.0,2.0,6.0,18.0,0.0,8.0,89.0,59,22,37,27.0,8.0,19.0
9408322,52,4,48,200,0,52,135,60,22.0,2.0,20.0,90.0,0.0,22.0,88.0,62,52,10,24.0,16.0,8.0
9609525,16,6,10,20,6,10,10,197,12.0,4.0,8.0,16.0,3.0,9.0,9.0,17,16,1,9.0,8.0,1.0
5310,18,5,13,28,0,18,71,28,11.0,3.0,8.0,16.0,0.0,11.0,37.0,35,18,17,5.0,5.0,0.0
9602369,9,8,1,1,2,7,13,164,1.0,1.0,0.0,0.0,0.0,1.0,5.0,38,9,29,14.0,1.0,13.0
9302290,14,3,11,21,3,11,11,234,8.0,3.0,5.0,9.0,1.0,7.0,7.0,16,14,2,9.0,8.0,1.0
11360,4,1,3,4,0,4,29,86,3.0,1.0,2.0,2.0,0.0,3.0,14.0,50,4,46,8.0,1.0,7.0
9507271,83,19,64,228,62,21,39,14,27.0,3.0,24.0,64.0,19.0,8.0,16.0,86,83,3,14.0,14.0,0.0
9503258,9,2,7,11,7,2,9,204,5.0,1.0,4.0,8.0,5.0,0.0,0.0,15,9,6,2.0,2.0,0.0
8292,27,7,20,60,0,27,331,1,17.0,3.0,14.0,41.0,0.0,17.0,265.0,69,27,42,37.0,12.0,25.0
6250,45,3,42,205,0,45,142,7,21.0,2.0,19.0,85.0,0.0,21.0,58.0,59,45,14,23.0,21.0,2.0
101102,9,6,3,3,4,5,35,46,1.0,1.0,0.0,0.0,0.0,1.0,11.0,40,9,31,3.0,1.0,2.0
9903270,12,8,4,7,0,12,116,5,0.0,0.0,0.0,0.0,0.0,0.0,0.0,78,12,66,8.0,3.0,5.0
9410268,5,5,0,0,3,2,2,208,1.0,1.0,0.0,0.0,1.0,0.0,0.0,9,5,4,1.0,1.0,0.0
9903496,19,9,10,21,0,19,71,79,13.0,8.0,5.0,10.0,0.0,13.0,34.0,31,19,12,16.0,13.0,3.0
9412221,1,1,0,0,0,1,7,196,0.0,0.0,0.0,0.0,0.0,0.0,0.0,9,1,8,4.0,0.0,4.0
9907209,6,3,3,3,2,4,47,11,3.0,2.0,1.0,1.0,0.0,3.0,43.0,29,6,23,10.0,2.0,8.0
9605428,21,8,13,21,15,6,6,106,5.0,2.0,3.0,4.0,5.0,0.0,0.0,23,21,2,2.0,2.0,0.0
9509375,60,3,57,285,1,59,360,17,53.0,3.0,50.0,261.0,0.0,53.0,336.0,75,60,15,40.0,29.0,11.0
9510333,16,3,13,25,1,15,50,17,15.0,2.0,13.0,25.0,0.0,15.0,48.0,26,16,10,2.0,1.0,1.0
9404327,19,8,11,39,13,6,6,134,12.0,3.0,9.0,30.0,8.0,4.0,4.0,21,19,2,11.0,11.0,0.0
9610463,14,14,0,0,10,4,32,26,3.0,3.0,0.0,0.0,0.0,3.0,25.0,31,14,17,11.0,2.0,9.0
9511380,27,12,15,26,6,21,30,203,10.0,6.0,4.0,7.0,3.0,7.0,11.0,31,27,4,6.0,3.0,3.0
9906457,4,4,0,0,0,4,10,104,1.0,1.0,0.0,0.0,0.0,1.0,2.0,11,4,7,3.0,1.0,2.0
9602314,4,1,3,3,3,1,1,110,0.0,0.0,0.0,0.0,0.0,0.0,0.0,10,4,6,1.0,0.0,1.0
9502352,17,6,11,25,1,16,65,6,7.0,2.0,5.0,9.0,0.0,7.0,33.0,27,17,10,3.0,3.0,0.0
9602268,1,1,0,0,0,1,5,21,,,,,,,,6,1,5,2.0,1.0,1.0
112045,19,5,14,26,3,16,39,4,9.0,2.0,7.0,12.0,3.0,6.0,10.0,29,19,10,5.0,4.0,1.0
9709244,11,5,6,9,2,9,28,7,0.0,0.0,0.0,0.0,0.0,0.0,0.0,43,11,32,5.0,4.0,1.0
9902382,4,4,0,0,1,3,13,1,1.0,1.0,0.0,0.0,0.0,1.0,3.0,17,4,13,5.0,1.0,4.0
9712428,12,3,9,16,8,4,8,376,3.0,1.0,2.0,3.0,3.0,0.0,0.0,18,12,6,3.0,2.0,1.0
9303215,28,11,17,29,28,0,0,94,6.0,2.0,4.0,9.0,6.0,0.0,0.0,28,28,0,1.0,1.0,0.0
9809242,21,6,15,34,1,20,63,28,12.0,3.0,9.0,14.0,0.0,12.0,35.0,34,21,13,6.0,4.0,2.0
9712447,7,1,6,13,0,7,38,54,6.0,1.0,5.0,10.0,0.0,6.0,29.0,19,7,12,10.0,5.0,5.0
9303266,2,2,0,0,2,0,0,543,1.0,1.0,0.0,0.0,1.0,0.0,0.0,2,2,0,1.0,1.0,0.0
9806510,6,5,1,1,1,5,23,101,2.0,2.0,0.0,0.0,0.0,2.0,14.0,27,6,21,3.0,0.0,3.0
103182,50,9,41,205,0,50,611,23,39.0,5.0,34.0,176.0,0.0,39.0,481.0,76,50,26,51.0,34.0,17.0
5066,17,2,15,27,3,14,88,24,10.0,1.0,9.0,16.0,0.0,10.0,55.0,38,17,21,9.0,4.0,5.0
9904501,10,6,4,4,4,6,6,224,4.0,2.0,2.0,2.0,0.0,4.0,4.0,11,10,1,5.0,4.0,1.0
9602358,6,3,3,4,6,0,0,224,6.0,3.0,3.0,4.0,6.0,0.0,0.0,6,6,0,5.0,5.0,0.0
8051,6,3,3,6,0,6,21,9,2.0,1.0,1.0,1.0,1.0,1.0,1.0,17,6,11,3.0,2.0,1.0
9804337,21,5,16,34,2,19,81,9,11.0,2.0,9.0,20.0,1.0,10.0,30.0,34,21,13,13.0,9.0,4.0
9607254,82,22,60,164,5,77,363,14,18.0,4.0,14.0,46.0,1.0,17.0,119.0,143,82,61,17.0,10.0,7.0
9605330,46,13,33,97,11,35,63,14,16.0,4.0,12.0,28.0,14.0,2.0,2.0,53,46,7,8.0,8.0,0.0
9706342,2,2,0,0,2,0,0,51,0.0,0.0,0.0,0.0,0.0,0.0,0.0,13,2,11,1.0,1.0,0.0
9607202,11,6,5,11,0,11,35,41,8.0,4.0,4.0,6.0,0.0,8.0,25.0,15,11,4,12.0,8.0,4.0
9905559,3,3,0,0,2,1,1,54,0.0,0.0,0.0,0.0,0.0,0.0,0.0,10,3,7,3.0,0.0,3.0
9901453,7,3,4,6,0,7,58,73,4.0,2.0,2.0,3.0,0.0,4.0,29.0,30,7,23,14.0,2.0,12.0
9601206,17,10,7,11,9,8,8,59,4.0,2.0,2.0,2.0,4.0,0.0,0.0,18,17,1,3.0,3.0,0.0
102074,18,7,11,27,3,15,38,66,9.0,1.0,8.0,20.0,3.0,6.0,10.0,32,18,14,11.0,9.0,2.0
9906428,5,5,0,0,5,0,0,259,3.0,3.0,0.0,0.0,3.0,0.0,0.0,6,5,1,2.0,2.0,0.0
9702216,69,13,56,138,6,63,198,9,38.0,7.0,31.0,73.0,2.0,36.0,93.0,88,69,19,12.0,10.0,2.0
9810364,13,5,8,12,0,13,81,17,12.0,4.0,8.0,12.0,0.0,12.0,73.0,29,13,16,15.0,6.0,9.0
9310272,8,8,0,0,2,6,11,253,1.0,1.0,0.0,0.0,0.0,1.0,2.0,16,8,8,3.0,1.0,2.0
9607472,6,2,4,6,0,6,18,66,6.0,2.0,4.0,6.0,0.0,6.0,16.0,12,6,6,8.0,5.0,3.0
9604263,2,1,1,1,2,0,0,778,1.0,1.0,0.0,0.0,1.0,0.0,0.0,3,2,1,1.0,1.0,0.0
9706370,1,1,0,0,1,0,0,57,,,,,,,,3,1,2,,,
9710540,4,4,0,0,0,4,17,36,1.0,1.0,0.0,0.0,0.0,1.0,1.0,16,4,12,3.0,1.0,2.0
9307311,42,13,29,112,42,0,0,150,15.0,3.0,12.0,38.0,15.0,0.0,0.0,42,42,0,7.0,7.0,0.0
4215,24,19,5,5,1,23,115,97,10.0,10.0,0.0,0.0,0.0,10.0,44.0,61,24,37,11.0,5.0,6.0
9606202,6,4,2,3,0,6,9,97,5.0,3.0,2.0,3.0,0.0,5.0,5.0,8,6,2,6.0,5.0,1.0
9702423,21,1,20,77,0,21,187,15,17.0,1.0,16.0,73.0,0.0,17.0,149.0,46,21,25,27.0,15.0,12.0
9403215,42,13,29,70,20,22,29,15,13.0,7.0,6.0,8.0,13.0,0.0,0.0,45,42,3,8.0,8.0,0.0
9505338,5,2,3,4,0,5,19,176,4.0,1.0,3.0,4.0,0.0,4.0,12.0,13,5,8,9.0,3.0,6.0
9506285,9,3,6,13,0,9,31,15,7.0,1.0,6.0,13.0,0.0,7.0,26.0,19,9,10,7.0,1.0,6.0
9902429,5,5,0,0,0,5,15,53,3.0,3.0,0.0,0.0,0.0,3.0,9.0,22,5,17,9.0,3.0,6.0
9606356,21,3,18,77,0,21,92,33,20.0,3.0,17.0,75.0,0.0,20.0,90.0,30,21,9,23.0,17.0,6.0
9702395,7,4,3,3,4,3,5,0,2.0,1.0,1.0,1.0,0.0,2.0,2.0,9,7,2,3.0,2.0,1.0
9906378,7,6,1,1,1,6,39,0,2.0,1.0,1.0,1.0,0.0,2.0,17.0,113,7,106,17.0,2.0,15.0
12134,20,5,15,34,1,19,64,0,9.0,2.0,7.0,19.0,1.0,8.0,18.0,37,20,17,11.0,8.0,3.0
9909514,14,5,9,10,3,11,36,3,3.0,2.0,1.0,1.0,3.0,0.0,0.0,25,14,11,3.0,1.0,2.0
9604430,14,4,10,36,14,0,0,52,11.0,2.0,9.0,34.0,11.0,0.0,0.0,15,14,1,10.0,10.0,0.0
9909262,4,3,1,1,3,1,1,249,1.0,1.0,0.0,0.0,0.0,1.0,1.0,6,4,2,3.0,1.0,2.0
9509347,12,7,5,6,2,10,19,112,6.0,6.0,0.0,0.0,0.0,6.0,15.0,16,12,4,10.0,6.0,4.0
9611336,8,6,2,3,3,5,10,41,3.0,2.0,1.0,2.0,0.0,3.0,7.0,16,8,8,7.0,3.0,4.0
9908237,13,4,9,14,2,11,22,74,6.0,2.0,4.0,6.0,1.0,5.0,10.0,20,13,7,7.0,5.0,2.0
10108,3,2,1,1,0,3,14,120,2.0,2.0,0.0,0.0,0.0,2.0,10.0,10,3,7,9.0,2.0,7.0
3303,8,7,1,1,2,6,7,263,2.0,2.0,0.0,0.0,1.0,1.0,1.0,16,8,8,5.0,2.0,3.0
9310228,77,16,61,298,11,66,66,40,59.0,8.0,51.0,255.0,5.0,54.0,54.0,78,77,1,32.0,31.0,1.0
9807385,6,2,4,8,0,6,15,8,3.0,1.0,2.0,3.0,0.0,3.0,3.0,12,6,6,4.0,3.0,1.0
110203,7,1,6,11,0,7,56,10,2.0,1.0,1.0,1.0,0.0,2.0,8.0,26,7,19,8.0,2.0,6.0
8069,14,6,8,10,1,13,51,5,2.0,2.0,0.0,0.0,2.0,0.0,0.0,29,14,15,2.0,2.0,0.0
4166,5,5,0,0,2,3,5,10,1.0,1.0,0.0,0.0,1.0,0.0,0.0,12,5,7,2.0,2.0,0.0
9801223,17,6,11,36,7,10,11,123,10.0,3.0,7.0,20.0,3.0,7.0,8.0,19,17,2,13.0,11.0,2.0
2272,27,6,21,92,1,26,214,15,22.0,5.0,17.0,80.0,1.0,21.0,180.0,47,27,20,11.0,7.0,4.0
7357,22,7,15,62,1,21,135,21,17.0,3.0,14.0,58.0,0.0,17.0,92.0,48,22,26,25.0,15.0,10.0
9605373,5,3,2,3,5,0,0,49,1.0,1.0,0.0,0.0,1.0,0.0,0.0,6,5,1,1.0,1.0,0.0
9508339,5,3,2,3,0,5,54,61,1.0,1.0,0.0,0.0,0.0,1.0,8.0,37,5,32,10.0,3.0,7.0
9905489,4,2,2,2,0,4,19,14,3.0,1.0,2.0,2.0,0.0,3.0,7.0,11,4,7,7.0,3.0,4.0
9912377,2,2,0,0,2,0,0,225,0.0,0.0,0.0,0.0,0.0,0.0,0.0,10,2,8,3.0,0.0,3.0
9702249,8,5,3,5,2,6,16,30,5.0,2.0,3.0,5.0,0.0,5.0,8.0,18,8,10,5.0,3.0,2.0
4181,8,3,5,8,0,8,33,95,7.0,3.0,4.0,6.0,0.0,7.0,23.0,21,8,13,15.0,5.0,10.0
9312266,16,10,6,12,0,16,23,34,2.0,2.0,0.0,0.0,2.0,0.0,0.0,20,16,4,3.0,3.0,0.0
9904276,13,3,10,32,0,13,90,32,12.0,2.0,10.0,31.0,0.0,12.0,74.0,36,13,23,21.0,12.0,9.0
4061,4,4,0,0,1,3,13,55,1.0,1.0,0.0,0.0,0.0,1.0,6.0,15,4,11,1.0,0.0,1.0
103064,21,4,17,72,0,21,245,23,17.0,3.0,14.0,67.0,0.0,17.0,238.0,47,21,26,24.0,8.0,16.0
9701422,24,7,17,49,4,20,34,13,18.0,4.0,14.0,43.0,2.0,16.0,26.0,27,24,3,15.0,13.0,2.0
9302289,6,6,0,0,6,0,0,41,2.0,2.0,0.0,0.0,2.0,0.0,0.0,6,6,0,2.0,2.0,0.0
9301221,2,1,1,1,2,0,0,1044,1.0,1.0,0.0,0.0,1.0,0.0,0.0,2,2,0,1.0,1.0,0.0
9804379,52,9,43,184,5,47,288,9,27.0,1.0,26.0,119.0,0.0,27.0,200.0,80,52,28,36.0,19.0,17.0
112305,14,5,9,16,0,14,135,7,0.0,0.0,0.0,0.0,0.0,0.0,0.0,89,14,75,13.0,5.0,8.0
9406235,19,8,11,45,2,17,82,36,15.0,7.0,8.0,34.0,0.0,15.0,61.0,25,19,6,20.0,14.0,6.0
9708211,15,3,12,25,0,15,85,1,8.0,2.0,6.0,12.0,0.0,8.0,32.0,32,15,17,9.0,3.0,6.0
9610271,14,7,7,9,0,14,79,10,3.0,1.0,2.0,2.0,0.0,3.0,23.0,54,14,40,5.0,3.0,2.0
9904470,2,2,0,0,0,2,7,162,2.0,2.0,0.0,0.0,0.0,2.0,4.0,13,2,11,6.0,2.0,4.0
9706401,2,1,1,1,2,0,0,218,2.0,1.0,1.0,1.0,2.0,0.0,0.0,5,2,3,2.0,0.0,2.0
9401202,28,4,24,90,17,11,11,35,15.0,2.0,13.0,47.0,15.0,0.0,0.0,29,28,1,11.0,11.0,0.0
9909470,12,5,7,13,3,9,47,59,3.0,1.0,2.0,3.0,0.0,3.0,17.0,25,12,13,11.0,3.0,8.0
9512419,8,5,3,4,1,7,70,6,5.0,4.0,1.0,1.0,0.0,5.0,59.0,29,8,21,16.0,5.0,11.0
9804371,5,2,3,3,4,1,8,15,1.0,1.0,0.0,0.0,1.0,0.0,0.0,16,5,11,1.0,1.0,0.0
12142,33,17,16,49,7,26,106,21,12.0,7.0,5.0,15.0,0.0,12.0,58.0,52,33,19,12.0,10.0,2.0
9409381,17,7,10,20,17,0,0,173,8.0,1.0,7.0,14.0,8.0,0.0,0.0,17,17,0,5.0,5.0,0.0
9712378,2,2,0,0,2,0,0,486,1.0,1.0,0.0,0.0,1.0,0.0,0.0,3,2,1,2.0,1.0,1.0
9507381,4,2,2,3,3,1,1,275,1.0,1.0,0.0,0.0,0.0,1.0,1.0,5,4,1,2.0,1.0,1.0
6081,3,3,0,0,0,3,12,74,1.0,1.0,0.0,0.0,1.0,0.0,0.0,18,3,15,2.0,0.0,2.0
9701400,33,5,28,75,5,28,70,13,15.0,1.0,14.0,31.0,0.0,15.0,35.0,42,33,9,10.0,7.0,3.0
9609467,30,13,17,33,5,25,72,67,13.0,2.0,11.0,23.0,1.0,12.0,37.0,47,30,17,14.0,9.0,5.0
9204222,26,9,17,35,26,0,0,200,6.0,1.0,5.0,12.0,6.0,0.0,0.0,26,26,0,6.0,6.0,0.0
9806476,2,2,0,0,0,2,6,154,1.0,1.0,0.0,0.0,1.0,0.0,0.0,11,2,9,1.0,0.0,1.0
9305284,27,1,26,76,27,0,0,143,19.0,1.0,18.0,56.0,19.0,0.0,0.0,27,27,0,11.0,11.0,0.0
9208244,26,11,15,19,14,12,14,29,6.0,3.0,3.0,4.0,0.0,6.0,6.0,28,26,2,4.0,3.0,1.0
9904490,18,5,13,20,16,2,2,29,8.0,3.0,5.0,10.0,8.0,0.0,0.0,20,18,2,2.0,2.0,0.0
106135,13,3,10,27,0,13,203,24,12.0,3.0,9.0,23.0,0.0,12.0,178.0,49,13,36,32.0,8.0,24.0
9304262,15,10,5,6,8,7,7,34,2.0,2.0,0.0,0.0,2.0,0.0,0.0,16,15,1,4.0,4.0,0.0
6007,10,4,6,7,0,10,38,83,4.0,2.0,2.0,2.0,0.0,4.0,18.0,24,10,14,12.0,3.0,9.0
9704413,5,3,2,2,4,1,1,92,1.0,1.0,0.0,0.0,1.0,0.0,0.0,8,5,3,1.0,1.0,0.0
4027,25,2,23,91,1,24,91,8,20.0,2.0,18.0,80.0,0.0,20.0,83.0,35,25,10,19.0,11.0,8.0
9912481,3,2,1,1,0,3,4,8,,,,,,,,6,3,3,,,
9506253,13,2,11,43,1,12,25,43,11.0,1.0,10.0,42.0,0.0,11.0,22.0,17,13,4,13.0,10.0,3.0
104075,2,1,1,1,0,2,8,22,0.0,0.0,0.0,0.0,0.0,0.0,0.0,12,2,10,6.0,0.0,6.0
7219,10,4,6,12,0,10,135,21,9.0,3.0,6.0,12.0,0.0,9.0,123.0,38,10,28,30.0,6.0,24.0
9803212,14,2,12,29,5,9,26,0,12.0,1.0,11.0,27.0,4.0,8.0,19.0,20,14,6,3.0,1.0,2.0
109239,2,1,1,1,1,1,1,239,1.0,1.0,0.0,0.0,1.0,0.0,0.0,19,2,17,2.0,0.0,2.0
9610430,8,3,5,10,0,8,34,57,7.0,2.0,5.0,10.0,0.0,7.0,15.0,21,8,13,7.0,4.0,3.0
9404305,8,5,3,3,1,7,11,245,2.0,1.0,1.0,1.0,2.0,0.0,0.0,13,8,5,4.0,2.0,2.0
7066,7,4,3,4,0,7,50,3,5.0,3.0,2.0,2.0,0.0,5.0,38.0,30,7,23,7.0,1.0,6.0
110200,3,3,0,0,0,3,14,19,,,,,,,,10,3,7,7.0,1.0,6.0
9605429,3,2,1,1,3,0,0,241,2.0,1.0,1.0,1.0,2.0,0.0,0.0,4,3,1,1.0,1.0,0.0
104312,13,2,11,28,0,13,98,2,4.0,1.0,3.0,4.0,0.0,4.0,19.0,54,13,41,16.0,11.0,5.0
11150,19,6,13,25,1,18,74,3,11.0,3.0,8.0,12.0,1.0,10.0,53.0,33,19,14,12.0,7.0,5.0
12018,11,1,10,23,10,1,1,0,1.0,1.0,0.0,0.0,1.0,0.0,0.0,13,11,2,2.0,1.0,1.0
9506437,15,9,6,12,1,14,49,135,6.0,2.0,4.0,5.0,0.0,6.0,23.0,23,15,8,11.0,6.0,5.0
9311249,9,6,3,3,5,4,8,32,1.0,1.0,0.0,0.0,0.0,1.0,2.0,19,9,10,2.0,1.0,1.0
106190,36,6,30,165,2,34,172,37,28.0,3.0,25.0,149.0,0.0,28.0,106.0,47,36,11,27.0,23.0,4.0
9909475,6,5,1,1,1,5,33,67,2.0,2.0,0.0,0.0,1.0,1.0,7.0,38,6,32,11.0,1.0,10.0
9701266,18,7,11,34,3,15,22,117,15.0,4.0,11.0,34.0,1.0,14.0,14.0,20,18,2,13.0,12.0,1.0
103317,4,1,3,3,0,4,46,23,4.0,1.0,3.0,3.0,0.0,4.0,40.0,18,4,14,9.0,2.0,7.0
9407223,11,5,6,9,11,0,0,30,3.0,2.0,1.0,1.0,3.0,0.0,0.0,11,11,0,3.0,3.0,0.0
9409316,14,5,9,11,1,13,36,183,4.0,1.0,3.0,4.0,0.0,4.0,6.0,24,14,10,6.0,4.0,2.0
9212271,42,5,37,154,1,41,41,56,37.0,3.0,34.0,134.0,1.0,36.0,36.0,43,42,1,27.0,26.0,1.0
9609327,1,1,0,0,1,0,0,61,0.0,0.0,0.0,0.0,0.0,0.0,0.0,3,1,2,,,
9610510,2,1,1,1,0,2,18,25,2.0,1.0,1.0,1.0,0.0,2.0,15.0,27,2,25,19.0,2.0,17.0
9804265,19,3,16,40,13,6,11,92,14.0,2.0,12.0,28.0,8.0,6.0,10.0,26,19,7,10.0,10.0,0.0
9712379,5,3,2,2,1,4,13,33,2.0,1.0,1.0,1.0,0.0,2.0,2.0,14,5,9,3.0,2.0,1.0
9512211,3,2,1,1,1,2,4,99,0.0,0.0,0.0,0.0,0.0,0.0,0.0,14,3,11,2.0,1.0,1.0
204050,5,3,2,2,0,5,25,3,4.0,3.0,1.0,1.0,0.0,4.0,14.0,28,5,23,10.0,4.0,6.0
206095,4,3,1,1,0,4,12,34,1.0,1.0,0.0,0.0,0.0,1.0,5.0,50,4,46,33.0,0.0,33.0
9902401,10,6,4,6,0,10,95,60,3.0,1.0,2.0,3.0,0.0,3.0,43.0,35,10,25,20.0,3.0,17.0
9212280,8,2,6,13,8,0,0,176,8.0,2.0,6.0,13.0,8.0,0.0,0.0,8,8,0,8.0,8.0,0.0
9810307,19,2,17,67,2,17,64,7,9.0,1.0,8.0,22.0,1.0,8.0,13.0,27,19,8,12.0,7.0,5.0
9502233,2,2,0,0,2,0,0,452,1.0,1.0,0.0,0.0,1.0,0.0,0.0,4,2,2,2.0,1.0,1.0
9802324,12,7,5,11,2,10,12,68,2.0,2.0,0.0,0.0,0.0,2.0,3.0,17,12,5,1.0,1.0,0.0
9801379,23,3,20,49,0,23,142,54,14.0,2.0,12.0,31.0,0.0,14.0,66.0,45,23,22,17.0,12.0,5.0
204051,2,2,0,0,0,2,9,3,0.0,0.0,0.0,0.0,0.0,0.0,0.0,42,2,40,5.0,0.0,5.0
206174,22,5,17,64,1,21,308,46,16.0,2.0,14.0,57.0,0.0,16.0,144.0,89,22,67,28.0,12.0,16.0
102136,12,1,11,43,0,12,91,0,9.0,1.0,8.0,27.0,0.0,9.0,63.0,30,12,18,18.0,11.0,7.0
9609204,22,3,19,55,1,21,83,3,15.0,2.0,13.0,36.0,0.0,15.0,25.0,42,22,20,12.0,10.0,2.0
203138,8,4,4,7,0,8,34,0,5.0,1.0,4.0,7.0,0.0,5.0,21.0,22,8,14,14.0,5.0,9.0
9806442,5,3,2,2,0,5,45,0,3.0,1.0,2.0,2.0,0.0,3.0,31.0,20,5,15,3.0,3.0,0.0
207186,8,5,3,5,0,8,77,32,3.0,3.0,0.0,0.0,0.0,3.0,46.0,50,8,42,23.0,3.0,20.0
7025,17,6,11,21,11,6,6,46,0.0,0.0,0.0,0.0,0.0,0.0,0.0,27,17,10,3.0,0.0,3.0
9902410,41,11,30,65,9,32,123,9,14.0,4.0,10.0,23.0,0.0,14.0,73.0,52,41,11,20.0,12.0,8.0
207231,1,1,0,0,0,1,14,3,0.0,0.0,0.0,0.0,0.0,0.0,0.0,76,1,75,16.0,0.0,16.0
9807231,5,4,1,1,1,4,11,5,0.0,0.0,0.0,0.0,0.0,0.0,0.0,20,5,15,,,
110232,2,1,1,1,0,2,3,381,1.0,1.0,0.0,0.0,0.0,1.0,1.0,6,2,4,1.0,1.0,0.0
9804277,21,9,12,14,1,20,126,87,15.0,5.0,10.0,12.0,0.0,15.0,98.0,53,21,32,22.0,11.0,11.0
9712523,7,4,3,3,2,5,12,65,3.0,2.0,1.0,1.0,2.0,1.0,1.0,13,7,6,2.0,2.0,0.0
205033,15,2,13,38,0,15,295,28,15.0,2.0,13.0,38.0,0.0,15.0,262.0,51,15,36,44.0,14.0,30.0
9702374,0,0,0,0,0,0,0,78,0.0,0.0,0.0,0.0,0.0,0.0,0.0,5,0,5,1.0,0.0,1.0
9604375,8,3,5,10,3,5,25,100,5.0,1.0,4.0,6.0,0.0,5.0,24.0,24,8,16,12.0,2.0,10.0
9303305,18,16,2,2,18,0,0,208,6.0,5.0,1.0,1.0,6.0,0.0,0.0,18,18,0,4.0,4.0,0.0
9302257,8,5,3,5,8,0,0,549,2.0,2.0,0.0,0.0,2.0,0.0,0.0,9,8,1,2.0,2.0,0.0
109081,8,4,4,4,2,6,17,65,3.0,1.0,2.0,2.0,0.0,3.0,10.0,21,8,13,4.0,1.0,3.0
106230,9,5,4,5,0,9,40,13,5.0,3.0,2.0,2.0,0.0,5.0,23.0,24,9,15,8.0,6.0,2.0
9510344,5,5,0,0,5,0,0,342,1.0,1.0,0.0,0.0,1.0,0.0,0.0,6,5,1,1.0,1.0,0.0
9811360,0,0,0,0,0,0,0,1208,,,,,,,,2,0,2,1.0,0.0,1.0
9610523,2,1,1,1,0,2,7,59,2.0,1.0,1.0,1.0,0.0,2.0,6.0,6,2,4,,,
12370,2,2,0,0,0,2,15,32,1.0,1.0,0.0,0.0,0.0,1.0,11.0,43,2,41,25.0,1.0,24.0
9706500,4,4,0,0,1,3,6,231,1.0,1.0,0.0,0.0,0.0,1.0,3.0,12,4,8,5.0,1.0,4.0
9802421,9,5,4,5,1,8,65,17,4.0,2.0,2.0,3.0,0.0,4.0,18.0,25,9,16,15.0,6.0,9.0
9803222,14,10,4,5,2,12,24,87,4.0,3.0,1.0,1.0,0.0,4.0,8.0,30,14,16,3.0,1.0,2.0
111465,10,3,7,10,0,10,83,2,9.0,3.0,6.0,9.0,0.0,9.0,75.0,28,10,18,21.0,8.0,13.0
9601295,4,2,2,3,2,2,2,41,1.0,1.0,0.0,0.0,1.0,0.0,0.0,9,4,5,1.0,1.0,0.0
9904299,1,1,0,0,1,0,0,196,1.0,1.0,0.0,0.0,1.0,0.0,0.0,7,1,6,1.0,1.0,0.0
9805392,2,1,1,1,0,2,3,8,,,,,,,,4,2,2,1.0,0.0,1.0
9602422,11,4,7,11,0,11,32,117,8.0,3.0,5.0,8.0,0.0,8.0,8.0,22,11,11,2.0,2.0,0.0
9804434,10,1,9,11,0,10,28,1,3.0,3.0,0.0,0.0,3.0,0.0,0.0,20,10,10,5.0,4.0,1.0
4182,2,2,0,0,2,0,0,128,0.0,0.0,0.0,0.0,0.0,0.0,0.0,11,2,9,3.0,0.0,3.0
205226,1,1,0,0,1,0,0,90,,,,,,,,3,1,2,,,
9605420,9,4,5,11,9,0,0,109,5.0,1.0,4.0,8.0,5.0,0.0,0.0,9,9,0,1.0,1.0,0.0
206191,1,1,0,0,0,1,8,26,1.0,1.0,0.0,0.0,0.0,1.0,1.0,9,1,8,3.0,1.0,2.0
9403404,2,1,1,1,0,2,2,240,1.0,1.0,0.0,0.0,1.0,0.0,0.0,4,2,2,1.0,1.0,0.0
9411289,21,7,14,36,17,4,4,157,10.0,3.0,7.0,15.0,7.0,3.0,3.0,22,21,1,8.0,8.0,0.0
9806322,1,1,0,0,0,1,7,62,0.0,0.0,0.0,0.0,0.0,0.0,0.0,15,1,14,4.0,0.0,4.0
9705226,16,8,8,14,12,4,7,79,8.0,4.0,4.0,7.0,4.0,4.0,7.0,24,16,8,9.0,8.0,1.0
202237,2,2,0,0,0,2,4,16,0.0,0.0,0.0,0.0,0.0,0.0,0.0,19,2,17,8.0,0.0,8.0
201054,4,4,0,0,0,4,30,19,3.0,3.0,0.0,0.0,0.0,3.0,18.0,20,4,16,8.0,3.0,5.0
108080,4,3,1,1,0,4,17,23,1.0,1.0,0.0,0.0,0.0,1.0,5.0,24,4,20,3.0,2.0,1.0
10101,10,6,4,4,1,9,31,88,2.0,2.0,0.0,0.0,0.0,2.0,12.0,30,10,20,11.0,2.0,9.0
9612406,2,2,0,0,0,2,15,6,,,,,,,,14,2,12,1.0,0.0,1.0
9712549,3,3,0,0,2,1,1,104,0.0,0.0,0.0,0.0,0.0,0.0,0.0,8,3,5,1.0,0.0,1.0
9611304,6,5,1,1,1,5,19,33,4.0,3.0,1.0,1.0,0.0,4.0,17.0,16,6,10,8.0,2.0,6.0
9903508,3,2,1,1,0,3,9,77,3.0,2.0,1.0,1.0,0.0,3.0,9.0,11,3,8,5.0,3.0,2.0
9905234,2,2,0,0,2,0,0,31,0.0,0.0,0.0,0.0,0.0,0.0,0.0,5,2,3,1.0,0.0,1.0
9912325,2,2,0,0,2,0,0,1,0.0,0.0,0.0,0.0,0.0,0.0,0.0,31,2,29,3.0,0.0,3.0
9906495,6,4,2,4,1,5,29,8,5.0,3.0,2.0,4.0,1.0,4.0,24.0,19,6,13,14.0,5.0,9.0
9801388,11,2,9,16,0,11,103,9,6.0,2.0,4.0,7.0,0.0,6.0,69.0,32,11,21,23.0,5.0,18.0
9106,5,1,4,5,0,5,19,8,5.0,1.0,4.0,5.0,0.0,5.0,17.0,11,5,6,9.0,4.0,5.0
9605411,14,6,8,20,10,4,7,27,3.0,1.0,2.0,3.0,1.0,2.0,2.0,17,14,3,5.0,4.0,1.0
9404326,5,5,0,0,5,0,0,174,1.0,1.0,0.0,0.0,1.0,0.0,0.0,5,5,0,2.0,2.0,0.0
9803346,3,2,1,1,3,0,0,51,1.0,1.0,0.0,0.0,1.0,0.0,0.0,4,3,1,1.0,1.0,0.0
101344,4,4,0,0,0,4,39,11,2.0,2.0,0.0,0.0,0.0,2.0,26.0,55,4,51,26.0,1.0,25.0
9612441,4,3,1,1,0,4,9,335,1.0,1.0,0.0,0.0,0.0,1.0,1.0,20,4,16,3.0,0.0,3.0
9304282,4,3,1,1,4,0,0,304,1.0,1.0,0.0,0.0,1.0,0.0,0.0,4,4,0,1.0,1.0,0.0
210193,8,7,1,1,2,6,27,121,1.0,1.0,0.0,0.0,0.0,1.0,2.0,42,8,34,11.0,3.0,8.0
203035,0,0,0,0,0,0,0,301,,,,,,,,1,0,1,,,
9406311,18,12,6,8,9,9,21,116,5.0,3.0,2.0,2.0,0.0,5.0,10.0,24,18,6,9.0,6.0,3.0
9405310,1,1,0,0,0,1,2,1158,,,,,,,,4,1,3,2.0,1.0,1.0
9707307,11,2,9,20,2,9,19,222,10.0,2.0,8.0,19.0,1.0,9.0,19.0,17,11,6,12.0,8.0,4.0
9612314,10,1,9,23,7,3,4,321,7.0,1.0,6.0,15.0,7.0,0.0,0.0,12,10,2,7.0,7.0,0.0
9906213,5,1,4,8,0,5,9,321,5.0,1.0,4.0,8.0,4.0,1.0,4.0,13,5,8,5.0,5.0,0.0
9510453,8,3,5,8,0,8,63,53,7.0,2.0,5.0,8.0,0.0,7.0,61.0,20,8,12,17.0,6.0,11.0
9606319,4,2,2,2,1,3,5,40,0.0,0.0,0.0,0.0,0.0,0.0,0.0,7,4,3,1.0,0.0,1.0
9606384,9,7,2,3,1,8,66,5,7.0,5.0,2.0,3.0,0.0,7.0,49.0,31,9,22,13.0,4.0,9.0
9608210,16,7,9,11,6,10,10,230,7.0,2.0,5.0,6.0,7.0,0.0,0.0,17,16,1,5.0,5.0,0.0
9707321,5,4,1,1,2,3,8,304,0.0,0.0,0.0,0.0,0.0,0.0,0.0,28,5,23,4.0,1.0,3.0
5258,4,4,0,0,0,4,30,1,1.0,1.0,0.0,0.0,0.0,1.0,19.0,56,4,52,25.0,1.0,24.0
9711250,7,5,2,2,1,6,23,14,0.0,0.0,0.0,0.0,0.0,0.0,0.0,23,7,16,3.0,1.0,2.0
9709213,16,6,10,20,2,14,41,14,4.0,4.0,0.0,0.0,0.0,4.0,5.0,26,16,10,5.0,5.0,0.0
9610295,4,1,3,3,1,3,4,27,4.0,1.0,3.0,3.0,1.0,3.0,4.0,8,4,4,,,
9708449,3,1,2,2,1,2,4,24,0.0,0.0,0.0,0.0,0.0,0.0,0.0,14,3,11,2.0,0.0,2.0
9604224,4,4,0,0,1,3,6,331,1.0,1.0,0.0,0.0,0.0,1.0,3.0,13,4,9,4.0,1.0,3.0
9411406,22,7,15,39,0,22,62,56,22.0,7.0,15.0,39.0,0.0,22.0,62.0,25,22,3,20.0,17.0,3.0
4072,4,3,1,1,0,4,19,2,2.0,1.0,1.0,1.0,0.0,2.0,10.0,15,4,11,1.0,1.0,0.0
9503293,12,4,8,15,12,0,0,221,7.0,2.0,5.0,10.0,7.0,0.0,0.0,12,12,0,4.0,4.0,0.0
9609475,0,0,0,0,0,0,0,23,0.0,0.0,0.0,0.0,0.0,0.0,0.0,16,0,16,7.0,0.0,7.0
9810527,6,4,2,3,0,6,19,8,0.0,0.0,0.0,0.0,0.0,0.0,0.0,21,6,15,2.0,0.0,2.0
102022,6,3,3,5,0,6,21,38,4.0,2.0,2.0,4.0,1.0,3.0,5.0,17,6,11,7.0,4.0,3.0
103234,14,8,6,8,2,12,43,172,4.0,3.0,1.0,1.0,0.0,4.0,14.0,25,14,11,7.0,3.0,4.0
9705359,2,2,0,0,1,1,6,36,0.0,0.0,0.0,0.0,0.0,0.0,0.0,26,2,24,2.0,0.0,2.0
9909536,6,3,3,7,2,4,21,5,3.0,2.0,1.0,2.0,0.0,3.0,16.0,15,6,9,2.0,0.0,2.0
9607227,1,1,0,0,0,1,3,26,0.0,0.0,0.0,0.0,0.0,0.0,0.0,7,1,6,1.0,0.0,1.0
9507459,0,0,0,0,0,0,0,175,0.0,0.0,0.0,0.0,0.0,0.0,0.0,3,0,3,2.0,0.0,2.0
9210271,5,3,2,2,5,0,0,56,,,,,,,,5,5,0,1.0,1.0,0.0
9309241,9,5,4,6,2,7,22,75,4.0,1.0,3.0,3.0,0.0,4.0,16.0,13,9,4,1.0,1.0,0.0
9505417,30,5,25,84,20,10,12,122,18.0,2.0,16.0,61.0,13.0,5.0,5.0,35,30,5,16.0,15.0,1.0
3063,2,2,0,0,0,2,9,55,1.0,1.0,0.0,0.0,0.0,1.0,4.0,11,2,9,2.0,0.0,2.0
9610535,4,3,1,2,0,4,10,150,2.0,2.0,0.0,0.0,0.0,2.0,4.0,12,4,8,2.0,1.0,1.0
9801342,4,3,1,2,0,4,16,182,3.0,2.0,1.0,2.0,0.0,3.0,10.0,10,4,6,7.0,3.0,4.0
9901436,0,0,0,0,0,0,0,1946,,,,,,,,1,0,1,1.0,0.0,1.0
108074,10,5,5,7,2,8,68,7,4.0,1.0,3.0,3.0,0.0,4.0,19.0,49,10,39,9.0,4.0,5.0
9912424,17,2,15,58,0,17,179,49,8.0,1.0,7.0,22.0,0.0,8.0,70.0,44,17,27,18.0,8.0,10.0
105028,10,5,5,5,2,8,72,32,2.0,1.0,1.0,1.0,0.0,2.0,18.0,71,10,61,12.0,2.0,10.0
11134,11,4,7,20,0,11,106,73,10.0,4.0,6.0,17.0,0.0,10.0,104.0,31,11,20,28.0,8.0,20.0
107058,2,2,0,0,1,1,2,2,1.0,1.0,0.0,0.0,1.0,0.0,0.0,17,2,15,6.0,0.0,6.0
203118,10,3,7,14,4,6,26,21,7.0,3.0,4.0,9.0,3.0,4.0,11.0,21,10,11,5.0,5.0,0.0
9902386,1,1,0,0,1,0,0,1945,,,,,,,,2,1,1,1.0,1.0,0.0
9807302,9,7,2,2,1,8,10,203,5.0,3.0,2.0,2.0,1.0,4.0,6.0,12,9,3,6.0,4.0,2.0
9812446,9,3,6,7,2,7,25,57,7.0,1.0,6.0,7.0,1.0,6.0,20.0,16,9,7,7.0,4.0,3.0
9602249,1,1,0,0,1,0,0,1344,,,,,,,,1,1,0,,,
203180,13,10,3,4,0,13,26,50,2.0,2.0,0.0,0.0,1.0,1.0,1.0,20,13,7,7.0,4.0,3.0
109118,5,4,1,1,1,4,25,42,2.0,2.0,0.0,0.0,0.0,2.0,10.0,24,5,19,5.0,1.0,4.0
9908335,4,4,0,0,4,0,0,635,1.0,1.0,0.0,0.0,1.0,0.0,0.0,4,4,0,2.0,2.0,0.0
9710442,5,1,4,9,1,4,9,333,5.0,1.0,4.0,9.0,1.0,4.0,8.0,9,5,4,7.0,4.0,3.0
9904477,11,4,7,17,0,11,96,9,9.0,3.0,6.0,15.0,0.0,9.0,80.0,31,11,20,21.0,7.0,14.0
9605378,2,1,1,1,0,2,7,265,2.0,1.0,1.0,1.0,0.0,2.0,7.0,7,2,5,6.0,2.0,4.0
9808407,3,2,1,1,2,1,1,606,1.0,1.0,0.0,0.0,1.0,0.0,0.0,4,3,1,1.0,1.0,0.0
9604208,2,2,0,0,0,2,5,6,2.0,2.0,0.0,0.0,1.0,1.0,3.0,18,2,16,1.0,0.0,1.0
9806352,25,7,18,71,1,24,98,11,16.0,3.0,13.0,56.0,0.0,16.0,59.0,40,25,15,18.0,14.0,4.0
9048,4,3,1,1,3,1,1,95,2.0,1.0,1.0,1.0,1.0,1.0,1.0,9,4,5,3.0,1.0,2.0
9305215,11,5,6,12,11,0,0,214,8.0,3.0,5.0,11.0,8.0,0.0,0.0,11,11,0,5.0,5.0,0.0
9702362,12,7,5,11,3,9,35,167,6.0,3.0,3.0,4.0,0.0,6.0,24.0,26,12,14,11.0,6.0,5.0
9503254,3,3,0,0,2,1,1,172,1.0,1.0,0.0,0.0,1.0,0.0,0.0,4,3,1,,,
9910562,9,6,3,5,0,9,48,40,6.0,3.0,3.0,5.0,0.0,6.0,41.0,44,9,35,15.0,2.0,13.0
9411250,5,2,3,5,5,0,0,51,4.0,1.0,3.0,5.0,4.0,0.0,0.0,5,5,0,5.0,5.0,0.0
9806424,23,13,10,21,5,18,139,17,10.0,5.0,5.0,14.0,0.0,10.0,111.0,56,23,33,8.0,1.0,7.0
9706277,9,3,6,9,0,9,35,182,8.0,2.0,6.0,8.0,0.0,8.0,33.0,16,9,7,11.0,5.0,6.0
9507450,1,1,0,0,0,1,2,72,0.0,0.0,0.0,0.0,0.0,0.0,0.0,5,1,4,1.0,0.0,1.0
207344,2,2,0,0,0,2,13,28,1.0,1.0,0.0,0.0,0.0,1.0,4.0,15,2,13,1.0,0.0,1.0
8286,5,2,3,3,1,4,14,4,1.0,1.0,0.0,0.0,0.0,1.0,3.0,44,5,39,16.0,0.0,16.0
5197,19,9,10,31,3,16,40,119,9.0,1.0,8.0,27.0,9.0,0.0,0.0,30,19,11,9.0,9.0,0.0
110089,20,12,8,9,14,6,9,0,2.0,1.0,1.0,1.0,2.0,0.0,0.0,25,20,5,2.0,2.0,0.0
9607349,16,9,7,10,9,7,9,74,4.0,2.0,2.0,2.0,4.0,0.0,0.0,23,16,7,3.0,2.0,1.0
105017,2,2,0,0,1,1,1,1,0.0,0.0,0.0,0.0,0.0,0.0,0.0,14,2,12,2.0,0.0,2.0
9605404,6,3,3,5,1,5,6,16,3.0,1.0,2.0,3.0,0.0,3.0,4.0,9,6,3,2.0,1.0,1.0
9705299,3,2,1,1,1,2,4,188,1.0,1.0,0.0,0.0,0.0,1.0,1.0,10,3,7,2.0,0.0,2.0
9809355,4,1,3,3,0,4,10,41,3.0,1.0,2.0,2.0,0.0,3.0,5.0,12,4,8,2.0,2.0,0.0
205070,3,3,0,0,0,3,20,0,2.0,2.0,0.0,0.0,0.0,2.0,14.0,18,3,15,12.0,2.0,10.0
6185,5,2,3,6,0,5,14,410,4.0,1.0,3.0,6.0,0.0,4.0,4.0,19,5,14,5.0,4.0,1.0
9207210,2,2,0,0,2,0,0,279,1.0,1.0,0.0,0.0,1.0,0.0,0.0,2,2,0,1.0,1.0,0.0
212125,0,0,0,0,0,0,0,59,0.0,0.0,0.0,0.0,0.0,0.0,0.0,17,0,17,2.0,0.0,2.0
1150,6,2,4,5,2,4,8,100,2.0,2.0,0.0,0.0,0.0,2.0,2.0,13,6,7,3.0,2.0,1.0
9606442,6,4,2,2,6,0,0,177,2.0,1.0,1.0,1.0,2.0,0.0,0.0,6,6,0,3.0,3.0,0.0
107025,0,0,0,0,0,0,0,525,0.0,0.0,0.0,0.0,0.0,0.0,0.0,3,0,3,1.0,0.0,1.0
9703201,26,11,15,38,11,15,27,136,15.0,6.0,9.0,22.0,3.0,12.0,23.0,30,26,4,13.0,11.0,2.0
10157,4,2,2,2,1,3,8,6,1.0,1.0,0.0,0.0,0.0,1.0,1.0,19,4,15,3.0,1.0,2.0
210005,1,1,0,0,1,0,0,6,0.0,0.0,0.0,0.0,0.0,0.0,0.0,17,1,16,9.0,0.0,9.0
6288,6,5,1,1,2,4,8,227,1.0,1.0,0.0,0.0,0.0,1.0,4.0,13,6,7,5.0,0.0,5.0
9306228,2,2,0,0,2,0,0,143,1.0,1.0,0.0,0.0,1.0,0.0,0.0,2,2,0,1.0,1.0,0.0
12205,8,7,1,1,2,6,22,5,0.0,0.0,0.0,0.0,0.0,0.0,0.0,30,8,22,4.0,2.0,2.0
9609320,13,6,7,9,1,12,38,30,9.0,6.0,3.0,4.0,0.0,9.0,30.0,22,13,9,5.0,4.0,1.0
9502345,2,2,0,0,1,1,2,271,1.0,1.0,0.0,0.0,0.0,1.0,2.0,13,2,11,3.0,1.0,2.0
9509273,2,2,0,0,0,2,3,10,0.0,0.0,0.0,0.0,0.0,0.0,0.0,22,2,20,1.0,1.0,0.0
9904277,22,10,12,20,1,21,50,11,4.0,3.0,1.0,1.0,3.0,1.0,1.0,33,22,11,3.0,3.0,0.0
9506440,2,1,1,1,0,2,3,54,1.0,1.0,0.0,0.0,1.0,0.0,0.0,4,2,2,1.0,1.0,0.0
211068,4,4,0,0,3,1,18,55,0.0,0.0,0.0,0.0,0.0,0.0,0.0,48,4,44,18.0,0.0,18.0
208256,4,1,3,3,0,4,31,7,1.0,1.0,0.0,0.0,0.0,1.0,4.0,33,4,29,9.0,2.0,7.0
9810528,6,5,1,1,1,5,25,87,2.0,2.0,0.0,0.0,1.0,1.0,2.0,19,6,13,5.0,2.0,3.0
9812213,2,2,0,0,0,2,3,29,0.0,0.0,0.0,0.0,0.0,0.0,0.0,11,2,9,5.0,0.0,5.0
7070,6,2,4,8,0,6,6,88,5.0,1.0,4.0,8.0,0.0,5.0,5.0,14,6,8,5.0,5.0,0.0
9809366,4,3,1,1,1,3,9,42,2.0,1.0,1.0,1.0,1.0,1.0,1.0,11,4,7,4.0,2.0,2.0
9503422,2,1,1,1,2,0,0,1705,,,,,,,,7,2,5,,,
9704432,6,1,5,8,3,3,4,213,3.0,1.0,2.0,2.0,0.0,3.0,4.0,9,6,3,6.0,4.0,2.0
110108,9,1,8,14,0,9,28,80,6.0,1.0,5.0,9.0,0.0,6.0,15.0,36,9,27,7.0,5.0,2.0
9709334,6,1,5,14,0,6,16,142,6.0,1.0,5.0,14.0,0.0,6.0,16.0,10,6,4,9.0,6.0,3.0
9412230,4,4,0,0,4,0,0,151,1.0,1.0,0.0,0.0,1.0,0.0,0.0,4,4,0,1.0,1.0,0.0
9611386,6,4,2,2,0,6,27,36,5.0,3.0,2.0,2.0,0.0,5.0,18.0,26,6,20,18.0,5.0,13.0
208112,7,5,2,4,0,7,72,23,2.0,2.0,0.0,0.0,0.0,2.0,23.0,80,7,73,20.0,2.0,18.0
9412231,10,2,8,15,10,0,0,110,10.0,2.0,8.0,15.0,10.0,0.0,0.0,10,10,0,5.0,5.0,0.0
9302308,2,1,1,1,2,0,0,216,2.0,1.0,1.0,1.0,2.0,0.0,0.0,2,2,0,2.0,2.0,0.0
102015,4,2,2,2,1,3,10,27,0.0,0.0,0.0,0.0,0.0,0.0,0.0,15,4,11,2.0,0.0,2.0
9511460,2,1,1,1,0,2,2,248,2.0,1.0,1.0,1.0,0.0,2.0,2.0,3,2,1,3.0,2.0,1.0
201069,2,1,1,1,0,2,4,903,,,,,,,,6,2,4,1.0,1.0,0.0
11168,2,1,1,1,0,2,8,181,2.0,1.0,1.0,1.0,0.0,2.0,7.0,13,2,11,9.0,2.0,7.0
206121,6,5,1,1,0,6,65,4,2.0,2.0,0.0,0.0,0.0,2.0,10.0,65,6,59,16.0,0.0,16.0
10273,4,2,2,2,0,4,24,57,0.0,0.0,0.0,0.0,0.0,0.0,0.0,32,4,28,6.0,0.0,6.0
9604252,1,1,0,0,1,0,0,242,,,,,,,,3,1,2,,,
9610372,6,5,1,2,0,6,44,17,6.0,5.0,1.0,2.0,0.0,6.0,43.0,19,6,13,,,
9902306,1,1,0,0,0,1,1,15,0.0,0.0,0.0,0.0,0.0,0.0,0.0,16,1,15,4.0,0.0,4.0
9502220,1,1,0,0,1,0,0,591,1.0,1.0,0.0,0.0,1.0,0.0,0.0,3,1,2,1.0,1.0,0.0
9606332,8,3,5,10,0,8,15,150,8.0,3.0,5.0,10.0,0.0,8.0,12.0,11,8,3,8.0,6.0,2.0
1307,16,4,12,34,1,15,78,68,10.0,2.0,8.0,21.0,0.0,10.0,53.0,31,16,15,16.0,8.0,8.0
9803221,10,5,5,13,0,10,65,113,8.0,3.0,5.0,12.0,0.0,8.0,56.0,26,10,16,20.0,7.0,13.0
104008,6,6,0,0,2,4,5,74,2.0,2.0,0.0,0.0,0.0,2.0,2.0,17,6,11,4.0,0.0,4.0
9811312,2,2,0,0,0,2,33,60,1.0,1.0,0.0,0.0,0.0,1.0,11.0,28,2,26,4.0,1.0,3.0
9911203,16,5,11,25,4,12,48,7,8.0,2.0,6.0,15.0,3.0,5.0,14.0,38,16,22,7.0,4.0,3.0
9702349,10,4,6,7,1,9,35,33,2.0,1.0,1.0,1.0,0.0,2.0,6.0,20,10,10,6.0,2.0,4.0
9904258,20,6,14,36,13,7,20,25,9.0,2.0,7.0,15.0,9.0,0.0,0.0,30,20,10,6.0,6.0,0.0
9905248,1,1,0,0,0,1,1,1999,0.0,0.0,0.0,0.0,0.0,0.0,0.0,2,1,1,1.0,0.0,1.0
9802384,11,4,7,17,3,8,10,106,7.0,2.0,5.0,12.0,1.0,6.0,6.0,14,11,3,8.0,7.0,1.0
9705409,12,3,9,26,2,10,25,113,11.0,3.0,8.0,24.0,2.0,9.0,22.0,16,12,4,13.0,9.0,4.0
1256,5,3,2,2,1,4,25,13,3.0,1.0,2.0,2.0,0.0,3.0,21.0,29,5,24,13.0,2.0,11.0
9710258,8,4,4,5,1,7,38,173,3.0,3.0,0.0,0.0,0.0,3.0,14.0,17,8,9,5.0,2.0,3.0
9807400,12,4,8,9,2,10,15,59,6.0,2.0,4.0,4.0,6.0,0.0,0.0,25,12,13,4.0,4.0,0.0
9712395,10,2,8,16,0,10,50,130,8.0,1.0,7.0,14.0,0.0,8.0,35.0,21,10,11,13.0,6.0,7.0
9502293,24,8,16,31,15,9,23,29,9.0,2.0,7.0,12.0,1.0,8.0,21.0,32,24,8,9.0,6.0,3.0
9412242,6,2,4,5,0,6,15,124,2.0,1.0,1.0,1.0,0.0,2.0,7.0,12,6,6,5.0,3.0,2.0
4008,15,5,10,28,0,15,112,16,4.0,3.0,1.0,2.0,0.0,4.0,48.0,47,15,32,17.0,1.0,16.0
6342,3,3,0,0,0,3,16,33,1.0,1.0,0.0,0.0,0.0,1.0,8.0,37,3,34,5.0,1.0,4.0
302257,0,0,0,0,0,0,0,11,,,,,,,,2,0,2,1.0,0.0,1.0
1013,4,1,3,3,0,4,16,13,4.0,1.0,3.0,3.0,4.0,0.0,0.0,13,4,9,4.0,3.0,1.0
9401252,9,6,3,5,9,0,0,210,5.0,3.0,2.0,3.0,5.0,0.0,0.0,9,9,0,4.0,4.0,0.0
9804219,8,5,3,4,5,3,6,84,3.0,3.0,0.0,0.0,1.0,2.0,3.0,14,8,6,3.0,3.0,0.0
102226,1,1,0,0,1,0,0,1743,,,,,,,,3,1,2,,,
9911504,8,8,0,0,0,8,56,39,6.0,6.0,0.0,0.0,0.0,6.0,34.0,28,8,20,15.0,5.0,10.0
108126,1,1,0,0,1,0,0,344,1.0,1.0,0.0,0.0,1.0,0.0,0.0,1,1,0,1.0,1.0,0.0
104211,5,4,1,1,5,0,0,477,3.0,2.0,1.0,1.0,3.0,0.0,0.0,6,5,1,3.0,3.0,0.0
9211,5,3,2,2,0,5,22,3,2.0,2.0,0.0,0.0,0.0,2.0,16.0,27,5,22,3.0,1.0,2.0
105237,2,2,0,0,1,1,1,477,1.0,1.0,0.0,0.0,0.0,1.0,1.0,11,2,9,2.0,1.0,1.0
107009,6,2,4,5,1,5,39,16,3.0,1.0,2.0,3.0,0.0,3.0,26.0,17,6,11,12.0,3.0,9.0
9903332,9,2,7,17,1,8,21,145,8.0,2.0,6.0,16.0,0.0,8.0,13.0,21,9,12,10.0,7.0,3.0
9510434,1,1,0,0,0,1,2,96,0.0,0.0,0.0,0.0,0.0,0.0,0.0,10,1,9,2.0,0.0,2.0
9701351,3,3,0,0,1,2,3,409,3.0,3.0,0.0,0.0,1.0,2.0,3.0,7,3,4,5.0,2.0,3.0
6303,1,1,0,0,0,1,1,1693,0.0,0.0,0.0,0.0,0.0,0.0,0.0,3,1,2,,,
9805351,3,3,0,0,0,3,10,260,1.0,1.0,0.0,0.0,0.0,1.0,5.0,15,3,12,6.0,1.0,5.0
212147,28,10,18,57,11,17,89,0,7.0,1.0,6.0,15.0,1.0,6.0,39.0,64,28,36,22.0,5.0,17.0
112185,1,1,0,0,0,1,7,64,1.0,1.0,0.0,0.0,0.0,1.0,6.0,9,1,8,1.0,0.0,1.0
9809269,4,4,0,0,1,3,6,4,2.0,2.0,0.0,0.0,0.0,2.0,5.0,18,4,14,4.0,1.0,3.0
1267,3,2,1,1,0,3,8,5,0.0,0.0,0.0,0.0,0.0,0.0,0.0,25,3,22,9.0,1.0,8.0
110362,2,2,0,0,0,2,35,4,0.0,0.0,0.0,0.0,0.0,0.0,0.0,54,2,52,9.0,1.0,8.0
107205,6,3,3,3,0,6,36,78,2.0,2.0,0.0,0.0,0.0,2.0,16.0,22,6,16,12.0,3.0,9.0
210381,3,2,1,1,0,3,10,24,1.0,1.0,0.0,0.0,0.0,1.0,3.0,28,3,25,5.0,1.0,4.0
9805318,17,5,12,29,5,12,118,33,10.0,1.0,9.0,20.0,0.0,10.0,103.0,39,17,22,23.0,8.0,15.0
9703283,3,2,1,1,3,0,0,36,,,,,,,,4,3,1,2.0,2.0,0.0
8243,6,2,4,7,6,0,0,261,5.0,1.0,4.0,7.0,5.0,0.0,0.0,6,6,0,5.0,5.0,0.0
9903443,3,1,2,3,0,3,17,13,3.0,1.0,2.0,3.0,0.0,3.0,16.0,14,3,11,8.0,1.0,7.0
9710238,4,1,3,4,0,4,19,18,4.0,1.0,3.0,4.0,0.0,4.0,18.0,28,4,24,8.0,4.0,4.0
9601381,4,3,1,2,4,0,0,179,3.0,2.0,1.0,2.0,3.0,0.0,0.0,8,4,4,3.0,3.0,0.0
102016,3,2,1,1,0,3,10,215,2.0,1.0,1.0,1.0,0.0,2.0,7.0,10,3,7,8.0,2.0,6.0
9308364,13,10,3,4,2,11,18,90,4.0,2.0,2.0,3.0,0.0,4.0,7.0,19,13,6,3.0,2.0,1.0
204061,10,7,3,5,5,5,16,172,3.0,2.0,1.0,1.0,0.0,3.0,13.0,17,10,7,9.0,3.0,6.0
11175,4,3,1,1,0,4,44,1,1.0,1.0,0.0,0.0,0.0,1.0,13.0,63,4,59,7.0,2.0,5.0
9509342,8,5,3,5,3,5,9,24,3.0,1.0,2.0,3.0,0.0,3.0,3.0,12,8,4,2.0,1.0,1.0
1239,7,1,6,12,0,7,34,161,6.0,1.0,5.0,11.0,0.0,6.0,26.0,18,7,11,13.0,6.0,7.0
12080,13,3,10,30,0,13,27,102,12.0,3.0,9.0,29.0,3.0,9.0,12.0,21,13,8,11.0,9.0,2.0
9906397,2,1,1,1,0,2,5,75,2.0,1.0,1.0,1.0,1.0,1.0,1.0,30,2,28,1.0,0.0,1.0
9507288,4,2,2,3,4,0,0,222,2.0,1.0,1.0,1.0,2.0,0.0,0.0,5,4,1,3.0,2.0,1.0
210085,3,3,0,0,0,3,22,1,1.0,1.0,0.0,0.0,0.0,1.0,4.0,30,3,27,11.0,1.0,10.0
9811376,9,5,4,4,0,9,29,152,7.0,4.0,3.0,3.0,0.0,7.0,23.0,18,9,9,10.0,6.0,4.0
6291,1,1,0,0,1,0,0,91,1.0,1.0,0.0,0.0,1.0,0.0,0.0,1,1,0,,,
106031,7,4,3,3,0,7,26,52,5.0,3.0,2.0,2.0,0.0,5.0,17.0,13,7,6,8.0,4.0,4.0
9601219,2,2,0,0,2,0,0,285,2.0,2.0,0.0,0.0,2.0,0.0,0.0,2,2,0,1.0,1.0,0.0
9804426,3,3,0,0,2,1,1,159,0.0,0.0,0.0,0.0,0.0,0.0,0.0,10,3,7,1.0,0.0,1.0
9907356,3,3,0,0,1,2,23,27,2.0,2.0,0.0,0.0,0.0,2.0,22.0,17,3,14,3.0,0.0,3.0
212388,1,1,0,0,0,1,9,95,1.0,1.0,0.0,0.0,0.0,1.0,3.0,22,1,21,4.0,1.0,3.0
9903338,3,3,0,0,2,1,1,230,0.0,0.0,0.0,0.0,0.0,0.0,0.0,4,3,1,1.0,1.0,0.0
9711318,10,4,6,16,1,9,51,94,8.0,2.0,6.0,16.0,0.0,8.0,48.0,18,10,8,15.0,8.0,7.0
9607230,1,1,0,0,0,1,5,155,1.0,1.0,0.0,0.0,0.0,1.0,3.0,6,1,5,4.0,1.0,3.0
9602276,4,3,1,1,1,3,3,458,2.0,1.0,1.0,1.0,0.0,2.0,2.0,5,4,1,1.0,1.0,0.0
8233,1,1,0,0,1,0,0,472,1.0,1.0,0.0,0.0,1.0,0.0,0.0,1,1,0,1.0,1.0,0.0
9602412,7,5,2,3,0,7,14,156,7.0,5.0,2.0,3.0,0.0,7.0,14.0,10,7,3,7.0,4.0,3.0
9511278,2,2,0,0,0,2,15,40,1.0,1.0,0.0,0.0,0.0,1.0,12.0,24,2,22,6.0,0.0,6.0
9211234,3,1,2,3,3,0,0,162,3.0,1.0,2.0,3.0,3.0,0.0,0.0,4,3,1,3.0,3.0,0.0
209145,1,1,0,0,0,1,3,126,1.0,1.0,0.0,0.0,0.0,1.0,3.0,10,1,9,5.0,1.0,4.0
210328,0,0,0,0,0,0,0,76,0.0,0.0,0.0,0.0,0.0,0.0,0.0,3,0,3,3.0,0.0,3.0
10063,2,1,1,1,0,2,24,27,2.0,1.0,1.0,1.0,0.0,2.0,17.0,17,2,15,10.0,2.0,8.0
111289,3,1,2,3,3,0,0,28,,,,,,,,5,3,2,,,
9509241,1,1,0,0,1,0,0,1647,,,,,,,,1,1,0,,,
9809522,1,1,0,0,0,1,5,318,0.0,0.0,0.0,0.0,0.0,0.0,0.0,11,1,10,1.0,0.0,1.0
9407304,3,3,0,0,2,1,2,54,1.0,1.0,0.0,0.0,1.0,0.0,0.0,9,3,6,1.0,1.0,0.0
103102,20,11,9,17,2,18,94,116,9.0,3.0,6.0,12.0,0.0,9.0,47.0,69,20,49,14.0,8.0,6.0
1179,3,1,2,2,3,0,0,250,0.0,0.0,0.0,0.0,0.0,0.0,0.0,9,3,6,4.0,0.0,4.0
205061,9,2,7,23,0,9,38,0,8.0,1.0,7.0,23.0,0.0,8.0,16.0,14,9,5,11.0,8.0,3.0
9808325,2,2,0,0,0,2,2,144,1.0,1.0,0.0,0.0,0.0,1.0,1.0,4,2,2,3.0,1.0,2.0
9508286,5,3,2,2,3,2,6,16,4.0,2.0,2.0,2.0,2.0,2.0,2.0,11,5,6,2.0,1.0,1.0
9812526,9,4,5,8,0,9,14,180,6.0,3.0,3.0,5.0,0.0,6.0,11.0,12,9,3,9.0,6.0,3.0
9503300,6,2,4,4,6,0,0,386,6.0,2.0,4.0,4.0,6.0,0.0,0.0,6,6,0,5.0,5.0,0.0
110345,3,1,2,3,0,3,9,16,3.0,1.0,2.0,3.0,0.0,3.0,7.0,10,3,7,6.0,1.0,5.0
9412282,10,5,5,6,3,7,14,13,6.0,1.0,5.0,6.0,1.0,5.0,10.0,15,10,5,4.0,3.0,1.0
205253,1,1,0,0,0,1,2,118,1.0,1.0,0.0,0.0,0.0,1.0,2.0,8,1,7,7.0,0.0,7.0
9507268,5,1,4,8,2,3,4,52,5.0,1.0,4.0,8.0,2.0,3.0,3.0,8,5,3,6.0,5.0,1.0
107015,2,2,0,0,1,1,8,11,1.0,1.0,0.0,0.0,1.0,0.0,0.0,12,2,10,1.0,0.0,1.0
12135,5,4,1,1,0,5,28,7,3.0,2.0,1.0,1.0,0.0,3.0,8.0,28,5,23,5.0,3.0,2.0
210445,0,0,0,0,0,0,0,23,0.0,0.0,0.0,0.0,0.0,0.0,0.0,58,0,58,22.0,0.0,22.0
207365,2,2,0,0,0,2,16,47,1.0,1.0,0.0,0.0,0.0,1.0,10.0,36,2,34,21.0,1.0,20.0
9808216,3,3,0,0,3,0,0,573,2.0,2.0,0.0,0.0,2.0,0.0,0.0,4,3,1,2.0,2.0,0.0
9408261,10,3,7,13,9,1,1,115,4.0,2.0,2.0,2.0,4.0,0.0,0.0,11,10,1,3.0,3.0,0.0
9511400,2,2,0,0,2,0,0,3,0.0,0.0,0.0,0.0,0.0,0.0,0.0,18,2,16,1.0,1.0,0.0
9711409,3,2,1,1,1,2,16,48,1.0,1.0,0.0,0.0,0.0,1.0,12.0,19,3,16,13.0,1.0,12.0
9306287,2,1,1,1,2,0,0,607,0.0,0.0,0.0,0.0,0.0,0.0,0.0,3,2,1,1.0,0.0,1.0
5176,0,0,0,0,0,0,0,177,0.0,0.0,0.0,0.0,0.0,0.0,0.0,9,0,9,2.0,0.0,2.0
9810201,4,3,1,1,0,4,5,152,2.0,2.0,0.0,0.0,0.0,2.0,3.0,7,4,3,2.0,1.0,1.0
9411398,1,1,0,0,1,0,0,93,0.0,0.0,0.0,0.0,0.0,0.0,0.0,9,1,8,1.0,0.0,1.0
210304,3,1,2,3,0,3,18,9,0.0,0.0,0.0,0.0,0.0,0.0,0.0,19,3,16,7.0,3.0,4.0
9708245,3,2,1,1,2,1,3,161,1.0,1.0,0.0,0.0,0.0,1.0,2.0,8,3,5,4.0,1.0,3.0
9307313,1,1,0,0,1,0,0,1166,0.0,0.0,0.0,0.0,0.0,0.0,0.0,2,1,1,1.0,1.0,0.0
9803477,9,3,6,16,7,2,7,121,7.0,1.0,6.0,16.0,7.0,0.0,0.0,13,9,4,7.0,7.0,0.0
106143,2,1,1,1,2,0,0,65,,,,,,,,3,2,1,,,
109224,6,2,4,5,1,5,10,165,6.0,2.0,4.0,5.0,1.0,5.0,9.0,9,6,3,7.0,5.0,2.0
201168,4,1,3,5,0,4,9,74,3.0,1.0,2.0,3.0,0.0,3.0,8.0,7,4,3,6.0,3.0,3.0
9904345,3,1,2,3,3,0,0,112,3.0,1.0,2.0,3.0,3.0,0.0,0.0,4,3,1,3.0,3.0,0.0
9906502,9,2,7,20,0,9,49,7,5.0,1.0,4.0,6.0,0.0,5.0,20.0,22,9,13,6.0,2.0,4.0
9712373,1,1,0,0,1,0,0,36,0.0,0.0,0.0,0.0,0.0,0.0,0.0,9,1,8,,,
9501350,3,2,1,1,0,3,4,266,3.0,2.0,1.0,1.0,0.0,3.0,4.0,10,3,7,2.0,0.0,2.0
9808428,4,2,2,2,2,2,5,33,2.0,1.0,1.0,1.0,2.0,0.0,0.0,17,4,13,2.0,2.0,0.0
9176,2,1,1,1,0,2,11,19,1.0,1.0,0.0,0.0,0.0,1.0,2.0,8,2,6,5.0,2.0,3.0
9210245,8,4,4,5,8,0,0,232,5.0,3.0,2.0,2.0,5.0,0.0,0.0,8,8,0,4.0,4.0,0.0
9511367,3,3,0,0,1,2,5,116,1.0,1.0,0.0,0.0,0.0,1.0,4.0,8,3,5,2.0,1.0,1.0
3279,7,3,4,5,0,7,16,40,3.0,3.0,0.0,0.0,0.0,3.0,10.0,18,7,11,7.0,3.0,4.0
208233,0,0,0,0,0,0,0,185,0.0,0.0,0.0,0.0,0.0,0.0,0.0,11,0,11,3.0,0.0,3.0
109191,3,3,0,0,3,0,0,31,0.0,0.0,0.0,0.0,0.0,0.0,0.0,9,3,6,1.0,0.0,1.0
9906245,1,1,0,0,0,1,6,384,0.0,0.0,0.0,0.0,0.0,0.0,0.0,17,1,16,4.0,0.0,4.0
9602311,1,1,0,0,1,0,0,22,0.0,0.0,0.0,0.0,0.0,0.0,0.0,8,1,7,2.0,0.0,2.0
9809365,9,2,7,10,3,6,18,131,6.0,1.0,5.0,7.0,0.0,6.0,16.0,14,9,5,5.0,5.0,0.0
9705225,1,1,0,0,0,1,5,79,1.0,1.0,0.0,0.0,0.0,1.0,5.0,10,1,9,3.0,0.0,3.0
207012,5,5,0,0,1,4,27,116,3.0,3.0,0.0,0.0,0.0,3.0,23.0,23,5,18,11.0,3.0,8.0
110289,3,1,2,2,0,3,8,4,0.0,0.0,0.0,0.0,0.0,0.0,0.0,22,3,19,5.0,0.0,5.0
211282,4,3,1,2,0,4,23,1,0.0,0.0,0.0,0.0,0.0,0.0,0.0,20,4,16,8.0,1.0,7.0
5167,6,2,4,4,1,5,83,0,3.0,1.0,2.0,2.0,0.0,3.0,47.0,62,6,56,15.0,3.0,12.0
9805340,10,4,6,17,0,10,16,175,10.0,4.0,6.0,17.0,0.0,10.0,16.0,14,10,4,10.0,8.0,2.0
101108,3,1,2,3,3,0,0,457,3.0,1.0,2.0,3.0,3.0,0.0,0.0,3,3,0,3.0,3.0,0.0
203063,4,2,2,3,1,3,10,54,0.0,0.0,0.0,0.0,0.0,0.0,0.0,19,4,15,6.0,0.0,6.0
9810399,2,1,1,1,0,2,2,188,0.0,0.0,0.0,0.0,0.0,0.0,0.0,14,2,12,2.0,0.0,2.0
9804372,6,5,1,1,0,6,38,63,4.0,4.0,0.0,0.0,0.0,4.0,25.0,25,6,19,13.0,3.0,10.0
9905298,1,1,0,0,1,0,0,94,,,,,,,,3,1,2,1.0,1.0,0.0
9406422,4,4,0,0,0,4,7,112,2.0,2.0,0.0,0.0,0.0,2.0,2.0,7,4,3,3.0,2.0,1.0
8225,2,2,0,0,1,1,1,372,0.0,0.0,0.0,0.0,0.0,0.0,0.0,5,2,3,1.0,0.0,1.0
210103,0,0,0,0,0,0,0,25,0.0,0.0,0.0,0.0,0.0,0.0,0.0,12,0,12,2.0,0.0,2.0
9907301,3,3,0,0,0,3,11,9,1.0,1.0,0.0,0.0,0.0,1.0,2.0,35,3,32,5.0,0.0,5.0
211063,2,2,0,0,1,1,7,32,1.0,1.0,0.0,0.0,0.0,1.0,7.0,13,2,11,1.0,0.0,1.0
9803398,2,2,0,0,2,0,0,126,1.0,1.0,0.0,0.0,1.0,0.0,0.0,10,2,8,3.0,2.0,1.0
9910234,2,2,0,0,0,2,4,1,1.0,1.0,0.0,0.0,0.0,1.0,1.0,17,2,15,2.0,1.0,1.0
9707499,1,1,0,0,0,1,4,47,0.0,0.0,0.0,0.0,0.0,0.0,0.0,7,1,6,,,
9910333,10,6,4,4,6,4,6,153,4.0,3.0,1.0,1.0,4.0,0.0,0.0,12,10,2,6.0,6.0,0.0
9904412,3,3,0,0,0,3,12,173,0.0,0.0,0.0,0.0,0.0,0.0,0.0,13,3,10,4.0,0.0,4.0
9712233,4,2,2,2,1,3,5,31,0.0,0.0,0.0,0.0,0.0,0.0,0.0,7,4,3,3.0,2.0,1.0
9710363,3,2,1,1,0,3,10,122,3.0,2.0,1.0,1.0,1.0,2.0,2.0,10,3,7,1.0,1.0,0.0
9912234,6,3,3,4,0,6,37,13,3.0,2.0,1.0,1.0,0.0,3.0,15.0,27,6,21,9.0,4.0,5.0
3255,0,0,0,0,0,0,0,504,0.0,0.0,0.0,0.0,0.0,0.0,0.0,4,0,4,2.0,0.0,2.0
11023,5,2,3,4,4,1,6,13,1.0,1.0,0.0,0.0,0.0,1.0,6.0,20,5,15,14.0,0.0,14.0
9610324,0,0,0,0,0,0,0,1042,,,,,,,,2,0,2,1.0,0.0,1.0
111448,1,1,0,0,0,1,2,17,0.0,0.0,0.0,0.0,0.0,0.0,0.0,15,1,14,6.0,0.0,6.0
204185,6,3,3,4,0,6,32,78,4.0,1.0,3.0,4.0,0.0,4.0,13.0,26,6,20,10.0,4.0,6.0
9807347,5,5,0,0,2,3,36,5,2.0,2.0,0.0,0.0,0.0,2.0,27.0,24,5,19,4.0,2.0,2.0
9607337,1,1,0,0,1,0,0,385,0.0,0.0,0.0,0.0,0.0,0.0,0.0,8,1,7,1.0,0.0,1.0
111217,1,1,0,0,1,0,0,1976,,,,,,,,5,1,4,1.0,0.0,1.0
206128,2,1,1,1,0,2,46,7,2.0,1.0,1.0,1.0,0.0,2.0,26.0,40,2,38,13.0,1.0,12.0
9907571,3,2,1,2,1,2,4,41,3.0,2.0,1.0,2.0,1.0,2.0,2.0,6,3,3,2.0,2.0,0.0
9611226,3,3,0,0,3,0,0,338,1.0,1.0,0.0,0.0,1.0,0.0,0.0,3,3,0,,,
103340,3,3,0,0,1,2,3,280,1.0,1.0,0.0,0.0,0.0,1.0,2.0,10,3,7,4.0,1.0,3.0
110070,3,2,1,1,0,3,9,177,2.0,2.0,0.0,0.0,0.0,2.0,6.0,16,3,13,5.0,1.0,4.0
9509252,1,1,0,0,0,1,1,112,0.0,0.0,0.0,0.0,0.0,0.0,0.0,25,1,24,6.0,0.0,6.0
9504380,2,2,0,0,0,2,2,77,1.0,1.0,0.0,0.0,1.0,0.0,0.0,3,2,1,1.0,1.0,0.0
210278,1,1,0,0,0,1,8,53,1.0,1.0,0.0,0.0,0.0,1.0,8.0,14,1,13,2.0,0.0,2.0
101245,3,2,1,1,0,3,26,34,3.0,2.0,1.0,1.0,0.0,3.0,18.0,23,3,20,13.0,3.0,10.0
107131,1,1,0,0,1,0,0,38,0.0,0.0,0.0,0.0,0.0,0.0,0.0,32,1,31,19.0,0.0,19.0
110209,1,1,0,0,1,0,0,37,1.0,1.0,0.0,0.0,1.0,0.0,0.0,8,1,7,4.0,1.0,3.0
212096,0,0,0,0,0,0,0,1440,,,,,,,,1,0,1,,,
9703296,2,2,0,0,1,1,1,367,1.0,1.0,0.0,0.0,1.0,0.0,0.0,3,2,1,1.0,1.0,0.0
9405307,0,0,0,0,0,0,0,1157,,,,,,,,1,0,1,,,
9901407,8,3,5,11,1,7,16,82,5.0,1.0,4.0,9.0,0.0,5.0,12.0,13,8,5,7.0,4.0,3.0
104025,3,1,2,3,0,3,3,51,3.0,1.0,2.0,3.0,0.0,3.0,3.0,8,3,5,1.0,0.0,1.0
10176,1,1,0,0,0,1,5,9,0.0,0.0,0.0,0.0,0.0,0.0,0.0,37,1,36,6.0,0.0,6.0
206004,3,3,0,0,0,3,11,3,0.0,0.0,0.0,0.0,0.0,0.0,0.0,19,3,16,4.0,0.0,4.0
6358,5,5,0,0,3,2,7,364,2.0,2.0,0.0,0.0,0.0,2.0,6.0,9,5,4,5.0,2.0,3.0
9407318,2,1,1,1,0,2,3,440,0.0,0.0,0.0,0.0,0.0,0.0,0.0,5,2,3,1.0,0.0,1.0
104070,0,0,0,0,0,0,0,226,0.0,0.0,0.0,0.0,0.0,0.0,0.0,8,0,8,2.0,0.0,2.0
9506290,7,0,7,19,7,0,0,147,7.0,0.0,7.0,19.0,7.0,0.0,0.0,7,7,0,7.0,7.0,0.0
9911470,4,4,0,0,2,2,11,0,2.0,2.0,0.0,0.0,0.0,2.0,8.0,24,4,20,7.0,2.0,5.0
210159,0,0,0,0,0,0,0,38,0.0,0.0,0.0,0.0,0.0,0.0,0.0,8,0,8,2.0,0.0,2.0
9907451,4,4,0,0,2,2,3,127,1.0,1.0,0.0,0.0,0.0,1.0,1.0,7,4,3,1.0,1.0,0.0
9305226,1,1,0,0,1,0,0,1981,1.0,1.0,0.0,0.0,1.0,0.0,0.0,1,1,0,1.0,1.0,0.0
206204,1,1,0,0,0,1,1,14,0.0,0.0,0.0,0.0,0.0,0.0,0.0,17,1,16,8.0,0.0,8.0
110250,0,0,0,0,0,0,0,140,0.0,0.0,0.0,0.0,0.0,0.0,0.0,21,0,21,5.0,0.0,5.0
9806411,5,3,2,3,0,5,9,234,3.0,2.0,1.0,1.0,0.0,3.0,5.0,8,5,3,6.0,4.0,2.0
9809323,1,1,0,0,0,1,3,136,1.0,1.0,0.0,0.0,0.0,1.0,3.0,8,1,7,1.0,0.0,1.0
9706527,2,2,0,0,1,1,1,235,1.0,1.0,0.0,0.0,1.0,0.0,0.0,5,2,3,1.0,1.0,0.0
9607361,0,0,0,0,0,0,0,40,0.0,0.0,0.0,0.0,0.0,0.0,0.0,14,0,14,5.0,0.0,5.0
110144,2,2,0,0,0,2,10,10,2.0,2.0,0.0,0.0,0.0,2.0,8.0,11,2,9,7.0,2.0,5.0
104208,4,4,0,0,0,4,6,186,2.0,2.0,0.0,0.0,0.0,2.0,3.0,12,4,8,4.0,2.0,2.0
111427,11,6,5,6,4,7,21,106,4.0,2.0,2.0,2.0,4.0,0.0,0.0,20,11,9,6.0,4.0,2.0
9902252,0,0,0,0,0,0,0,496,0.0,0.0,0.0,0.0,0.0,0.0,0.0,2,0,2,2.0,0.0,2.0
9609241,1,1,0,0,0,1,3,0,0.0,0.0,0.0,0.0,0.0,0.0,0.0,10,1,9,1.0,0.0,1.0
9708261,1,1,0,0,0,1,1,105,0.0,0.0,0.0,0.0,0.0,0.0,0.0,4,1,3,1.0,0.0,1.0
9907455,3,3,0,0,0,3,11,303,3.0,3.0,0.0,0.0,0.0,3.0,9.0,13,3,10,7.0,3.0,4.0
9906522,0,0,0,0,0,0,0,117,0.0,0.0,0.0,0.0,0.0,0.0,0.0,9,0,9,1.0,0.0,1.0
9138,1,1,0,0,0,1,2,38,1.0,1.0,0.0,0.0,0.0,1.0,2.0,7,1,6,2.0,0.0,2.0
101211,4,2,2,2,2,2,2,166,3.0,1.0,2.0,2.0,3.0,0.0,0.0,7,4,3,3.0,3.0,0.0
207085,1,1,0,0,0,1,4,22,0.0,0.0,0.0,0.0,0.0,0.0,0.0,13,1,12,4.0,1.0,3.0
9606409,3,1,2,2,3,0,0,243,3.0,1.0,2.0,2.0,3.0,0.0,0.0,4,3,1,3.0,3.0,0.0
207229,0,0,0,0,0,0,0,63,0.0,0.0,0.0,0.0,0.0,0.0,0.0,10,0,10,1.0,0.0,1.0
9512247,0,0,0,0,0,0,0,267,0.0,0.0,0.0,0.0,0.0,0.0,0.0,3,0,3,2.0,0.0,2.0
9912221,4,4,0,0,2,2,10,8,2.0,2.0,0.0,0.0,0.0,2.0,4.0,15,4,11,6.0,1.0,5.0
205345,5,2,3,3,0,5,41,62,5.0,2.0,3.0,3.0,0.0,5.0,36.0,24,5,19,16.0,5.0,11.0
9060,3,3,0,0,1,2,3,264,3.0,3.0,0.0,0.0,1.0,2.0,3.0,6,3,3,2.0,2.0,0.0
9905431,0,0,0,0,0,0,0,7,0.0,0.0,0.0,0.0,0.0,0.0,0.0,9,0,9,5.0,0.0,5.0
9601274,0,0,0,0,0,0,0,170,,,,,,,,1,0,1,,,
102195,4,3,1,2,1,3,10,30,1.0,1.0,0.0,0.0,0.0,1.0,2.0,10,4,6,6.0,3.0,3.0
9268,4,3,1,1,0,4,10,6,0.0,0.0,0.0,0.0,0.0,0.0,0.0,13,4,9,7.0,0.0,7.0
9810490,1,1,0,0,0,1,1,33,1.0,1.0,0.0,0.0,0.0,1.0,1.0,28,1,27,17.0,0.0,17.0
208126,1,1,0,0,0,1,9,9,,,,,,,,11,1,10,5.0,1.0,4.0
211030,0,0,0,0,0,0,0,138,0.0,0.0,0.0,0.0,0.0,0.0,0.0,8,0,8,4.0,0.0,4.0
9908428,2,2,0,0,1,1,2,372,2.0,2.0,0.0,0.0,1.0,1.0,1.0,6,2,4,3.0,1.0,2.0
9506360,2,2,0,0,1,1,2,401,1.0,1.0,0.0,0.0,0.0,1.0,2.0,4,2,2,3.0,1.0,2.0
210073,1,1,0,0,0,1,8,73,0.0,0.0,0.0,0.0,0.0,0.0,0.0,11,1,10,7.0,1.0,6.0
9901303,0,0,0,0,0,0,0,15,0.0,0.0,0.0,0.0,0.0,0.0,0.0,15,0,15,5.0,0.0,5.0
206199,3,3,0,0,0,3,17,1,0.0,0.0,0.0,0.0,0.0,0.0,0.0,30,3,27,5.0,1.0,4.0
9609531,0,0,0,0,0,0,0,207,0.0,0.0,0.0,0.0,0.0,0.0,0.0,13,0,13,4.0,0.0,4.0
10251,2,1,1,1,0,2,13,6,2.0,1.0,1.0,1.0,1.0,1.0,1.0,13,2,11,8.0,2.0,6.0
8270,2,2,0,0,0,2,11,12,0.0,0.0,0.0,0.0,0.0,0.0,0.0,27,2,25,3.0,1.0,2.0
210382,0,0,0,0,0,0,0,1,0.0,0.0,0.0,0.0,0.0,0.0,0.0,3,0,3,3.0,0.0,3.0
205169,0,0,0,0,0,0,0,198,0.0,0.0,0.0,0.0,0.0,0.0,0.0,1,0,1,1.0,0.0,1.0
302202,0,0,0,0,0,0,0,239,0.0,0.0,0.0,0.0,0.0,0.0,0.0,5,0,5,4.0,0.0,4.0
9605268,2,2,0,0,0,2,20,134,2.0,2.0,0.0,0.0,0.0,2.0,16.0,12,2,10,11.0,2.0,9.0
9910565,3,2,1,1,0,3,13,9,2.0,2.0,0.0,0.0,0.0,2.0,3.0,14,3,11,1.0,0.0,1.0
9710399,1,1,0,0,0,1,2,247,1.0,1.0,0.0,0.0,0.0,1.0,2.0,6,1,5,3.0,1.0,2.0
9503211,0,0,0,0,0,0,0,134,,,,,,,,1,0,1,,,
203111,0,0,0,0,0,0,0,349,0.0,0.0,0.0,0.0,0.0,0.0,0.0,2,0,2,2.0,0.0,2.0
301064,1,1,0,0,0,1,9,18,0.0,0.0,0.0,0.0,0.0,0.0,0.0,32,1,31,2.0,0.0,2.0
7183,3,2,1,1,2,1,5,266,1.0,1.0,0.0,0.0,0.0,1.0,2.0,8,3,5,2.0,1.0,1.0
204063,2,2,0,0,0,2,24,2,1.0,1.0,0.0,0.0,0.0,1.0,11.0,43,2,41,3.0,2.0,1.0
9812469,1,1,0,0,1,0,0,2050,,,,,,,,1,1,0,,,
210430,3,1,2,2,0,3,13,9,0.0,0.0,0.0,0.0,0.0,0.0,0.0,40,3,37,5.0,2.0,3.0
9612430,0,0,0,0,0,0,0,385,0.0,0.0,0.0,0.0,0.0,0.0,0.0,2,0,2,2.0,0.0,2.0
9303222,2,2,0,0,2,0,0,238,1.0,1.0,0.0,0.0,1.0,0.0,0.0,2,2,0,1.0,1.0,0.0
9910410,3,1,2,3,0,3,35,21,2.0,1.0,1.0,1.0,0.0,2.0,20.0,31,3,28,7.0,3.0,4.0
9910454,2,1,1,1,0,2,4,390,2.0,1.0,1.0,1.0,0.0,2.0,4.0,4,2,2,4.0,2.0,2.0
6286,2,2,0,0,0,2,2,153,2.0,2.0,0.0,0.0,1.0,1.0,1.0,7,2,5,3.0,1.0,2.0
102169,5,1,4,10,0,5,73,4,5.0,1.0,4.0,10.0,0.0,5.0,65.0,29,5,24,7.0,4.0,3.0
101295,1,1,0,0,0,1,3,102,1.0,1.0,0.0,0.0,0.0,1.0,2.0,9,1,8,2.0,0.0,2.0
212278,0,0,0,0,0,0,0,111,0.0,0.0,0.0,0.0,0.0,0.0,0.0,3,0,3,1.0,0.0,1.0
9510429,1,1,0,0,0,1,1,14,1.0,1.0,0.0,0.0,0.0,1.0,1.0,8,1,7,2.0,0.0,2.0
9605322,1,1,0,0,1,0,0,342,0.0,0.0,0.0,0.0,0.0,0.0,0.0,4,1,3,2.0,0.0,2.0
111208,3,1,2,3,0,3,14,65,3.0,1.0,2.0,3.0,1.0,2.0,6.0,10,3,7,5.0,3.0,2.0
9406304,0,0,0,0,0,0,0,1466,,,,,,,,2,0,2,,,
9610353,2,2,0,0,0,2,14,90,2.0,2.0,0.0,0.0,0.0,2.0,12.0,16,2,14,10.0,2.0,8.0
9907530,2,1,1,1,0,2,14,5,1.0,1.0,0.0,0.0,0.0,1.0,5.0,14,2,12,5.0,2.0,3.0
9908448,1,1,0,0,0,1,1,139,1.0,1.0,0.0,0.0,0.0,1.0,1.0,2,1,1,,,
101314,1,1,0,0,1,0,0,4,0.0,0.0,0.0,0.0,0.0,0.0,0.0,19,1,18,8.0,0.0,8.0
9702396,1,1,0,0,0,1,2,103,0.0,0.0,0.0,0.0,0.0,0.0,0.0,4,1,3,1.0,0.0,1.0
9308321,2,2,0,0,0,2,2,56,0.0,0.0,0.0,0.0,0.0,0.0,0.0,5,2,3,1.0,0.0,1.0
210336,1,1,0,0,0,1,2,25,1.0,1.0,0.0,0.0,1.0,0.0,0.0,11,1,10,3.0,0.0,3.0
9305216,0,0,0,0,0,0,0,1950,0.0,0.0,0.0,0.0,0.0,0.0,0.0,2,0,2,,,
210002,3,3,0,0,1,2,7,1,0.0,0.0,0.0,0.0,0.0,0.0,0.0,15,3,12,1.0,0.0,1.0
202033,2,2,0,0,0,2,3,244,2.0,2.0,0.0,0.0,0.0,2.0,3.0,13,2,11,4.0,2.0,2.0
111199,6,1,5,7,0,6,49,0,5.0,2.0,3.0,4.0,0.0,5.0,37.0,34,6,28,12.0,4.0,8.0
9088,0,0,0,0,0,0,0,186,0.0,0.0,0.0,0.0,0.0,0.0,0.0,3,0,3,,,
301068,0,0,0,0,0,0,0,10,0.0,0.0,0.0,0.0,0.0,0.0,0.0,51,0,51,8.0,0.0,8.0
5046,2,2,0,0,0,2,8,22,1.0,1.0,0.0,0.0,0.0,1.0,6.0,40,2,38,13.0,0.0,13.0
204020,4,3,1,1,0,4,16,89,2.0,2.0,0.0,0.0,0.0,2.0,8.0,18,4,14,2.0,1.0,1.0
207077,1,1,0,0,0,1,1,9,0.0,0.0,0.0,0.0,0.0,0.0,0.0,12,1,11,2.0,0.0,2.0
9911376,2,1,1,1,1,1,2,8,0.0,0.0,0.0,0.0,0.0,0.0,0.0,13,2,11,1.0,0.0,1.0
301205,0,0,0,0,0,0,0,71,0.0,0.0,0.0,0.0,0.0,0.0,0.0,3,0,3,1.0,0.0,1.0
209201,0,0,0,0,0,0,0,220,0.0,0.0,0.0,0.0,0.0,0.0,0.0,3,0,3,3.0,0.0,3.0
9805265,0,0,0,0,0,0,0,454,0.0,0.0,0.0,0.0,0.0,0.0,0.0,8,0,8,1.0,0.0,1.0
9808315,1,1,0,0,0,1,3,333,1.0,1.0,0.0,0.0,0.0,1.0,3.0,4,1,3,3.0,1.0,2.0
212251,0,0,0,0,0,0,0,22,,,,,,,,6,0,6,3.0,0.0,3.0
9610472,0,0,0,0,0,0,0,10,0.0,0.0,0.0,0.0,0.0,0.0,0.0,10,0,10,,,
9806478,1,1,0,0,0,1,4,285,1.0,1.0,0.0,0.0,0.0,1.0,2.0,9,1,8,3.0,1.0,2.0
9508251,1,1,0,0,1,0,0,371,1.0,1.0,0.0,0.0,1.0,0.0,0.0,2,1,1,2.0,1.0,1.0
9808397,1,1,0,0,1,0,0,146,,,,,,,,1,1,0,1.0,1.0,0.0
106318,2,1,1,1,0,2,8,6,1.0,1.0,0.0,0.0,0.0,1.0,1.0,9,2,7,7.0,2.0,5.0
6264,2,2,0,0,1,1,3,143,1.0,1.0,0.0,0.0,0.0,1.0,3.0,9,2,7,3.0,1.0,2.0
11348,5,3,2,2,1,4,27,257,4.0,2.0,2.0,2.0,0.0,4.0,9.0,15,5,10,6.0,4.0,2.0
210271,2,2,0,0,0,2,3,46,0.0,0.0,0.0,0.0,0.0,0.0,0.0,14,2,12,1.0,0.0,1.0
111265,0,0,0,0,0,0,0,64,0.0,0.0,0.0,0.0,0.0,0.0,0.0,12,0,12,1.0,0.0,1.0
9906367,1,1,0,0,1,0,0,362,1.0,1.0,0.0,0.0,1.0,0.0,0.0,4,1,3,1.0,1.0,0.0
9908453,0,0,0,0,0,0,0,57,,,,,,,,4,0,4,,,
10235,0,0,0,0,0,0,0,138,0.0,0.0,0.0,0.0,0.0,0.0,0.0,5,0,5,1.0,0.0,1.0
9610248,0,0,0,0,0,0,0,42,0.0,0.0,0.0,0.0,0.0,0.0,0.0,8,0,8,1.0,0.0,1.0
9410374,0,0,0,0,0,0,0,123,0.0,0.0,0.0,0.0,0.0,0.0,0.0,4,0,4,,,
9706442,0,0,0,0,0,0,0,211,0.0,0.0,0.0,0.0,0.0,0.0,0.0,5,0,5,5.0,0.0,5.0
9601263,3,3,0,0,3,0,0,337,1.0,1.0,0.0,0.0,1.0,0.0,0.0,3,3,0,2.0,2.0,0.0
112207,5,2,3,5,0,5,8,70,4.0,1.0,3.0,5.0,3.0,1.0,2.0,10,5,5,6.0,4.0,2.0
2143,4,4,0,0,0,4,17,121,4.0,4.0,0.0,0.0,0.0,4.0,13.0,26,4,22,7.0,3.0,4.0
112243,2,2,0,0,2,0,0,6,0.0,0.0,0.0,0.0,0.0,0.0,0.0,43,2,41,14.0,0.0,14.0
9908366,2,1,1,1,0,2,3,339,2.0,1.0,1.0,1.0,0.0,2.0,2.0,8,2,6,1.0,0.0,1.0
9308361,1,1,0,0,0,1,1,229,1.0,1.0,0.0,0.0,0.0,1.0,1.0,5,1,4,3.0,1.0,2.0
9905289,2,1,1,1,1,1,1,374,1.0,1.0,0.0,0.0,1.0,0.0,0.0,5,2,3,2.0,2.0,0.0
210447,1,1,0,0,0,1,11,20,1.0,1.0,0.0,0.0,0.0,1.0,9.0,19,1,18,12.0,1.0,11.0
9911360,0,0,0,0,0,0,0,2092,,,,,,,,4,0,4,,,
302267,0,0,0,0,0,0,0,1,,,,,,,,11,0,11,,,
210313,1,1,0,0,0,1,15,9,1.0,1.0,0.0,0.0,0.0,1.0,15.0,17,1,16,4.0,0.0,4.0
9803302,0,0,0,0,0,0,0,78,0.0,0.0,0.0,0.0,0.0,0.0,0.0,9,0,9,2.0,0.0,2.0
9411418,0,0,0,0,0,0,0,100,0.0,0.0,0.0,0.0,0.0,0.0,0.0,2,0,2,1.0,0.0,1.0
110321,2,1,1,1,0,2,3,375,2.0,1.0,1.0,1.0,0.0,2.0,2.0,9,2,7,3.0,2.0,1.0
9510244,0,0,0,0,0,0,0,97,,,,,,,,1,0,1,,,
9810525,0,0,0,0,0,0,0,35,0.0,0.0,0.0,0.0,0.0,0.0,0.0,9,0,9,3.0,0.0,3.0
9807271,0,0,0,0,0,0,0,519,0.0,0.0,0.0,0.0,0.0,0.0,0.0,1,0,1,1.0,0.0,1.0
9312344,2,1,1,1,2,0,0,113,,,,,,,,2,2,0,1.0,1.0,0.0
207119,0,0,0,0,0,0,0,689,0.0,0.0,0.0,0.0,0.0,0.0,0.0,1,0,1,1.0,0.0,1.0
9233,0,0,0,0,0,0,0,111,0.0,0.0,0.0,0.0,0.0,0.0,0.0,3,0,3,,,
201156,3,2,1,1,0,3,36,18,2.0,2.0,0.0,0.0,0.0,2.0,28.0,95,3,92,20.0,1.0,19.0
105040,2,1,1,1,0,2,23,4,2.0,1.0,1.0,1.0,0.0,2.0,13.0,51,2,49,6.0,2.0,4.0
105209,3,3,0,0,0,3,13,309,1.0,1.0,0.0,0.0,0.0,1.0,2.0,15,3,12,3.0,1.0,2.0
207291,2,2,0,0,0,2,14,38,2.0,2.0,0.0,0.0,0.0,2.0,14.0,35,2,33,22.0,1.0,21.0
9802428,0,0,0,0,0,0,0,374,0.0,0.0,0.0,0.0,0.0,0.0,0.0,5,0,5,1.0,0.0,1.0
9710221,0,0,0,0,0,0,0,35,0.0,0.0,0.0,0.0,0.0,0.0,0.0,10,0,10,1.0,0.0,1.0
9809569,0,0,0,0,0,0,0,175,0.0,0.0,0.0,0.0,0.0,0.0,0.0,3,0,3,,,
111174,0,0,0,0,0,0,0,127,0.0,0.0,0.0,0.0,0.0,0.0,0.0,13,0,13,7.0,0.0,7.0
9507224,0,0,0,0,0,0,0,837,,,,,,,,5,0,5,1.0,0.0,1.0
206182,2,1,1,1,0,2,13,26,0.0,0.0,0.0,0.0,0.0,0.0,0.0,12,2,10,3.0,2.0,1.0
205086,0,0,0,0,0,0,0,14,0.0,0.0,0.0,0.0,0.0,0.0,0.0,8,0,8,7.0,0.0,7.0
10266,1,1,0,0,1,0,0,695,1.0,1.0,0.0,0.0,1.0,0.0,0.0,4,1,3,1.0,1.0,0.0
110011,1,1,0,0,0,1,2,165,1.0,1.0,0.0,0.0,0.0,1.0,2.0,14,1,13,,,
9410202,0,0,0,0,0,0,0,253,0.0,0.0,0.0,0.0,0.0,0.0,0.0,1,0,1,,,
9711404,1,1,0,0,1,0,0,216,1.0,1.0,0.0,0.0,1.0,0.0,0.0,2,1,1,1.0,1.0,0.0
7024,4,4,0,0,4,0,0,252,2.0,2.0,0.0,0.0,2.0,0.0,0.0,5,4,1,2.0,2.0,0.0
208180,0,0,0,0,0,0,0,136,0.0,0.0,0.0,0.0,0.0,0.0,0.0,11,0,11,8.0,0.0,8.0
302157,0,0,0,0,0,0,0,1478,,,,,,,,2,0,2,,,
9507249,0,0,0,0,0,0,0,0,0.0,0.0,0.0,0.0,0.0,0.0,0.0,15,0,15,9.0,0.0,9.0
9710505,1,1,0,0,0,1,2,334,1.0,1.0,0.0,0.0,0.0,1.0,2.0,7,1,6,3.0,1.0,2.0
9710555,2,1,1,1,0,2,7,23,0.0,0.0,0.0,0.0,0.0,0.0,0.0,57,2,55,13.0,0.0,13.0
9602346,2,2,0,0,0,2,2,220,1.0,1.0,0.0,0.0,0.0,1.0,1.0,6,2,4,1.0,1.0,0.0
210062,1,1,0,0,0,1,3,402,1.0,1.0,0.0,0.0,0.0,1.0,2.0,6,1,5,4.0,1.0,3.0
301030,0,0,0,0,0,0,0,181,0.0,0.0,0.0,0.0,0.0,0.0,0.0,17,0,17,6.0,0.0,6.0
301159,0,0,0,0,0,0,0,58,0.0,0.0,0.0,0.0,0.0,0.0,0.0,33,0,33,13.0,0.0,13.0
9507369,2,2,0,0,0,2,5,237,2.0,2.0,0.0,0.0,0.0,2.0,5.0,6,2,4,6.0,2.0,4.0
202253,3,3,0,0,1,2,3,120,2.0,2.0,0.0,0.0,0.0,2.0,3.0,7,3,4,4.0,2.0,2.0
9908210,1,1,0,0,1,0,0,153,,,,,,,,1,1,0,1.0,1.0,0.0
11028,0,0,0,0,0,0,0,133,,,,,,,,4,0,4,2.0,0.0,2.0
9710471,0,0,0,0,0,0,0,352,0.0,0.0,0.0,0.0,0.0,0.0,0.0,6,0,6,2.0,0.0,2.0
301007,0,0,0,0,0,0,0,52,0.0,0.0,0.0,0.0,0.0,0.0,0.0,12,0,12,3.0,0.0,3.0
101012,0,0,0,0,0,0,0,108,0.0,0.0,0.0,0.0,0.0,0.0,0.0,5,0,5,1.0,0.0,1.0
9706302,0,0,0,0,0,0,0,103,0.0,0.0,0.0,0.0,0.0,0.0,0.0,2,0,2,1.0,0.0,1.0
9311276,1,1,0,0,1,0,0,1695,1.0,1.0,0.0,0.0,1.0,0.0,0.0,1,1,0,,,
208032,0,0,0,0,0,0,0,120,0.0,0.0,0.0,0.0,0.0,0.0,0.0,3,0,3,3.0,0.0,3.0
105164,0,0,0,0,0,0,0,62,0.0,0.0,0.0,0.0,0.0,0.0,0.0,5,0,5,2.0,0.0,2.0
209321,0,0,0,0,0,0,0,107,0.0,0.0,0.0,0.0,0.0,0.0,0.0,6,0,6,3.0,0.0,3.0
11328,1,1,0,0,1,0,0,324,1.0,1.0,0.0,0.0,1.0,0.0,0.0,5,1,4,2.0,1.0,1.0
207090,0,0,0,0,0,0,0,146,,,,,,,,1,0,1,,,
9308219,0,0,0,0,0,0,0,1711,,,,,,,,1,0,1,,,
206164,0,0,0,0,0,0,0,1,0.0,0.0,0.0,0.0,0.0,0.0,0.0,11,0,11,1.0,0.0,1.0
103134,0,0,0,0,0,0,0,14,0.0,0.0,0.0,0.0,0.0,0.0,0.0,19,0,19,3.0,0.0,3.0
101218,0,0,0,0,0,0,0,97,0.0,0.0,0.0,0.0,0.0,0.0,0.0,4,0,4,,,
106282,1,1,0,0,0,1,4,96,1.0,1.0,0.0,0.0,0.0,1.0,4.0,10,1,9,7.0,1.0,6.0
210420,0,0,0,0,0,0,0,190,0.0,0.0,0.0,0.0,0.0,0.0,0.0,4,0,4,3.0,0.0,3.0
9809388,1,1,0,0,0,1,1,152,1.0,1.0,0.0,0.0,0.0,1.0,1.0,2,1,1,1.0,1.0,0.0
9912479,0,0,0,0,0,0,0,154,0.0,0.0,0.0,0.0,0.0,0.0,0.0,2,0,2,1.0,0.0,1.0
9709486,1,1,0,0,1,0,0,222,,,,,,,,2,1,1,1.0,1.0,0.0
9803469,3,3,0,0,1,2,7,167,2.0,2.0,0.0,0.0,0.0,2.0,7.0,7,3,4,6.0,2.0,4.0
101174,1,1,0,0,0,1,18,9,1.0,1.0,0.0,0.0,0.0,1.0,6.0,29,1,28,6.0,1.0,5.0
205279,2,2,0,0,1,1,1,15,0.0,0.0,0.0,0.0,0.0,0.0,0.0,51,2,49,3.0,0.0,3.0
302241,0,0,0,0,0,0,0,49,0.0,0.0,0.0,0.0,0.0,0.0,0.0,43,0,43,22.0,0.0,22.0
212356,0,0,0,0,0,0,0,54,0.0,0.0,0.0,0.0,0.0,0.0,0.0,10,0,10,4.0,0.0,4.0
205232,2,2,0,0,0,2,9,13,0.0,0.0,0.0,0.0,0.0,0.0,0.0,23,2,21,4.0,1.0,3.0
9408361,0,0,0,0,0,0,0,1575,,,,,,,,2,0,2,,,
9901359,1,1,0,0,0,1,2,44,0.0,0.0,0.0,0.0,0.0,0.0,0.0,25,1,24,4.0,0.0,4.0
9905393,0,0,0,0,0,0,0,49,,,,,,,,6,0,6,1.0,0.0,1.0
9802343,1,1,0,0,0,1,3,4,0.0,0.0,0.0,0.0,0.0,0.0,0.0,36,1,35,9.0,0.0,9.0
108206,0,0,0,0,0,0,0,10,0.0,0.0,0.0,0.0,0.0,0.0,0.0,18,0,18,6.0,0.0,6.0
210287,2,2,0,0,0,2,16,23,1.0,1.0,0.0,0.0,0.0,1.0,10.0,19,2,17,11.0,1.0,10.0
9709326,0,0,0,0,0,0,0,132,0.0,0.0,0.0,0.0,0.0,0.0,0.0,6,0,6,4.0,0.0,4.0
9200,1,1,0,0,0,1,3,71,1.0,1.0,0.0,0.0,0.0,1.0,1.0,4,1,3,3.0,1.0,2.0
1082,0,0,0,0,0,0,0,0,0.0,0.0,0.0,0.0,0.0,0.0,0.0,24,0,24,10.0,0.0,10.0
9310213,0,0,0,0,0,0,0,1801,,,,,,,,1,0,1,,,
110076,1,1,0,0,1,0,0,590,1.0,1.0,0.0,0.0,1.0,0.0,0.0,4,1,3,2.0,0.0,2.0
9310300,1,1,0,0,1,0,0,53,0.0,0.0,0.0,0.0,0.0,0.0,0.0,10,1,9,1.0,1.0,0.0
9906440,0,0,0,0,0,0,0,965,,,,,,,,1,0,1,,,
202080,0,0,0,0,0,0,0,251,0.0,0.0,0.0,0.0,0.0,0.0,0.0,18,0,18,7.0,0.0,7.0
9912206,0,0,0,0,0,0,0,43,,,,,,,,3,0,3,,,
9903415,1,1,0,0,1,0,0,148,1.0,1.0,0.0,0.0,1.0,0.0,0.0,10,1,9,4.0,0.0,4.0
9411292,1,1,0,0,1,0,0,706,1.0,1.0,0.0,0.0,1.0,0.0,0.0,3,1,2,1.0,1.0,0.0
9305259,0,0,0,0,0,0,0,207,0.0,0.0,0.0,0.0,0.0,0.0,0.0,2,0,2,1.0,0.0,1.0
107193,0,0,0,0,0,0,0,39,0.0,0.0,0.0,0.0,0.0,0.0,0.0,19,0,19,14.0,0.0,14.0
9811409,0,0,0,0,0,0,0,708,0.0,0.0,0.0,0.0,0.0,0.0,0.0,1,0,1,1.0,0.0,1.0
109123,0,0,0,0,0,0,0,40,0.0,0.0,0.0,0.0,0.0,0.0,0.0,11,0,11,3.0,0.0,3.0
9309304,0,0,0,0,0,0,0,69,0.0,0.0,0.0,0.0,0.0,0.0,0.0,7,0,7,1.0,0.0,1.0
203162,0,0,0,0,0,0,0,309,0.0,0.0,0.0,0.0,0.0,0.0,0.0,12,0,12,3.0,0.0,3.0
9408374,0,0,0,0,0,0,0,1953,,,,,,,,1,0,1,,,
12263,1,1,0,0,1,0,0,2,0.0,0.0,0.0,0.0,0.0,0.0,0.0,13,1,12,1.0,1.0,0.0
9606258,5,4,1,1,5,0,0,233,2.0,1.0,1.0,1.0,2.0,0.0,0.0,5,5,0,1.0,1.0,0.0
111197,2,2,0,0,0,2,8,8,2.0,2.0,0.0,0.0,0.0,2.0,8.0,16,2,14,12.0,0.0,12.0
11087,0,0,0,0,0,0,0,56,0.0,0.0,0.0,0.0,0.0,0.0,0.0,20,0,20,13.0,0.0,13.0
9707350,1,1,0,0,1,0,0,325,0.0,0.0,0.0,0.0,0.0,0.0,0.0,4,1,3,2.0,0.0,2.0
9712529,0,0,0,0,0,0,0,529,0.0,0.0,0.0,0.0,0.0,0.0,0.0,8,0,8,1.0,0.0,1.0
9703376,1,1,0,0,1,0,0,100,0.0,0.0,0.0,0.0,0.0,0.0,0.0,6,1,5,1.0,1.0,0.0
1135,2,1,1,1,0,2,4,8,0.0,0.0,0.0,0.0,0.0,0.0,0.0,7,2,5,2.0,1.0,1.0
5229,1,1,0,0,0,1,3,3,1.0,1.0,0.0,0.0,0.0,1.0,3.0,19,1,18,2.0,0.0,2.0
212234,0,0,0,0,0,0,0,106,0.0,0.0,0.0,0.0,0.0,0.0,0.0,14,0,14,7.0,0.0,7.0
9808220,0,0,0,0,0,0,0,213,0.0,0.0,0.0,0.0,0.0,0.0,0.0,4,0,4,1.0,0.0,1.0
209335,0,0,0,0,0,0,0,139,0.0,0.0,0.0,0.0,0.0,0.0,0.0,6,0,6,2.0,0.0,2.0
9708308,0,0,0,0,0,0,0,0,0.0,0.0,0.0,0.0,0.0,0.0,0.0,10,0,10,5.0,0.0,5.0
103033,2,2,0,0,1,1,3,33,1.0,1.0,0.0,0.0,0.0,1.0,3.0,37,2,35,9.0,0.0,9.0
6294,0,0,0,0,0,0,0,190,0.0,0.0,0.0,0.0,0.0,0.0,0.0,14,0,14,2.0,0.0,2.0
9810414,1,1,0,0,0,1,4,78,0.0,0.0,0.0,0.0,0.0,0.0,0.0,13,1,12,2.0,1.0,1.0
9910467,0,0,0,0,0,0,0,1,0.0,0.0,0.0,0.0,0.0,0.0,0.0,21,0,21,17.0,0.0,17.0
10188,2,2,0,0,2,0,0,78,0.0,0.0,0.0,0.0,0.0,0.0,0.0,14,2,12,1.0,1.0,0.0
209112,0,0,0,0,0,0,0,131,,,,,,,,1,0,1,,,
9807363,0,0,0,0,0,0,0,248,0.0,0.0,0.0,0.0,0.0,0.0,0.0,2,0,2,1.0,0.0,1.0
202052,0,0,0,0,0,0,0,86,0.0,0.0,0.0,0.0,0.0,0.0,0.0,19,0,19,4.0,0.0,4.0
212022,0,0,0,0,0,0,0,18,0.0,0.0,0.0,0.0,0.0,0.0,0.0,19,0,19,10.0,0.0,10.0
9401286,0,0,0,0,0,0,0,768,0.0,0.0,0.0,0.0,0.0,0.0,0.0,2,0,2,1.0,0.0,1.0
201016,0,0,0,0,0,0,0,42,0.0,0.0,0.0,0.0,0.0,0.0,0.0,14,0,14,1.0,0.0,1.0
9906491,0,0,0,0,0,0,0,135,,,,,,,,1,0,1,1.0,0.0,1.0
111129,1,1,0,0,0,1,18,117,1.0,1.0,0.0,0.0,0.0,1.0,8.0,24,1,23,5.0,0.0,5.0
9805483,1,1,0,0,0,1,1,362,1.0,1.0,0.0,0.0,0.0,1.0,1.0,2,1,1,1.0,1.0,0.0
9401261,1,1,0,0,1,0,0,576,1.0,1.0,0.0,0.0,1.0,0.0,0.0,1,1,0,1.0,1.0,0.0
9710479,0,0,0,0,0,0,0,42,0.0,0.0,0.0,0.0,0.0,0.0,0.0,9,0,9,,,
9705259,0,0,0,0,0,0,0,118,,,,,,,,1,0,1,,,
107246,0,0,0,0,0,0,0,108,,,,,,,,3,0,3,2.0,0.0,2.0
302210,0,0,0,0,0,0,0,21,0.0,0.0,0.0,0.0,0.0,0.0,0.0,46,0,46,19.0,0.0,19.0
9706222,0,0,0,0,0,0,0,238,0.0,0.0,0.0,0.0,0.0,0.0,0.0,7,0,7,1.0,0.0,1.0
210101,0,0,0,0,0,0,0,115,0.0,0.0,0.0,0.0,0.0,0.0,0.0,5,0,5,2.0,0.0,2.0
108154,0,0,0,0,0,0,0,26,0.0,0.0,0.0,0.0,0.0,0.0,0.0,17,0,17,3.0,0.0,3.0
9611214,0,0,0,0,0,0,0,105,0.0,0.0,0.0,0.0,0.0,0.0,0.0,7,0,7,4.0,0.0,4.0
9407295,0,0,0,0,0,0,0,1038,,,,,,,,2,0,2,,,
211089,1,1,0,0,0,1,1,30,0.0,0.0,0.0,0.0,0.0,0.0,0.0,11,1,10,7.0,0.0,7.0
4149,1,1,0,0,0,1,5,421,1.0,1.0,0.0,0.0,0.0,1.0,3.0,12,1,11,4.0,1.0,3.0
9712490,0,0,0,0,0,0,0,137,0.0,0.0,0.0,0.0,0.0,0.0,0.0,2,0,2,2.0,0.0,2.0
9807467,0,0,0,0,0,0,0,154,0.0,0.0,0.0,0.0,0.0,0.0,0.0,2,0,2,,,
208221,0,0,0,0,0,0,0,52,0.0,0.0,0.0,0.0,0.0,0.0,0.0,17,0,17,7.0,0.0,7.0
209288,0,0,0,0,0,0,0,217,0.0,0.0,0.0,0.0,0.0,0.0,0.0,4,0,4,1.0,0.0,1.0
101069,0,0,0,0,0,0,0,132,0.0,0.0,0.0,0.0,0.0,0.0,0.0,7,0,7,4.0,0.0,4.0
208104,0,0,0,0,0,0,0,17,0.0,0.0,0.0,0.0,0.0,0.0,0.0,34,0,34,7.0,0.0,7.0
209018,0,0,0,0,0,0,0,0,0.0,0.0,0.0,0.0,0.0,0.0,0.0,58,0,58,2.0,0.0,2.0
12104,1,1,0,0,0,1,1,45,0.0,0.0,0.0,0.0,0.0,0.0,0.0,15,1,14,4.0,0.0,4.0
301058,1,1,0,0,0,1,7,83,1.0,1.0,0.0,0.0,0.0,1.0,4.0,18,1,17,7.0,1.0,6.0
9802265,1,1,0,0,0,1,3,204,1.0,1.0,0.0,0.0,0.0,1.0,3.0,10,1,9,4.0,1.0,3.0
9809303,0,0,0,0,0,0,0,162,0.0,0.0,0.0,0.0,0.0,0.0,0.0,2,0,2,1.0,0.0,1.0
9611365,0,0,0,0,0,0,0,332,0.0,0.0,0.0,0.0,0.0,0.0,0.0,10,0,10,6.0,0.0,6.0
9609513,0,0,0,0,0,0,0,422,0.0,0.0,0.0,0.0,0.0,0.0,0.0,10,0,10,1.0,0.0,1.0
112269,0,0,0,0,0,0,0,177,0.0,0.0,0.0,0.0,0.0,0.0,0.0,5,0,5,,,
211193,1,1,0,0,0,1,4,109,1.0,1.0,0.0,0.0,0.0,1.0,4.0,23,1,22,11.0,0.0,11.0
210025,0,0,0,0,0,0,0,1019,0.0,0.0,0.0,0.0,0.0,0.0,0.0,1,0,1,,,
9502367,0,0,0,0,0,0,0,323,0.0,0.0,0.0,0.0,0.0,0.0,0.0,1,0,1,1.0,0.0,1.0
9701403,1,1,0,0,1,0,0,694,1.0,1.0,0.0,0.0,1.0,0.0,0.0,1,1,0,1.0,1.0,0.0
9707325,1,1,0,0,0,1,2,332,1.0,1.0,0.0,0.0,0.0,1.0,1.0,8,1,7,4.0,0.0,4.0
9907252,0,0,0,0,0,0,0,56,0.0,0.0,0.0,0.0,0.0,0.0,0.0,10,0,10,2.0,0.0,2.0
9605427,0,0,0,0,0,0,0,1577,0.0,0.0,0.0,0.0,0.0,0.0,0.0,6,0,6,5.0,0.0,5.0
302090,0,0,0,0,0,0,0,65,0.0,0.0,0.0,0.0,0.0,0.0,0.0,12,0,12,9.0,0.0,9.0
104231,1,1,0,0,1,0,0,730,1.0,1.0,0.0,0.0,1.0,0.0,0.0,1,1,0,1.0,1.0,0.0
9910354,0,0,0,0,0,0,0,15,0.0,0.0,0.0,0.0,0.0,0.0,0.0,12,0,12,3.0,0.0,3.0
9902248,0,0,0,0,0,0,0,11,0.0,0.0,0.0,0.0,0.0,0.0,0.0,8,0,8,1.0,0.0,1.0
9502202,0,0,0,0,0,0,0,1858,,,,,,,,1,0,1,1.0,0.0,1.0
9807365,1,1,0,0,0,1,1,222,0.0,0.0,0.0,0.0,0.0,0.0,0.0,7,1,6,5.0,0.0,5.0
9806527,0,0,0,0,0,0,0,97,0.0,0.0,0.0,0.0,0.0,0.0,0.0,4,0,4,2.0,0.0,2.0
9512255,1,1,0,0,1,0,0,139,0.0,0.0,0.0,0.0,0.0,0.0,0.0,3,1,2,1.0,1.0,0.0
9610240,0,0,0,0,0,0,0,5,0.0,0.0,0.0,0.0,0.0,0.0,0.0,5,0,5,1.0,0.0,1.0
2025,1,1,0,0,0,1,2,1,0.0,0.0,0.0,0.0,0.0,0.0,0.0,21,1,20,4.0,0.0,4.0
207349,0,0,0,0,0,0,0,52,,,,,,,,4,0,4,,,
9803330,0,0,0,0,0,0,0,36,0.0,0.0,0.0,0.0,0.0,0.0,0.0,17,0,17,3.0,0.0,3.0
211364,0,0,0,0,0,0,0,2049,,,,,,,,1,0,1,,,
9910486,0,0,0,0,0,0,0,321,0.0,0.0,0.0,0.0,0.0,0.0,0.0,11,0,11,4.0,0.0,4.0
12038,0,0,0,0,0,0,0,60,0.0,0.0,0.0,0.0,0.0,0.0,0.0,22,0,22,8.0,0.0,8.0
9907563,0,0,0,0,0,0,0,356,0.0,0.0,0.0,0.0,0.0,0.0,0.0,3,0,3,1.0,0.0,1.0
9410263,0,0,0,0,0,0,0,592,0.0,0.0,0.0,0.0,0.0,0.0,0.0,1,0,1,1.0,0.0,1.0
204248,0,0,0,0,0,0,0,84,0.0,0.0,0.0,0.0,0.0,0.0,0.0,10,0,10,2.0,0.0,2.0
205132,0,0,0,0,0,0,0,1823,0.0,0.0,0.0,0.0,0.0,0.0,0.0,8,0,8,1.0,0.0,1.0
10316,1,1,0,0,1,0,0,1757,,,,,,,,1,1,0,,,
111361,0,0,0,0,0,0,0,84,0.0,0.0,0.0,0.0,0.0,0.0,0.0,11,0,11,3.0,0.0,3.0
302037,0,0,0,0,0,0,0,1,0.0,0.0,0.0,0.0,0.0,0.0,0.0,7,0,7,2.0,0.0,2.0
9409431,0,0,0,0,0,0,0,272,0.0,0.0,0.0,0.0,0.0,0.0,0.0,1,0,1,1.0,0.0,1.0
301036,0,0,0,0,0,0,0,80,0.0,0.0,0.0,0.0,0.0,0.0,0.0,4,0,4,3.0,0.0,3.0
9307227,0,0,0,0,0,0,0,1375,0.0,0.0,0.0,0.0,0.0,0.0,0.0,1,0,1,1.0,0.0,1.0
108169,0,0,0,0,0,0,0,205,0.0,0.0,0.0,0.0,0.0,0.0,0.0,4,0,4,2.0,0.0,2.0
9810540,1,1,0,0,0,1,8,68,1.0,1.0,0.0,0.0,0.0,1.0,6.0,13,1,12,5.0,1.0,4.0
9910434,0,0,0,0,0,0,0,78,0.0,0.0,0.0,0.0,0.0,0.0,0.0,10,0,10,1.0,0.0,1.0
9706517,0,0,0,0,0,0,0,30,,,,,,,,4,0,4,,,
9226,0,0,0,0,0,0,0,301,0.0,0.0,0.0,0.0,0.0,0.0,0.0,3,0,3,1.0,0.0,1.0
207019,0,0,0,0,0,0,0,16,0.0,0.0,0.0,0.0,0.0,0.0,0.0,5,0,5,5.0,0.0,5.0
9611447,0,0,0,0,0,0,0,27,0.0,0.0,0.0,0.0,0.0,0.0,0.0,8,0,8,2.0,0.0,2.0
9310274,0,0,0,0,0,0,0,48,,,,,,,,2,0,2,,,
212027,1,1,0,0,0,1,10,27,1.0,1.0,0.0,0.0,0.0,1.0,10.0,12,1,11,11.0,1.0,10.0
207173,1,1,0,0,0,1,5,115,0.0,0.0,0.0,0.0,0.0,0.0,0.0,24,1,23,7.0,0.0,7.0
6330,0,0,0,0,0,0,0,197,0.0,0.0,0.0,0.0,0.0,0.0,0.0,2,0,2,2.0,0.0,2.0
107028,0,0,0,0,0,0,0,11,0.0,0.0,0.0,0.0,0.0,0.0,0.0,25,0,25,10.0,0.0,10.0
8213,0,0,0,0,0,0,0,2,0.0,0.0,0.0,0.0,0.0,0.0,0.0,26,0,26,2.0,0.0,2.0
106043,0,0,0,0,0,0,0,138,0.0,0.0,0.0,0.0,0.0,0.0,0.0,6,0,6,3.0,0.0,3.0
9605343,0,0,0,0,0,0,0,444,0.0,0.0,0.0,0.0,0.0,0.0,0.0,2,0,2,1.0,0.0,1.0
210201,1,1,0,0,0,1,7,24,0.0,0.0,0.0,0.0,0.0,0.0,0.0,28,1,27,21.0,0.0,21.0
9405280,0,0,0,0,0,0,0,120,,,,,,,,1,0,1,,,
9801299,0,0,0,0,0,0,0,1059,,,,,,,,1,0,1,,,
105075,0,0,0,0,0,0,0,158,0.0,0.0,0.0,0.0,0.0,0.0,0.0,3,0,3,1.0,0.0,1.0
9807328,0,0,0,0,0,0,0,9,0.0,0.0,0.0,0.0,0.0,0.0,0.0,11,0,11,2.0,0.0,2.0
112053,0,0,0,0,0,0,0,1098,0.0,0.0,0.0,0.0,0.0,0.0,0.0,3,0,3,,,
9805437,0,0,0,0,0,0,0,13,0.0,0.0,0.0,0.0,0.0,0.0,0.0,6,0,6,2.0,0.0,2.0
9808337,0,0,0,0,0,0,0,111,0.0,0.0,0.0,0.0,0.0,0.0,0.0,6,0,6,5.0,0.0,5.0
11169,0,0,0,0,0,0,0,242,0.0,0.0,0.0,0.0,0.0,0.0,0.0,12,0,12,4.0,0.0,4.0
9402355,0,0,0,0,0,0,0,0,0.0,0.0,0.0,0.0,0.0,0.0,0.0,11,0,11,4.0,0.0,4.0
10216,0,0,0,0,0,0,0,16,0.0,0.0,0.0,0.0,0.0,0.0,0.0,13,0,13,5.0,0.0,5.0
9311315,0,0,0,0,0,0,0,205,0.0,0.0,0.0,0.0,0.0,0.0,0.0,1,0,1,1.0,0.0,1.0
9512357,0,0,0,0,0,0,0,994,,,,,,,,1,0,1,,,
210082,0,0,0,0,0,0,0,39,0.0,0.0,0.0,0.0,0.0,0.0,0.0,33,0,33,12.0,0.0,12.0
9211239,46,18,28,66,46,0,0,83,10.0,1.0,9.0,21.0,10.0,0.0,0.0,46,46,0,4.0,4.0,0.0
9210215,7,5,2,5,7,0,0,34,1.0,1.0,0.0,0.0,1.0,0.0,0.0,7,7,0,1.0,1.0,0.0
9042,6,4,2,2,0,6,58,1,3.0,1.0,2.0,2.0,0.0,3.0,15.0,26,6,20,9.0,4.0,5.0
9804363,155,20,135,706,17,138,744,1,29.0,9.0,20.0,50.0,0.0,29.0,170.0,213,155,58,21.0,21.0,0.0
9306320,464,98,366,1617,316,148,283,6,66.0,10.0,56.0,285.0,29.0,37.0,68.0,479,464,15,31.0,29.0,2.0
9407342,19,5,14,43,2,17,24,58,5.0,5.0,0.0,0.0,0.0,5.0,9.0,21,19,2,7.0,6.0,1.0
9908362,71,15,56,214,71,0,0,6,15.0,5.0,10.0,24.0,15.0,0.0,0.0,71,71,0,9.0,9.0,0.0
9806308,120,15,105,594,17,103,681,7,41.0,6.0,35.0,153.0,0.0,41.0,402.0,156,120,36,42.0,23.0,19.0
9708222,65,7,58,257,2,63,243,1,25.0,3.0,22.0,119.0,0.0,25.0,77.0,90,65,25,4.0,4.0,0.0
105306,12,8,4,6,0,12,56,34,5.0,2.0,3.0,5.0,0.0,5.0,19.0,70,12,58,10.0,4.0,6.0
9304219,3,1,2,2,3,0,0,538,2.0,1.0,1.0,1.0,2.0,0.0,0.0,3,3,0,3.0,3.0,0.0
204087,18,8,10,19,4,14,37,4,5.0,1.0,4.0,7.0,0.0,5.0,9.0,55,18,37,6.0,6.0,0.0
9505409,49,9,40,137,34,15,22,33,16.0,1.0,15.0,35.0,16.0,0.0,0.0,53,49,4,11.0,11.0,0.0
9808430,11,3,8,13,1,10,38,19,3.0,3.0,0.0,0.0,0.0,3.0,11.0,50,11,39,12.0,0.0,12.0
2036,61,16,45,175,10,51,248,4,24.0,5.0,19.0,58.0,2.0,22.0,96.0,87,61,26,17.0,7.0,10.0
9908278,1,1,0,0,1,0,0,196,0.0,0.0,0.0,0.0,0.0,0.0,0.0,5,1,4,1.0,0.0,1.0
9402326,47,8,39,84,13,34,77,6,20.0,6.0,14.0,29.0,6.0,14.0,19.0,53,47,6,9.0,8.0,1.0
9411337,13,5,8,21,6,7,11,403,5.0,2.0,3.0,5.0,5.0,0.0,0.0,20,13,7,2.0,2.0,0.0
9610368,16,4,12,25,0,16,47,33,7.0,1.0,6.0,8.0,0.0,7.0,20.0,25,16,9,7.0,4.0,3.0
9707229,10,2,8,21,0,10,19,48,8.0,2.0,6.0,11.0,0.0,8.0,13.0,14,10,4,2.0,1.0,1.0
9806486,27,6,21,72,0,27,167,48,18.0,3.0,15.0,46.0,0.0,18.0,97.0,54,27,27,22.0,14.0,8.0
9906462,18,1,17,46,1,17,82,48,12.0,1.0,11.0,28.0,0.0,12.0,56.0,29,18,11,19.0,12.0,7.0
210108,2,2,0,0,0,2,25,4,1.0,1.0,0.0,0.0,0.0,1.0,11.0,27,2,25,12.0,1.0,11.0
104024,33,8,25,72,24,9,13,121,7.0,1.0,6.0,16.0,7.0,0.0,0.0,40,33,7,4.0,4.0,0.0
9311336,27,7,20,48,27,0,0,35,12.0,3.0,9.0,20.0,12.0,0.0,0.0,27,27,0,2.0,2.0,0.0
9705383,13,10,3,4,3,10,31,5,4.0,3.0,1.0,1.0,0.0,4.0,8.0,19,13,6,2.0,2.0,0.0
9903369,15,2,13,24,2,13,98,26,11.0,2.0,9.0,14.0,0.0,11.0,95.0,26,15,11,14.0,5.0,9.0
9906419,32,7,25,52,10,22,59,4,11.0,3.0,8.0,13.0,3.0,8.0,23.0,43,32,11,13.0,9.0,4.0
9907305,15,3,12,20,0,15,78,163,5.0,1.0,4.0,4.0,0.0,5.0,25.0,32,15,17,11.0,3.0,8.0
101150,5,2,3,4,0,5,24,36,4.0,2.0,2.0,2.0,0.0,4.0,12.0,14,5,9,7.0,3.0,4.0
9810432,18,2,16,49,0,18,71,86,16.0,2.0,14.0,38.0,0.0,16.0,64.0,25,18,7,17.0,12.0,5.0
9309248,40,8,32,75,32,8,8,93,12.0,4.0,8.0,15.0,7.0,5.0,5.0,42,40,2,8.0,8.0,0.0
107081,45,10,35,122,8,37,103,4,12.0,3.0,9.0,15.0,3.0,9.0,12.0,61,45,16,10.0,9.0,1.0
203034,16,4,12,20,2,14,100,2,8.0,1.0,7.0,14.0,0.0,8.0,51.0,45,16,29,16.0,8.0,8.0
9405265,1,1,0,0,1,0,0,511,1.0,1.0,0.0,0.0,1.0,0.0,0.0,1,1,0,1.0,1.0,0.0
9209285,27,17,10,21,9,18,22,207,5.0,3.0,2.0,3.0,0.0,5.0,5.0,30,27,3,4.0,4.0,0.0
9509305,2,1,1,1,0,2,3,149,1.0,1.0,0.0,0.0,0.0,1.0,2.0,5,2,3,1.0,0.0,1.0
9504413,49,7,42,191,8,41,83,25,19.0,1.0,18.0,72.0,2.0,17.0,31.0,52,49,3,19.0,17.0,2.0
9506256,86,7,79,558,17,69,176,23,43.0,2.0,41.0,250.0,0.0,43.0,119.0,91,86,5,31.0,27.0,4.0
9410385,29,3,26,120,29,0,0,71,23.0,1.0,22.0,109.0,23.0,0.0,0.0,29,29,0,19.0,19.0,0.0
9512378,48,17,31,91,20,28,85,0,7.0,7.0,0.0,0.0,0.0,7.0,23.0,60,48,12,12.0,5.0,7.0
9407247,160,7,153,1390,160,0,0,21,97.0,3.0,94.0,1038.0,97.0,0.0,0.0,160,160,0,54.0,54.0,0.0
9408315,38,7,31,126,8,30,77,12,8.0,1.0,7.0,16.0,0.0,8.0,19.0,50,38,12,11.0,8.0,3.0
9408397,30,9,21,42,11,19,19,0,13.0,6.0,7.0,7.0,4.0,9.0,9.0,31,30,1,9.0,8.0,1.0
2096,8,4,4,6,0,8,103,0,4.0,3.0,1.0,1.0,0.0,4.0,58.0,34,8,26,19.0,4.0,15.0
9712290,153,12,141,1171,153,0,0,0,71.0,1.0,70.0,699.0,71.0,0.0,0.0,153,153,0,43.0,43.0,0.0
9811379,59,9,50,228,0,59,353,3,48.0,7.0,41.0,176.0,0.0,48.0,290.0,90,59,31,35.0,25.0,10.0
9807235,169,8,161,1374,39,130,301,3,91.0,4.0,87.0,957.0,15.0,76.0,145.0,188,169,19,46.0,43.0,3.0
9606360,41,5,36,129,31,10,12,0,32.0,2.0,30.0,108.0,32.0,0.0,0.0,43,41,2,23.0,23.0,0.0
9305205,27,10,17,41,11,16,29,0,14.0,8.0,6.0,12.0,1.0,13.0,25.0,30,27,3,8.0,6.0,2.0
9808355,65,6,59,346,2,63,630,3,42.0,5.0,37.0,238.0,0.0,42.0,394.0,110,65,45,41.0,24.0,17.0
9906469,180,20,160,839,64,116,260,0,34.0,2.0,32.0,134.0,23.0,11.0,14.0,195,180,15,12.0,12.0,0.0
9903481,27,3,24,112,10,17,54,0,22.0,1.0,21.0,99.0,22.0,0.0,0.0,40,27,13,4.0,2.0,2.0
9711400,27,7,20,82,5,22,159,0,18.0,4.0,14.0,61.0,2.0,16.0,121.0,66,27,39,22.0,9.0,13.0
9709439,39,9,30,90,8,31,87,0,9.0,2.0,7.0,19.0,5.0,4.0,8.0,54,39,15,4.0,2.0,2.0
9903252,22,10,12,22,3,19,137,0,5.0,2.0,3.0,5.0,0.0,5.0,70.0,54,22,32,8.0,4.0,4.0
9902283,69,11,58,291,0,69,808,3,39.0,3.0,36.0,202.0,0.0,39.0,555.0,125,69,56,50.0,23.0,27.0
9910551,15,7,8,14,1,14,74,8,11.0,5.0,6.0,11.0,1.0,10.0,32.0,34,15,19,14.0,8.0,6.0
9409285,41,7,34,132,2,39,88,10,9.0,2.0,7.0,26.0,9.0,0.0,0.0,47,41,6,11.0,10.0,1.0
9709373,7,1,6,19,7,0,0,215,4.0,1.0,3.0,5.0,4.0,0.0,0.0,7,7,0,4.0,4.0,0.0
9211293,11,4,7,16,11,0,0,242,7.0,3.0,4.0,9.0,7.0,0.0,0.0,11,11,0,4.0,4.0,0.0
104091,15,3,12,20,0,15,80,81,13.0,2.0,11.0,18.0,0.0,13.0,72.0,29,15,14,17.0,7.0,10.0
9502414,10,5,5,8,2,8,52,75,0.0,0.0,0.0,0.0,0.0,0.0,0.0,36,10,26,10.0,5.0,5.0
9801321,11,3,8,24,5,6,9,187,8.0,2.0,6.0,20.0,2.0,6.0,9.0,15,11,4,10.0,8.0,2.0
9607310,77,11,66,410,9,68,167,46,49.0,3.0,46.0,291.0,1.0,48.0,114.0,83,77,6,20.0,16.0,4.0
9404218,11,5,6,7,11,0,0,137,5.0,2.0,3.0,4.0,5.0,0.0,0.0,12,11,1,3.0,3.0,0.0
9401208,44,11,33,81,10,34,69,46,7.0,6.0,1.0,2.0,0.0,7.0,13.0,49,44,5,9.0,6.0,3.0
9506319,7,3,4,6,0,7,23,3,3.0,2.0,1.0,1.0,0.0,3.0,10.0,13,7,6,1.0,1.0,0.0
9707517,10,5,5,9,1,9,28,63,2.0,2.0,0.0,0.0,0.0,2.0,4.0,21,10,11,9.0,1.0,8.0
9609342,30,5,25,58,3,27,154,10,12.0,1.0,11.0,25.0,1.0,11.0,51.0,59,30,29,10.0,2.0,8.0
9302212,14,3,11,20,14,0,0,46,9.0,1.0,8.0,16.0,9.0,0.0,0.0,14,14,0,2.0,2.0,0.0
9606342,89,2,87,430,28,61,145,42,43.0,1.0,42.0,211.0,6.0,37.0,84.0,99,89,10,23.0,21.0,2.0
9501247,29,6,23,50,6,23,45,10,11.0,1.0,10.0,21.0,1.0,10.0,15.0,33,29,4,9.0,7.0,2.0
9303280,48,13,35,114,48,0,0,75,20.0,9.0,11.0,27.0,20.0,0.0,0.0,48,48,0,15.0,15.0,0.0
9609451,23,1,22,100,9,14,44,12,19.0,1.0,18.0,88.0,19.0,0.0,0.0,35,23,12,5.0,5.0,0.0
9705229,10,5,5,6,1,9,31,36,7.0,3.0,4.0,4.0,0.0,7.0,25.0,18,10,8,3.0,1.0,2.0
9308238,5,4,1,1,3,2,2,329,1.0,1.0,0.0,0.0,1.0,0.0,0.0,7,5,2,1.0,1.0,0.0
9801271,261,74,187,728,48,213,1423,5,36.0,20.0,16.0,42.0,0.0,36.0,568.0,373,261,112,53.0,15.0,38.0
4247,38,3,35,173,0,38,287,34,33.0,2.0,31.0,155.0,0.0,33.0,257.0,73,38,35,34.0,20.0,14.0
9404281,72,11,61,446,31,41,67,1,47.0,3.0,44.0,337.0,18.0,29.0,50.0,74,72,2,29.0,27.0,2.0
9706512,31,2,29,72,0,31,119,1,18.0,2.0,16.0,41.0,0.0,18.0,63.0,46,31,15,19.0,14.0,5.0
104304,52,6,46,165,4,48,139,23,31.0,2.0,29.0,119.0,1.0,30.0,73.0,72,52,20,27.0,23.0,4.0
108240,19,1,18,44,0,19,171,34,17.0,1.0,16.0,35.0,0.0,17.0,149.0,55,19,36,15.0,6.0,9.0
9812278,15,3,12,38,2,13,95,1,14.0,2.0,12.0,38.0,1.0,13.0,95.0,27,15,12,20.0,12.0,8.0
9408406,187,15,172,1154,144,43,48,55,66.0,5.0,61.0,543.0,66.0,0.0,0.0,190,187,3,37.0,37.0,0.0
9611285,17,5,12,24,9,8,26,12,5.0,1.0,4.0,5.0,2.0,3.0,4.0,23,17,6,6.0,6.0,0.0
9706268,14,2,12,37,1,13,57,158,11.0,1.0,10.0,33.0,0.0,11.0,27.0,25,14,11,14.0,11.0,3.0
9601234,75,10,65,212,66,9,30,67,19.0,1.0,18.0,76.0,19.0,0.0,0.0,82,75,7,15.0,15.0,0.0
9402358,23,5,18,54,1,22,52,93,18.0,4.0,14.0,43.0,1.0,17.0,40.0,27,23,4,19.0,16.0,3.0
9609395,18,2,16,45,1,17,36,69,2.0,1.0,1.0,1.0,0.0,2.0,8.0,23,18,5,7.0,3.0,4.0
9810488,3,2,1,1,1,2,2,34,0.0,0.0,0.0,0.0,0.0,0.0,0.0,6,3,3,1.0,0.0,1.0
104280,9,3,6,14,0,9,40,6,4.0,2.0,2.0,2.0,1.0,3.0,5.0,26,9,17,1.0,1.0,0.0
9703277,37,4,33,104,8,29,46,6,20.0,1.0,19.0,52.0,2.0,18.0,32.0,40,37,3,9.0,8.0,1.0
9812508,7,3,4,8,0,7,40,1,6.0,2.0,4.0,8.0,0.0,6.0,28.0,19,7,12,2.0,1.0,1.0
9506313,21,7,14,23,6,15,17,58,12.0,4.0,8.0,14.0,2.0,10.0,12.0,24,21,3,3.0,2.0,1.0
9310326,48,7,41,158,46,2,2,1,14.0,3.0,11.0,37.0,14.0,0.0,0.0,49,48,1,3.0,3.0,0.0
9608231,35,3,32,99,16,19,41,1,10.0,1.0,9.0,22.0,2.0,8.0,18.0,62,35,27,9.0,8.0,1.0
9908382,26,7,19,42,0,26,254,32,8.0,2.0,6.0,12.0,0.0,8.0,43.0,70,26,44,14.0,8.0,6.0
9806515,13,4,9,17,3,10,27,141,7.0,2.0,5.0,9.0,0.0,7.0,13.0,28,13,15,7.0,4.0,3.0
9901398,2,2,0,0,2,0,0,300,0.0,0.0,0.0,0.0,0.0,0.0,0.0,6,2,4,3.0,0.0,3.0
9610280,51,28,23,39,24,27,62,59,12.0,8.0,4.0,4.0,3.0,9.0,13.0,61,51,10,8.0,7.0,1.0
9604284,24,4,20,57,1,23,42,40,12.0,2.0,10.0,28.0,0.0,12.0,24.0,28,24,4,13.0,11.0,2.0
9804294,79,14,65,241,3,76,505,7,17.0,5.0,12.0,35.0,0.0,17.0,125.0,146,79,67,26.0,2.0,24.0
9404253,37,17,20,45,11,26,71,10,10.0,6.0,4.0,8.0,0.0,10.0,29.0,46,37,9,8.0,5.0,3.0
9808411,14,7,7,10,12,2,6,212,3.0,1.0,2.0,3.0,3.0,0.0,0.0,19,14,5,3.0,3.0,0.0
9603412,37,11,26,74,7,30,106,12,12.0,4.0,8.0,22.0,1.0,11.0,43.0,51,37,14,14.0,7.0,7.0
9312296,76,12,64,796,1,75,367,15,66.0,7.0,59.0,742.0,0.0,66.0,340.0,91,76,15,60.0,51.0,9.0
9510271,19,3,16,59,2,17,144,15,15.0,1.0,14.0,46.0,0.0,15.0,130.0,50,19,31,21.0,11.0,10.0
9803408,14,6,8,12,6,8,10,76,8.0,4.0,4.0,6.0,8.0,0.0,0.0,16,14,2,7.0,7.0,0.0
9311267,4,2,2,2,4,0,0,371,2.0,1.0,1.0,1.0,2.0,0.0,0.0,5,4,1,2.0,2.0,0.0
9808429,9,4,5,11,1,8,45,80,6.0,3.0,3.0,5.0,0.0,6.0,21.0,35,9,26,7.0,0.0,7.0
9803322,5,2,3,4,0,5,5,151,3.0,2.0,1.0,1.0,0.0,3.0,3.0,7,5,2,2.0,2.0,0.0
9602203,10,6,4,4,8,2,4,30,1.0,1.0,0.0,0.0,0.0,1.0,2.0,23,10,13,2.0,0.0,2.0
9607393,30,26,4,10,30,0,0,98,2.0,2.0,0.0,0.0,2.0,0.0,0.0,30,30,0,2.0,2.0,0.0
9809341,24,4,20,46,4,20,33,126,14.0,1.0,13.0,22.0,2.0,12.0,18.0,28,24,4,11.0,9.0,2.0
9603214,29,8,21,117,3,26,38,11,19.0,3.0,16.0,86.0,0.0,19.0,30.0,31,29,2,19.0,17.0,2.0
9605357,72,3,69,527,43,29,30,16,51.0,1.0,50.0,388.0,31.0,20.0,20.0,74,72,2,25.0,25.0,0.0
9504245,33,12,21,63,27,6,6,17,12.0,4.0,8.0,24.0,11.0,1.0,1.0,35,33,2,9.0,9.0,0.0
9402209,43,17,26,66,32,11,11,57,23.0,7.0,16.0,48.0,13.0,10.0,10.0,44,43,1,12.0,11.0,1.0
9812433,3,3,0,0,0,3,27,151,1.0,1.0,0.0,0.0,0.0,1.0,12.0,18,3,15,13.0,1.0,12.0
9605225,6,1,5,8,0,6,13,30,2.0,1.0,1.0,1.0,0.0,2.0,4.0,13,6,7,6.0,4.0,2.0
9709360,31,9,22,42,1,30,111,151,11.0,3.0,8.0,14.0,0.0,11.0,55.0,41,31,10,17.0,9.0,8.0
9707326,44,5,39,185,1,43,173,30,32.0,1.0,31.0,158.0,0.0,32.0,138.0,53,44,9,31.0,23.0,8.0
9405359,18,11,7,14,4,14,50,86,2.0,2.0,0.0,0.0,0.0,2.0,5.0,49,18,31,9.0,1.0,8.0
9404239,25,9,16,43,1,24,56,35,10.0,3.0,7.0,17.0,1.0,9.0,9.0,33,25,8,8.0,7.0,1.0
9710281,17,7,10,28,0,17,31,59,7.0,4.0,3.0,6.0,0.0,7.0,11.0,22,17,5,7.0,4.0,3.0
9804275,27,10,17,65,2,25,251,6,5.0,1.0,4.0,9.0,0.0,5.0,110.0,131,27,104,48.0,1.0,47.0
9408380,22,1,21,79,3,19,43,24,14.0,1.0,13.0,44.0,14.0,0.0,0.0,26,22,4,4.0,4.0,0.0
9407394,73,10,63,292,28,45,211,6,35.0,3.0,32.0,168.0,3.0,32.0,155.0,86,73,13,29.0,22.0,7.0
9311215,42,4,38,136,5,37,89,6,17.0,2.0,15.0,45.0,1.0,16.0,45.0,45,42,3,9.0,9.0,0.0
9312235,47,11,36,192,45,2,2,87,34.0,5.0,29.0,161.0,34.0,0.0,0.0,49,47,2,26.0,26.0,0.0
9402218,16,7,9,30,4,12,16,96,14.0,5.0,9.0,30.0,2.0,12.0,16.0,18,16,2,14.0,12.0,2.0
9404248,51,7,44,162,41,10,10,8,12.0,1.0,11.0,33.0,12.0,0.0,0.0,52,51,1,12.0,12.0,0.0
9310342,6,6,0,0,6,0,0,225,2.0,2.0,0.0,0.0,2.0,0.0,0.0,6,6,0,1.0,1.0,0.0
9607355,80,8,72,397,48,32,32,45,45.0,1.0,44.0,280.0,20.0,25.0,25.0,81,80,1,33.0,32.0,1.0
9702219,5,3,2,2,0,5,20,40,3.0,2.0,1.0,1.0,0.0,3.0,16.0,12,5,7,1.0,1.0,0.0
9811401,2,2,0,0,0,2,7,45,1.0,1.0,0.0,0.0,0.0,1.0,3.0,9,2,7,4.0,1.0,3.0
9206239,16,5,11,35,16,0,0,22,10.0,2.0,8.0,23.0,10.0,0.0,0.0,16,16,0,2.0,2.0,0.0
9305241,49,5,44,166,49,0,0,22,21.0,2.0,19.0,87.0,21.0,0.0,0.0,49,49,0,17.0,17.0,0.0
9804255,61,7,54,251,3,58,449,15,42.0,4.0,38.0,192.0,1.0,41.0,367.0,88,61,27,36.0,17.0,19.0
9208232,2,2,0,0,2,0,0,2053,,,,,,,,2,2,0,,,
9611328,2,2,0,0,0,2,2,88,0.0,0.0,0.0,0.0,0.0,0.0,0.0,6,2,4,1.0,0.0,1.0
9811364,14,5,9,18,9,5,5,357,9.0,4.0,5.0,13.0,9.0,0.0,0.0,17,14,3,7.0,7.0,0.0
9807278,143,44,99,299,33,110,515,42,20.0,11.0,9.0,13.0,0.0,20.0,125.0,225,143,82,19.0,7.0,12.0
9805485,7,2,5,8,2,5,7,21,6.0,1.0,5.0,8.0,3.0,3.0,4.0,13,7,6,1.0,0.0,1.0
9704338,51,16,35,146,28,23,40,36,20.0,3.0,17.0,94.0,20.0,0.0,0.0,56,51,5,18.0,18.0,0.0
9706526,41,7,34,148,8,33,64,43,12.0,2.0,10.0,24.0,5.0,7.0,7.0,49,41,8,15.0,11.0,4.0
9811382,45,7,38,142,8,37,146,43,18.0,1.0,17.0,67.0,0.0,18.0,74.0,56,45,11,16.0,12.0,4.0
9908349,12,9,3,4,1,11,72,66,2.0,2.0,0.0,0.0,0.0,2.0,7.0,34,12,22,3.0,1.0,2.0
6320,1,1,0,0,0,1,2,334,0.0,0.0,0.0,0.0,0.0,0.0,0.0,5,1,4,2.0,0.0,2.0
9403342,19,7,12,31,19,0,0,105,11.0,2.0,9.0,22.0,11.0,0.0,0.0,19,19,0,10.0,10.0,0.0
2209,54,4,50,276,0,54,837,20,52.0,4.0,48.0,269.0,0.0,52.0,817.0,114,54,60,75.0,31.0,44.0
9808444,70,2,68,882,0,70,243,20,62.0,2.0,60.0,846.0,0.0,62.0,216.0,74,70,4,55.0,51.0,4.0
9810514,59,4,55,623,0,59,228,20,54.0,2.0,52.0,607.0,0.0,54.0,208.0,63,59,4,49.0,45.0,4.0
9304280,5,4,1,1,5,0,0,273,1.0,1.0,0.0,0.0,1.0,0.0,0.0,5,5,0,1.0,1.0,0.0
9411370,1,1,0,0,0,1,1,116,0.0,0.0,0.0,0.0,0.0,0.0,0.0,5,1,4,,,
11273,6,2,4,5,0,6,53,20,2.0,1.0,1.0,1.0,0.0,2.0,13.0,33,6,27,10.0,2.0,8.0
9912519,6,2,4,6,1,5,14,147,4.0,1.0,3.0,5.0,1.0,3.0,10.0,28,6,22,8.0,4.0,4.0
9906548,9,5,4,4,5,4,4,64,3.0,1.0,2.0,2.0,3.0,0.0,0.0,13,9,4,4.0,3.0,1.0
212228,5,1,4,5,0,5,20,37,5.0,1.0,4.0,5.0,0.0,5.0,20.0,11,5,6,9.0,5.0,4.0
211009,2,2,0,0,1,1,1,121,0.0,0.0,0.0,0.0,0.0,0.0,0.0,23,2,21,5.0,0.0,5.0
9605365,7,2,5,8,0,7,24,6,6.0,1.0,5.0,8.0,0.0,6.0,16.0,13,7,6,9.0,6.0,3.0
9208201,17,7,10,21,17,0,0,67,8.0,2.0,6.0,15.0,8.0,0.0,0.0,17,17,0,3.0,3.0,0.0
9405233,94,11,83,287,59,35,46,10,16.0,1.0,15.0,26.0,6.0,10.0,10.0,98,94,4,14.0,14.0,0.0
9805289,21,6,15,40,0,21,179,5,11.0,3.0,8.0,20.0,0.0,11.0,130.0,42,21,21,26.0,8.0,18.0
9210228,44,13,31,105,44,0,0,4,16.0,1.0,15.0,48.0,16.0,0.0,0.0,44,44,0,11.0,11.0,0.0
9808312,106,18,88,459,10,96,609,4,36.0,2.0,34.0,211.0,0.0,36.0,249.0,146,106,40,28.0,20.0,8.0
9909509,42,1,41,151,3,39,217,73,37.0,1.0,36.0,141.0,0.0,37.0,208.0,55,42,13,36.0,25.0,11.0
9310335,3,3,0,0,2,1,2,441,0.0,0.0,0.0,0.0,0.0,0.0,0.0,6,3,3,2.0,0.0,2.0
9802358,34,6,28,72,3,31,107,73,9.0,3.0,6.0,12.0,0.0,9.0,35.0,52,34,18,4.0,4.0,0.0
9406202,24,12,12,21,15,9,15,372,12.0,7.0,5.0,8.0,5.0,7.0,7.0,28,24,4,4.0,4.0,0.0
9510287,22,14,8,19,7,15,81,5,3.0,3.0,0.0,0.0,0.0,3.0,23.0,74,22,52,14.0,3.0,11.0
9504300,15,11,4,4,15,0,0,23,1.0,1.0,0.0,0.0,1.0,0.0,0.0,17,15,2,3.0,3.0,0.0
9406317,16,4,12,29,3,13,13,35,6.0,2.0,4.0,7.0,0.0,6.0,6.0,17,16,1,7.0,6.0,1.0
9907291,12,2,10,23,9,3,5,4,8.0,1.0,7.0,15.0,8.0,0.0,0.0,15,12,3,5.0,5.0,0.0
9607379,34,9,25,93,6,28,32,4,18.0,4.0,14.0,53.0,2.0,16.0,19.0,37,34,3,14.0,13.0,1.0
9908529,28,6,22,75,2,26,52,4,20.0,2.0,18.0,56.0,1.0,19.0,34.0,33,28,5,19.0,17.0,2.0
9510365,62,3,59,563,0,62,121,70,55.0,1.0,54.0,555.0,0.0,55.0,109.0,67,62,5,46.0,44.0,2.0
9610394,4,4,0,0,3,1,1,159,0.0,0.0,0.0,0.0,0.0,0.0,0.0,13,4,9,8.0,0.0,8.0
9607433,41,8,33,133,18,23,32,0,24.0,3.0,21.0,90.0,16.0,8.0,8.0,47,41,6,11.0,11.0,0.0
9707451,30,10,20,47,9,21,115,41,12.0,2.0,10.0,24.0,0.0,12.0,62.0,94,30,64,17.0,12.0,5.0
9705418,3,2,1,1,3,0,0,81,0.0,0.0,0.0,0.0,0.0,0.0,0.0,8,3,5,1.0,1.0,0.0
9411326,2,2,0,0,1,1,2,41,1.0,1.0,0.0,0.0,0.0,1.0,2.0,7,2,5,1.0,1.0,0.0
9607467,3,3,0,0,1,2,10,41,0.0,0.0,0.0,0.0,0.0,0.0,0.0,15,3,12,2.0,0.0,2.0
9607476,4,2,2,3,0,4,11,84,4.0,2.0,2.0,3.0,0.0,4.0,11.0,8,4,4,4.0,2.0,2.0
9510325,32,2,30,150,3,29,39,49,21.0,2.0,19.0,97.0,1.0,20.0,20.0,37,32,5,21.0,20.0,1.0
9701344,8,6,2,2,3,5,31,10,2.0,1.0,1.0,1.0,2.0,0.0,0.0,24,8,16,2.0,2.0,0.0
9809553,4,3,1,1,0,4,21,6,1.0,1.0,0.0,0.0,0.0,1.0,3.0,22,4,18,4.0,1.0,3.0
112102,85,15,70,216,1,84,269,23,28.0,4.0,24.0,78.0,0.0,28.0,107.0,94,85,9,24.0,16.0,8.0
9704453,17,9,8,14,3,14,22,67,0.0,0.0,0.0,0.0,0.0,0.0,0.0,63,17,46,8.0,0.0,8.0
9211244,12,6,6,7,10,2,2,49,1.0,1.0,0.0,0.0,1.0,0.0,0.0,13,12,1,2.0,2.0,0.0
9309249,23,5,18,52,13,10,10,32,3.0,2.0,1.0,1.0,0.0,3.0,3.0,24,23,1,4.0,4.0,0.0
9910420,60,10,50,220,3,57,359,3,38.0,3.0,35.0,150.0,0.0,38.0,272.0,76,60,16,23.0,20.0,3.0
9905390,60,4,56,384,0,60,211,5,38.0,1.0,37.0,265.0,0.0,38.0,120.0,74,60,14,37.0,33.0,4.0
2245,28,10,18,31,1,27,179,5,3.0,3.0,0.0,0.0,0.0,3.0,13.0,87,28,59,6.0,0.0,6.0
6127,11,2,9,19,2,9,24,0,9.0,2.0,7.0,16.0,2.0,7.0,19.0,18,11,7,2.0,0.0,2.0
9702404,20,6,14,57,9,11,17,116,9.0,3.0,6.0,20.0,0.0,9.0,15.0,26,20,6,10.0,8.0,2.0
9806246,23,9,14,33,2,21,40,31,15.0,4.0,11.0,26.0,2.0,13.0,30.0,26,23,3,9.0,6.0,3.0
9065,34,2,32,136,0,34,132,18,31.0,2.0,29.0,124.0,1.0,30.0,108.0,51,34,17,22.0,18.0,4.0
9708227,77,12,65,432,2,75,447,23,40.0,9.0,31.0,178.0,0.0,40.0,216.0,104,77,27,42.0,32.0,10.0
102193,36,6,30,284,0,36,209,23,34.0,5.0,29.0,282.0,0.0,34.0,201.0,59,36,23,25.0,22.0,3.0
9709322,70,7,63,268,2,68,153,27,44.0,3.0,41.0,186.0,0.0,44.0,90.0,76,70,6,20.0,17.0,3.0
102277,13,9,4,6,8,5,13,46,1.0,1.0,0.0,0.0,1.0,0.0,0.0,18,13,5,2.0,2.0,0.0
106334,41,8,33,87,1,40,361,18,25.0,3.0,22.0,62.0,0.0,25.0,198.0,86,41,45,28.0,15.0,13.0
103034,19,3,16,63,1,18,134,23,16.0,1.0,15.0,62.0,1.0,15.0,129.0,38,19,19,16.0,8.0,8.0
108192,19,6,13,23,2,17,137,23,6.0,2.0,4.0,5.0,0.0,6.0,82.0,54,19,35,27.0,6.0,21.0
9403239,10,1,9,24,6,4,4,18,6.0,1.0,5.0,9.0,4.0,2.0,2.0,11,10,1,6.0,6.0,0.0
9505438,20,4,16,57,4,16,27,46,9.0,1.0,8.0,20.0,0.0,9.0,10.0,26,20,6,11.0,9.0,2.0
9612478,5,5,0,0,4,1,5,42,1.0,1.0,0.0,0.0,0.0,1.0,3.0,11,5,6,,,
106128,15,3,12,23,2,13,29,0,11.0,2.0,9.0,16.0,2.0,9.0,24.0,23,15,8,7.0,1.0,6.0
105294,7,4,3,4,1,6,26,3,5.0,3.0,2.0,3.0,1.0,4.0,7.0,24,7,17,3.0,2.0,1.0
9808399,4,2,2,3,1,3,3,111,4.0,2.0,2.0,3.0,1.0,3.0,3.0,5,4,1,2.0,2.0,0.0
9507388,29,4,25,84,29,0,0,4,18.0,2.0,16.0,64.0,18.0,0.0,0.0,29,29,0,15.0,15.0,0.0
9805418,19,11,8,15,6,13,26,118,8.0,2.0,6.0,13.0,0.0,8.0,15.0,22,19,3,9.0,7.0,2.0
9911213,14,4,10,15,7,7,35,118,4.0,1.0,3.0,4.0,0.0,4.0,13.0,30,14,16,8.0,3.0,5.0
9605312,26,11,15,42,15,11,14,30,15.0,6.0,9.0,24.0,6.0,9.0,9.0,28,26,2,9.0,8.0,1.0
9807330,10,6,4,4,4,6,7,43,1.0,1.0,0.0,0.0,1.0,0.0,0.0,12,10,2,2.0,2.0,0.0
9911536,1,1,0,0,1,0,0,635,0.0,0.0,0.0,0.0,0.0,0.0,0.0,2,1,1,1.0,0.0,1.0
9602356,25,6,19,35,14,11,12,287,3.0,2.0,1.0,1.0,1.0,2.0,2.0,27,25,2,4.0,3.0,1.0
9604234,15,2,13,40,0,15,78,43,11.0,2.0,9.0,30.0,0.0,11.0,62.0,24,15,9,14.0,8.0,6.0
9803250,12,4,8,19,2,10,22,19,6.0,1.0,5.0,11.0,0.0,6.0,7.0,24,12,12,8.0,6.0,2.0
9503476,21,8,13,26,8,13,30,9,4.0,2.0,2.0,3.0,1.0,3.0,7.0,29,21,8,7.0,4.0,3.0
9702242,13,5,8,12,1,12,30,39,9.0,3.0,6.0,9.0,0.0,9.0,25.0,23,13,10,3.0,3.0,0.0
9909310,6,3,3,4,0,6,31,39,5.0,3.0,2.0,2.0,0.0,5.0,26.0,19,6,13,14.0,4.0,10.0
9502283,13,5,8,16,2,11,46,93,7.0,4.0,3.0,3.0,0.0,7.0,36.0,20,13,7,13.0,6.0,7.0
9812486,49,3,46,490,0,49,467,2,42.0,3.0,39.0,471.0,0.0,42.0,433.0,71,49,22,51.0,39.0,12.0
9907223,7,3,4,5,0,7,62,2,1.0,1.0,0.0,0.0,0.0,1.0,13.0,33,7,26,11.0,2.0,9.0
9905503,4,4,0,0,2,2,7,43,1.0,1.0,0.0,0.0,0.0,1.0,3.0,29,4,25,2.0,0.0,2.0
9807462,101,9,92,787,3,98,355,11,76.0,6.0,70.0,691.0,0.0,76.0,272.0,118,101,17,59.0,55.0,4.0
11056,24,2,22,82,0,24,253,19,22.0,1.0,21.0,77.0,0.0,22.0,228.0,40,24,16,32.0,19.0,13.0
109078,35,5,30,161,1,34,422,19,29.0,2.0,27.0,152.0,0.0,29.0,373.0,77,35,42,41.0,26.0,15.0
207182,5,4,1,1,0,5,8,80,2.0,1.0,1.0,1.0,0.0,2.0,5.0,8,5,3,1.0,1.0,0.0
103217,26,6,20,71,0,26,284,8,18.0,2.0,16.0,52.0,0.0,18.0,204.0,66,26,40,40.0,14.0,26.0
9512344,19,6,13,25,19,0,0,160,4.0,1.0,3.0,5.0,4.0,0.0,0.0,20,19,1,4.0,4.0,0.0
210009,4,4,0,0,0,4,68,19,4.0,4.0,0.0,0.0,0.0,4.0,62.0,33,4,29,25.0,3.0,22.0
103201,34,9,25,79,0,34,188,2,13.0,1.0,12.0,57.0,13.0,0.0,0.0,43,34,9,5.0,5.0,0.0
105064,46,8,38,133,3,43,123,28,28.0,5.0,23.0,85.0,1.0,27.0,94.0,53,46,7,25.0,19.0,6.0
108098,28,9,19,61,0,28,202,28,13.0,4.0,9.0,22.0,0.0,13.0,56.0,63,28,35,15.0,8.0,7.0
1302,12,7,5,8,1,11,37,26,7.0,6.0,1.0,2.0,0.0,7.0,25.0,29,12,17,4.0,3.0,1.0
9701420,29,11,18,31,6,23,73,91,7.0,3.0,4.0,9.0,0.0,7.0,18.0,44,29,15,6.0,1.0,5.0
109258,3,2,1,1,0,3,15,2,2.0,1.0,1.0,1.0,0.0,2.0,2.0,19,3,16,3.0,0.0,3.0
4214,20,8,12,19,1,19,75,2,8.0,3.0,5.0,9.0,3.0,5.0,5.0,33,20,13,7.0,6.0,1.0
12028,1,1,0,0,0,1,2,2,0.0,0.0,0.0,0.0,0.0,0.0,0.0,19,1,18,,,
9302220,6,4,2,2,4,2,4,96,2.0,2.0,0.0,0.0,1.0,1.0,3.0,9,6,3,5.0,2.0,3.0
9807246,17,2,15,24,5,12,104,5,6.0,1.0,5.0,8.0,0.0,6.0,62.0,55,17,38,21.0,1.0,20.0
9703350,19,2,17,38,2,17,55,37,8.0,2.0,6.0,15.0,0.0,8.0,33.0,29,19,10,14.0,7.0,7.0
9504371,12,2,10,26,3,9,40,60,5.0,1.0,4.0,6.0,0.0,5.0,18.0,24,12,12,3.0,3.0,0.0
9402279,7,5,2,3,0,7,7,85,4.0,3.0,1.0,1.0,0.0,4.0,4.0,8,7,1,5.0,4.0,1.0
9211257,16,7,9,17,16,0,0,28,7.0,6.0,1.0,2.0,7.0,0.0,0.0,16,16,0,4.0,4.0,0.0
9602395,8,7,1,1,2,6,15,12,3.0,3.0,0.0,0.0,0.0,3.0,7.0,20,8,12,2.0,1.0,1.0
9307316,15,3,12,25,5,10,15,234,8.0,2.0,6.0,11.0,2.0,6.0,9.0,17,15,2,9.0,7.0,2.0
9503489,37,7,30,94,28,9,9,86,12.0,2.0,10.0,34.0,7.0,5.0,5.0,41,37,4,7.0,7.0,0.0
9603204,68,13,55,163,43,25,37,14,23.0,3.0,20.0,50.0,23.0,0.0,0.0,71,68,3,14.0,14.0,0.0
9504330,69,11,58,189,58,11,16,204,21.0,2.0,19.0,59.0,17.0,4.0,4.0,74,69,5,9.0,9.0,0.0
11355,16,5,11,18,4,12,248,1,10.0,4.0,6.0,11.0,0.0,10.0,191.0,97,16,81,32.0,7.0,25.0
8029,5,3,2,3,0,5,60,7,2.0,1.0,1.0,1.0,0.0,2.0,19.0,32,5,27,10.0,3.0,7.0
101121,3,1,2,2,0,3,51,32,0.0,0.0,0.0,0.0,0.0,0.0,0.0,37,3,34,10.0,0.0,10.0
9903455,27,8,19,72,0,27,170,1,22.0,6.0,16.0,47.0,0.0,22.0,135.0,46,27,19,17.0,13.0,4.0
9410343,15,6,9,22,5,10,19,62,10.0,3.0,7.0,20.0,1.0,9.0,17.0,19,15,4,10.0,8.0,2.0
9908384,11,2,9,13,2,9,18,79,8.0,1.0,7.0,9.0,0.0,8.0,14.0,17,11,6,6.0,4.0,2.0
9502214,5,3,2,3,5,0,0,72,3.0,2.0,1.0,1.0,3.0,0.0,0.0,5,5,0,2.0,2.0,0.0
9501324,45,5,40,252,0,45,118,11,35.0,2.0,33.0,228.0,0.0,35.0,94.0,48,45,3,9.0,9.0,0.0
9706347,44,7,37,147,5,39,79,11,18.0,4.0,14.0,49.0,7.0,11.0,11.0,57,44,13,16.0,14.0,2.0
9602374,101,22,79,312,4,97,830,17,61.0,11.0,50.0,226.0,0.0,61.0,681.0,165,101,64,49.0,25.0,24.0
9511433,31,3,28,101,0,31,167,17,28.0,2.0,26.0,94.0,0.0,28.0,155.0,42,31,11,27.0,21.0,6.0
9404333,31,11,20,31,19,12,26,25,10.0,3.0,7.0,14.0,10.0,0.0,0.0,35,31,4,8.0,5.0,3.0
9611380,1,1,0,0,1,0,0,1396,,,,,,,,1,1,0,,,
9702331,19,2,17,59,2,17,43,24,13.0,1.0,12.0,41.0,4.0,9.0,14.0,32,19,13,2.0,2.0,0.0
9905479,5,4,1,1,3,2,2,425,2.0,1.0,1.0,1.0,0.0,2.0,2.0,7,5,2,3.0,2.0,1.0
9606355,8,1,7,14,2,6,10,104,4.0,1.0,3.0,6.0,1.0,3.0,3.0,13,8,5,4.0,4.0,0.0
9504217,15,4,11,25,0,15,122,6,10.0,3.0,7.0,16.0,0.0,10.0,88.0,37,15,22,22.0,7.0,15.0
9603356,4,1,3,4,0,4,4,21,1.0,1.0,0.0,0.0,1.0,0.0,0.0,5,4,1,4.0,4.0,0.0
112109,6,3,3,4,0,6,25,4,3.0,2.0,1.0,1.0,0.0,3.0,12.0,18,6,12,4.0,2.0,2.0
9709330,15,7,8,14,1,14,84,7,8.0,3.0,5.0,8.0,1.0,7.0,52.0,31,15,16,4.0,1.0,3.0
9905338,6,3,3,4,0,6,50,1,2.0,2.0,0.0,0.0,0.0,2.0,19.0,47,6,41,9.0,0.0,9.0
9805314,6,1,5,6,0,6,12,376,2.0,1.0,1.0,1.0,0.0,2.0,2.0,10,6,4,3.0,1.0,2.0
107095,3,3,0,0,1,2,4,28,0.0,0.0,0.0,0.0,0.0,0.0,0.0,14,3,11,2.0,1.0,1.0
9909286,10,5,5,6,4,6,8,28,5.0,2.0,3.0,3.0,5.0,0.0,0.0,13,10,3,5.0,5.0,0.0
9507218,29,8,21,74,25,4,4,101,15.0,3.0,12.0,40.0,15.0,0.0,0.0,32,29,3,8.0,8.0,0.0
9306299,7,3,4,6,7,0,0,260,2.0,1.0,1.0,1.0,2.0,0.0,0.0,7,7,0,1.0,1.0,0.0
9812266,13,8,5,5,2,11,29,101,7.0,4.0,3.0,3.0,0.0,7.0,20.0,29,13,16,7.0,4.0,3.0
106352,20,2,18,74,0,20,176,10,6.0,2.0,4.0,13.0,0.0,6.0,27.0,60,20,40,11.0,6.0,5.0
9145,24,9,15,41,1,23,198,24,11.0,6.0,5.0,12.0,0.0,11.0,95.0,54,24,30,18.0,8.0,10.0
9906398,3,3,0,0,3,0,0,224,2.0,2.0,0.0,0.0,2.0,0.0,0.0,3,3,0,1.0,1.0,0.0
9607263,6,2,4,7,0,6,16,188,5.0,1.0,4.0,7.0,0.0,5.0,10.0,12,6,6,6.0,5.0,1.0
10082,4,4,0,0,0,4,15,9,1.0,1.0,0.0,0.0,0.0,1.0,1.0,15,4,11,2.0,0.0,2.0
109160,9,9,0,0,1,8,34,14,2.0,2.0,0.0,0.0,0.0,2.0,15.0,46,9,37,8.0,1.0,7.0
9304233,8,3,5,9,7,1,1,14,1.0,1.0,0.0,0.0,1.0,0.0,0.0,11,8,3,2.0,0.0,2.0
9607442,12,3,9,15,1,11,37,14,6.0,2.0,4.0,6.0,0.0,6.0,19.0,22,12,10,4.0,4.0,0.0
9706522,20,4,16,26,1,19,41,14,11.0,3.0,8.0,18.0,1.0,10.0,10.0,31,20,11,12.0,11.0,1.0
9607390,11,3,8,15,1,10,21,41,4.0,1.0,3.0,4.0,1.0,3.0,3.0,18,11,7,3.0,3.0,0.0
9907224,31,3,28,139,0,31,277,68,28.0,3.0,25.0,124.0,0.0,28.0,199.0,65,31,34,38.0,24.0,14.0
9302256,13,6,7,14,13,0,0,44,5.0,4.0,1.0,1.0,5.0,0.0,0.0,13,13,0,5.0,5.0,0.0
9611249,3,1,2,2,2,1,7,44,2.0,1.0,1.0,1.0,1.0,1.0,3.0,10,3,7,5.0,2.0,3.0
106306,7,4,3,6,2,5,10,45,5.0,2.0,3.0,4.0,4.0,1.0,1.0,23,7,16,5.0,5.0,0.0
9906438,1,1,0,0,0,1,1,77,,,,,,,,4,1,3,,,
9709499,84,15,69,220,35,49,105,47,26.0,2.0,24.0,56.0,1.0,25.0,51.0,93,84,9,20.0,18.0,2.0
9907210,3,2,1,2,3,0,0,2064,,,,,,,,3,3,0,,,
9807249,19,4,15,88,0,19,114,16,14.0,2.0,12.0,76.0,2.0,12.0,56.0,52,19,33,19.0,14.0,5.0
9609345,9,1,8,18,0,9,44,66,6.0,1.0,5.0,10.0,0.0,6.0,27.0,20,9,11,11.0,5.0,6.0
9604382,8,2,6,11,0,8,24,14,4.0,2.0,2.0,3.0,0.0,4.0,7.0,22,8,14,5.0,3.0,2.0
9706371,3,2,1,2,0,3,30,16,3.0,2.0,1.0,2.0,0.0,3.0,26.0,21,3,18,15.0,3.0,12.0
9710541,15,9,6,8,2,13,70,16,2.0,2.0,0.0,0.0,0.0,2.0,28.0,50,15,35,20.0,3.0,17.0
9207228,34,10,24,53,34,0,0,8,10.0,7.0,3.0,4.0,10.0,0.0,0.0,34,34,0,5.0,5.0,0.0
9406231,24,11,13,33,24,0,0,97,8.0,2.0,6.0,13.0,8.0,0.0,0.0,24,24,0,4.0,4.0,0.0
9712311,1,1,0,0,1,0,0,488,0.0,0.0,0.0,0.0,0.0,0.0,0.0,5,1,4,2.0,0.0,2.0
9705469,13,5,8,33,0,13,161,15,10.0,3.0,7.0,32.0,0.0,10.0,141.0,37,13,24,28.0,10.0,18.0
9403216,5,3,2,3,2,3,3,237,3.0,1.0,2.0,3.0,0.0,3.0,3.0,6,5,1,4.0,3.0,1.0
9505435,4,3,1,1,0,4,21,15,2.0,2.0,0.0,0.0,0.0,2.0,6.0,17,4,13,5.0,2.0,3.0
9304254,19,15,4,5,1,18,35,15,5.0,5.0,0.0,0.0,0.0,5.0,7.0,25,19,6,3.0,3.0,0.0
9304290,14,7,7,10,14,0,0,4,3.0,1.0,2.0,3.0,3.0,0.0,0.0,14,14,0,4.0,4.0,0.0
9601318,1,1,0,0,1,0,0,35,0.0,0.0,0.0,0.0,0.0,0.0,0.0,6,1,5,2.0,0.0,2.0
9802424,28,2,26,93,28,0,0,283,22.0,1.0,21.0,75.0,22.0,0.0,0.0,28,28,0,14.0,14.0,0.0
2282,11,7,4,6,2,9,30,122,6.0,3.0,3.0,5.0,0.0,6.0,21.0,16,11,5,10.0,6.0,4.0
101231,6,3,3,3,1,5,25,0,2.0,1.0,1.0,1.0,0.0,2.0,19.0,20,6,14,1.0,1.0,0.0
9912435,33,11,22,89,12,21,50,0,18.0,6.0,12.0,51.0,2.0,16.0,32.0,48,33,15,21.0,15.0,6.0
9606468,24,5,19,51,5,19,29,90,18.0,3.0,15.0,43.0,2.0,16.0,25.0,30,24,6,14.0,12.0,2.0
9912303,5,3,2,3,0,5,9,71,3.0,1.0,2.0,3.0,0.0,3.0,6.0,42,5,37,26.0,0.0,26.0
9511277,3,1,2,2,0,3,4,112,0.0,0.0,0.0,0.0,0.0,0.0,0.0,6,3,3,1.0,1.0,0.0
9812517,3,2,1,1,1,2,2,36,2.0,2.0,0.0,0.0,1.0,1.0,1.0,8,3,5,2.0,2.0,0.0
9912242,16,7,9,23,4,12,32,74,4.0,1.0,3.0,5.0,3.0,1.0,1.0,28,16,12,10.0,7.0,3.0
10276,1,1,0,0,0,1,2,120,1.0,1.0,0.0,0.0,0.0,1.0,2.0,5,1,4,1.0,0.0,1.0
5321,25,3,22,71,2,23,75,3,22.0,2.0,20.0,68.0,0.0,22.0,74.0,31,25,6,11.0,7.0,4.0
9312349,70,11,59,252,12,58,58,40,56.0,6.0,50.0,216.0,5.0,51.0,51.0,71,70,1,24.0,23.0,1.0
9811225,10,5,5,11,1,9,31,9,8.0,3.0,5.0,11.0,1.0,7.0,18.0,26,10,16,8.0,5.0,3.0
201081,14,8,6,18,0,14,133,10,2.0,2.0,0.0,0.0,0.0,2.0,12.0,56,14,42,15.0,5.0,10.0
9125,7,5,2,3,0,7,56,69,2.0,2.0,0.0,0.0,0.0,2.0,19.0,39,7,32,10.0,2.0,8.0
5093,6,5,1,1,0,6,71,3,6.0,5.0,1.0,1.0,0.0,6.0,67.0,77,6,71,26.0,2.0,24.0
9802423,3,3,0,0,0,3,3,123,2.0,2.0,0.0,0.0,1.0,1.0,1.0,8,3,5,4.0,1.0,3.0
3122,24,10,14,37,1,23,233,15,14.0,4.0,10.0,33.0,0.0,14.0,155.0,98,24,74,21.0,6.0,15.0
8122,4,2,2,3,4,0,0,761,1.0,1.0,0.0,0.0,1.0,0.0,0.0,5,4,1,2.0,2.0,0.0
9209278,11,6,5,6,11,0,0,419,4.0,3.0,1.0,1.0,4.0,0.0,0.0,11,11,0,5.0,5.0,0.0
9510289,28,1,27,72,16,12,16,61,13.0,1.0,12.0,27.0,12.0,1.0,1.0,33,28,5,8.0,8.0,0.0
9408353,11,4,7,12,11,0,0,130,4.0,2.0,2.0,3.0,4.0,0.0,0.0,11,11,0,3.0,3.0,0.0
9501358,39,4,35,188,17,22,22,30,30.0,1.0,29.0,174.0,16.0,14.0,14.0,41,39,2,24.0,23.0,1.0
9702441,6,2,4,9,1,5,12,30,4.0,2.0,2.0,5.0,0.0,4.0,4.0,11,6,5,1.0,0.0,1.0
7222,23,6,17,34,0,23,122,95,16.0,4.0,12.0,21.0,0.0,16.0,87.0,45,23,22,23.0,9.0,14.0
9401330,14,12,2,2,14,0,0,152,6.0,6.0,0.0,0.0,6.0,0.0,0.0,14,14,0,2.0,2.0,0.0
9904448,27,6,21,106,6,21,88,32,13.0,3.0,10.0,50.0,0.0,13.0,54.0,39,27,12,20.0,14.0,6.0
102030,8,5,3,4,3,5,22,5,1.0,1.0,0.0,0.0,1.0,0.0,0.0,23,8,15,1.0,1.0,0.0
103183,40,7,33,133,4,36,341,23,26.0,3.0,23.0,110.0,0.0,26.0,286.0,71,40,31,21.0,9.0,12.0
9704212,17,6,11,24,2,15,33,100,4.0,2.0,2.0,3.0,0.0,4.0,6.0,30,17,13,6.0,4.0,2.0
9501274,6,4,2,3,6,0,0,41,1.0,1.0,0.0,0.0,1.0,0.0,0.0,6,6,0,2.0,2.0,0.0
9309336,11,5,6,7,11,0,0,14,3.0,3.0,0.0,0.0,3.0,0.0,0.0,11,11,0,1.0,1.0,0.0
9702354,28,3,25,81,2,26,81,130,14.0,3.0,11.0,34.0,0.0,14.0,52.0,38,28,10,14.0,9.0,5.0
204066,1,1,0,0,1,0,0,169,0.0,0.0,0.0,0.0,0.0,0.0,0.0,11,1,10,2.0,0.0,2.0
9407317,29,9,20,92,1,28,79,36,21.0,7.0,14.0,57.0,1.0,20.0,58.0,34,29,5,18.0,15.0,3.0
9710503,2,2,0,0,0,2,4,8,0.0,0.0,0.0,0.0,0.0,0.0,0.0,15,2,13,5.0,0.0,5.0
9703374,5,4,1,1,1,4,12,10,1.0,1.0,0.0,0.0,0.0,1.0,5.0,27,5,22,4.0,1.0,3.0
4208,33,9,24,93,0,33,275,0,22.0,4.0,18.0,71.0,0.0,22.0,195.0,72,33,39,35.0,18.0,17.0
9706523,5,2,3,4,2,3,3,218,5.0,2.0,3.0,4.0,2.0,3.0,3.0,7,5,2,5.0,4.0,1.0
9511244,3,2,1,1,2,1,1,89,1.0,1.0,0.0,0.0,1.0,0.0,0.0,6,3,3,1.0,0.0,1.0
9909559,5,3,2,2,1,4,11,67,4.0,2.0,2.0,2.0,0.0,4.0,11.0,10,5,5,1.0,1.0,0.0
9604376,17,4,13,34,0,17,106,6,12.0,3.0,9.0,24.0,0.0,12.0,87.0,30,17,13,20.0,11.0,9.0
9808484,10,2,8,13,3,7,14,46,0.0,0.0,0.0,0.0,0.0,0.0,0.0,33,10,23,7.0,0.0,7.0
103231,10,4,6,7,0,10,57,21,3.0,1.0,2.0,3.0,0.0,3.0,17.0,29,10,19,12.0,6.0,6.0
9411258,15,7,8,13,15,0,0,173,5.0,3.0,2.0,3.0,5.0,0.0,0.0,15,15,0,4.0,4.0,0.0
9510312,16,3,13,29,3,13,41,50,9.0,1.0,8.0,16.0,0.0,9.0,25.0,28,16,12,6.0,5.0,1.0
1178,5,1,4,5,0,5,27,21,5.0,1.0,4.0,5.0,0.0,5.0,24.0,18,5,13,13.0,3.0,10.0
107234,3,1,2,2,0,3,18,1,2.0,1.0,1.0,1.0,0.0,2.0,7.0,20,3,17,5.0,0.0,5.0
9709408,60,3,57,249,41,19,39,83,26.0,4.0,22.0,99.0,13.0,13.0,23.0,68,60,8,18.0,18.0,0.0
9710382,30,17,13,25,20,10,11,83,12.0,6.0,6.0,13.0,4.0,8.0,8.0,33,30,3,8.0,7.0,1.0
9410272,17,8,9,12,7,10,15,57,10.0,3.0,7.0,9.0,3.0,7.0,12.0,23,17,6,6.0,6.0,0.0
9807490,4,4,0,0,0,4,16,154,3.0,3.0,0.0,0.0,0.0,3.0,9.0,12,4,8,2.0,1.0,1.0
9709420,21,6,15,34,4,17,32,143,14.0,3.0,11.0,27.0,0.0,14.0,21.0,24,21,3,6.0,6.0,0.0
201298,3,3,0,0,0,3,13,7,1.0,1.0,0.0,0.0,0.0,1.0,3.0,20,3,17,7.0,1.0,6.0
108268,13,6,7,15,1,12,71,165,12.0,5.0,7.0,15.0,1.0,11.0,47.0,24,13,11,17.0,11.0,6.0
107052,11,5,6,10,1,10,40,8,2.0,1.0,1.0,1.0,0.0,2.0,9.0,35,11,24,12.0,2.0,10.0
5139,11,6,5,6,3,8,54,25,6.0,2.0,4.0,4.0,0.0,6.0,34.0,27,11,16,11.0,3.0,8.0
8168,6,5,1,1,0,6,42,9,2.0,2.0,0.0,0.0,0.0,2.0,5.0,27,6,21,10.0,5.0,5.0
9605239,13,6,7,10,12,1,1,160,5.0,3.0,2.0,2.0,4.0,1.0,1.0,14,13,1,2.0,1.0,1.0
101226,7,1,6,13,0,7,39,8,6.0,1.0,5.0,11.0,0.0,6.0,32.0,29,7,22,4.0,4.0,0.0
9912297,7,7,0,0,5,2,9,98,0.0,0.0,0.0,0.0,0.0,0.0,0.0,21,7,14,10.0,0.0,10.0
9602258,6,4,2,5,1,5,11,44,4.0,2.0,2.0,5.0,0.0,4.0,9.0,11,6,5,1.0,1.0,0.0
204145,5,2,3,3,0,5,42,22,4.0,1.0,3.0,3.0,0.0,4.0,35.0,36,5,31,10.0,0.0,10.0
9093,3,3,0,0,0,3,29,21,3.0,3.0,0.0,0.0,0.0,3.0,29.0,18,3,15,17.0,2.0,15.0
11387,21,3,18,89,0,21,259,0,19.0,3.0,16.0,82.0,0.0,19.0,229.0,51,21,30,40.0,15.0,25.0
3181,12,8,4,5,7,5,7,25,4.0,3.0,1.0,1.0,4.0,0.0,0.0,22,12,10,3.0,3.0,0.0
9808322,12,5,7,9,7,5,12,152,4.0,2.0,2.0,2.0,0.0,4.0,10.0,15,12,3,6.0,3.0,3.0
9307307,3,3,0,0,0,3,4,245,1.0,1.0,0.0,0.0,1.0,0.0,0.0,8,3,5,1.0,1.0,0.0
11153,5,3,2,2,0,5,26,3,3.0,3.0,0.0,0.0,0.0,3.0,20.0,48,5,43,11.0,2.0,9.0
9709503,4,4,0,0,2,2,11,43,0.0,0.0,0.0,0.0,0.0,0.0,0.0,15,4,11,3.0,1.0,2.0
209129,0,0,0,0,0,0,0,69,0.0,0.0,0.0,0.0,0.0,0.0,0.0,15,0,15,1.0,0.0,1.0
106287,7,6,1,1,2,5,11,55,1.0,1.0,0.0,0.0,1.0,0.0,0.0,27,7,20,4.0,3.0,1.0
11248,25,8,17,36,1,24,281,12,15.0,5.0,10.0,23.0,0.0,15.0,227.0,78,25,53,37.0,8.0,29.0
101187,2,2,0,0,1,1,2,47,0.0,0.0,0.0,0.0,0.0,0.0,0.0,14,2,12,,,
212345,2,2,0,0,0,2,11,393,2.0,2.0,0.0,0.0,0.0,2.0,7.0,10,2,8,7.0,2.0,5.0
9402289,9,5,4,5,4,5,13,10,3.0,1.0,2.0,2.0,0.0,3.0,6.0,20,9,11,3.0,2.0,1.0
111068,31,8,23,73,0,31,180,37,23.0,5.0,18.0,57.0,0.0,23.0,138.0,49,31,18,23.0,14.0,9.0
9405299,21,5,16,79,7,14,38,94,17.0,3.0,14.0,67.0,8.0,9.0,9.0,29,21,8,15.0,13.0,2.0
9406238,7,2,5,15,0,7,24,60,6.0,1.0,5.0,13.0,0.0,6.0,21.0,14,7,7,10.0,6.0,4.0
104056,10,2,8,22,0,10,195,23,8.0,1.0,7.0,19.0,0.0,8.0,150.0,62,10,52,20.0,4.0,16.0
9407308,5,5,0,0,5,0,0,30,1.0,1.0,0.0,0.0,1.0,0.0,0.0,5,5,0,1.0,1.0,0.0
9709358,8,2,6,12,7,1,1,151,5.0,2.0,3.0,6.0,5.0,0.0,0.0,9,8,1,1.0,1.0,0.0
9301232,30,6,24,86,1,29,29,56,24.0,4.0,20.0,62.0,0.0,24.0,24.0,31,30,1,18.0,17.0,1.0
9610320,1,1,0,0,1,0,0,61,0.0,0.0,0.0,0.0,0.0,0.0,0.0,20,1,19,4.0,0.0,4.0
9611449,13,4,9,23,1,12,20,25,6.0,1.0,5.0,8.0,0.0,6.0,14.0,18,13,5,9.0,6.0,3.0
9806299,20,4,16,38,2,18,120,92,13.0,5.0,8.0,20.0,0.0,13.0,90.0,33,20,13,23.0,13.0,10.0
9807573,6,2,4,6,0,6,13,33,2.0,1.0,1.0,1.0,0.0,2.0,2.0,9,6,3,3.0,2.0,1.0
9207244,5,4,1,1,5,0,0,103,3.0,2.0,1.0,1.0,3.0,0.0,0.0,5,5,0,,,
205032,8,3,5,7,0,8,58,3,3.0,1.0,2.0,2.0,0.0,3.0,12.0,30,8,22,9.0,3.0,6.0
9307212,3,3,0,0,3,0,0,87,1.0,1.0,0.0,0.0,1.0,0.0,0.0,3,3,0,,,
9906413,6,2,4,5,1,5,19,15,1.0,1.0,0.0,0.0,0.0,1.0,1.0,13,6,7,5.0,4.0,1.0
9301255,5,2,3,6,0,5,5,176,5.0,2.0,3.0,6.0,0.0,5.0,5.0,6,5,1,6.0,5.0,1.0
9811454,11,8,3,3,4,7,46,12,3.0,3.0,0.0,0.0,0.0,3.0,33.0,26,11,15,15.0,3.0,12.0
9812231,4,3,1,1,2,2,2,139,2.0,1.0,1.0,1.0,2.0,0.0,0.0,5,4,1,2.0,2.0,0.0
9907265,4,1,3,5,1,3,14,14,3.0,1.0,2.0,3.0,1.0,2.0,5.0,15,4,11,4.0,3.0,1.0
9902345,4,4,0,0,0,4,34,27,1.0,1.0,0.0,0.0,0.0,1.0,3.0,33,4,29,13.0,2.0,11.0
204273,5,1,4,6,0,5,18,3,0.0,0.0,0.0,0.0,0.0,0.0,0.0,19,5,14,6.0,1.0,5.0
9906433,7,4,3,4,2,5,16,3,1.0,1.0,0.0,0.0,0.0,1.0,3.0,17,7,10,1.0,1.0,0.0
105297,19,8,11,38,3,16,55,0,13.0,4.0,9.0,32.0,0.0,13.0,48.0,25,19,6,7.0,7.0,0.0
9705335,5,4,1,1,2,3,7,148,1.0,1.0,0.0,0.0,0.0,1.0,1.0,9,5,4,3.0,2.0,1.0
204194,15,2,13,52,0,15,82,0,13.0,1.0,12.0,48.0,0.0,13.0,66.0,44,15,29,22.0,12.0,10.0
9807569,5,1,4,4,1,4,7,0,0.0,0.0,0.0,0.0,0.0,0.0,0.0,10,5,5,3.0,0.0,3.0
9709234,7,2,5,7,0,7,8,60,4.0,1.0,3.0,4.0,4.0,0.0,0.0,10,7,3,2.0,2.0,0.0
7310,4,3,1,2,0,4,29,69,3.0,2.0,1.0,1.0,0.0,3.0,16.0,24,4,20,9.0,2.0,7.0
9910405,8,3,5,12,1,7,21,47,7.0,2.0,5.0,12.0,0.0,7.0,18.0,24,8,16,11.0,7.0,4.0
1073,9,5,4,7,0,9,66,5,2.0,2.0,0.0,0.0,0.0,2.0,16.0,46,9,37,17.0,2.0,15.0
9610441,2,2,0,0,0,2,10,10,1.0,1.0,0.0,0.0,0.0,1.0,5.0,13,2,11,1.0,0.0,1.0
110310,10,7,3,5,4,6,13,381,4.0,4.0,0.0,0.0,0.0,4.0,8.0,17,10,7,7.0,4.0,3.0
9810443,4,3,1,1,0,4,31,87,3.0,2.0,1.0,1.0,0.0,3.0,23.0,32,4,28,13.0,2.0,11.0
9809211,18,5,13,41,10,8,11,24,3.0,2.0,1.0,2.0,1.0,2.0,4.0,22,18,4,9.0,8.0,1.0
205284,7,1,6,13,0,7,119,28,7.0,1.0,6.0,13.0,0.0,7.0,100.0,44,7,37,35.0,6.0,29.0
3097,0,0,0,0,0,0,0,9,0.0,0.0,0.0,0.0,0.0,0.0,0.0,11,0,11,3.0,0.0,3.0
9706262,5,4,1,1,1,4,13,100,3.0,3.0,0.0,0.0,0.0,3.0,9.0,11,5,6,7.0,3.0,4.0
9710220,5,4,1,1,2,3,7,225,0.0,0.0,0.0,0.0,0.0,0.0,0.0,11,5,6,2.0,1.0,1.0
9801358,2,2,0,0,0,2,2,101,1.0,1.0,0.0,0.0,1.0,0.0,0.0,4,2,2,,,
109159,3,3,0,0,0,3,8,65,2.0,2.0,0.0,0.0,0.0,2.0,6.0,14,3,11,4.0,0.0,4.0
107199,6,1,5,10,0,6,44,13,4.0,1.0,3.0,6.0,0.0,4.0,19.0,21,6,15,8.0,3.0,5.0
9608226,4,4,0,0,2,2,8,13,0.0,0.0,0.0,0.0,0.0,0.0,0.0,36,4,32,5.0,0.0,5.0
211399,0,0,0,0,0,0,0,524,0.0,0.0,0.0,0.0,0.0,0.0,0.0,2,0,2,1.0,0.0,1.0
9702383,10,4,6,9,4,6,11,59,5.0,2.0,3.0,6.0,0.0,5.0,9.0,14,10,4,6.0,4.0,2.0
101249,10,4,6,11,0,10,156,15,7.0,3.0,4.0,6.0,0.0,7.0,111.0,77,10,67,21.0,4.0,17.0
9302315,13,2,11,37,12,1,1,33,11.0,1.0,10.0,28.0,11.0,0.0,0.0,14,13,1,10.0,10.0,0.0
9806253,22,14,8,17,1,21,177,17,19.0,11.0,8.0,17.0,0.0,19.0,171.0,38,22,16,24.0,8.0,16.0
9303279,19,9,10,17,19,0,0,75,4.0,2.0,2.0,3.0,4.0,0.0,0.0,19,19,0,5.0,5.0,0.0
9604390,6,4,2,4,0,6,27,35,4.0,2.0,2.0,4.0,0.0,4.0,19.0,21,6,15,8.0,3.0,5.0
9506329,17,5,12,32,6,11,28,102,9.0,2.0,7.0,21.0,1.0,8.0,16.0,24,17,7,9.0,7.0,2.0
9712243,1,1,0,0,0,1,8,1,1.0,1.0,0.0,0.0,0.0,1.0,6.0,22,1,21,12.0,0.0,12.0
9806231,2,2,0,0,0,2,18,8,1.0,1.0,0.0,0.0,0.0,1.0,11.0,20,2,18,7.0,0.0,7.0
9212227,5,2,3,4,2,3,3,1113,,,,,,,,6,5,1,,,
9506352,4,3,1,2,4,0,0,1358,,,,,,,,4,4,0,,,
205237,5,2,3,4,1,4,6,128,2.0,1.0,1.0,1.0,0.0,2.0,2.0,20,5,15,3.0,2.0,1.0
9903371,8,2,6,14,0,8,40,60,6.0,1.0,5.0,13.0,0.0,6.0,19.0,25,8,17,11.0,6.0,5.0
9906545,26,1,25,149,3,23,45,109,26.0,1.0,25.0,149.0,3.0,23.0,41.0,29,26,3,24.0,22.0,2.0
9312312,20,8,12,41,1,19,65,56,19.0,7.0,12.0,41.0,0.0,19.0,65.0,26,20,6,17.0,14.0,3.0
9407327,4,4,0,0,4,0,0,188,1.0,1.0,0.0,0.0,1.0,0.0,0.0,5,4,1,2.0,1.0,1.0
9610216,1,1,0,0,0,1,2,93,0.0,0.0,0.0,0.0,0.0,0.0,0.0,11,1,10,4.0,0.0,4.0
9806480,4,3,1,1,0,4,6,103,2.0,2.0,0.0,0.0,1.0,1.0,3.0,10,4,6,4.0,1.0,3.0
9710304,12,3,9,31,0,12,42,7,8.0,2.0,6.0,18.0,0.0,8.0,17.0,20,12,8,6.0,4.0,2.0
203163,2,2,0,0,0,2,3,19,1.0,1.0,0.0,0.0,1.0,0.0,0.0,21,2,19,3.0,0.0,3.0
202132,2,2,0,0,0,2,6,19,1.0,1.0,0.0,0.0,0.0,1.0,2.0,23,2,21,8.0,1.0,7.0
108081,2,1,1,1,2,0,0,2001,1.0,1.0,0.0,0.0,1.0,0.0,0.0,2,2,0,1.0,1.0,0.0
11397,5,5,0,0,2,3,5,205,2.0,2.0,0.0,0.0,0.0,2.0,2.0,11,5,6,3.0,2.0,1.0
9901323,19,2,17,59,0,19,54,49,12.0,1.0,11.0,45.0,0.0,12.0,21.0,31,19,12,14.0,11.0,3.0
9808290,17,5,12,18,1,16,79,1,7.0,3.0,4.0,5.0,0.0,7.0,49.0,38,17,21,9.0,7.0,2.0
9612221,2,2,0,0,2,0,0,1796,,,,,,,,2,2,0,,,
9501282,19,11,8,9,13,6,11,77,3.0,3.0,0.0,0.0,3.0,0.0,0.0,25,19,6,3.0,3.0,0.0
10135,1,1,0,0,0,1,1,20,0.0,0.0,0.0,0.0,0.0,0.0,0.0,8,1,7,4.0,0.0,4.0
8290,12,6,6,12,1,11,49,34,9.0,3.0,6.0,12.0,0.0,9.0,43.0,21,12,9,6.0,2.0,4.0
9706249,18,4,14,32,3,15,26,8,7.0,1.0,6.0,11.0,1.0,6.0,6.0,23,18,5,7.0,5.0,2.0
9806267,22,7,15,41,0,22,163,9,11.0,3.0,8.0,26.0,0.0,11.0,116.0,48,22,26,34.0,10.0,24.0
10070,5,1,4,5,0,5,24,8,5.0,1.0,4.0,5.0,0.0,5.0,24.0,15,5,10,12.0,4.0,8.0
9606390,4,3,1,1,1,3,5,27,2.0,1.0,1.0,1.0,2.0,0.0,0.0,7,4,3,3.0,3.0,0.0
9811243,5,2,3,3,2,3,5,38,0.0,0.0,0.0,0.0,0.0,0.0,0.0,13,5,8,4.0,0.0,4.0
9809441,3,2,1,2,1,2,6,51,2.0,2.0,0.0,0.0,0.0,2.0,6.0,10,3,7,1.0,1.0,0.0
9312268,36,13,23,50,30,6,6,57,13.0,2.0,11.0,24.0,13.0,0.0,0.0,37,36,1,7.0,7.0,0.0
9701234,15,3,12,25,2,13,47,29,6.0,1.0,5.0,11.0,0.0,6.0,6.0,31,15,16,6.0,4.0,2.0
9610531,5,4,1,1,1,4,9,25,0.0,0.0,0.0,0.0,0.0,0.0,0.0,15,5,10,2.0,1.0,1.0
202152,5,3,2,3,0,5,7,121,2.0,1.0,1.0,1.0,0.0,2.0,2.0,15,5,10,4.0,3.0,1.0
9402343,1,1,0,0,1,0,0,301,0.0,0.0,0.0,0.0,0.0,0.0,0.0,2,1,1,1.0,0.0,1.0
9501386,6,2,4,6,6,0,0,116,2.0,1.0,1.0,1.0,2.0,0.0,0.0,6,6,0,2.0,2.0,0.0
9610256,1,1,0,0,0,1,3,29,1.0,1.0,0.0,0.0,0.0,1.0,3.0,12,1,11,1.0,0.0,1.0
9710445,6,2,4,7,0,6,18,222,6.0,2.0,4.0,7.0,0.0,6.0,18.0,11,6,5,11.0,6.0,5.0
9612384,6,2,4,5,2,4,11,41,4.0,1.0,3.0,3.0,1.0,3.0,8.0,11,6,5,6.0,2.0,4.0
9705377,9,2,7,15,2,7,8,321,7.0,1.0,6.0,12.0,2.0,5.0,5.0,12,9,3,6.0,5.0,1.0
9611402,1,1,0,0,0,1,7,53,1.0,1.0,0.0,0.0,0.0,1.0,7.0,8,1,7,,,
9608242,6,4,2,3,0,6,37,40,5.0,3.0,2.0,3.0,0.0,5.0,35.0,18,6,12,5.0,1.0,4.0
9702377,2,2,0,0,0,2,2,409,0.0,0.0,0.0,0.0,0.0,0.0,0.0,5,2,3,3.0,0.0,3.0
9703245,15,11,4,5,11,4,5,139,3.0,3.0,0.0,0.0,3.0,0.0,0.0,30,15,15,3.0,3.0,0.0
9307299,2,2,0,0,1,1,1,39,1.0,1.0,0.0,0.0,1.0,0.0,0.0,3,2,1,,,
8084,11,2,9,14,1,10,27,29,3.0,1.0,2.0,2.0,0.0,3.0,7.0,31,11,20,8.0,5.0,3.0
9711353,3,1,2,2,1,2,4,14,0.0,0.0,0.0,0.0,0.0,0.0,0.0,9,3,6,3.0,0.0,3.0
9709452,27,5,22,39,7,20,33,47,13.0,2.0,11.0,20.0,4.0,9.0,14.0,32,27,5,10.0,7.0,3.0
11383,3,3,0,0,0,3,18,9,0.0,0.0,0.0,0.0,0.0,0.0,0.0,25,3,22,18.0,0.0,18.0
9509415,11,6,5,6,6,5,7,91,3.0,1.0,2.0,2.0,3.0,0.0,0.0,15,11,4,4.0,3.0,1.0
9712320,4,3,1,1,0,4,19,51,4.0,3.0,1.0,1.0,0.0,4.0,16.0,17,4,13,8.0,3.0,5.0
9603440,14,5,9,25,1,13,50,56,13.0,4.0,9.0,25.0,0.0,13.0,50.0,19,14,5,15.0,10.0,5.0
9401272,12,3,9,21,0,12,35,56,11.0,3.0,8.0,20.0,0.0,11.0,34.0,16,12,4,14.0,10.0,4.0
9505443,4,4,0,0,4,0,0,218,2.0,2.0,0.0,0.0,2.0,0.0,0.0,4,4,0,2.0,2.0,0.0
9505278,1,1,0,0,1,0,0,2052,,,,,,,,1,1,0,,,
9910310,15,3,12,24,0,15,113,9,6.0,2.0,4.0,6.0,0.0,6.0,58.0,41,15,26,14.0,7.0,7.0
104033,3,2,1,1,0,3,25,38,2.0,2.0,0.0,0.0,0.0,2.0,17.0,19,3,16,14.0,1.0,13.0
6257,16,3,13,25,0,16,61,11,9.0,1.0,8.0,16.0,0.0,9.0,38.0,26,16,10,4.0,0.0,4.0
9712354,3,1,2,3,3,0,0,95,1.0,1.0,0.0,0.0,1.0,0.0,0.0,3,3,0,2.0,2.0,0.0
9510206,9,4,5,6,5,4,5,188,2.0,1.0,1.0,1.0,1.0,1.0,1.0,12,9,3,3.0,2.0,1.0
9211312,1,1,0,0,1,0,0,1555,,,,,,,,1,1,0,,,
9410254,5,3,2,2,4,1,1,175,3.0,2.0,1.0,1.0,3.0,0.0,0.0,7,5,2,4.0,4.0,0.0
9401242,14,3,11,25,14,0,0,87,8.0,2.0,6.0,12.0,8.0,0.0,0.0,14,14,0,4.0,4.0,0.0
12085,11,3,8,19,0,11,144,7,10.0,3.0,7.0,16.0,0.0,10.0,117.0,50,11,39,12.0,4.0,8.0
9603240,13,4,9,24,13,0,0,63,11.0,2.0,9.0,24.0,11.0,0.0,0.0,13,13,0,6.0,6.0,0.0
101291,0,0,0,0,0,0,0,94,0.0,0.0,0.0,0.0,0.0,0.0,0.0,7,0,7,3.0,0.0,3.0
9612206,1,1,0,0,0,1,4,302,0.0,0.0,0.0,0.0,0.0,0.0,0.0,12,1,11,2.0,0.0,2.0
9704266,2,2,0,0,2,0,0,1154,1.0,1.0,0.0,0.0,1.0,0.0,0.0,9,2,7,1.0,1.0,0.0
107280,2,2,0,0,1,1,2,21,0.0,0.0,0.0,0.0,0.0,0.0,0.0,11,2,9,1.0,1.0,0.0
9407224,3,1,2,2,0,3,6,49,0.0,0.0,0.0,0.0,0.0,0.0,0.0,7,3,4,1.0,0.0,1.0
9912425,12,2,10,21,0,12,160,49,11.0,2.0,9.0,18.0,0.0,11.0,114.0,45,12,33,24.0,7.0,17.0
105078,4,3,1,1,0,4,12,74,1.0,1.0,0.0,0.0,0.0,1.0,2.0,20,4,16,6.0,1.0,5.0
12057,14,5,9,33,0,14,59,21,5.0,3.0,2.0,3.0,0.0,5.0,12.0,29,14,15,10.0,1.0,9.0
9312265,7,4,3,3,7,0,0,112,4.0,4.0,0.0,0.0,4.0,0.0,0.0,8,7,1,1.0,1.0,0.0
203179,1,1,0,0,0,1,8,73,1.0,1.0,0.0,0.0,0.0,1.0,8.0,15,1,14,,,
9911357,2,2,0,0,2,0,0,292,1.0,1.0,0.0,0.0,1.0,0.0,0.0,2,2,0,1.0,1.0,0.0
9911260,3,2,1,1,0,3,8,13,2.0,1.0,1.0,1.0,0.0,2.0,5.0,12,3,9,1.0,0.0,1.0
9510330,1,1,0,0,0,1,1,194,0.0,0.0,0.0,0.0,0.0,0.0,0.0,5,1,4,4.0,0.0,4.0
9703431,1,1,0,0,0,1,1,141,0.0,0.0,0.0,0.0,0.0,0.0,0.0,6,1,5,1.0,0.0,1.0
204265,12,6,6,16,8,4,15,50,6.0,1.0,5.0,15.0,6.0,0.0,0.0,19,12,7,3.0,2.0,1.0
110161,4,3,1,1,0,4,43,2,1.0,1.0,0.0,0.0,0.0,1.0,7.0,38,4,34,20.0,2.0,18.0
9908396,7,6,1,2,1,6,35,50,1.0,1.0,0.0,0.0,0.0,1.0,5.0,40,7,33,6.0,3.0,3.0
9711474,3,1,2,3,0,3,8,333,3.0,1.0,2.0,3.0,0.0,3.0,8.0,8,3,5,6.0,2.0,4.0
9905334,2,1,1,1,1,1,2,53,0.0,0.0,0.0,0.0,0.0,0.0,0.0,8,2,6,1.0,0.0,1.0
103185,3,1,2,2,3,0,0,187,0.0,0.0,0.0,0.0,0.0,0.0,0.0,7,3,4,2.0,2.0,0.0
9606432,5,2,3,4,2,3,4,319,2.0,1.0,1.0,1.0,0.0,2.0,2.0,8,5,3,2.0,2.0,0.0
9510260,3,3,0,0,1,2,4,374,,,,,,,,7,3,4,2.0,0.0,2.0
9807287,5,4,1,1,1,4,19,9,0.0,0.0,0.0,0.0,0.0,0.0,0.0,19,5,14,1.0,1.0,0.0
9909549,8,2,6,13,0,8,46,69,3.0,1.0,2.0,3.0,0.0,3.0,10.0,20,8,12,10.0,5.0,5.0
9502328,2,2,0,0,1,1,3,214,1.0,1.0,0.0,0.0,0.0,1.0,1.0,10,2,8,1.0,0.0,1.0
9612494,2,2,0,0,0,2,8,22,0.0,0.0,0.0,0.0,0.0,0.0,0.0,11,2,9,2.0,0.0,2.0
9705426,1,1,0,0,1,0,0,11,,,,,,,,7,1,6,,,
9602343,29,3,26,60,1,28,131,40,23.0,3.0,20.0,51.0,0.0,23.0,118.0,37,29,8,20.0,13.0,7.0
9609470,5,3,2,2,0,5,6,51,3.0,1.0,2.0,2.0,3.0,0.0,0.0,10,5,5,4.0,4.0,0.0
9902424,5,4,1,1,1,4,6,64,1.0,1.0,0.0,0.0,0.0,1.0,1.0,13,5,8,3.0,2.0,1.0
9803458,2,1,1,1,0,2,6,182,2.0,1.0,1.0,1.0,0.0,2.0,6.0,14,2,12,8.0,0.0,8.0
9605409,6,3,3,6,5,1,2,72,1.0,1.0,0.0,0.0,0.0,1.0,2.0,9,6,3,2.0,0.0,2.0
209047,6,5,1,1,5,1,7,0,0.0,0.0,0.0,0.0,0.0,0.0,0.0,71,6,65,19.0,0.0,19.0
4005,2,1,1,1,0,2,11,32,0.0,0.0,0.0,0.0,0.0,0.0,0.0,16,2,14,2.0,0.0,2.0
5280,6,5,1,1,2,4,31,70,2.0,2.0,0.0,0.0,0.0,2.0,29.0,25,6,19,20.0,2.0,18.0
111131,6,4,2,5,0,6,45,0,6.0,4.0,2.0,5.0,0.0,6.0,45.0,20,6,14,16.0,3.0,13.0
9511333,32,14,18,24,4,28,56,217,10.0,3.0,7.0,8.0,0.0,10.0,17.0,43,32,11,10.0,8.0,2.0
301280,1,1,0,0,0,1,4,65,1.0,1.0,0.0,0.0,0.0,1.0,3.0,16,1,15,8.0,0.0,8.0
9902211,1,1,0,0,0,1,5,16,0.0,0.0,0.0,0.0,0.0,0.0,0.0,12,1,11,1.0,0.0,1.0
103057,8,1,7,8,2,6,10,51,7.0,1.0,6.0,7.0,1.0,6.0,10.0,13,8,5,8.0,6.0,2.0
205147,2,2,0,0,1,1,6,3,0.0,0.0,0.0,0.0,0.0,0.0,0.0,16,2,14,2.0,0.0,2.0
205131,9,4,5,12,0,9,49,3,0.0,0.0,0.0,0.0,0.0,0.0,0.0,26,9,17,9.0,5.0,4.0
6343,3,1,2,3,0,3,8,410,3.0,1.0,2.0,3.0,0.0,3.0,6.0,14,3,11,5.0,3.0,2.0
9207211,5,5,0,0,5,0,0,217,2.0,2.0,0.0,0.0,2.0,0.0,0.0,5,5,0,2.0,2.0,0.0
8048,4,4,0,0,4,0,0,108,0.0,0.0,0.0,0.0,0.0,0.0,0.0,11,4,7,1.0,0.0,1.0
9307251,0,0,0,0,0,0,0,515,0.0,0.0,0.0,0.0,0.0,0.0,0.0,2,0,2,1.0,0.0,1.0
9708263,8,1,7,9,1,7,7,188,7.0,1.0,6.0,8.0,1.0,6.0,6.0,10,8,2,4.0,4.0,0.0
6206,3,2,1,1,1,2,10,129,2.0,1.0,1.0,1.0,0.0,2.0,10.0,23,3,20,11.0,2.0,9.0
212321,2,2,0,0,0,2,18,1,1.0,1.0,0.0,0.0,0.0,1.0,6.0,31,2,29,10.0,1.0,9.0
112148,7,5,2,2,0,7,17,1,2.0,2.0,0.0,0.0,1.0,1.0,1.0,27,7,20,4.0,0.0,4.0
210035,1,1,0,0,0,1,1,29,0.0,0.0,0.0,0.0,0.0,0.0,0.0,16,1,15,4.0,0.0,4.0
8066,6,2,4,6,1,5,11,31,1.0,1.0,0.0,0.0,0.0,1.0,2.0,12,6,6,5.0,4.0,1.0
9409214,1,1,0,0,0,1,1,19,0.0,0.0,0.0,0.0,0.0,0.0,0.0,7,1,6,1.0,0.0,1.0
105280,3,2,1,2,3,0,0,37,2.0,1.0,1.0,1.0,2.0,0.0,0.0,8,3,5,,,
105291,14,4,10,37,1,13,35,80,12.0,4.0,8.0,26.0,1.0,11.0,28.0,21,14,7,16.0,12.0,4.0
9601216,9,3,6,14,1,8,17,104,6.0,2.0,4.0,12.0,0.0,6.0,6.0,14,9,5,7.0,6.0,1.0
9507358,7,4,3,4,5,2,2,74,3.0,1.0,2.0,2.0,3.0,0.0,0.0,11,7,4,3.0,3.0,0.0
9904402,2,1,1,1,0,2,7,16,0.0,0.0,0.0,0.0,0.0,0.0,0.0,19,2,17,4.0,2.0,2.0
9507318,3,1,2,2,2,1,4,54,1.0,1.0,0.0,0.0,1.0,0.0,0.0,9,3,6,3.0,1.0,2.0
2214,4,2,2,2,0,4,26,42,1.0,1.0,0.0,0.0,0.0,1.0,6.0,37,4,33,14.0,1.0,13.0
204166,12,1,11,32,0,12,149,1,12.0,1.0,11.0,32.0,0.0,12.0,148.0,44,12,32,28.0,11.0,17.0
9610366,2,2,0,0,1,1,2,134,0.0,0.0,0.0,0.0,0.0,0.0,0.0,31,2,29,17.0,0.0,17.0
9507458,1,1,0,0,0,1,1,88,1.0,1.0,0.0,0.0,0.0,1.0,1.0,6,1,5,3.0,1.0,2.0
105214,6,1,5,9,0,6,82,38,6.0,1.0,5.0,9.0,0.0,6.0,82.0,26,6,20,24.0,6.0,18.0
9166,0,0,0,0,0,0,0,355,0.0,0.0,0.0,0.0,0.0,0.0,0.0,4,0,4,3.0,0.0,3.0
9507275,10,9,1,2,9,1,2,229,6.0,6.0,0.0,0.0,5.0,1.0,2.0,13,10,3,6.0,4.0,2.0
9704440,6,1,5,8,3,3,4,213,3.0,1.0,2.0,2.0,0.0,3.0,4.0,8,6,2,6.0,4.0,2.0
204123,11,5,6,9,0,11,47,80,4.0,3.0,1.0,1.0,0.0,4.0,18.0,31,11,20,9.0,4.0,5.0
9801387,4,1,3,5,0,4,29,142,4.0,1.0,3.0,5.0,0.0,4.0,29.0,14,4,10,13.0,4.0,9.0
4109,6,5,1,1,4,2,3,16,2.0,2.0,0.0,0.0,2.0,0.0,0.0,20,6,14,2.0,2.0,0.0
9411212,0,0,0,0,0,0,0,111,0.0,0.0,0.0,0.0,0.0,0.0,0.0,1,0,1,,,
102029,5,3,2,3,0,5,36,4,2.0,2.0,0.0,0.0,0.0,2.0,12.0,48,5,43,10.0,3.0,7.0
203053,2,2,0,0,0,2,16,23,2.0,2.0,0.0,0.0,0.0,2.0,15.0,21,2,19,13.0,1.0,12.0
9704454,3,1,2,2,0,3,6,216,3.0,1.0,2.0,2.0,0.0,3.0,3.0,5,3,2,2.0,2.0,0.0
9908424,8,7,1,2,2,6,7,72,4.0,3.0,1.0,2.0,4.0,0.0,0.0,12,8,4,2.0,2.0,0.0
9511458,1,1,0,0,0,1,3,58,1.0,1.0,0.0,0.0,0.0,1.0,1.0,9,1,8,3.0,1.0,2.0
108057,6,3,3,4,0,6,34,37,3.0,2.0,1.0,1.0,0.0,3.0,18.0,14,6,8,9.0,2.0,7.0
9607278,9,4,5,14,9,0,0,181,7.0,4.0,3.0,7.0,7.0,0.0,0.0,9,9,0,5.0,5.0,0.0
206206,3,2,1,1,0,3,23,4,2.0,1.0,1.0,1.0,0.0,2.0,7.0,22,3,19,5.0,0.0,5.0
11314,20,3,17,56,1,19,174,9,18.0,3.0,15.0,49.0,0.0,18.0,172.0,44,20,24,13.0,7.0,6.0
9604215,3,2,1,1,0,3,9,47,2.0,1.0,1.0,1.0,2.0,0.0,0.0,12,3,9,3.0,2.0,1.0
9407297,0,0,0,0,0,0,0,113,0.0,0.0,0.0,0.0,0.0,0.0,0.0,3,0,3,1.0,0.0,1.0
212132,3,1,2,2,0,3,51,4,2.0,1.0,1.0,1.0,0.0,2.0,33.0,42,3,39,21.0,1.0,20.0
9710295,8,3,5,9,1,7,14,18,2.0,2.0,0.0,0.0,2.0,0.0,0.0,11,8,3,2.0,2.0,0.0
9708231,3,2,1,1,2,1,5,150,1.0,1.0,0.0,0.0,0.0,1.0,4.0,9,3,6,6.0,1.0,5.0
5210,14,2,12,35,0,14,144,68,12.0,1.0,11.0,32.0,0.0,12.0,116.0,38,14,24,27.0,11.0,16.0
9812261,9,4,5,8,1,8,64,113,8.0,3.0,5.0,7.0,0.0,8.0,63.0,24,9,15,19.0,7.0,12.0
104050,4,3,1,1,0,4,29,1,1.0,1.0,0.0,0.0,0.0,1.0,22.0,40,4,36,21.0,1.0,20.0
9057,3,3,0,0,1,2,5,29,0.0,0.0,0.0,0.0,0.0,0.0,0.0,22,3,19,10.0,0.0,10.0
104263,4,1,3,3,0,4,37,55,2.0,1.0,1.0,1.0,0.0,2.0,24.0,33,4,29,14.0,2.0,12.0
9704290,8,7,1,2,4,4,9,204,1.0,1.0,0.0,0.0,0.0,1.0,4.0,15,8,7,5.0,1.0,4.0
9905379,8,3,5,10,0,8,25,25,4.0,2.0,2.0,3.0,0.0,4.0,13.0,18,8,10,10.0,4.0,6.0
9906526,6,3,3,3,4,2,2,269,3.0,1.0,2.0,2.0,2.0,1.0,1.0,9,6,3,4.0,3.0,1.0
9907415,5,5,0,0,4,1,1,397,2.0,2.0,0.0,0.0,1.0,1.0,1.0,9,5,4,3.0,1.0,2.0
9805246,0,0,0,0,0,0,0,5,0.0,0.0,0.0,0.0,0.0,0.0,0.0,18,0,18,11.0,0.0,11.0
9811504,1,1,0,0,0,1,1,1454,0.0,0.0,0.0,0.0,0.0,0.0,0.0,3,1,2,,,
9805489,2,2,0,0,0,2,4,212,1.0,1.0,0.0,0.0,0.0,1.0,2.0,4,2,2,2.0,0.0,2.0
9611238,5,4,1,1,1,4,4,68,3.0,2.0,1.0,1.0,1.0,2.0,2.0,7,5,2,3.0,2.0,1.0
8140,4,4,0,0,2,2,7,166,1.0,1.0,0.0,0.0,0.0,1.0,5.0,16,4,12,4.0,0.0,4.0
9904471,8,6,2,4,2,6,25,49,5.0,3.0,2.0,4.0,0.0,5.0,21.0,17,8,9,9.0,4.0,5.0
9412378,2,1,1,1,2,0,0,433,1.0,1.0,0.0,0.0,1.0,0.0,0.0,2,2,0,1.0,1.0,0.0
6101,3,3,0,0,1,2,2,57,2.0,2.0,0.0,0.0,2.0,0.0,0.0,6,3,3,3.0,2.0,1.0
7086,4,3,1,2,0,4,17,33,1.0,1.0,0.0,0.0,0.0,1.0,6.0,30,4,26,5.0,2.0,3.0
110069,7,3,4,5,2,5,17,11,4.0,1.0,3.0,3.0,0.0,4.0,9.0,13,7,6,3.0,2.0,1.0
9403339,9,3,6,11,4,5,5,116,7.0,3.0,4.0,8.0,4.0,3.0,3.0,11,9,2,8.0,7.0,1.0
7276,4,2,2,3,0,4,42,32,4.0,2.0,2.0,3.0,0.0,4.0,41.0,44,4,40,21.0,4.0,17.0
9901334,17,12,5,7,0,17,68,84,10.0,7.0,3.0,3.0,0.0,10.0,44.0,35,17,18,13.0,6.0,7.0
9607434,4,4,0,0,2,2,3,120,0.0,0.0,0.0,0.0,0.0,0.0,0.0,7,4,3,1.0,1.0,0.0
9402331,2,1,1,1,1,1,1,163,1.0,1.0,0.0,0.0,1.0,0.0,0.0,4,2,2,1.0,1.0,0.0
9311358,2,2,0,0,2,0,0,344,1.0,1.0,0.0,0.0,1.0,0.0,0.0,3,2,1,1.0,0.0,1.0
9710212,2,2,0,0,0,2,12,67,2.0,2.0,0.0,0.0,0.0,2.0,12.0,14,2,12,5.0,0.0,5.0
9904291,12,6,6,14,3,9,35,82,8.0,2.0,6.0,14.0,0.0,8.0,32.0,31,12,19,10.0,5.0,5.0
6202,7,4,3,3,2,5,16,42,3.0,1.0,2.0,2.0,0.0,3.0,9.0,16,7,9,8.0,3.0,5.0
107219,23,10,13,19,6,17,49,106,9.0,4.0,5.0,8.0,0.0,9.0,28.0,37,23,14,14.0,8.0,6.0
9910406,5,3,2,2,0,5,20,145,4.0,2.0,2.0,2.0,0.0,4.0,16.0,17,5,12,9.0,3.0,6.0
9503408,3,2,1,1,1,2,2,103,3.0,2.0,1.0,1.0,1.0,2.0,2.0,4,3,1,4.0,3.0,1.0
9045,1,1,0,0,1,0,0,557,1.0,1.0,0.0,0.0,1.0,0.0,0.0,2,1,1,2.0,1.0,1.0
9609367,2,2,0,0,0,2,3,19,,,,,,,,4,2,2,,,
9501383,4,3,1,1,1,3,3,345,2.0,2.0,0.0,0.0,2.0,0.0,0.0,8,4,4,1.0,1.0,0.0
212202,15,4,11,21,1,14,92,0,6.0,1.0,5.0,9.0,0.0,6.0,46.0,29,15,14,16.0,4.0,12.0
12102,12,5,7,11,3,9,10,64,9.0,4.0,5.0,8.0,0.0,9.0,10.0,16,12,4,6.0,5.0,1.0
9910459,1,1,0,0,0,1,2,194,1.0,1.0,0.0,0.0,0.0,1.0,1.0,3,1,2,2.0,1.0,1.0
9803452,1,1,0,0,1,0,0,870,1.0,1.0,0.0,0.0,1.0,0.0,0.0,1,1,0,1.0,1.0,0.0
9806304,1,1,0,0,0,1,3,1378,0.0,0.0,0.0,0.0,0.0,0.0,0.0,4,1,3,,,
205287,6,4,2,2,0,6,52,7,1.0,1.0,0.0,0.0,0.0,1.0,4.0,37,6,31,13.0,0.0,13.0
211021,3,1,2,2,0,3,89,49,3.0,1.0,2.0,2.0,0.0,3.0,60.0,73,3,70,27.0,3.0,24.0
9912290,4,3,1,1,0,4,24,30,2.0,2.0,0.0,0.0,0.0,2.0,7.0,25,4,21,17.0,1.0,16.0
9711282,1,1,0,0,0,1,18,36,1.0,1.0,0.0,0.0,0.0,1.0,14.0,19,1,18,5.0,1.0,4.0
203148,2,1,1,1,0,2,4,80,2.0,1.0,1.0,1.0,0.0,2.0,2.0,13,2,11,6.0,2.0,4.0
9711256,5,2,3,4,0,5,24,13,4.0,2.0,2.0,3.0,0.0,4.0,17.0,17,5,12,1.0,0.0,1.0
9802344,3,3,0,0,0,3,15,18,0.0,0.0,0.0,0.0,0.0,0.0,0.0,24,3,21,7.0,1.0,6.0
9703364,6,5,1,2,3,3,3,179,3.0,2.0,1.0,2.0,0.0,3.0,3.0,13,6,7,5.0,3.0,2.0
2018,4,1,3,5,4,0,0,7,0.0,0.0,0.0,0.0,0.0,0.0,0.0,17,4,13,7.0,0.0,7.0
302164,1,1,0,0,0,1,4,216,1.0,1.0,0.0,0.0,0.0,1.0,1.0,5,1,4,4.0,1.0,3.0
9808359,1,1,0,0,0,1,1,22,0.0,0.0,0.0,0.0,0.0,0.0,0.0,7,1,6,1.0,0.0,1.0
12217,5,3,2,3,0,5,24,7,2.0,2.0,0.0,0.0,0.0,2.0,5.0,20,5,15,5.0,2.0,3.0
9804266,1,1,0,0,0,1,8,24,1.0,1.0,0.0,0.0,0.0,1.0,7.0,21,1,20,1.0,0.0,1.0
3201,11,3,8,21,0,11,36,161,10.0,2.0,8.0,21.0,0.0,10.0,33.0,19,11,8,8.0,5.0,3.0
202112,5,2,3,5,0,5,29,102,4.0,1.0,3.0,5.0,0.0,4.0,14.0,16,5,11,11.0,4.0,7.0
111066,8,4,4,5,4,4,5,13,0.0,0.0,0.0,0.0,0.0,0.0,0.0,13,8,5,,,
9212273,3,2,1,1,3,0,0,184,1.0,1.0,0.0,0.0,1.0,0.0,0.0,4,3,1,1.0,0.0,1.0
210045,3,3,0,0,0,3,26,9,0.0,0.0,0.0,0.0,0.0,0.0,0.0,42,3,39,6.0,0.0,6.0
9604231,12,5,7,8,1,11,25,123,8.0,3.0,5.0,6.0,0.0,8.0,17.0,17,12,5,7.0,5.0,2.0
106101,6,1,5,7,0,6,22,91,6.0,1.0,5.0,7.0,0.0,6.0,16.0,12,6,6,11.0,6.0,5.0
4141,3,3,0,0,0,3,12,52,1.0,1.0,0.0,0.0,0.0,1.0,5.0,10,3,7,6.0,1.0,5.0
9903201,9,5,4,6,3,6,12,220,6.0,2.0,4.0,6.0,3.0,3.0,3.0,16,9,7,7.0,6.0,1.0
9806427,2,1,1,1,0,2,4,91,0.0,0.0,0.0,0.0,0.0,0.0,0.0,17,2,15,7.0,0.0,7.0
9705284,1,1,0,0,1,0,0,1247,,,,,,,,2,1,1,1.0,1.0,0.0
209137,5,4,1,1,0,5,18,92,1.0,1.0,0.0,0.0,0.0,1.0,5.0,41,5,36,18.0,1.0,17.0
6145,11,2,9,17,1,10,26,31,7.0,1.0,6.0,12.0,1.0,6.0,16.0,30,11,19,6.0,5.0,1.0
9807218,3,3,0,0,1,2,4,71,2.0,2.0,0.0,0.0,0.0,2.0,4.0,5,3,2,4.0,2.0,2.0
9612416,5,5,0,0,4,1,2,155,1.0,1.0,0.0,0.0,0.0,1.0,2.0,8,5,3,2.0,2.0,0.0
9809431,2,2,0,0,0,2,15,24,2.0,2.0,0.0,0.0,0.0,2.0,11.0,22,2,20,,,
204338,2,2,0,0,1,1,3,31,1.0,1.0,0.0,0.0,0.0,1.0,2.0,15,2,13,2.0,0.0,2.0
9701363,3,3,0,0,1,2,2,224,2.0,2.0,0.0,0.0,0.0,2.0,2.0,8,3,5,3.0,2.0,1.0
111147,4,2,2,3,0,4,26,165,4.0,2.0,2.0,3.0,0.0,4.0,23.0,16,4,12,11.0,4.0,7.0
3296,2,2,0,0,2,0,0,497,1.0,1.0,0.0,0.0,1.0,0.0,0.0,8,2,6,2.0,1.0,1.0
209146,2,2,0,0,0,2,7,23,0.0,0.0,0.0,0.0,0.0,0.0,0.0,22,2,20,3.0,0.0,3.0
110353,4,3,1,1,0,4,33,76,3.0,2.0,1.0,1.0,0.0,3.0,11.0,20,4,16,9.0,3.0,6.0
9901217,0,0,0,0,0,0,0,70,,,,,,,,3,0,3,,,
4077,7,5,2,3,1,6,19,0,3.0,2.0,1.0,1.0,0.0,3.0,7.0,28,7,21,6.0,1.0,5.0
9709285,4,4,0,0,2,2,5,21,0.0,0.0,0.0,0.0,0.0,0.0,0.0,25,4,21,3.0,1.0,2.0
9905293,2,2,0,0,0,2,11,2,,,,,,,,11,2,9,,,
9606248,1,1,0,0,1,0,0,100,0.0,0.0,0.0,0.0,0.0,0.0,0.0,4,1,3,,,
9404202,5,4,1,1,5,0,0,132,3.0,2.0,1.0,1.0,3.0,0.0,0.0,5,5,0,2.0,2.0,0.0
9911488,4,4,0,0,1,3,10,15,1.0,1.0,0.0,0.0,0.0,1.0,2.0,24,4,20,2.0,0.0,2.0
4196,3,3,0,0,0,3,14,54,1.0,1.0,0.0,0.0,0.0,1.0,4.0,16,3,13,2.0,1.0,1.0
9904208,4,4,0,0,3,1,1,144,2.0,2.0,0.0,0.0,1.0,1.0,1.0,6,4,2,1.0,1.0,0.0
9812255,1,1,0,0,0,1,2,115,,,,,,,,5,1,4,1.0,1.0,0.0
9406312,9,2,7,19,9,0,0,180,9.0,2.0,7.0,19.0,9.0,0.0,0.0,9,9,0,9.0,9.0,0.0
9807210,1,1,0,0,1,0,0,386,1.0,1.0,0.0,0.0,1.0,0.0,0.0,2,1,1,,,
112346,6,3,3,4,0,6,64,16,1.0,1.0,0.0,0.0,0.0,1.0,15.0,34,6,28,6.0,2.0,4.0
9408323,3,3,0,0,0,3,3,13,,,,,,,,4,3,1,1.0,1.0,0.0
7258,13,5,8,15,0,13,171,11,6.0,2.0,4.0,8.0,0.0,6.0,126.0,46,13,33,29.0,5.0,24.0
9512294,2,2,0,0,0,2,14,124,1.0,1.0,0.0,0.0,0.0,1.0,10.0,23,2,21,13.0,1.0,12.0
109010,3,3,0,0,0,3,25,11,1.0,1.0,0.0,0.0,0.0,1.0,18.0,35,3,32,26.0,1.0,25.0
2062,8,5,3,7,4,4,14,278,4.0,2.0,2.0,4.0,1.0,3.0,6.0,12,8,4,8.0,5.0,3.0
206011,1,1,0,0,0,1,21,23,1.0,1.0,0.0,0.0,0.0,1.0,18.0,40,1,39,21.0,1.0,20.0
107149,7,4,3,3,0,7,13,47,3.0,2.0,1.0,1.0,0.0,3.0,3.0,16,7,9,1.0,1.0,0.0
9407230,2,2,0,0,2,0,0,129,1.0,1.0,0.0,0.0,1.0,0.0,0.0,2,2,0,1.0,1.0,0.0
9809320,7,5,2,3,1,6,11,177,5.0,3.0,2.0,3.0,0.0,5.0,9.0,9,7,2,7.0,5.0,2.0
104182,2,1,1,1,0,2,4,261,2.0,1.0,1.0,1.0,0.0,2.0,4.0,4,2,2,4.0,2.0,2.0
9610501,2,1,1,1,1,1,1,7,2.0,1.0,1.0,1.0,2.0,0.0,0.0,20,2,18,2.0,2.0,0.0
211283,0,0,0,0,0,0,0,55,0.0,0.0,0.0,0.0,0.0,0.0,0.0,61,0,61,22.0,0.0,22.0
1148,6,5,1,1,2,4,10,177,4.0,3.0,1.0,1.0,2.0,2.0,4.0,15,6,9,4.0,2.0,2.0
9409236,2,1,1,1,2,0,0,152,,,,,,,,2,2,0,1.0,1.0,0.0
9806239,5,2,3,3,0,5,20,33,5.0,2.0,3.0,3.0,0.0,5.0,19.0,14,5,9,3.0,1.0,2.0
110208,10,4,6,9,0,10,70,9,7.0,3.0,4.0,7.0,0.0,7.0,30.0,37,10,27,15.0,6.0,9.0
5272,3,3,0,0,2,1,1,38,0.0,0.0,0.0,0.0,0.0,0.0,0.0,23,3,20,3.0,0.0,3.0
9906212,3,2,1,1,0,3,26,6,2.0,2.0,0.0,0.0,0.0,2.0,20.0,25,3,22,10.0,1.0,9.0
9907219,5,1,4,5,1,4,12,121,5.0,1.0,4.0,5.0,1.0,4.0,11.0,9,5,4,7.0,4.0,3.0
9811491,1,1,0,0,0,1,2,34,1.0,1.0,0.0,0.0,0.0,1.0,1.0,10,1,9,,,
204198,0,0,0,0,0,0,0,54,,,,,,,,3,0,3,,,
201253,9,4,5,6,0,9,86,1,6.0,2.0,4.0,5.0,0.0,6.0,55.0,52,9,43,18.0,2.0,16.0
9911380,2,1,1,1,2,0,0,112,2.0,1.0,1.0,1.0,2.0,0.0,0.0,9,2,7,1.0,0.0,1.0
9507221,3,2,1,1,3,0,0,139,1.0,1.0,0.0,0.0,1.0,0.0,0.0,5,3,2,4.0,2.0,2.0
9602416,5,2,3,6,5,0,0,26,2.0,1.0,1.0,1.0,2.0,0.0,0.0,5,5,0,3.0,3.0,0.0
2017,3,3,0,0,3,0,0,1256,,,,,,,,3,3,0,,,
9804423,0,0,0,0,0,0,0,212,0.0,0.0,0.0,0.0,0.0,0.0,0.0,4,0,4,3.0,0.0,3.0
9904500,4,3,1,1,0,4,11,19,2.0,1.0,1.0,1.0,0.0,2.0,4.0,16,4,12,9.0,2.0,7.0
9610254,0,0,0,0,0,0,0,862,,,,,,,,1,0,1,1.0,0.0,1.0
9608279,4,2,2,2,3,1,1,211,0.0,0.0,0.0,0.0,0.0,0.0,0.0,5,4,1,1.0,1.0,0.0
9911537,4,4,0,0,0,4,21,21,3.0,3.0,0.0,0.0,0.0,3.0,13.0,22,4,18,10.0,2.0,8.0
4225,6,3,3,4,1,5,6,185,6.0,3.0,3.0,4.0,1.0,5.0,6.0,8,6,2,5.0,4.0,1.0
9706363,9,7,2,3,0,9,30,31,9.0,7.0,2.0,3.0,0.0,9.0,30.0,13,9,4,11.0,7.0,4.0
9209284,2,2,0,0,2,0,0,384,1.0,1.0,0.0,0.0,1.0,0.0,0.0,2,2,0,,,
106296,0,0,0,0,0,0,0,7,0.0,0.0,0.0,0.0,0.0,0.0,0.0,14,0,14,3.0,0.0,3.0
9901242,7,3,4,5,0,7,19,131,5.0,2.0,3.0,4.0,0.0,5.0,13.0,33,7,26,6.0,5.0,1.0
9808440,2,1,1,1,0,2,14,11,2.0,1.0,1.0,1.0,0.0,2.0,10.0,9,2,7,1.0,1.0,0.0
2284,3,3,0,0,1,2,4,41,2.0,2.0,0.0,0.0,0.0,2.0,3.0,9,3,6,2.0,2.0,0.0
9902417,7,2,5,8,2,5,24,4,3.0,2.0,1.0,2.0,0.0,3.0,15.0,18,7,11,4.0,3.0,1.0
9809285,0,0,0,0,0,0,0,85,0.0,0.0,0.0,0.0,0.0,0.0,0.0,10,0,10,4.0,0.0,4.0
9808418,1,1,0,0,1,0,0,162,0.0,0.0,0.0,0.0,0.0,0.0,0.0,15,1,14,,,
9904386,5,1,4,7,1,4,17,175,4.0,1.0,3.0,6.0,0.0,4.0,14.0,12,5,7,10.0,4.0,6.0
101109,2,1,1,1,2,0,0,457,2.0,1.0,1.0,1.0,2.0,0.0,0.0,2,2,0,2.0,2.0,0.0
9909449,6,4,2,3,0,6,31,16,1.0,1.0,0.0,0.0,0.0,1.0,5.0,27,6,21,7.0,1.0,6.0
109034,8,3,5,8,0,8,50,116,6.0,1.0,5.0,8.0,0.0,6.0,38.0,22,8,14,14.0,6.0,8.0
9912405,4,4,0,0,0,4,15,87,1.0,1.0,0.0,0.0,0.0,1.0,4.0,41,4,37,16.0,0.0,16.0
9906278,0,0,0,0,0,0,0,16,0.0,0.0,0.0,0.0,0.0,0.0,0.0,40,0,40,17.0,0.0,17.0
9503483,2,2,0,0,0,2,8,112,2.0,2.0,0.0,0.0,0.0,2.0,5.0,9,2,7,1.0,0.0,1.0
7164,1,1,0,0,0,1,1,29,0.0,0.0,0.0,0.0,0.0,0.0,0.0,22,1,21,2.0,0.0,2.0
2051,6,3,3,3,4,2,2,171,4.0,1.0,3.0,3.0,2.0,2.0,2.0,14,6,8,5.0,4.0,1.0
108095,3,2,1,1,0,3,19,9,3.0,2.0,1.0,1.0,0.0,3.0,9.0,27,3,24,10.0,3.0,7.0
212064,4,3,1,1,0,4,13,312,1.0,1.0,0.0,0.0,0.0,1.0,4.0,28,4,24,8.0,1.0,7.0
9803291,0,0,0,0,0,0,0,112,0.0,0.0,0.0,0.0,0.0,0.0,0.0,5,0,5,4.0,0.0,4.0
9607415,1,1,0,0,0,1,1,5,0.0,0.0,0.0,0.0,0.0,0.0,0.0,32,1,31,1.0,1.0,0.0
9804295,9,2,7,19,0,9,44,9,9.0,2.0,7.0,19.0,0.0,9.0,33.0,21,9,12,11.0,9.0,2.0
4041,2,1,1,1,0,2,6,51,2.0,1.0,1.0,1.0,0.0,2.0,2.0,16,2,14,3.0,0.0,3.0
9705415,0,0,0,0,0,0,0,68,0.0,0.0,0.0,0.0,0.0,0.0,0.0,8,0,8,1.0,0.0,1.0
9712425,10,6,4,4,4,6,9,31,4.0,3.0,1.0,1.0,3.0,1.0,1.0,16,10,6,5.0,4.0,1.0
7234,8,5,3,3,1,7,40,122,6.0,4.0,2.0,2.0,0.0,6.0,33.0,18,8,10,13.0,5.0,8.0
9904439,3,2,1,1,3,0,0,31,3.0,2.0,1.0,1.0,3.0,0.0,0.0,7,3,4,4.0,0.0,4.0
212236,0,0,0,0,0,0,0,48,0.0,0.0,0.0,0.0,0.0,0.0,0.0,12,0,12,6.0,0.0,6.0
12015,15,4,11,25,0,15,60,51,13.0,2.0,11.0,25.0,1.0,12.0,40.0,29,15,14,17.0,11.0,6.0
11118,2,2,0,0,0,2,2,2045,,,,,,,,4,2,2,,,
104309,3,3,0,0,0,3,23,17,1.0,1.0,0.0,0.0,0.0,1.0,12.0,19,3,16,6.0,1.0,5.0
106197,2,2,0,0,1,1,2,84,0.0,0.0,0.0,0.0,0.0,0.0,0.0,13,2,11,8.0,0.0,8.0
9809484,1,1,0,0,0,1,21,5,1.0,1.0,0.0,0.0,0.0,1.0,14.0,24,1,23,4.0,0.0,4.0
9809340,4,3,1,1,0,4,16,22,1.0,1.0,0.0,0.0,0.0,1.0,6.0,23,4,19,4.0,1.0,3.0
9711320,0,0,0,0,0,0,0,138,0.0,0.0,0.0,0.0,0.0,0.0,0.0,2,0,2,1.0,0.0,1.0
201055,4,2,2,3,0,4,41,7,4.0,2.0,2.0,3.0,0.0,4.0,28.0,29,4,25,7.0,0.0,7.0
9909422,4,3,1,2,2,2,4,41,3.0,2.0,1.0,2.0,1.0,2.0,2.0,7,4,3,2.0,2.0,0.0
9807329,2,2,0,0,0,2,10,17,0.0,0.0,0.0,0.0,0.0,0.0,0.0,17,2,15,3.0,1.0,2.0
11335,5,3,2,3,3,2,5,280,3.0,2.0,1.0,1.0,1.0,2.0,3.0,22,5,17,6.0,2.0,4.0
206196,2,2,0,0,0,2,13,38,2.0,2.0,0.0,0.0,0.0,2.0,13.0,23,2,21,17.0,1.0,16.0
9603425,0,0,0,0,0,0,0,1603,,,,,,,,2,0,2,,,
105231,2,2,0,0,0,2,10,51,0.0,0.0,0.0,0.0,0.0,0.0,0.0,20,2,18,3.0,0.0,3.0
110358,1,1,0,0,1,0,0,31,1.0,1.0,0.0,0.0,1.0,0.0,0.0,7,1,6,1.0,1.0,0.0
9309297,6,2,4,12,6,0,0,34,6.0,2.0,4.0,12.0,6.0,0.0,0.0,6,6,0,6.0,6.0,0.0
203130,1,1,0,0,1,0,0,1438,,,,,,,,2,1,1,,,
107055,2,2,0,0,0,2,10,37,1.0,1.0,0.0,0.0,0.0,1.0,2.0,20,2,18,4.0,1.0,3.0
9611427,0,0,0,0,0,0,0,6,,,,,,,,12,0,12,1.0,0.0,1.0
9911259,2,2,0,0,2,0,0,666,1.0,1.0,0.0,0.0,1.0,0.0,0.0,2,2,0,1.0,1.0,0.0
9708414,1,1,0,0,1,0,0,40,1.0,1.0,0.0,0.0,1.0,0.0,0.0,2,1,1,1.0,1.0,0.0
9906347,3,2,1,1,0,3,9,120,2.0,2.0,0.0,0.0,0.0,2.0,7.0,7,3,4,6.0,2.0,4.0
9409258,1,1,0,0,1,0,0,1774,1.0,1.0,0.0,0.0,1.0,0.0,0.0,1,1,0,1.0,1.0,0.0
9907353,3,3,0,0,1,2,4,59,1.0,1.0,0.0,0.0,1.0,0.0,0.0,17,3,14,3.0,0.0,3.0
9912365,3,1,2,2,3,0,0,540,3.0,1.0,2.0,2.0,3.0,0.0,0.0,3,3,0,3.0,3.0,0.0
106121,3,2,1,1,3,0,0,400,2.0,1.0,1.0,1.0,2.0,0.0,0.0,7,3,4,2.0,2.0,0.0
9407390,9,2,7,12,1,8,23,17,0.0,0.0,0.0,0.0,0.0,0.0,0.0,16,9,7,3.0,0.0,3.0
1209,5,4,1,2,1,4,9,226,4.0,3.0,1.0,2.0,0.0,4.0,6.0,10,5,5,5.0,4.0,1.0
9807206,4,1,3,6,0,4,9,147,4.0,1.0,3.0,6.0,0.0,4.0,8.0,12,4,8,6.0,4.0,2.0
209142,1,1,0,0,0,1,2,8,0.0,0.0,0.0,0.0,0.0,0.0,0.0,15,1,14,4.0,0.0,4.0
9208262,0,0,0,0,0,0,0,317,0.0,0.0,0.0,0.0,0.0,0.0,0.0,1,0,1,1.0,0.0,1.0
111366,0,0,0,0,0,0,0,21,0.0,0.0,0.0,0.0,0.0,0.0,0.0,9,0,9,6.0,0.0,6.0
9308206,1,1,0,0,0,1,1,47,1.0,1.0,0.0,0.0,0.0,1.0,1.0,3,1,2,1.0,1.0,0.0
111343,7,6,1,2,2,5,15,130,1.0,1.0,0.0,0.0,0.0,1.0,3.0,21,7,14,3.0,1.0,2.0
9810507,1,1,0,0,0,1,5,140,1.0,1.0,0.0,0.0,0.0,1.0,4.0,8,1,7,7.0,1.0,6.0
9610311,6,5,1,1,5,1,1,327,3.0,3.0,0.0,0.0,2.0,1.0,1.0,7,6,1,3.0,2.0,1.0
9806421,1,1,0,0,0,1,1,136,1.0,1.0,0.0,0.0,0.0,1.0,1.0,6,1,5,2.0,0.0,2.0
9702250,1,1,0,0,0,1,2,235,1.0,1.0,0.0,0.0,0.0,1.0,2.0,9,1,8,6.0,1.0,5.0
107023,0,0,0,0,0,0,0,315,0.0,0.0,0.0,0.0,0.0,0.0,0.0,6,0,6,2.0,0.0,2.0
9403406,2,1,1,1,2,0,0,134,2.0,1.0,1.0,1.0,2.0,0.0,0.0,2,2,0,,,
110397,1,1,0,0,0,1,1,23,0.0,0.0,0.0,0.0,0.0,0.0,0.0,26,1,25,1.0,0.0,1.0
111443,1,1,0,0,1,0,0,106,1.0,1.0,0.0,0.0,1.0,0.0,0.0,1,1,0,,,
9707303,3,2,1,1,3,0,0,496,3.0,2.0,1.0,1.0,3.0,0.0,0.0,3,3,0,3.0,3.0,0.0
212367,1,1,0,0,0,1,3,35,0.0,0.0,0.0,0.0,0.0,0.0,0.0,20,1,19,8.0,0.0,8.0
106020,1,1,0,0,0,1,6,25,0.0,0.0,0.0,0.0,0.0,0.0,0.0,30,1,29,8.0,0.0,8.0
9709201,4,2,2,2,2,2,2,167,3.0,1.0,2.0,2.0,3.0,0.0,0.0,12,4,8,3.0,3.0,0.0
4051,9,3,6,14,4,5,13,125,3.0,2.0,1.0,1.0,0.0,3.0,3.0,17,9,8,6.0,4.0,2.0
106272,1,1,0,0,0,1,1,137,0.0,0.0,0.0,0.0,0.0,0.0,0.0,11,1,10,3.0,0.0,3.0
101293,3,2,1,1,1,2,2,166,3.0,2.0,1.0,1.0,1.0,2.0,2.0,4,3,1,4.0,3.0,1.0
111375,1,1,0,0,0,1,7,294,1.0,1.0,0.0,0.0,0.0,1.0,7.0,12,1,11,10.0,1.0,9.0
9607371,4,2,2,3,1,3,6,243,3.0,1.0,2.0,3.0,0.0,3.0,3.0,8,4,4,5.0,3.0,2.0
110238,6,3,3,7,1,5,35,71,5.0,2.0,3.0,6.0,0.0,5.0,32.0,19,6,13,14.0,4.0,10.0
9911326,0,0,0,0,0,0,0,22,0.0,0.0,0.0,0.0,0.0,0.0,0.0,11,0,11,4.0,0.0,4.0
9605218,2,2,0,0,0,2,7,41,1.0,1.0,0.0,0.0,0.0,1.0,3.0,8,2,6,1.0,0.0,1.0
109104,1,1,0,0,1,0,0,259,0.0,0.0,0.0,0.0,0.0,0.0,0.0,4,1,3,1.0,1.0,0.0
10191,3,1,2,2,0,3,54,24,2.0,1.0,1.0,1.0,0.0,2.0,26.0,40,3,37,17.0,3.0,14.0
9902377,2,2,0,0,0,2,2,214,0.0,0.0,0.0,0.0,0.0,0.0,0.0,5,2,3,2.0,0.0,2.0
10110,0,0,0,0,0,0,0,68,0.0,0.0,0.0,0.0,0.0,0.0,0.0,6,0,6,2.0,0.0,2.0
108255,2,2,0,0,0,2,12,30,0.0,0.0,0.0,0.0,0.0,0.0,0.0,17,2,15,3.0,0.0,3.0
101158,8,5,3,3,4,4,15,17,3.0,1.0,2.0,2.0,0.0,3.0,12.0,28,8,20,7.0,3.0,4.0
9806323,2,2,0,0,0,2,8,33,2.0,2.0,0.0,0.0,0.0,2.0,8.0,15,2,13,3.0,0.0,3.0
107275,4,3,1,1,0,4,36,9,3.0,3.0,0.0,0.0,0.0,3.0,26.0,36,4,32,10.0,2.0,8.0
205192,2,2,0,0,2,0,0,177,0.0,0.0,0.0,0.0,0.0,0.0,0.0,9,2,7,1.0,1.0,0.0
210256,0,0,0,0,0,0,0,99,0.0,0.0,0.0,0.0,0.0,0.0,0.0,20,0,20,2.0,0.0,2.0
9602434,3,3,0,0,0,3,5,47,1.0,1.0,0.0,0.0,0.0,1.0,1.0,10,3,7,2.0,1.0,1.0
211175,1,1,0,0,0,1,9,46,1.0,1.0,0.0,0.0,0.0,1.0,8.0,16,1,15,2.0,0.0,2.0
9811476,1,1,0,0,0,1,1,161,1.0,1.0,0.0,0.0,0.0,1.0,1.0,2,1,1,,,
209106,0,0,0,0,0,0,0,63,0.0,0.0,0.0,0.0,0.0,0.0,0.0,8,0,8,1.0,0.0,1.0
9310260,3,2,1,1,0,3,3,207,2.0,1.0,1.0,1.0,2.0,0.0,0.0,4,3,1,2.0,2.0,0.0
9214,2,2,0,0,0,2,12,6,2.0,2.0,0.0,0.0,0.0,2.0,5.0,17,2,15,12.0,2.0,10.0
9907295,1,1,0,0,1,0,0,1905,1.0,1.0,0.0,0.0,1.0,0.0,0.0,1,1,0,,,
202235,2,1,1,1,0,2,4,1,2.0,1.0,1.0,1.0,0.0,2.0,3.0,6,2,4,4.0,2.0,2.0
204207,2,2,0,0,2,0,0,198,1.0,1.0,0.0,0.0,1.0,0.0,0.0,6,2,4,2.0,1.0,1.0
208017,0,0,0,0,0,0,0,36,0.0,0.0,0.0,0.0,0.0,0.0,0.0,3,0,3,,,
9702328,0,0,0,0,0,0,0,155,0.0,0.0,0.0,0.0,0.0,0.0,0.0,7,0,7,5.0,0.0,5.0
107091,1,1,0,0,0,1,4,226,1.0,1.0,0.0,0.0,0.0,1.0,1.0,5,1,4,2.0,1.0,1.0
9709321,0,0,0,0,0,0,0,1556,0.0,0.0,0.0,0.0,0.0,0.0,0.0,3,0,3,2.0,0.0,2.0
212063,0,0,0,0,0,0,0,37,0.0,0.0,0.0,0.0,0.0,0.0,0.0,10,0,10,1.0,0.0,1.0
9710385,2,2,0,0,0,2,9,179,2.0,2.0,0.0,0.0,0.0,2.0,2.0,10,2,8,3.0,2.0,1.0
207244,1,1,0,0,0,1,6,42,1.0,1.0,0.0,0.0,0.0,1.0,3.0,28,1,27,11.0,0.0,11.0
9703222,3,2,1,1,2,1,1,266,1.0,1.0,0.0,0.0,0.0,1.0,1.0,5,3,2,2.0,2.0,0.0
6166,2,2,0,0,2,0,0,150,1.0,1.0,0.0,0.0,1.0,0.0,0.0,4,2,2,1.0,1.0,0.0
9812509,2,2,0,0,1,1,1,84,2.0,2.0,0.0,0.0,1.0,1.0,1.0,7,2,5,2.0,1.0,1.0
105193,1,1,0,0,0,1,1,79,1.0,1.0,0.0,0.0,0.0,1.0,1.0,14,1,13,2.0,0.0,2.0
9208229,1,1,0,0,1,0,0,162,1.0,1.0,0.0,0.0,1.0,0.0,0.0,1,1,0,1.0,1.0,0.0
9502240,1,1,0,0,1,0,0,75,0.0,0.0,0.0,0.0,0.0,0.0,0.0,15,1,14,11.0,0.0,11.0
9409220,1,1,0,0,0,1,1,346,0.0,0.0,0.0,0.0,0.0,0.0,0.0,2,1,1,1.0,0.0,1.0
103108,7,5,2,3,1,6,9,72,7.0,5.0,2.0,3.0,4.0,3.0,3.0,10,7,3,5.0,4.0,1.0
9911403,0,0,0,0,0,0,0,175,0.0,0.0,0.0,0.0,0.0,0.0,0.0,8,0,8,2.0,0.0,2.0
9711441,7,1,6,12,0,7,20,4,2.0,1.0,1.0,1.0,0.0,2.0,2.0,20,7,13,6.0,3.0,3.0
102233,2,1,1,1,0,2,6,102,2.0,1.0,1.0,1.0,0.0,2.0,2.0,8,2,6,,,
9902402,2,2,0,0,2,0,0,111,2.0,2.0,0.0,0.0,2.0,0.0,0.0,2,2,0,2.0,2.0,0.0
9501368,2,1,1,1,0,2,5,14,2.0,1.0,1.0,1.0,0.0,2.0,2.0,7,2,5,,,
102300,1,1,0,0,0,1,2,89,1.0,1.0,0.0,0.0,0.0,1.0,2.0,4,1,3,4.0,1.0,3.0
9904227,3,1,2,3,0,3,3,65,3.0,1.0,2.0,3.0,3.0,0.0,0.0,4,3,1,3.0,3.0,0.0
9409322,0,0,0,0,0,0,0,563,0.0,0.0,0.0,0.0,0.0,0.0,0.0,1,0,1,1.0,0.0,1.0
203193,0,0,0,0,0,0,0,13,0.0,0.0,0.0,0.0,0.0,0.0,0.0,17,0,17,2.0,0.0,2.0
206028,1,1,0,0,0,1,5,106,1.0,1.0,0.0,0.0,0.0,1.0,4.0,6,1,5,4.0,1.0,3.0
9909237,7,4,3,5,1,6,8,139,2.0,1.0,1.0,1.0,0.0,2.0,3.0,10,7,3,4.0,2.0,2.0
9611298,1,1,0,0,0,1,1,300,1.0,1.0,0.0,0.0,1.0,0.0,0.0,6,1,5,,,
9701240,2,1,1,1,1,1,1,103,1.0,1.0,0.0,0.0,0.0,1.0,1.0,9,2,7,2.0,1.0,1.0
302252,0,0,0,0,0,0,0,370,0.0,0.0,0.0,0.0,0.0,0.0,0.0,1,0,1,1.0,0.0,1.0
105153,0,0,0,0,0,0,0,310,0.0,0.0,0.0,0.0,0.0,0.0,0.0,14,0,14,2.0,0.0,2.0
1050,2,1,1,1,0,2,8,11,0.0,0.0,0.0,0.0,0.0,0.0,0.0,19,2,17,4.0,0.0,4.0
110265,0,0,0,0,0,0,0,177,0.0,0.0,0.0,0.0,0.0,0.0,0.0,4,0,4,,,
9901444,6,2,4,6,2,4,10,244,5.0,1.0,4.0,5.0,2.0,3.0,8.0,10,6,4,9.0,6.0,3.0
9903321,0,0,0,0,0,0,0,252,0.0,0.0,0.0,0.0,0.0,0.0,0.0,2,0,2,1.0,0.0,1.0
9512402,0,0,0,0,0,0,0,787,0.0,0.0,0.0,0.0,0.0,0.0,0.0,1,0,1,1.0,0.0,1.0
9506247,0,0,0,0,0,0,0,386,0.0,0.0,0.0,0.0,0.0,0.0,0.0,2,0,2,2.0,0.0,2.0
4093,2,1,1,1,1,1,4,22,0.0,0.0,0.0,0.0,0.0,0.0,0.0,6,2,4,2.0,0.0,2.0
206141,1,1,0,0,0,1,4,31,0.0,0.0,0.0,0.0,0.0,0.0,0.0,18,1,17,4.0,0.0,4.0
302137,0,0,0,0,0,0,0,59,0.0,0.0,0.0,0.0,0.0,0.0,0.0,13,0,13,3.0,0.0,3.0
207159,0,0,0,0,0,0,0,109,0.0,0.0,0.0,0.0,0.0,0.0,0.0,5,0,5,2.0,0.0,2.0
201255,2,1,1,1,1,1,2,71,2.0,1.0,1.0,1.0,1.0,1.0,1.0,16,2,14,6.0,0.0,6.0
11267,0,0,0,0,0,0,0,22,0.0,0.0,0.0,0.0,0.0,0.0,0.0,14,0,14,9.0,0.0,9.0
8030,1,1,0,0,0,1,3,171,1.0,1.0,0.0,0.0,0.0,1.0,2.0,4,1,3,2.0,1.0,1.0
9906320,2,2,0,0,2,0,0,334,1.0,1.0,0.0,0.0,1.0,0.0,0.0,4,2,2,1.0,1.0,0.0
201215,0,0,0,0,0,0,0,2,0.0,0.0,0.0,0.0,0.0,0.0,0.0,8,0,8,2.0,0.0,2.0
9905401,0,0,0,0,0,0,0,509,0.0,0.0,0.0,0.0,0.0,0.0,0.0,5,0,5,1.0,0.0,1.0
204055,1,1,0,0,0,1,3,80,1.0,1.0,0.0,0.0,0.0,1.0,2.0,7,1,6,3.0,1.0,2.0
11399,1,1,0,0,0,1,1,569,1.0,1.0,0.0,0.0,0.0,1.0,1.0,2,1,1,2.0,1.0,1.0
104125,0,0,0,0,0,0,0,22,0.0,0.0,0.0,0.0,0.0,0.0,0.0,14,0,14,1.0,0.0,1.0
203093,3,3,0,0,0,3,9,498,1.0,1.0,0.0,0.0,1.0,0.0,0.0,14,3,11,3.0,0.0,3.0
106268,0,0,0,0,0,0,0,2,0.0,0.0,0.0,0.0,0.0,0.0,0.0,9,0,9,1.0,0.0,1.0
9608232,0,0,0,0,0,0,0,537,0.0,0.0,0.0,0.0,0.0,0.0,0.0,4,0,4,2.0,0.0,2.0
301095,1,1,0,0,0,1,11,46,1.0,1.0,0.0,0.0,0.0,1.0,6.0,42,1,41,2.0,0.0,2.0
204294,0,0,0,0,0,0,0,42,0.0,0.0,0.0,0.0,0.0,0.0,0.0,17,0,17,9.0,0.0,9.0
211402,0,0,0,0,0,0,0,27,0.0,0.0,0.0,0.0,0.0,0.0,0.0,15,0,15,5.0,0.0,5.0
9610475,0,0,0,0,0,0,0,239,0.0,0.0,0.0,0.0,0.0,0.0,0.0,2,0,2,1.0,0.0,1.0
12111,0,0,0,0,0,0,0,1829,,,,,,,,6,0,6,,,
9504359,1,1,0,0,1,0,0,276,0.0,0.0,0.0,0.0,0.0,0.0,0.0,2,1,1,1.0,1.0,0.0
9906372,0,0,0,0,0,0,0,83,0.0,0.0,0.0,0.0,0.0,0.0,0.0,8,0,8,,,
203205,1,1,0,0,0,1,1,132,1.0,1.0,0.0,0.0,0.0,1.0,1.0,3,1,2,2.0,1.0,1.0
9811422,1,1,0,0,1,0,0,337,1.0,1.0,0.0,0.0,1.0,0.0,0.0,2,1,1,1.0,1.0,0.0
209264,3,3,0,0,0,3,10,70,2.0,2.0,0.0,0.0,0.0,2.0,4.0,18,3,15,8.0,3.0,5.0
9810460,1,1,0,0,0,1,3,66,0.0,0.0,0.0,0.0,0.0,0.0,0.0,17,1,16,,,
12172,1,1,0,0,0,1,1,6,1.0,1.0,0.0,0.0,1.0,0.0,0.0,12,1,11,1.0,0.0,1.0
9906315,0,0,0,0,0,0,0,272,0.0,0.0,0.0,0.0,0.0,0.0,0.0,5,0,5,3.0,0.0,3.0
9309222,1,1,0,0,1,0,0,41,0.0,0.0,0.0,0.0,0.0,0.0,0.0,6,1,5,4.0,0.0,4.0
212295,1,1,0,0,0,1,4,45,1.0,1.0,0.0,0.0,0.0,1.0,4.0,11,1,10,1.0,0.0,1.0
9508341,0,0,0,0,0,0,0,572,0.0,0.0,0.0,0.0,0.0,0.0,0.0,2,0,2,1.0,0.0,1.0
106171,0,0,0,0,0,0,0,27,0.0,0.0,0.0,0.0,0.0,0.0,0.0,10,0,10,,,
211466,0,0,0,0,0,0,0,70,0.0,0.0,0.0,0.0,0.0,0.0,0.0,7,0,7,4.0,0.0,4.0
211444,2,1,1,1,0,2,16,9,1.0,1.0,0.0,0.0,0.0,1.0,13.0,20,2,18,4.0,1.0,3.0
9708381,0,0,0,0,0,0,0,15,0.0,0.0,0.0,0.0,0.0,0.0,0.0,15,0,15,8.0,0.0,8.0
9809482,0,0,0,0,0,0,0,101,0.0,0.0,0.0,0.0,0.0,0.0,0.0,4,0,4,1.0,0.0,1.0
8119,1,1,0,0,1,0,0,375,0.0,0.0,0.0,0.0,0.0,0.0,0.0,4,1,3,3.0,0.0,3.0
9612360,0,0,0,0,0,0,0,52,0.0,0.0,0.0,0.0,0.0,0.0,0.0,7,0,7,7.0,0.0,7.0
4063,3,3,0,0,1,2,7,126,2.0,2.0,0.0,0.0,0.0,2.0,7.0,7,3,4,6.0,2.0,4.0
101178,1,1,0,0,0,1,1,90,0.0,0.0,0.0,0.0,0.0,0.0,0.0,19,1,18,11.0,0.0,11.0
208216,0,0,0,0,0,0,0,1975,0.0,0.0,0.0,0.0,0.0,0.0,0.0,7,0,7,1.0,0.0,1.0
9812265,0,0,0,0,0,0,0,54,0.0,0.0,0.0,0.0,0.0,0.0,0.0,10,0,10,,,
301184,0,0,0,0,0,0,0,46,0.0,0.0,0.0,0.0,0.0,0.0,0.0,33,0,33,9.0,0.0,9.0
206092,3,3,0,0,2,1,4,18,2.0,2.0,0.0,0.0,2.0,0.0,0.0,11,3,8,2.0,2.0,0.0
205114,1,1,0,0,0,1,17,5,1.0,1.0,0.0,0.0,0.0,1.0,10.0,66,1,65,9.0,1.0,8.0
5018,2,1,1,1,2,0,0,169,2.0,1.0,1.0,1.0,2.0,0.0,0.0,7,2,5,,,
201079,5,2,3,4,0,5,23,64,3.0,2.0,1.0,1.0,0.0,3.0,13.0,23,5,18,10.0,4.0,6.0
302243,0,0,0,0,0,0,0,0,0.0,0.0,0.0,0.0,0.0,0.0,0.0,22,0,22,12.0,0.0,12.0
204297,1,1,0,0,0,1,12,2,1.0,1.0,0.0,0.0,0.0,1.0,6.0,25,1,24,3.0,0.0,3.0
5243,0,0,0,0,0,0,0,39,0.0,0.0,0.0,0.0,0.0,0.0,0.0,22,0,22,17.0,0.0,17.0
9802417,0,0,0,0,0,0,0,344,0.0,0.0,0.0,0.0,0.0,0.0,0.0,1,0,1,1.0,0.0,1.0
9712423,0,0,0,0,0,0,0,148,,,,,,,,1,0,1,,,
208084,1,1,0,0,0,1,10,26,1.0,1.0,0.0,0.0,0.0,1.0,2.0,21,1,20,6.0,1.0,5.0
112288,0,0,0,0,0,0,0,12,0.0,0.0,0.0,0.0,0.0,0.0,0.0,25,0,25,2.0,0.0,2.0
12147,0,0,0,0,0,0,0,65,0.0,0.0,0.0,0.0,0.0,0.0,0.0,3,0,3,2.0,0.0,2.0
9407201,0,0,0,0,0,0,0,108,0.0,0.0,0.0,0.0,0.0,0.0,0.0,1,0,1,,,
211166,0,0,0,0,0,0,0,498,0.0,0.0,0.0,0.0,0.0,0.0,0.0,6,0,6,2.0,0.0,2.0
212354,1,1,0,0,0,1,3,37,0.0,0.0,0.0,0.0,0.0,0.0,0.0,11,1,10,2.0,1.0,1.0
6012,3,1,2,2,1,2,10,110,3.0,1.0,2.0,2.0,1.0,2.0,6.0,12,3,9,9.0,2.0,7.0
205348,1,1,0,0,0,1,10,136,1.0,1.0,0.0,0.0,0.0,1.0,9.0,24,1,23,10.0,1.0,9.0
208213,1,1,0,0,0,1,2,226,1.0,1.0,0.0,0.0,0.0,1.0,2.0,5,1,4,4.0,1.0,3.0
9801450,0,0,0,0,0,0,0,1219,0.0,0.0,0.0,0.0,0.0,0.0,0.0,1,0,1,,,
9909468,0,0,0,0,0,0,0,217,0.0,0.0,0.0,0.0,0.0,0.0,0.0,7,0,7,1.0,0.0,1.0
205157,1,1,0,0,0,1,17,29,1.0,1.0,0.0,0.0,0.0,1.0,10.0,25,1,24,6.0,1.0,5.0
111029,0,0,0,0,0,0,0,1636,0.0,0.0,0.0,0.0,0.0,0.0,0.0,5,0,5,,,
212364,0,0,0,0,0,0,0,1360,0.0,0.0,0.0,0.0,0.0,0.0,0.0,3,0,3,,,
9706204,0,0,0,0,0,0,0,90,0.0,0.0,0.0,0.0,0.0,0.0,0.0,6,0,6,4.0,0.0,4.0
207189,1,1,0,0,0,1,2,58,0.0,0.0,0.0,0.0,0.0,0.0,0.0,8,1,7,2.0,0.0,2.0
8291,1,1,0,0,0,1,17,151,1.0,1.0,0.0,0.0,0.0,1.0,9.0,20,1,19,10.0,1.0,9.0
9307215,1,1,0,0,1,0,0,120,1.0,1.0,0.0,0.0,1.0,0.0,0.0,1,1,0,,,
207048,0,0,0,0,0,0,0,1916,,,,,,,,2,0,2,,,
111451,0,0,0,0,0,0,0,767,0.0,0.0,0.0,0.0,0.0,0.0,0.0,3,0,3,3.0,0.0,3.0
207295,0,0,0,0,0,0,0,219,0.0,0.0,0.0,0.0,0.0,0.0,0.0,5,0,5,2.0,0.0,2.0
105022,1,1,0,0,0,1,3,52,1.0,1.0,0.0,0.0,0.0,1.0,2.0,8,1,7,1.0,1.0,0.0
9908259,0,0,0,0,0,0,0,51,,,,,,,,3,0,3,,,
207223,0,0,0,0,0,0,0,113,0.0,0.0,0.0,0.0,0.0,0.0,0.0,3,0,3,2.0,0.0,2.0
9704233,0,0,0,0,0,0,0,13,0.0,0.0,0.0,0.0,0.0,0.0,0.0,8,0,8,2.0,0.0,2.0
9912422,1,1,0,0,1,0,0,350,0.0,0.0,0.0,0.0,0.0,0.0,0.0,2,1,1,1.0,0.0,1.0
302105,0,0,0,0,0,0,0,393,0.0,0.0,0.0,0.0,0.0,0.0,0.0,9,0,9,4.0,0.0,4.0
102008,3,3,0,0,1,2,2,142,1.0,1.0,0.0,0.0,0.0,1.0,1.0,9,3,6,6.0,1.0,5.0
201095,1,1,0,0,0,1,3,90,1.0,1.0,0.0,0.0,0.0,1.0,3.0,7,1,6,4.0,1.0,3.0
112047,0,0,0,0,0,0,0,199,0.0,0.0,0.0,0.0,0.0,0.0,0.0,4,0,4,2.0,0.0,2.0
9609291,0,0,0,0,0,0,0,439,0.0,0.0,0.0,0.0,0.0,0.0,0.0,1,0,1,,,
6317,0,0,0,0,0,0,0,119,0.0,0.0,0.0,0.0,0.0,0.0,0.0,7,0,7,1.0,0.0,1.0
9902455,0,0,0,0,0,0,0,456,0.0,0.0,0.0,0.0,0.0,0.0,0.0,6,0,6,,,
108101,1,1,0,0,0,1,5,99,1.0,1.0,0.0,0.0,0.0,1.0,5.0,11,1,10,7.0,1.0,6.0
107314,1,1,0,0,0,1,2,15,0.0,0.0,0.0,0.0,0.0,0.0,0.0,24,1,23,1.0,0.0,1.0
11038,0,0,0,0,0,0,0,27,0.0,0.0,0.0,0.0,0.0,0.0,0.0,16,0,16,6.0,0.0,6.0
9408220,0,0,0,0,0,0,0,1497,0.0,0.0,0.0,0.0,0.0,0.0,0.0,1,0,1,,,
210416,1,1,0,0,0,1,5,95,1.0,1.0,0.0,0.0,0.0,1.0,2.0,22,1,21,3.0,0.0,3.0
206111,0,0,0,0,0,0,0,259,0.0,0.0,0.0,0.0,0.0,0.0,0.0,8,0,8,1.0,0.0,1.0
211094,0,0,0,0,0,0,0,70,0.0,0.0,0.0,0.0,0.0,0.0,0.0,3,0,3,1.0,0.0,1.0
9909300,1,1,0,0,0,1,7,130,1.0,1.0,0.0,0.0,0.0,1.0,7.0,14,1,13,10.0,0.0,10.0
212187,0,0,0,0,0,0,0,195,0.0,0.0,0.0,0.0,0.0,0.0,0.0,9,0,9,3.0,0.0,3.0
211382,1,1,0,0,0,1,14,49,0.0,0.0,0.0,0.0,0.0,0.0,0.0,39,1,38,20.0,0.0,20.0
9309278,0,0,0,0,0,0,0,237,0.0,0.0,0.0,0.0,0.0,0.0,0.0,2,0,2,2.0,0.0,2.0
203018,0,0,0,0,0,0,0,34,,,,,,,,10,0,10,1.0,0.0,1.0
9710387,0,0,0,0,0,0,0,97,0.0,0.0,0.0,0.0,0.0,0.0,0.0,6,0,6,3.0,0.0,3.0
10005,0,0,0,0,0,0,0,812,0.0,0.0,0.0,0.0,0.0,0.0,0.0,1,0,1,1.0,0.0,1.0
210297,0,0,0,0,0,0,0,378,0.0,0.0,0.0,0.0,0.0,0.0,0.0,4,0,4,2.0,0.0,2.0
210227,0,0,0,0,0,0,0,20,0.0,0.0,0.0,0.0,0.0,0.0,0.0,32,0,32,6.0,0.0,6.0
301120,0,0,0,0,0,0,0,67,0.0,0.0,0.0,0.0,0.0,0.0,0.0,18,0,18,13.0,0.0,13.0
208195,0,0,0,0,0,0,0,16,0.0,0.0,0.0,0.0,0.0,0.0,0.0,33,0,33,15.0,0.0,15.0
9612309,3,3,0,0,1,2,2,132,1.0,1.0,0.0,0.0,1.0,0.0,0.0,5,3,2,,,
101310,1,1,0,0,1,0,0,335,1.0,1.0,0.0,0.0,1.0,0.0,0.0,7,1,6,1.0,1.0,0.0
207232,0,0,0,0,0,0,0,2,0.0,0.0,0.0,0.0,0.0,0.0,0.0,15,0,15,9.0,0.0,9.0
9503267,0,0,0,0,0,0,0,478,0.0,0.0,0.0,0.0,0.0,0.0,0.0,3,0,3,1.0,0.0,1.0
212400,0,0,0,0,0,0,0,156,0.0,0.0,0.0,0.0,0.0,0.0,0.0,6,0,6,6.0,0.0,6.0
9309300,0,0,0,0,0,0,0,298,0.0,0.0,0.0,0.0,0.0,0.0,0.0,2,0,2,,,
210213,2,2,0,0,0,2,8,80,1.0,1.0,0.0,0.0,0.0,1.0,6.0,19,2,17,4.0,0.0,4.0
104299,0,0,0,0,0,0,0,72,,,,,,,,2,0,2,,,
9608298,0,0,0,0,0,0,0,311,0.0,0.0,0.0,0.0,0.0,0.0,0.0,4,0,4,1.0,0.0,1.0
9501321,0,0,0,0,0,0,0,153,0.0,0.0,0.0,0.0,0.0,0.0,0.0,1,0,1,,,
208255,0,0,0,0,0,0,0,383,0.0,0.0,0.0,0.0,0.0,0.0,0.0,5,0,5,5.0,0.0,5.0
9703461,0,0,0,0,0,0,0,348,0.0,0.0,0.0,0.0,0.0,0.0,0.0,2,0,2,2.0,0.0,2.0
9407262,0,0,0,0,0,0,0,1923,,,,,,,,1,0,1,,,
9304221,1,1,0,0,1,0,0,708,1.0,1.0,0.0,0.0,1.0,0.0,0.0,1,1,0,1.0,1.0,0.0
9705424,0,0,0,0,0,0,0,48,0.0,0.0,0.0,0.0,0.0,0.0,0.0,10,0,10,6.0,0.0,6.0
112316,0,0,0,0,0,0,0,111,0.0,0.0,0.0,0.0,0.0,0.0,0.0,7,0,7,5.0,0.0,5.0
212045,0,0,0,0,0,0,0,110,0.0,0.0,0.0,0.0,0.0,0.0,0.0,5,0,5,4.0,0.0,4.0
302078,2,1,1,1,0,2,6,2,2.0,1.0,1.0,1.0,0.0,2.0,2.0,34,2,32,10.0,0.0,10.0
12344,0,0,0,0,0,0,0,65,0.0,0.0,0.0,0.0,0.0,0.0,0.0,5,0,5,2.0,0.0,2.0
12280,0,0,0,0,0,0,0,1510,,,,,,,,1,0,1,,,
9510374,0,0,0,0,0,0,0,326,0.0,0.0,0.0,0.0,0.0,0.0,0.0,1,0,1,1.0,0.0,1.0
9711432,1,1,0,0,1,0,0,243,1.0,1.0,0.0,0.0,1.0,0.0,0.0,4,1,3,1.0,1.0,0.0
9710306,0,0,0,0,0,0,0,191,0.0,0.0,0.0,0.0,0.0,0.0,0.0,2,0,2,2.0,0.0,2.0
302189,0,0,0,0,0,0,0,2,0.0,0.0,0.0,0.0,0.0,0.0,0.0,54,0,54,26.0,0.0,26.0
9708375,0,0,0,0,0,0,0,490,0.0,0.0,0.0,0.0,0.0,0.0,0.0,3,0,3,3.0,0.0,3.0
102258,0,0,0,0,0,0,0,31,0.0,0.0,0.0,0.0,0.0,0.0,0.0,11,0,11,1.0,0.0,1.0
6132,0,0,0,0,0,0,0,1,0.0,0.0,0.0,0.0,0.0,0.0,0.0,31,0,31,18.0,0.0,18.0
105076,1,1,0,0,0,1,7,106,1.0,1.0,0.0,0.0,0.0,1.0,6.0,11,1,10,9.0,1.0,8.0
4058,0,0,0,0,0,0,0,1653,,,,,,,,6,0,6,,,
210121,0,0,0,0,0,0,0,127,0.0,0.0,0.0,0.0,0.0,0.0,0.0,7,0,7,6.0,0.0,6.0
210409,0,0,0,0,0,0,0,9,0.0,0.0,0.0,0.0,0.0,0.0,0.0,27,0,27,2.0,0.0,2.0
209185,1,1,0,0,0,1,1,133,0.0,0.0,0.0,0.0,0.0,0.0,0.0,13,1,12,3.0,0.0,3.0
210439,0,0,0,0,0,0,0,171,0.0,0.0,0.0,0.0,0.0,0.0,0.0,4,0,4,3.0,0.0,3.0
209167,1,1,0,0,0,1,1,473,1.0,1.0,0.0,0.0,1.0,0.0,0.0,3,1,2,2.0,1.0,1.0
301180,0,0,0,0,0,0,0,1,0.0,0.0,0.0,0.0,0.0,0.0,0.0,29,0,29,17.0,0.0,17.0
101141,1,1,0,0,0,1,2,79,0.0,0.0,0.0,0.0,0.0,0.0,0.0,7,1,6,1.0,1.0,0.0
104065,0,0,0,0,0,0,0,202,0.0,0.0,0.0,0.0,0.0,0.0,0.0,3,0,3,2.0,0.0,2.0
301008,0,0,0,0,0,0,0,116,0.0,0.0,0.0,0.0,0.0,0.0,0.0,13,0,13,7.0,0.0,7.0
201072,1,1,0,0,0,1,1,86,0.0,0.0,0.0,0.0,0.0,0.0,0.0,4,1,3,1.0,0.0,1.0
9902265,0,0,0,0,0,0,0,45,0.0,0.0,0.0,0.0,0.0,0.0,0.0,8,0,8,4.0,0.0,4.0
9264,0,0,0,0,0,0,0,786,0.0,0.0,0.0,0.0,0.0,0.0,0.0,2,0,2,1.0,0.0,1.0
105102,1,1,0,0,0,1,2,175,1.0,1.0,0.0,0.0,0.0,1.0,1.0,3,1,2,2.0,1.0,1.0
7057,1,1,0,0,0,1,1,70,1.0,1.0,0.0,0.0,1.0,0.0,0.0,4,1,3,,,
11338,0,0,0,0,0,0,0,343,0.0,0.0,0.0,0.0,0.0,0.0,0.0,2,0,2,1.0,0.0,1.0
9802249,0,0,0,0,0,0,0,323,0.0,0.0,0.0,0.0,0.0,0.0,0.0,4,0,4,3.0,0.0,3.0
9912440,0,0,0,0,0,0,0,16,0.0,0.0,0.0,0.0,0.0,0.0,0.0,10,0,10,6.0,0.0,6.0
210366,0,0,0,0,0,0,0,43,0.0,0.0,0.0,0.0,0.0,0.0,0.0,11,0,11,4.0,0.0,4.0
112342,0,0,0,0,0,0,0,1357,0.0,0.0,0.0,0.0,0.0,0.0,0.0,1,0,1,,,
211151,0,0,0,0,0,0,0,66,0.0,0.0,0.0,0.0,0.0,0.0,0.0,22,0,22,3.0,0.0,3.0
9601223,0,0,0,0,0,0,0,345,0.0,0.0,0.0,0.0,0.0,0.0,0.0,3,0,3,,,
211249,0,0,0,0,0,0,0,157,0.0,0.0,0.0,0.0,0.0,0.0,0.0,5,0,5,1.0,0.0,1.0
202130,0,0,0,0,0,0,0,349,0.0,0.0,0.0,0.0,0.0,0.0,0.0,2,0,2,2.0,0.0,2.0
9307308,0,0,0,0,0,0,0,256,0.0,0.0,0.0,0.0,0.0,0.0,0.0,3,0,3,,,
203174,0,0,0,0,0,0,0,74,0.0,0.0,0.0,0.0,0.0,0.0,0.0,9,0,9,4.0,0.0,4.0
106242,0,0,0,0,0,0,0,382,0.0,0.0,0.0,0.0,0.0,0.0,0.0,8,0,8,3.0,0.0,3.0
9402228,0,0,0,0,0,0,0,214,0.0,0.0,0.0,0.0,0.0,0.0,0.0,1,0,1,1.0,0.0,1.0
9912507,3,2,1,1,0,3,11,421,3.0,2.0,1.0,1.0,3.0,0.0,0.0,8,3,5,3.0,3.0,0.0
109031,0,0,0,0,0,0,0,704,0.0,0.0,0.0,0.0,0.0,0.0,0.0,6,0,6,1.0,0.0,1.0
209275,1,1,0,0,0,1,5,45,0.0,0.0,0.0,0.0,0.0,0.0,0.0,11,1,10,6.0,1.0,5.0
212326,0,0,0,0,0,0,0,0,0.0,0.0,0.0,0.0,0.0,0.0,0.0,28,0,28,12.0,0.0,12.0
9510405,0,0,0,0,0,0,0,200,0.0,0.0,0.0,0.0,0.0,0.0,0.0,6,0,6,4.0,0.0,4.0
9905373,1,1,0,0,0,1,4,23,1.0,1.0,0.0,0.0,0.0,1.0,2.0,13,1,12,5.0,0.0,5.0
204349,0,0,0,0,0,0,0,5,0.0,0.0,0.0,0.0,0.0,0.0,0.0,14,0,14,2.0,0.0,2.0
202224,0,0,0,0,0,0,0,24,0.0,0.0,0.0,0.0,0.0,0.0,0.0,5,0,5,2.0,0.0,2.0
202022,0,0,0,0,0,0,0,12,0.0,0.0,0.0,0.0,0.0,0.0,0.0,27,0,27,3.0,0.0,3.0
111104,0,0,0,0,0,0,0,91,0.0,0.0,0.0,0.0,0.0,0.0,0.0,3,0,3,3.0,0.0,3.0
9705381,0,0,0,0,0,0,0,150,0.0,0.0,0.0,0.0,0.0,0.0,0.0,6,0,6,2.0,0.0,2.0
7229,0,0,0,0,0,0,0,118,0.0,0.0,0.0,0.0,0.0,0.0,0.0,9,0,9,7.0,0.0,7.0
212409,0,0,0,0,0,0,0,388,0.0,0.0,0.0,0.0,0.0,0.0,0.0,6,0,6,2.0,0.0,2.0
9511445,1,1,0,0,1,0,0,422,1.0,1.0,0.0,0.0,1.0,0.0,0.0,4,1,3,1.0,1.0,0.0
9402202,0,0,0,0,0,0,0,223,,,,,,,,3,0,3,1.0,0.0,1.0
212206,1,1,0,0,0,1,7,123,1.0,1.0,0.0,0.0,0.0,1.0,4.0,8,1,7,5.0,1.0,4.0
206265,0,0,0,0,0,0,0,128,0.0,0.0,0.0,0.0,0.0,0.0,0.0,1,0,1,,,
104029,0,0,0,0,0,0,0,180,0.0,0.0,0.0,0.0,0.0,0.0,0.0,8,0,8,1.0,0.0,1.0
9611349,0,0,0,0,0,0,0,132,0.0,0.0,0.0,0.0,0.0,0.0,0.0,3,0,3,2.0,0.0,2.0
9605263,0,0,0,0,0,0,0,77,0.0,0.0,0.0,0.0,0.0,0.0,0.0,8,0,8,6.0,0.0,6.0
9809400,1,1,0,0,1,0,0,1528,1.0,1.0,0.0,0.0,1.0,0.0,0.0,1,1,0,1.0,1.0,0.0
112258,0,0,0,0,0,0,0,727,0.0,0.0,0.0,0.0,0.0,0.0,0.0,1,0,1,1.0,0.0,1.0
302008,0,0,0,0,0,0,0,27,0.0,0.0,0.0,0.0,0.0,0.0,0.0,26,0,26,12.0,0.0,12.0
9309243,0,0,0,0,0,0,0,1602,,,,,,,,2,0,2,,,
102066,0,0,0,0,0,0,0,13,0.0,0.0,0.0,0.0,0.0,0.0,0.0,10,0,10,2.0,0.0,2.0
9407276,0,0,0,0,0,0,0,10,0.0,0.0,0.0,0.0,0.0,0.0,0.0,8,0,8,,,
301144,0,0,0,0,0,0,0,48,0.0,0.0,0.0,0.0,0.0,0.0,0.0,22,0,22,8.0,0.0,8.0
211361,0,0,0,0,0,0,0,106,0.0,0.0,0.0,0.0,0.0,0.0,0.0,8,0,8,,,
9607257,2,1,1,1,0,2,4,97,2.0,1.0,1.0,1.0,0.0,2.0,2.0,4,2,2,2.0,2.0,0.0
9904498,0,0,0,0,0,0,0,356,0.0,0.0,0.0,0.0,0.0,0.0,0.0,1,0,1,,,
207155,0,0,0,0,0,0,0,59,0.0,0.0,0.0,0.0,0.0,0.0,0.0,13,0,13,8.0,0.0,8.0
112016,2,1,1,1,0,2,11,1,2.0,1.0,1.0,1.0,0.0,2.0,3.0,17,2,15,3.0,2.0,1.0
206255,0,0,0,0,0,0,0,47,0.0,0.0,0.0,0.0,0.0,0.0,0.0,17,0,17,8.0,0.0,8.0
9705360,0,0,0,0,0,0,0,22,0.0,0.0,0.0,0.0,0.0,0.0,0.0,4,0,4,4.0,0.0,4.0
105282,0,0,0,0,0,0,0,30,0.0,0.0,0.0,0.0,0.0,0.0,0.0,18,0,18,9.0,0.0,9.0
9712365,0,0,0,0,0,0,0,194,0.0,0.0,0.0,0.0,0.0,0.0,0.0,5,0,5,,,
109286,0,0,0,0,0,0,0,23,,,,,,,,10,0,10,3.0,0.0,3.0
12133,0,0,0,0,0,0,0,53,0.0,0.0,0.0,0.0,0.0,0.0,0.0,4,0,4,2.0,0.0,2.0
203102,0,0,0,0,0,0,0,80,0.0,0.0,0.0,0.0,0.0,0.0,0.0,7,0,7,1.0,0.0,1.0
9409400,0,0,0,0,0,0,0,896,,,,,,,,1,0,1,,,
9069,1,1,0,0,1,0,0,13,0.0,0.0,0.0,0.0,0.0,0.0,0.0,13,1,12,2.0,1.0,1.0
8194,0,0,0,0,0,0,0,217,0.0,0.0,0.0,0.0,0.0,0.0,0.0,8,0,8,5.0,0.0,5.0
9806326,0,0,0,0,0,0,0,8,0.0,0.0,0.0,0.0,0.0,0.0,0.0,9,0,9,2.0,0.0,2.0
210353,0,0,0,0,0,0,0,1,,,,,,,,8,0,8,,,
204195,0,0,0,0,0,0,0,146,0.0,0.0,0.0,0.0,0.0,0.0,0.0,7,0,7,1.0,0.0,1.0
9912381,0,0,0,0,0,0,0,14,0.0,0.0,0.0,0.0,0.0,0.0,0.0,20,0,20,9.0,0.0,9.0
211216,0,0,0,0,0,0,0,19,0.0,0.0,0.0,0.0,0.0,0.0,0.0,23,0,23,5.0,0.0,5.0
107067,0,0,0,0,0,0,0,1180,,,,,,,,2,0,2,,,
9803443,1,1,0,0,0,1,7,68,1.0,1.0,0.0,0.0,0.0,1.0,5.0,8,1,7,4.0,1.0,3.0
301220,0,0,0,0,0,0,0,28,0.0,0.0,0.0,0.0,0.0,0.0,0.0,15,0,15,1.0,0.0,1.0
9511257,0,0,0,0,0,0,0,659,0.0,0.0,0.0,0.0,0.0,0.0,0.0,2,0,2,2.0,0.0,2.0
6137,0,0,0,0,0,0,0,0,0.0,0.0,0.0,0.0,0.0,0.0,0.0,28,0,28,1.0,0.0,1.0
9610291,0,0,0,0,0,0,0,1264,0.0,0.0,0.0,0.0,0.0,0.0,0.0,3,0,3,,,
9610201,0,0,0,0,0,0,0,369,0.0,0.0,0.0,0.0,0.0,0.0,0.0,2,0,2,2.0,0.0,2.0
9409360,0,0,0,0,0,0,0,15,0.0,0.0,0.0,0.0,0.0,0.0,0.0,6,0,6,2.0,0.0,2.0
9212231,0,0,0,0,0,0,0,1030,0.0,0.0,0.0,0.0,0.0,0.0,0.0,1,0,1,,,
111148,0,0,0,0,0,0,0,268,0.0,0.0,0.0,0.0,0.0,0.0,0.0,6,0,6,4.0,0.0,4.0
302135,1,1,0,0,0,1,5,19,1.0,1.0,0.0,0.0,0.0,1.0,5.0,39,1,38,14.0,0.0,14.0
9604433,0,0,0,0,0,0,0,371,0.0,0.0,0.0,0.0,0.0,0.0,0.0,3,0,3,1.0,0.0,1.0
9303242,0,0,0,0,0,0,0,369,0.0,0.0,0.0,0.0,0.0,0.0,0.0,2,0,2,2.0,0.0,2.0
9907313,0,0,0,0,0,0,0,116,0.0,0.0,0.0,0.0,0.0,0.0,0.0,9,0,9,9.0,0.0,9.0
212066,0,0,0,0,0,0,0,155,0.0,0.0,0.0,0.0,0.0,0.0,0.0,20,0,20,10.0,0.0,10.0
204203,0,0,0,0,0,0,0,21,0.0,0.0,0.0,0.0,0.0,0.0,0.0,10,0,10,1.0,0.0,1.0
9070,0,0,0,0,0,0,0,72,0.0,0.0,0.0,0.0,0.0,0.0,0.0,4,0,4,2.0,0.0,2.0
11125,0,0,0,0,0,0,0,34,0.0,0.0,0.0,0.0,0.0,0.0,0.0,39,0,39,30.0,0.0,30.0
9504386,0,0,0,0,0,0,0,1105,,,,,,,,1,0,1,,,
9906414,0,0,0,0,0,0,0,387,0.0,0.0,0.0,0.0,0.0,0.0,0.0,2,0,2,2.0,0.0,2.0
211456,0,0,0,0,0,0,0,105,0.0,0.0,0.0,0.0,0.0,0.0,0.0,46,0,46,11.0,0.0,11.0
204009,0,0,0,0,0,0,0,22,0.0,0.0,0.0,0.0,0.0,0.0,0.0,4,0,4,1.0,0.0,1.0
301103,0,0,0,0,0,0,0,354,0.0,0.0,0.0,0.0,0.0,0.0,0.0,9,0,9,2.0,0.0,2.0
4260,0,0,0,0,0,0,0,5,,,,,,,,9,0,9,1.0,0.0,1.0
9608316,0,0,0,0,0,0,0,345,0.0,0.0,0.0,0.0,0.0,0.0,0.0,7,0,7,3.0,0.0,3.0
106003,0,0,0,0,0,0,0,579,0.0,0.0,0.0,0.0,0.0,0.0,0.0,1,0,1,1.0,0.0,1.0
9608353,0,0,0,0,0,0,0,320,0.0,0.0,0.0,0.0,0.0,0.0,0.0,7,0,7,2.0,0.0,2.0
9710369,0,0,0,0,0,0,0,199,0.0,0.0,0.0,0.0,0.0,0.0,0.0,2,0,2,1.0,0.0,1.0
9708236,0,0,0,0,0,0,0,322,0.0,0.0,0.0,0.0,0.0,0.0,0.0,2,0,2,1.0,0.0,1.0
9302217,62,13,49,218,62,0,0,13,14.0,4.0,10.0,24.0,14.0,0.0,0.0,62,62,0,7.0,7.0,0.0
9211304,189,29,160,1183,189,0,0,34,72.0,7.0,65.0,725.0,72.0,0.0,0.0,189,189,0,49.0,49.0,0.0
9054,4,2,2,3,1,3,16,1,2.0,1.0,1.0,1.0,0.0,2.0,4.0,16,4,12,7.0,3.0,4.0
9805403,69,19,50,147,5,64,362,1,18.0,7.0,11.0,24.0,0.0,18.0,127.0,104,69,35,19.0,11.0,8.0
9307247,225,5,220,1649,84,141,215,6,115.0,3.0,112.0,994.0,24.0,91.0,150.0,229,225,4,42.0,40.0,2.0
9408213,120,9,111,842,62,58,117,7,39.0,3.0,36.0,222.0,24.0,15.0,15.0,130,120,10,21.0,21.0,0.0
9302210,315,72,243,1494,205,110,236,15,76.0,6.0,70.0,771.0,15.0,61.0,150.0,328,315,13,50.0,45.0,5.0
9806501,32,4,28,96,3,29,84,58,14.0,5.0,9.0,18.0,1.0,13.0,27.0,39,32,7,15.0,11.0,4.0
9710245,27,4,23,103,5,22,24,1,5.0,2.0,3.0,6.0,5.0,0.0,0.0,30,27,3,6.0,6.0,0.0
106050,23,12,11,24,3,20,333,7,6.0,3.0,3.0,6.0,0.0,6.0,163.0,140,23,117,44.0,6.0,38.0
9405274,4,3,1,1,2,2,2,538,2.0,2.0,0.0,0.0,1.0,1.0,1.0,5,4,1,3.0,2.0,1.0
206024,9,7,2,3,0,9,76,4,3.0,3.0,0.0,0.0,0.0,3.0,30.0,37,9,28,6.0,3.0,3.0
9505429,21,3,18,44,12,9,16,114,7.0,2.0,5.0,11.0,3.0,4.0,7.0,24,21,3,8.0,6.0,2.0
9809486,6,3,3,6,1,5,7,4,3.0,1.0,2.0,3.0,3.0,0.0,0.0,10,6,4,1.0,0.0,1.0
9158,26,11,15,30,7,19,53,4,6.0,3.0,3.0,5.0,2.0,4.0,7.0,41,26,15,2.0,2.0,0.0
9911385,43,8,35,124,1,42,225,4,21.0,3.0,18.0,55.0,0.0,21.0,93.0,68,43,25,20.0,7.0,13.0
9512264,62,7,55,206,22,40,81,33,20.0,1.0,19.0,61.0,12.0,8.0,9.0,75,62,13,14.0,13.0,1.0
9411426,248,23,225,1480,136,112,244,26,96.0,2.0,94.0,790.0,46.0,50.0,126.0,257,248,9,42.0,42.0,0.0
9610424,10,3,7,23,2,8,23,33,8.0,2.0,6.0,21.0,8.0,0.0,0.0,16,10,6,3.0,3.0,0.0
9707477,41,8,33,148,1,40,310,12,9.0,3.0,6.0,14.0,2.0,7.0,64.0,86,41,45,21.0,6.0,15.0
9807207,16,2,14,26,6,10,10,80,5.0,1.0,4.0,6.0,5.0,0.0,0.0,17,16,1,4.0,4.0,0.0
9907231,143,54,89,210,66,77,126,66,12.0,2.0,10.0,35.0,9.0,3.0,3.0,149,143,6,11.0,11.0,0.0
9207267,12,5,7,9,12,0,0,210,4.0,2.0,2.0,4.0,4.0,0.0,0.0,12,12,0,3.0,3.0,0.0
105239,49,6,43,223,49,0,0,37,18.0,2.0,16.0,99.0,18.0,0.0,0.0,49,49,0,18.0,18.0,0.0
9312303,6,2,4,9,1,5,13,26,4.0,1.0,3.0,6.0,0.0,4.0,8.0,9,6,3,6.0,4.0,2.0
9705400,19,7,12,22,2,17,45,7,4.0,3.0,1.0,1.0,0.0,4.0,4.0,31,19,12,8.0,6.0,2.0
9903417,164,12,152,858,29,135,513,2,44.0,2.0,42.0,176.0,2.0,42.0,239.0,173,164,9,23.0,23.0,0.0
9203215,9,4,5,7,9,0,0,35,5.0,2.0,3.0,5.0,5.0,0.0,0.0,9,9,0,4.0,4.0,0.0
9908402,2,2,0,0,2,0,0,300,0.0,0.0,0.0,0.0,0.0,0.0,0.0,4,2,2,2.0,1.0,1.0
9210242,135,29,106,415,135,0,0,4,20.0,4.0,16.0,54.0,20.0,0.0,0.0,135,135,0,5.0,5.0,0.0
9811291,286,7,279,3300,9,277,1297,2,145.0,4.0,141.0,2017.0,0.0,145.0,890.0,310,286,24,72.0,65.0,7.0
9308347,45,7,38,161,45,0,0,114,23.0,4.0,19.0,97.0,23.0,0.0,0.0,46,45,1,21.0,21.0,0.0
107101,35,7,28,68,7,28,77,4,9.0,1.0,8.0,12.0,1.0,8.0,13.0,45,35,10,11.0,9.0,2.0
203065,4,4,0,0,1,3,15,26,1.0,1.0,0.0,0.0,0.0,1.0,8.0,16,4,12,4.0,1.0,3.0
102263,0,0,0,0,0,0,0,456,0.0,0.0,0.0,0.0,0.0,0.0,0.0,4,0,4,3.0,0.0,3.0
9211240,7,5,2,2,7,0,0,63,2.0,2.0,0.0,0.0,2.0,0.0,0.0,7,7,0,2.0,2.0,0.0
9510310,7,4,3,5,4,3,3,149,1.0,1.0,0.0,0.0,1.0,0.0,0.0,9,7,2,1.0,0.0,1.0
9505426,12,8,4,5,0,12,35,25,2.0,2.0,0.0,0.0,0.0,2.0,5.0,26,12,14,4.0,1.0,3.0
9507424,26,10,16,50,5,21,38,134,8.0,2.0,6.0,17.0,0.0,8.0,9.0,34,26,8,9.0,8.0,1.0
9412265,97,8,89,329,7,90,345,8,23.0,6.0,17.0,49.0,0.0,23.0,163.0,115,97,18,29.0,18.0,11.0
9512399,29,9,20,33,1,28,192,3,13.0,6.0,7.0,14.0,0.0,13.0,73.0,56,29,27,14.0,9.0,5.0
9407248,57,11,46,139,21,36,63,99,17.0,3.0,14.0,34.0,2.0,15.0,29.0,60,57,3,11.0,9.0,2.0
9409369,60,8,52,288,8,52,114,3,13.0,2.0,11.0,25.0,0.0,13.0,27.0,73,60,13,14.0,12.0,2.0
9409372,50,15,35,105,15,35,58,0,13.0,6.0,7.0,13.0,2.0,11.0,20.0,54,50,4,15.0,12.0,3.0
2108,118,11,107,779,17,101,532,0,73.0,5.0,68.0,574.0,9.0,64.0,386.0,145,118,27,53.0,40.0,13.0
9712488,58,4,54,265,21,37,122,3,30.0,2.0,28.0,146.0,30.0,0.0,0.0,76,58,18,22.0,22.0,0.0
9811390,138,11,127,1121,29,109,307,0,77.0,4.0,73.0,772.0,14.0,63.0,168.0,150,138,12,53.0,49.0,4.0
9808205,174,18,156,922,30,144,650,0,42.0,3.0,39.0,229.0,2.0,40.0,141.0,217,174,43,32.0,26.0,6.0
9706309,22,8,14,41,6,16,29,0,9.0,1.0,8.0,28.0,4.0,5.0,5.0,30,22,8,10.0,9.0,1.0
9306212,78,18,60,232,62,16,19,0,23.0,8.0,15.0,58.0,12.0,11.0,14.0,80,78,2,15.0,15.0,0.0
9809554,45,5,40,233,7,38,111,3,38.0,2.0,36.0,211.0,7.0,31.0,95.0,56,45,11,31.0,26.0,5.0
9907390,49,4,45,211,0,49,278,3,35.0,4.0,31.0,155.0,0.0,35.0,186.0,70,49,21,15.0,12.0,3.0
9908513,37,6,31,122,2,35,442,0,16.0,3.0,13.0,52.0,0.0,16.0,271.0,105,37,68,45.0,13.0,32.0
9408277,2,2,0,0,2,0,0,159,1.0,1.0,0.0,0.0,1.0,0.0,0.0,9,2,7,2.0,1.0,1.0
9801368,74,12,62,325,40,34,92,0,9.0,2.0,7.0,21.0,9.0,0.0,0.0,80,74,6,8.0,8.0,0.0
9412278,46,21,25,56,30,16,26,0,6.0,4.0,2.0,3.0,6.0,0.0,0.0,74,46,28,4.0,4.0,0.0
9712238,11,5,6,7,8,3,3,0,1.0,1.0,0.0,0.0,1.0,0.0,0.0,13,11,2,1.0,1.0,0.0
9911258,17,1,16,64,0,17,129,0,17.0,1.0,16.0,64.0,0.0,17.0,121.0,35,17,18,31.0,17.0,14.0
9410326,89,29,60,182,20,69,160,10,20.0,8.0,12.0,34.0,5.0,15.0,31.0,98,89,9,12.0,9.0,3.0
9709494,19,2,17,84,0,19,50,82,17.0,1.0,16.0,75.0,0.0,17.0,46.0,22,19,3,19.0,16.0,3.0
9301239,25,9,16,35,24,1,1,0,12.0,4.0,8.0,19.0,11.0,1.0,1.0,26,25,1,5.0,4.0,1.0
2060,20,3,17,59,0,20,76,81,18.0,3.0,15.0,56.0,0.0,18.0,70.0,27,20,7,19.0,14.0,5.0
9505318,4,3,1,1,3,1,1,81,2.0,1.0,1.0,1.0,2.0,0.0,0.0,5,4,1,1.0,1.0,0.0
9511331,17,7,10,21,11,6,8,51,7.0,2.0,5.0,16.0,7.0,0.0,0.0,24,17,7,7.0,7.0,0.0
9608308,116,20,96,621,24,92,261,46,63.0,5.0,58.0,418.0,3.0,60.0,170.0,126,116,10,33.0,31.0,2.0
9405256,23,8,15,37,6,17,41,3,6.0,3.0,3.0,3.0,2.0,4.0,11.0,30,23,7,11.0,7.0,4.0
9404259,7,4,3,4,3,4,6,33,1.0,1.0,0.0,0.0,0.0,1.0,1.0,10,7,3,3.0,1.0,2.0
9507368,25,9,16,39,2,23,51,10,8.0,4.0,4.0,7.0,1.0,7.0,7.0,43,25,18,7.0,6.0,1.0
9709361,2,2,0,0,0,2,2,225,1.0,1.0,0.0,0.0,0.0,1.0,1.0,9,2,7,2.0,1.0,1.0
9704275,51,6,45,236,9,42,384,36,29.0,6.0,23.0,165.0,0.0,29.0,347.0,68,51,17,42.0,27.0,15.0
12029,2,2,0,0,2,0,0,80,1.0,1.0,0.0,0.0,1.0,0.0,0.0,3,2,1,2.0,2.0,0.0
9606423,83,5,78,321,3,80,184,42,41.0,2.0,39.0,167.0,2.0,39.0,101.0,91,83,8,22.0,19.0,3.0
9501325,33,11,22,49,3,30,109,10,13.0,3.0,10.0,21.0,0.0,13.0,47.0,44,33,11,8.0,6.0,2.0
9304216,40,10,30,72,1,39,84,18,8.0,3.0,5.0,11.0,1.0,7.0,16.0,47,40,7,9.0,5.0,4.0
9610358,68,9,59,271,3,65,456,5,42.0,4.0,38.0,200.0,0.0,42.0,334.0,92,68,24,42.0,31.0,11.0
9705231,7,6,1,1,5,2,4,235,2.0,2.0,0.0,0.0,0.0,2.0,3.0,18,7,11,5.0,1.0,4.0
9308309,70,9,61,315,10,60,182,69,42.0,2.0,40.0,211.0,2.0,40.0,130.0,81,70,11,30.0,25.0,5.0
9807514,8,8,0,0,8,0,0,312,1.0,1.0,0.0,0.0,1.0,0.0,0.0,15,8,7,1.0,1.0,0.0
5133,8,2,6,12,0,8,21,173,7.0,1.0,6.0,12.0,0.0,7.0,12.0,25,8,17,7.0,4.0,3.0
9404283,144,11,133,1367,84,60,99,1,97.0,4.0,93.0,1074.0,52.0,45.0,69.0,148,144,4,38.0,36.0,2.0
9707354,85,8,77,326,2,83,383,1,52.0,4.0,48.0,213.0,1.0,51.0,207.0,109,85,24,34.0,28.0,6.0
105056,41,9,32,89,4,37,198,23,10.0,2.0,8.0,17.0,0.0,10.0,66.0,62,41,21,20.0,8.0,12.0
110194,15,10,5,6,1,14,75,67,5.0,2.0,3.0,4.0,0.0,5.0,41.0,37,15,22,20.0,4.0,16.0
7318,13,2,11,45,13,0,0,62,12.0,1.0,11.0,44.0,12.0,0.0,0.0,14,13,1,10.0,10.0,0.0
9410203,27,5,22,75,16,11,15,5,16.0,1.0,15.0,57.0,12.0,4.0,4.0,29,27,2,3.0,2.0,1.0
9611443,32,7,25,102,7,25,193,5,15.0,3.0,12.0,63.0,0.0,15.0,153.0,51,32,19,27.0,13.0,14.0
9706275,34,9,25,59,5,29,121,5,13.0,3.0,10.0,25.0,0.0,13.0,57.0,50,34,16,11.0,3.0,8.0
9610451,287,66,221,598,160,127,229,104,30.0,2.0,28.0,98.0,9.0,21.0,28.0,327,287,40,14.0,5.0,9.0
9404276,8,5,3,3,8,0,0,348,3.0,1.0,2.0,2.0,3.0,0.0,0.0,9,8,1,2.0,2.0,0.0
9609502,11,10,1,1,1,10,24,93,5.0,4.0,1.0,1.0,0.0,5.0,11.0,17,11,6,7.0,4.0,3.0
9902437,40,6,34,130,5,35,143,13,25.0,2.0,23.0,95.0,2.0,23.0,124.0,53,40,13,27.0,16.0,11.0
105066,14,5,9,16,4,10,56,6,5.0,4.0,1.0,1.0,0.0,5.0,17.0,27,14,13,9.0,2.0,7.0
9705235,65,6,59,238,1,64,564,6,31.0,5.0,26.0,84.0,0.0,31.0,331.0,95,65,30,22.0,15.0,7.0
9901342,12,5,7,9,0,12,77,1,7.0,3.0,4.0,4.0,0.0,7.0,46.0,36,12,24,3.0,0.0,3.0
5015,7,4,3,3,0,7,31,273,3.0,2.0,1.0,1.0,3.0,0.0,0.0,20,7,13,4.0,4.0,0.0
9402227,89,14,75,362,89,0,0,1,29.0,3.0,26.0,137.0,29.0,0.0,0.0,89,89,0,8.0,8.0,0.0
9611347,31,12,19,41,15,16,30,87,7.0,2.0,5.0,9.0,2.0,5.0,8.0,45,31,14,6.0,4.0,2.0
9810475,44,16,28,62,4,40,76,9,10.0,2.0,8.0,18.0,6.0,4.0,4.0,51,44,7,4.0,4.0,0.0
9907549,13,7,6,11,3,10,27,86,2.0,2.0,0.0,0.0,0.0,2.0,7.0,28,13,15,5.0,5.0,0.0
9902362,8,4,4,9,1,7,41,141,6.0,4.0,2.0,5.0,0.0,6.0,21.0,24,8,16,13.0,4.0,9.0
9802286,5,4,1,1,1,4,6,31,3.0,3.0,0.0,0.0,1.0,2.0,2.0,9,5,4,2.0,2.0,0.0
9604340,38,4,34,225,3,35,99,21,31.0,3.0,28.0,193.0,0.0,31.0,87.0,44,38,6,20.0,17.0,3.0
9810336,53,3,50,170,4,49,209,7,15.0,3.0,12.0,48.0,0.0,15.0,48.0,73,53,20,14.0,12.0,2.0
9406346,30,8,22,72,5,25,86,18,7.0,2.0,5.0,8.0,0.0,7.0,33.0,39,30,9,16.0,11.0,5.0
9811235,38,16,22,44,5,33,117,7,9.0,5.0,4.0,6.0,5.0,4.0,4.0,52,38,14,7.0,7.0,0.0
9603420,135,13,122,1018,18,117,703,15,79.0,2.0,77.0,797.0,4.0,75.0,559.0,179,135,44,68.0,51.0,17.0
9508379,132,11,121,680,34,98,410,15,35.0,4.0,31.0,248.0,3.0,32.0,127.0,158,132,26,28.0,22.0,6.0
9511250,38,12,26,64,36,2,2,7,6.0,1.0,5.0,15.0,6.0,0.0,0.0,41,38,3,2.0,2.0,0.0
9806435,14,5,9,14,2,12,20,76,7.0,2.0,5.0,6.0,7.0,0.0,0.0,17,14,3,6.0,6.0,0.0
9405232,5,5,0,0,3,2,2,371,4.0,4.0,0.0,0.0,3.0,1.0,1.0,6,5,1,3.0,2.0,1.0
9212246,40,8,32,143,40,0,0,151,19.0,3.0,16.0,88.0,19.0,0.0,0.0,40,40,0,17.0,17.0,0.0
9212308,57,6,51,252,57,0,0,19,18.0,2.0,16.0,58.0,18.0,0.0,0.0,57,57,0,15.0,15.0,0.0
9608387,10,3,7,13,1,9,35,62,5.0,1.0,4.0,5.0,0.0,5.0,27.0,23,10,13,11.0,3.0,8.0
9410414,48,6,42,224,48,0,0,80,27.0,1.0,26.0,147.0,27.0,0.0,0.0,48,48,0,21.0,21.0,0.0
9907489,49,3,46,297,0,49,557,24,46.0,3.0,43.0,276.0,0.0,46.0,533.0,76,49,27,49.0,26.0,23.0
9604272,53,15,38,106,28,25,57,16,12.0,3.0,9.0,20.0,3.0,9.0,24.0,58,53,5,10.0,7.0,3.0
9606427,70,4,66,433,13,57,196,16,45.0,2.0,43.0,300.0,15.0,30.0,72.0,80,70,10,19.0,14.0,5.0
9509348,133,12,121,1082,80,53,78,11,93.0,3.0,90.0,940.0,93.0,0.0,0.0,138,133,5,70.0,69.0,1.0
9503386,15,5,10,24,2,13,23,11,8.0,1.0,7.0,18.0,0.0,8.0,16.0,17,15,2,9.0,7.0,2.0
9901438,12,5,7,12,1,11,23,30,0.0,0.0,0.0,0.0,0.0,0.0,0.0,20,12,8,7.0,2.0,5.0
9705389,13,6,7,23,4,9,22,4,1.0,1.0,0.0,0.0,0.0,1.0,3.0,19,13,6,7.0,3.0,4.0
9802359,6,3,3,4,2,4,30,151,3.0,2.0,1.0,2.0,0.0,3.0,19.0,16,6,10,10.0,3.0,7.0
9405243,8,7,1,1,7,1,1,133,2.0,2.0,0.0,0.0,2.0,0.0,0.0,10,8,2,1.0,1.0,0.0
9409380,92,30,62,203,74,18,28,71,20.0,2.0,18.0,80.0,20.0,0.0,0.0,106,92,14,16.0,16.0,0.0
9404343,25,7,18,54,0,25,48,86,7.0,2.0,5.0,7.0,0.0,7.0,14.0,29,25,4,8.0,8.0,0.0
9711483,11,4,7,26,0,11,47,31,10.0,3.0,7.0,22.0,0.0,10.0,45.0,24,11,13,14.0,7.0,7.0
9807421,84,11,73,336,4,80,550,24,45.0,5.0,40.0,210.0,0.0,45.0,355.0,121,84,37,34.0,23.0,11.0
9505224,71,13,58,222,3,68,225,8,21.0,3.0,18.0,51.0,6.0,15.0,25.0,83,71,12,14.0,11.0,3.0
9407407,48,7,41,172,1,47,291,6,31.0,5.0,26.0,109.0,0.0,31.0,215.0,59,48,11,28.0,18.0,10.0
9312220,28,1,27,98,3,25,56,6,10.0,2.0,8.0,23.0,10.0,0.0,0.0,31,28,3,8.0,8.0,0.0
9409412,23,13,10,13,18,5,11,4,6.0,4.0,2.0,4.0,6.0,0.0,0.0,26,23,3,5.0,5.0,0.0
9411375,10,6,4,5,5,5,10,96,4.0,1.0,3.0,4.0,0.0,4.0,9.0,13,10,3,7.0,4.0,3.0
9407268,36,6,30,98,21,15,16,8,17.0,3.0,14.0,46.0,12.0,5.0,5.0,38,36,2,12.0,11.0,1.0
9811202,103,8,95,796,9,94,421,32,72.0,3.0,69.0,634.0,2.0,70.0,331.0,119,103,16,57.0,49.0,8.0
9710463,59,16,43,170,29,30,79,38,28.0,2.0,26.0,127.0,6.0,22.0,44.0,75,59,16,21.0,17.0,4.0
9804338,7,4,3,5,1,6,19,40,2.0,1.0,1.0,1.0,0.0,2.0,10.0,18,7,11,2.0,1.0,1.0
9904418,3,2,1,1,0,3,17,45,2.0,1.0,1.0,1.0,0.0,2.0,15.0,13,3,10,10.0,2.0,8.0
9301236,81,8,73,376,81,0,0,22,33.0,4.0,29.0,196.0,33.0,0.0,0.0,81,81,0,25.0,25.0,0.0
9308257,14,8,6,11,9,5,5,22,5.0,3.0,2.0,3.0,5.0,0.0,0.0,15,14,1,3.0,2.0,1.0
9807351,15,6,9,30,10,5,12,38,7.0,3.0,4.0,9.0,4.0,3.0,4.0,20,15,5,4.0,2.0,2.0
9302298,29,12,17,48,29,0,0,88,10.0,6.0,4.0,15.0,10.0,0.0,0.0,29,29,0,6.0,6.0,0.0
9612448,5,4,1,2,2,3,10,88,3.0,2.0,1.0,2.0,0.0,3.0,8.0,17,5,12,7.0,3.0,4.0
9906510,3,2,1,1,0,3,4,357,2.0,1.0,1.0,1.0,0.0,2.0,2.0,7,3,4,3.0,2.0,1.0
9410346,19,6,13,19,17,2,2,21,5.0,1.0,4.0,5.0,5.0,0.0,0.0,20,19,1,3.0,3.0,0.0
9409202,13,2,11,22,11,2,2,50,3.0,1.0,2.0,3.0,1.0,2.0,2.0,14,13,1,4.0,4.0,0.0
1103,24,4,20,69,0,24,140,19,13.0,0.0,13.0,42.0,0.0,13.0,59.0,49,24,25,18.0,11.0,7.0
9706534,70,12,58,297,7,63,255,66,26.0,6.0,20.0,89.0,4.0,22.0,63.0,94,70,24,24.0,17.0,7.0
9812348,16,4,12,27,1,15,93,66,5.0,2.0,3.0,3.0,0.0,5.0,21.0,40,16,24,8.0,2.0,6.0
9908387,19,9,10,24,1,18,145,14,2.0,2.0,0.0,0.0,0.0,2.0,14.0,54,19,35,4.0,2.0,2.0
6352,4,3,1,1,2,2,11,43,2.0,1.0,1.0,1.0,0.0,2.0,10.0,27,4,23,10.0,2.0,8.0
9408366,26,14,12,13,24,2,2,43,4.0,4.0,0.0,0.0,4.0,0.0,0.0,27,26,1,3.0,3.0,0.0
3140,20,2,18,55,1,19,209,20,19.0,2.0,17.0,50.0,1.0,18.0,206.0,47,20,27,39.0,12.0,27.0
9810509,63,5,58,606,0,63,247,20,56.0,2.0,54.0,589.0,0.0,56.0,214.0,70,63,7,47.0,43.0,4.0
9903359,14,1,13,33,8,6,29,116,4.0,1.0,3.0,3.0,0.0,4.0,24.0,22,14,8,11.0,4.0,7.0
9305206,78,15,63,273,68,10,10,49,22.0,7.0,15.0,31.0,22.0,0.0,0.0,79,78,1,12.0,12.0,0.0
9412337,10,9,1,1,2,8,16,245,3.0,2.0,1.0,1.0,0.0,3.0,3.0,17,10,7,4.0,3.0,1.0
101308,5,2,3,4,0,5,17,136,5.0,2.0,3.0,4.0,0.0,5.0,17.0,13,5,8,13.0,5.0,8.0
7102,5,2,3,4,0,5,6,220,4.0,1.0,3.0,4.0,2.0,2.0,2.0,10,5,5,5.0,3.0,2.0
101289,4,3,1,1,0,4,21,20,0.0,0.0,0.0,0.0,0.0,0.0,0.0,13,4,9,1.0,1.0,0.0
206020,20,4,16,67,3,17,53,37,16.0,2.0,14.0,60.0,2.0,14.0,45.0,25,20,5,20.0,16.0,4.0
9908433,65,18,47,110,36,29,148,102,16.0,5.0,11.0,24.0,6.0,10.0,70.0,98,65,33,22.0,6.0,16.0
9608277,35,7,28,69,5,30,46,78,17.0,2.0,15.0,40.0,9.0,8.0,8.0,40,35,5,9.0,8.0,1.0
9603298,6,4,2,3,1,5,14,29,3.0,1.0,2.0,3.0,0.0,3.0,9.0,15,6,9,6.0,3.0,3.0
9407404,84,19,65,223,27,57,112,10,15.0,5.0,10.0,44.0,0.0,15.0,32.0,91,84,7,15.0,12.0,3.0
9811316,30,13,17,47,3,27,144,5,5.0,3.0,2.0,3.0,0.0,5.0,43.0,80,30,50,26.0,0.0,26.0
9306248,34,12,22,91,34,0,0,5,18.0,5.0,13.0,54.0,18.0,0.0,0.0,34,34,0,6.0,6.0,0.0
9210229,31,8,23,67,31,0,0,4,13.0,1.0,12.0,33.0,13.0,0.0,0.0,31,31,0,12.0,12.0,0.0
9207247,5,5,0,0,5,0,0,42,1.0,1.0,0.0,0.0,1.0,0.0,0.0,5,5,0,1.0,1.0,0.0
9405337,32,6,26,82,29,3,4,42,7.0,1.0,6.0,14.0,7.0,0.0,0.0,34,32,2,8.0,8.0,0.0
9802443,6,2,4,4,1,5,6,42,1.0,1.0,0.0,0.0,1.0,0.0,0.0,9,6,3,3.0,2.0,1.0
9711446,9,3,6,11,1,8,38,114,6.0,2.0,4.0,6.0,0.0,6.0,23.0,28,9,19,15.0,5.0,10.0
9604232,46,5,41,132,29,17,44,5,8.0,3.0,5.0,5.0,3.0,5.0,17.0,59,46,13,12.0,6.0,6.0
9505416,27,6,21,55,5,22,23,92,10.0,3.0,7.0,15.0,0.0,10.0,10.0,29,27,2,6.0,5.0,1.0
9503432,12,4,8,19,2,10,17,35,3.0,1.0,2.0,2.0,1.0,2.0,3.0,18,12,6,6.0,6.0,0.0
9908378,15,2,13,35,1,14,118,4,13.0,2.0,11.0,25.0,1.0,12.0,63.0,49,15,34,20.0,7.0,13.0
9607485,63,7,56,209,4,59,246,4,15.0,3.0,12.0,23.0,1.0,14.0,40.0,106,63,43,21.0,12.0,9.0
9909266,16,1,15,49,0,16,141,4,13.0,1.0,12.0,32.0,0.0,13.0,96.0,40,16,24,23.0,13.0,10.0
9607449,67,4,63,531,1,66,195,70,55.0,2.0,53.0,508.0,1.0,54.0,161.0,73,67,6,46.0,43.0,3.0
9905257,5,4,1,2,5,0,0,1112,1.0,1.0,0.0,0.0,1.0,0.0,0.0,5,5,0,1.0,1.0,0.0
9903303,9,5,4,8,0,9,41,0,4.0,3.0,1.0,2.0,0.0,4.0,10.0,20,9,11,11.0,6.0,5.0
9804428,25,9,16,34,3,22,71,41,11.0,4.0,7.0,10.0,0.0,11.0,38.0,45,25,20,16.0,12.0,4.0
9412213,16,6,10,12,16,0,0,18,5.0,2.0,3.0,3.0,5.0,0.0,0.0,16,16,0,3.0,3.0,0.0
9412361,21,8,13,25,9,12,40,10,1.0,1.0,0.0,0.0,0.0,1.0,6.0,54,21,33,6.0,3.0,3.0
9703220,98,11,87,347,17,81,290,23,34.0,2.0,32.0,125.0,3.0,31.0,119.0,111,98,13,30.0,23.0,7.0
9608487,16,2,14,37,6,10,17,84,15.0,1.0,14.0,36.0,5.0,10.0,17.0,18,16,2,11.0,9.0,2.0
9511267,6,4,2,2,0,6,9,49,5.0,3.0,2.0,2.0,0.0,5.0,8.0,10,6,4,2.0,1.0,1.0
9307320,23,12,11,19,3,20,33,62,12.0,7.0,5.0,9.0,0.0,12.0,18.0,27,23,4,10.0,9.0,1.0
9811226,6,5,1,1,0,6,20,1,0.0,0.0,0.0,0.0,0.0,0.0,0.0,24,6,18,1.0,0.0,1.0
112255,64,20,44,110,1,63,316,23,24.0,5.0,19.0,47.0,0.0,24.0,140.0,75,64,11,26.0,16.0,10.0
9704443,9,2,7,26,6,3,4,23,7.0,1.0,6.0,21.0,5.0,2.0,2.0,20,9,11,7.0,7.0,0.0
9502318,22,17,5,5,3,19,73,10,5.0,5.0,0.0,0.0,1.0,4.0,11.0,35,22,13,8.0,5.0,3.0
9403389,20,10,10,21,9,11,19,169,10.0,5.0,5.0,13.0,0.0,10.0,13.0,30,20,10,8.0,6.0,2.0
9911272,29,22,7,10,6,23,128,5,1.0,1.0,0.0,0.0,0.0,1.0,10.0,143,29,114,19.0,1.0,18.0
9906514,17,3,14,29,0,17,295,2,14.0,3.0,11.0,24.0,0.0,14.0,248.0,47,17,30,23.0,11.0,12.0
4028,62,1,61,374,19,43,104,18,42.0,1.0,41.0,266.0,34.0,8.0,8.0,75,62,13,33.0,33.0,0.0
7254,40,13,27,70,4,36,209,3,13.0,4.0,9.0,27.0,1.0,12.0,58.0,83,40,43,13.0,4.0,9.0
9703345,27,6,21,64,0,27,42,116,9.0,1.0,8.0,14.0,0.0,9.0,15.0,35,27,8,13.0,11.0,2.0
9808415,41,8,33,100,9,32,150,31,21.0,3.0,18.0,52.0,1.0,20.0,105.0,60,41,19,22.0,11.0,11.0
102098,79,6,73,447,4,75,552,18,45.0,6.0,39.0,220.0,2.0,43.0,324.0,123,79,44,45.0,32.0,13.0
9209292,23,4,19,52,23,0,0,69,11.0,1.0,10.0,26.0,11.0,0.0,0.0,24,23,1,2.0,2.0,0.0
102199,37,4,33,281,1,36,259,23,34.0,3.0,31.0,276.0,0.0,34.0,247.0,59,37,22,27.0,24.0,3.0
9906471,10,6,4,5,9,1,2,27,3.0,3.0,0.0,0.0,3.0,0.0,0.0,14,10,4,2.0,2.0,0.0
102319,13,5,8,19,1,12,60,107,7.0,2.0,5.0,14.0,2.0,5.0,5.0,26,13,13,6.0,4.0,2.0
107151,24,11,13,27,0,24,299,18,20.0,7.0,13.0,26.0,0.0,20.0,135.0,51,24,27,22.0,12.0,10.0
103048,57,2,55,369,0,57,789,23,46.0,2.0,44.0,307.0,0.0,46.0,575.0,125,57,68,50.0,35.0,15.0
110195,7,3,4,7,1,6,42,34,2.0,1.0,1.0,1.0,0.0,2.0,16.0,31,7,24,17.0,3.0,14.0
9404227,14,6,8,10,2,12,12,18,1.0,1.0,0.0,0.0,1.0,0.0,0.0,15,14,1,4.0,4.0,0.0
9601330,3,3,0,0,1,2,14,4,0.0,0.0,0.0,0.0,0.0,0.0,0.0,20,3,17,1.0,0.0,1.0
9812454,8,2,6,8,1,7,41,42,4.0,1.0,3.0,5.0,0.0,4.0,19.0,24,8,16,10.0,4.0,6.0
6078,31,4,27,72,10,21,89,0,17.0,1.0,16.0,55.0,0.0,17.0,61.0,51,31,20,11.0,6.0,5.0
11251,83,3,80,445,24,59,172,0,33.0,2.0,31.0,156.0,18.0,15.0,23.0,104,83,21,19.0,19.0,0.0
9903277,6,6,0,0,1,5,16,111,5.0,5.0,0.0,0.0,0.0,5.0,15.0,10,6,4,8.0,5.0,3.0
9604287,7,6,1,1,5,2,2,238,0.0,0.0,0.0,0.0,0.0,0.0,0.0,12,7,5,1.0,0.0,1.0
9903244,20,6,14,27,9,11,17,11,8.0,1.0,7.0,16.0,8.0,0.0,0.0,28,20,8,6.0,4.0,2.0
9911232,9,3,6,9,9,0,0,177,4.0,1.0,3.0,5.0,4.0,0.0,0.0,11,9,2,4.0,4.0,0.0
9605324,23,7,16,38,4,19,28,140,9.0,4.0,5.0,12.0,0.0,9.0,12.0,28,23,5,10.0,8.0,2.0
9807434,28,5,23,74,3,25,94,11,19.0,3.0,16.0,58.0,0.0,19.0,71.0,35,28,7,3.0,2.0,1.0
9912232,4,1,3,4,0,4,20,252,3.0,1.0,2.0,2.0,0.0,3.0,8.0,14,4,10,6.0,3.0,3.0
6053,4,3,1,1,2,2,9,19,1.0,1.0,0.0,0.0,0.0,1.0,7.0,13,4,9,8.0,1.0,7.0
9608343,23,2,21,121,1,22,101,43,20.0,2.0,18.0,114.0,1.0,19.0,86.0,33,23,10,27.0,17.0,10.0
9907494,15,4,11,46,1,14,25,19,12.0,2.0,10.0,44.0,2.0,10.0,10.0,25,15,10,5.0,2.0,3.0
9511270,27,5,22,44,24,3,3,129,10.0,3.0,7.0,14.0,9.0,1.0,1.0,29,27,2,3.0,3.0,0.0
9706334,25,11,14,25,2,23,102,39,14.0,3.0,11.0,18.0,0.0,14.0,64.0,47,25,22,22.0,13.0,9.0
9409208,31,7,24,84,31,0,0,39,20.0,3.0,17.0,64.0,20.0,0.0,0.0,31,31,0,17.0,17.0,0.0
9607253,14,4,10,25,10,4,10,71,11.0,1.0,10.0,25.0,11.0,0.0,0.0,18,14,4,11.0,11.0,0.0
2223,11,3,8,11,4,7,26,50,4.0,1.0,3.0,3.0,2.0,2.0,3.0,26,11,15,10.0,2.0,8.0
9907328,8,3,5,8,2,6,73,2,6.0,1.0,5.0,8.0,0.0,6.0,69.0,41,8,33,17.0,4.0,13.0
1120,5,3,2,3,0,5,21,57,2.0,2.0,0.0,0.0,0.0,2.0,8.0,20,5,15,6.0,2.0,4.0
9808257,54,17,37,104,6,48,148,11,28.0,7.0,21.0,59.0,5.0,23.0,70.0,68,54,14,8.0,4.0,4.0
11094,45,2,43,273,0,45,644,19,38.0,1.0,37.0,251.0,0.0,38.0,538.0,79,45,34,57.0,36.0,21.0
109079,26,3,23,110,0,26,155,19,24.0,2.0,22.0,109.0,0.0,24.0,149.0,45,26,19,32.0,23.0,9.0
208096,11,2,9,17,0,11,74,19,7.0,1.0,6.0,11.0,0.0,7.0,37.0,26,11,15,16.0,8.0,8.0
104013,3,2,1,1,0,3,3,354,0.0,0.0,0.0,0.0,0.0,0.0,0.0,9,3,6,1.0,0.0,1.0
9612297,14,2,12,30,0,14,60,16,4.0,2.0,2.0,2.0,0.0,4.0,20.0,33,14,19,4.0,1.0,3.0
209248,4,2,2,2,0,4,39,19,3.0,1.0,2.0,2.0,0.0,3.0,26.0,35,4,31,13.0,3.0,10.0
105067,19,3,16,34,3,16,53,28,4.0,2.0,2.0,2.0,1.0,3.0,6.0,28,19,9,4.0,3.0,1.0
110235,5,3,2,2,0,5,13,28,1.0,1.0,0.0,0.0,0.0,1.0,1.0,12,5,7,2.0,1.0,1.0
110201,5,4,1,1,1,4,10,28,0.0,0.0,0.0,0.0,0.0,0.0,0.0,23,5,18,8.0,0.0,8.0
9307345,13,8,5,9,13,0,0,114,4.0,2.0,2.0,4.0,4.0,0.0,0.0,13,13,0,4.0,4.0,0.0
9307277,8,8,0,0,7,1,1,418,1.0,1.0,0.0,0.0,0.0,1.0,1.0,9,8,1,2.0,1.0,1.0
112236,1,1,0,0,0,1,5,2,1.0,1.0,0.0,0.0,0.0,1.0,3.0,30,1,29,4.0,1.0,3.0
9801329,22,8,14,37,3,19,57,158,11.0,4.0,7.0,23.0,0.0,11.0,35.0,32,22,10,16.0,9.0,7.0
103189,1,1,0,0,1,0,0,1419,0.0,0.0,0.0,0.0,0.0,0.0,0.0,9,1,8,1.0,0.0,1.0
9206216,16,5,11,19,16,0,0,96,5.0,2.0,3.0,4.0,5.0,0.0,0.0,16,16,0,3.0,3.0,0.0
9808255,53,10,43,149,19,34,55,37,12.0,2.0,10.0,29.0,12.0,0.0,0.0,57,53,4,17.0,14.0,3.0
9806273,5,5,0,0,4,1,17,5,1.0,1.0,0.0,0.0,0.0,1.0,17.0,28,5,23,17.0,0.0,17.0
9804446,4,2,2,3,0,4,19,10,0.0,0.0,0.0,0.0,0.0,0.0,0.0,20,4,16,4.0,0.0,4.0
9410249,10,2,8,14,2,8,8,85,5.0,3.0,2.0,2.0,0.0,5.0,5.0,11,10,1,7.0,6.0,1.0
9703265,7,3,4,7,2,5,5,28,5.0,1.0,4.0,7.0,0.0,5.0,5.0,9,7,2,6.0,5.0,1.0
9412259,29,3,26,103,16,13,33,12,17.0,2.0,15.0,78.0,17.0,0.0,0.0,36,29,7,3.0,3.0,0.0
9412365,10,5,5,7,2,8,26,234,4.0,2.0,2.0,2.0,0.0,4.0,14.0,17,10,7,10.0,5.0,5.0
9912373,16,3,13,25,5,11,25,86,7.0,1.0,6.0,12.0,5.0,2.0,2.0,22,16,6,5.0,5.0,0.0
9612348,4,2,2,3,4,0,0,109,,,,,,,,4,4,0,,,
9506243,54,5,49,199,10,44,96,48,39.0,3.0,36.0,149.0,5.0,34.0,80.0,58,54,4,22.0,19.0,3.0
105103,12,4,8,23,0,12,184,1,11.0,3.0,8.0,23.0,0.0,11.0,115.0,51,12,39,26.0,10.0,16.0
8046,40,5,35,203,0,40,214,7,19.0,3.0,16.0,80.0,0.0,19.0,70.0,66,40,26,25.0,21.0,4.0
101145,3,1,2,3,0,3,32,1,0.0,0.0,0.0,0.0,0.0,0.0,0.0,34,3,31,1.0,0.0,1.0
9904271,8,3,5,7,2,6,25,1,0.0,0.0,0.0,0.0,0.0,0.0,0.0,74,8,66,6.0,0.0,6.0
9411361,2,1,1,1,2,0,0,25,0.0,0.0,0.0,0.0,0.0,0.0,0.0,6,2,4,3.0,0.0,3.0
9281,12,4,8,14,0,12,46,79,5.0,4.0,1.0,1.0,0.0,5.0,18.0,23,12,11,14.0,8.0,6.0
9505232,15,2,13,28,9,6,15,79,9.0,2.0,7.0,18.0,5.0,4.0,7.0,23,15,8,7.0,7.0,0.0
9508302,80,5,75,443,1,79,222,11,62.0,3.0,59.0,374.0,0.0,62.0,161.0,85,80,5,35.0,32.0,3.0
9707447,17,6,11,27,6,11,14,209,9.0,4.0,5.0,16.0,5.0,4.0,4.0,20,17,3,5.0,4.0,1.0
9610381,41,5,36,138,0,41,253,17,35.0,4.0,31.0,125.0,0.0,35.0,230.0,55,41,14,10.0,10.0,0.0
9601283,4,3,1,1,0,4,13,17,3.0,2.0,1.0,1.0,0.0,3.0,3.0,10,4,6,4.0,2.0,2.0
9608366,28,3,25,50,17,11,22,25,9.0,1.0,8.0,18.0,9.0,0.0,0.0,31,28,3,4.0,1.0,3.0
9612292,10,3,7,10,3,7,43,26,2.0,1.0,1.0,1.0,0.0,2.0,17.0,37,10,27,7.0,5.0,2.0
9209266,4,2,2,2,4,0,0,289,1.0,1.0,0.0,0.0,1.0,0.0,0.0,4,4,0,1.0,1.0,0.0
9309232,16,5,11,39,16,0,0,104,9.0,1.0,8.0,27.0,9.0,0.0,0.0,16,16,0,8.0,8.0,0.0
9608373,11,5,6,7,2,9,41,104,6.0,3.0,3.0,3.0,1.0,5.0,17.0,24,11,13,12.0,5.0,7.0
9505408,6,2,4,8,0,6,10,8,3.0,1.0,2.0,3.0,3.0,0.0,0.0,9,6,3,,,
9405396,36,7,29,103,36,0,0,22,20.0,1.0,19.0,66.0,20.0,0.0,0.0,36,36,0,16.0,16.0,0.0
201201,19,9,10,28,2,17,31,80,6.0,3.0,3.0,4.0,0.0,6.0,15.0,22,19,3,7.0,5.0,2.0
9809437,22,2,20,37,2,20,97,5,1.0,1.0,0.0,0.0,0.0,1.0,7.0,46,22,24,9.0,5.0,4.0
2264,9,2,7,9,1,8,57,12,7.0,1.0,6.0,8.0,1.0,6.0,33.0,28,9,19,4.0,0.0,4.0
9612425,14,3,11,18,1,13,45,9,1.0,1.0,0.0,0.0,0.0,1.0,5.0,27,14,13,6.0,1.0,5.0
8204,23,4,19,77,2,21,85,28,16.0,2.0,14.0,55.0,1.0,15.0,51.0,37,23,14,10.0,7.0,3.0
203171,1,1,0,0,0,1,9,192,1.0,1.0,0.0,0.0,0.0,1.0,7.0,10,1,9,8.0,1.0,7.0
9212225,9,6,3,4,9,0,0,110,3.0,1.0,2.0,3.0,3.0,0.0,0.0,9,9,0,3.0,3.0,0.0
9306302,3,3,0,0,2,1,2,414,0.0,0.0,0.0,0.0,0.0,0.0,0.0,5,3,2,1.0,0.0,1.0
9411267,29,7,22,65,10,19,38,14,10.0,2.0,8.0,15.0,3.0,7.0,12.0,36,29,7,5.0,5.0,0.0
107097,23,4,19,75,0,23,168,10,5.0,2.0,3.0,6.0,0.0,5.0,19.0,46,23,23,13.0,8.0,5.0
9904330,29,7,22,94,7,22,152,24,5.0,4.0,1.0,1.0,0.0,5.0,24.0,64,29,35,23.0,13.0,10.0
9404237,28,10,18,43,28,0,0,45,11.0,2.0,9.0,22.0,11.0,0.0,0.0,28,28,0,4.0,4.0,0.0
9701355,3,3,0,0,2,1,1,188,1.0,1.0,0.0,0.0,1.0,0.0,0.0,4,3,1,1.0,1.0,0.0
104198,12,3,9,17,0,12,100,9,9.0,3.0,6.0,13.0,0.0,9.0,70.0,32,12,20,7.0,5.0,2.0
1287,11,3,8,16,1,10,93,14,7.0,2.0,5.0,10.0,0.0,7.0,75.0,40,11,29,24.0,7.0,17.0
9610261,4,3,1,1,1,3,4,354,2.0,1.0,1.0,1.0,2.0,0.0,0.0,9,4,5,2.0,2.0,0.0
9608293,6,4,2,2,0,6,10,354,1.0,1.0,0.0,0.0,0.0,1.0,1.0,11,6,5,2.0,1.0,1.0
9707478,15,5,10,14,6,9,24,14,9.0,2.0,7.0,11.0,6.0,3.0,3.0,25,15,10,7.0,7.0,0.0
9610316,5,2,3,4,5,0,0,189,4.0,2.0,2.0,3.0,4.0,0.0,0.0,5,5,0,3.0,3.0,0.0
9908221,4,3,1,1,1,3,8,127,2.0,2.0,0.0,0.0,0.0,2.0,7.0,12,4,8,1.0,0.0,1.0
9207271,3,3,0,0,3,0,0,169,1.0,1.0,0.0,0.0,1.0,0.0,0.0,3,3,0,1.0,1.0,0.0
9611337,3,3,0,0,3,0,0,471,2.0,2.0,0.0,0.0,2.0,0.0,0.0,5,3,2,4.0,2.0,2.0
202105,21,8,13,26,4,17,69,45,13.0,5.0,8.0,14.0,0.0,13.0,63.0,32,21,11,18.0,9.0,9.0
9907544,5,1,4,5,1,4,12,11,1.0,1.0,0.0,0.0,1.0,0.0,0.0,11,5,6,1.0,1.0,0.0
9710356,41,9,32,133,6,35,117,9,25.0,4.0,21.0,91.0,1.0,24.0,79.0,49,41,8,6.0,6.0,0.0
9907497,10,3,7,13,0,10,44,17,7.0,2.0,5.0,10.0,0.0,7.0,38.0,18,10,8,7.0,4.0,3.0
9504357,12,2,10,29,3,9,13,16,7.0,1.0,6.0,19.0,7.0,0.0,0.0,17,12,5,3.0,3.0,0.0
9610492,22,6,16,42,4,18,92,8,6.0,3.0,3.0,5.0,0.0,6.0,43.0,43,22,21,4.0,2.0,2.0
9605210,12,8,4,5,6,6,11,584,4.0,3.0,1.0,1.0,4.0,0.0,0.0,16,12,4,3.0,3.0,0.0
9706375,3,2,1,1,3,0,0,1908,,,,,,,,3,3,0,1.0,1.0,0.0
9710546,12,7,5,6,12,0,0,216,3.0,3.0,0.0,0.0,3.0,0.0,0.0,13,12,1,2.0,2.0,0.0
9503470,9,4,5,9,9,0,0,8,6.0,2.0,4.0,7.0,6.0,0.0,0.0,9,9,0,6.0,6.0,0.0
9410340,19,6,13,27,18,1,1,132,9.0,4.0,5.0,11.0,9.0,0.0,0.0,20,19,1,5.0,5.0,0.0
9807541,6,4,2,2,6,0,0,98,3.0,1.0,2.0,2.0,3.0,0.0,0.0,6,6,0,3.0,3.0,0.0
9709286,17,2,15,63,0,17,287,15,15.0,1.0,14.0,60.0,0.0,15.0,273.0,54,17,37,37.0,14.0,23.0
9403310,30,11,19,33,2,28,56,112,15.0,9.0,6.0,6.0,2.0,13.0,23.0,35,30,5,12.0,10.0,2.0
9506284,38,10,28,86,2,36,143,15,27.0,6.0,21.0,69.0,1.0,26.0,97.0,54,38,16,7.0,3.0,4.0
9211219,18,9,9,28,15,3,3,112,15.0,6.0,9.0,26.0,15.0,0.0,0.0,20,18,2,6.0,6.0,0.0
9904396,5,3,2,2,3,2,3,5,,,,,,,,7,5,2,2.0,2.0,0.0
9605318,8,7,1,1,0,8,15,365,4.0,3.0,1.0,1.0,0.0,4.0,8.0,14,8,6,3.0,3.0,0.0
9809424,9,5,4,8,1,8,29,0,5.0,2.0,3.0,4.0,0.0,5.0,9.0,24,9,15,6.0,4.0,2.0
3013,6,3,3,7,0,6,23,122,5.0,2.0,3.0,7.0,0.0,5.0,19.0,13,6,7,10.0,5.0,5.0
104021,7,2,5,11,3,4,4,0,6.0,2.0,4.0,9.0,6.0,0.0,0.0,9,7,2,1.0,1.0,0.0
9812249,2,2,0,0,1,1,5,0,,,,,,,,7,2,5,,,
9608292,9,4,5,10,0,9,37,52,7.0,4.0,3.0,6.0,1.0,6.0,28.0,16,9,7,11.0,5.0,6.0
9912338,16,5,11,29,0,16,115,71,11.0,4.0,7.0,16.0,0.0,11.0,93.0,55,16,39,32.0,7.0,25.0
9511349,16,8,8,10,4,12,63,15,3.0,3.0,0.0,0.0,0.0,3.0,7.0,30,16,14,6.0,3.0,3.0
9807557,7,4,3,5,1,6,32,46,5.0,2.0,3.0,5.0,0.0,5.0,31.0,35,7,28,8.0,0.0,8.0
9601218,4,2,2,2,4,0,0,74,0.0,0.0,0.0,0.0,0.0,0.0,0.0,8,4,4,1.0,1.0,0.0
103239,4,3,1,1,1,3,15,120,2.0,2.0,0.0,0.0,0.0,2.0,13.0,22,4,18,11.0,2.0,9.0
6014,18,5,13,17,0,18,203,3,13.0,4.0,9.0,13.0,0.0,13.0,110.0,49,18,31,11.0,5.0,6.0
9402274,41,12,29,95,1,40,66,40,32.0,7.0,25.0,85.0,0.0,32.0,55.0,44,41,3,23.0,21.0,2.0
9811262,3,1,2,3,0,3,8,8,1.0,1.0,0.0,0.0,0.0,1.0,1.0,6,3,3,2.0,1.0,1.0
206136,9,5,4,7,0,9,83,4,6.0,2.0,4.0,7.0,0.0,6.0,52.0,36,9,27,18.0,6.0,12.0
9202,6,4,2,2,2,4,7,62,1.0,1.0,0.0,0.0,0.0,1.0,3.0,26,6,20,8.0,1.0,7.0
7145,4,3,1,1,1,3,16,3,0.0,0.0,0.0,0.0,0.0,0.0,0.0,19,4,15,4.0,0.0,4.0
9803284,16,1,15,27,3,13,44,21,7.0,1.0,6.0,8.0,1.0,6.0,14.0,25,16,9,8.0,5.0,3.0
6119,31,6,25,83,2,29,335,15,20.0,3.0,17.0,60.0,0.0,20.0,281.0,88,31,57,32.0,4.0,28.0
11160,25,9,16,37,2,23,73,21,12.0,3.0,9.0,18.0,0.0,12.0,45.0,35,25,10,7.0,6.0,1.0
9211285,4,2,2,2,4,0,0,419,2.0,2.0,0.0,0.0,2.0,0.0,0.0,4,4,0,3.0,3.0,0.0
9603221,7,7,0,0,2,5,15,61,0.0,0.0,0.0,0.0,0.0,0.0,0.0,22,7,15,1.0,1.0,0.0
9502416,18,8,10,19,13,5,5,306,7.0,5.0,2.0,4.0,7.0,0.0,0.0,19,18,1,5.0,5.0,0.0
9605394,1,1,0,0,1,0,0,1726,,,,,,,,1,1,0,1.0,1.0,0.0
9705429,53,11,42,240,25,28,55,30,37.0,5.0,32.0,189.0,22.0,15.0,27.0,58,53,5,14.0,11.0,3.0
12305,8,3,5,6,2,6,55,48,5.0,2.0,3.0,3.0,0.0,5.0,37.0,29,8,21,17.0,4.0,13.0
9507315,5,5,0,0,0,5,10,10,0.0,0.0,0.0,0.0,0.0,0.0,0.0,13,5,8,2.0,0.0,2.0
9906221,18,4,14,41,1,17,173,7,11.0,1.0,10.0,28.0,0.0,11.0,111.0,51,18,33,13.0,6.0,7.0
9611369,12,3,9,13,1,11,16,3,3.0,2.0,1.0,1.0,1.0,2.0,4.0,18,12,6,4.0,2.0,2.0
103224,8,1,7,22,0,8,200,23,8.0,1.0,7.0,22.0,0.0,8.0,198.0,52,8,44,25.0,4.0,21.0
9710214,19,5,14,46,0,19,120,13,15.0,3.0,12.0,41.0,1.0,14.0,86.0,39,19,20,23.0,12.0,11.0
9507436,21,5,16,33,10,11,20,41,11.0,2.0,9.0,19.0,11.0,0.0,0.0,23,21,2,7.0,7.0,0.0
9310306,12,8,4,4,6,6,11,413,5.0,3.0,2.0,2.0,3.0,2.0,2.0,17,12,5,5.0,4.0,1.0
9703432,17,7,10,23,3,14,49,130,7.0,1.0,6.0,13.0,0.0,7.0,29.0,35,17,18,11.0,2.0,9.0
206056,6,2,4,6,1,5,14,26,1.0,1.0,0.0,0.0,1.0,0.0,0.0,36,6,30,5.0,4.0,1.0
9408250,16,6,10,38,2,14,23,36,10.0,6.0,4.0,12.0,0.0,10.0,15.0,19,16,3,13.0,10.0,3.0
9801420,4,2,2,2,0,4,22,1,1.0,1.0,0.0,0.0,1.0,0.0,0.0,14,4,10,2.0,1.0,1.0
9906385,5,2,3,6,0,5,17,12,1.0,1.0,0.0,0.0,0.0,1.0,9.0,18,5,13,4.0,4.0,0.0
8064,9,9,0,0,8,1,5,77,3.0,3.0,0.0,0.0,3.0,0.0,0.0,19,9,10,3.0,1.0,2.0
105093,10,5,5,9,7,3,3,192,3.0,1.0,2.0,3.0,3.0,0.0,0.0,11,10,1,2.0,1.0,1.0
11164,2,2,0,0,0,2,26,13,2.0,2.0,0.0,0.0,0.0,2.0,11.0,32,2,30,5.0,1.0,4.0
9910534,1,1,0,0,0,1,1,24,0.0,0.0,0.0,0.0,0.0,0.0,0.0,26,1,25,15.0,0.0,15.0
9608392,15,8,7,10,0,15,168,6,12.0,7.0,5.0,8.0,0.0,12.0,134.0,35,15,20,17.0,6.0,11.0
9810211,4,3,1,1,0,4,45,46,3.0,2.0,1.0,1.0,0.0,3.0,31.0,37,4,33,10.0,0.0,10.0
104037,4,1,3,5,0,4,9,21,0.0,0.0,0.0,0.0,0.0,0.0,0.0,10,4,6,1.0,0.0,1.0
9601391,14,9,5,7,2,12,52,10,2.0,2.0,0.0,0.0,1.0,1.0,5.0,38,14,24,9.0,3.0,6.0
9401332,17,4,13,41,6,11,11,256,10.0,1.0,9.0,31.0,1.0,9.0,9.0,18,17,1,11.0,10.0,1.0
9706259,4,3,1,1,2,2,4,90,3.0,2.0,1.0,1.0,2.0,1.0,2.0,13,4,9,5.0,0.0,5.0
108068,10,2,8,21,1,9,32,78,9.0,2.0,7.0,20.0,1.0,8.0,14.0,18,10,8,11.0,9.0,2.0
9710268,36,4,32,71,2,34,76,83,16.0,3.0,13.0,37.0,0.0,16.0,35.0,43,36,7,7.0,5.0,2.0
9711231,70,4,66,327,6,64,204,83,32.0,2.0,30.0,140.0,4.0,28.0,57.0,86,70,16,22.0,19.0,3.0
9410273,21,5,16,22,11,10,18,57,10.0,2.0,8.0,13.0,2.0,8.0,16.0,28,21,7,8.0,7.0,1.0
9905231,2,2,0,0,0,2,3,154,1.0,1.0,0.0,0.0,0.0,1.0,1.0,5,2,3,,,
9907384,11,6,5,6,1,10,22,143,9.0,5.0,4.0,5.0,1.0,8.0,19.0,15,11,4,6.0,5.0,1.0
6003,6,2,4,5,0,6,11,29,1.0,1.0,0.0,0.0,0.0,1.0,3.0,14,6,8,5.0,1.0,4.0
105090,13,2,11,32,0,13,71,165,13.0,2.0,11.0,32.0,0.0,13.0,54.0,23,13,10,19.0,13.0,6.0
107144,15,8,7,12,0,15,221,24,8.0,3.0,5.0,9.0,0.0,8.0,146.0,79,15,64,38.0,5.0,33.0
9409444,14,5,9,26,14,0,0,25,7.0,3.0,4.0,10.0,7.0,0.0,0.0,14,14,0,2.0,2.0,0.0
9307290,3,2,1,1,1,2,2,303,0.0,0.0,0.0,0.0,0.0,0.0,0.0,7,3,4,1.0,1.0,0.0
9601328,2,2,0,0,0,2,2,81,0.0,0.0,0.0,0.0,0.0,0.0,0.0,9,2,7,3.0,0.0,3.0
104277,16,3,13,38,2,14,69,8,11.0,3.0,8.0,23.0,1.0,10.0,47.0,27,16,11,7.0,6.0,1.0
9312281,6,4,2,2,4,2,4,374,4.0,3.0,1.0,1.0,4.0,0.0,0.0,9,6,3,2.0,2.0,0.0
9606272,4,2,2,3,1,3,5,68,3.0,1.0,2.0,3.0,2.0,1.0,1.0,9,4,5,2.0,0.0,2.0
12360,6,3,3,4,0,6,39,45,4.0,2.0,2.0,3.0,0.0,4.0,27.0,14,6,8,12.0,4.0,8.0
9808204,6,1,5,14,6,0,0,21,0.0,0.0,0.0,0.0,0.0,0.0,0.0,7,6,1,1.0,0.0,1.0
103258,49,5,44,254,1,48,310,0,39.0,2.0,37.0,222.0,0.0,39.0,242.0,77,49,28,37.0,19.0,18.0
107232,4,4,0,0,3,1,1,239,1.0,1.0,0.0,0.0,1.0,0.0,0.0,6,4,2,2.0,1.0,1.0
9508324,8,3,5,15,7,1,1,152,6.0,2.0,4.0,12.0,6.0,0.0,0.0,9,8,1,6.0,6.0,0.0
9311348,2,2,0,0,2,0,0,245,1.0,1.0,0.0,0.0,1.0,0.0,0.0,4,2,2,1.0,1.0,0.0
3121,4,3,1,1,0,4,24,3,2.0,2.0,0.0,0.0,0.0,2.0,8.0,14,4,10,,,
205158,1,1,0,0,1,0,0,169,1.0,1.0,0.0,0.0,1.0,0.0,0.0,5,1,4,1.0,1.0,0.0
9311374,15,6,9,13,15,0,0,237,8.0,3.0,5.0,8.0,8.0,0.0,0.0,15,15,0,3.0,3.0,0.0
111047,16,9,7,12,1,15,120,2,5.0,1.0,4.0,5.0,0.0,5.0,26.0,57,16,41,13.0,6.0,7.0
104040,8,4,4,5,0,8,132,12,4.0,2.0,2.0,2.0,0.0,4.0,87.0,55,8,47,31.0,4.0,27.0
102103,7,2,5,8,0,7,25,3,3.0,1.0,2.0,2.0,3.0,0.0,0.0,20,7,13,1.0,1.0,0.0
203010,1,1,0,0,1,0,0,393,0.0,0.0,0.0,0.0,0.0,0.0,0.0,4,1,3,1.0,0.0,1.0
9607470,8,1,7,14,1,7,15,27,5.0,1.0,4.0,7.0,0.0,5.0,6.0,14,8,6,2.0,2.0,0.0
202090,13,1,12,25,0,13,55,37,9.0,1.0,8.0,15.0,1.0,8.0,37.0,29,13,16,8.0,7.0,1.0
9706462,9,3,6,12,0,9,62,94,6.0,2.0,4.0,7.0,0.0,6.0,39.0,21,9,12,6.0,1.0,5.0
9701221,5,4,1,1,5,0,0,348,0.0,0.0,0.0,0.0,0.0,0.0,0.0,7,5,2,1.0,1.0,0.0
104106,9,6,3,3,0,9,22,23,8.0,5.0,3.0,3.0,0.0,8.0,19.0,15,9,6,1.0,0.0,1.0
9410226,5,5,0,0,3,2,3,96,1.0,1.0,0.0,0.0,0.0,1.0,2.0,7,5,2,1.0,0.0,1.0
9811206,11,4,7,9,1,10,16,39,1.0,1.0,0.0,0.0,0.0,1.0,2.0,15,11,4,1.0,0.0,1.0
9302201,24,3,21,83,0,24,24,56,17.0,2.0,15.0,46.0,0.0,17.0,17.0,25,24,1,15.0,14.0,1.0
9411353,15,8,7,10,15,0,0,134,2.0,1.0,1.0,1.0,2.0,0.0,0.0,15,15,0,3.0,3.0,0.0
9702266,17,5,12,36,1,16,58,25,6.0,2.0,4.0,10.0,1.0,5.0,22.0,30,17,13,5.0,5.0,0.0
9901231,14,10,4,4,1,13,30,5,2.0,1.0,1.0,1.0,0.0,2.0,6.0,30,14,16,3.0,2.0,1.0
9901368,6,2,4,7,0,6,35,2,0.0,0.0,0.0,0.0,0.0,0.0,0.0,15,6,9,1.0,0.0,1.0
9501275,8,4,4,7,6,2,2,99,2.0,1.0,1.0,1.0,2.0,0.0,0.0,14,8,6,1.0,1.0,0.0
211315,1,1,0,0,0,1,8,3,1.0,1.0,0.0,0.0,0.0,1.0,5.0,41,1,40,13.0,1.0,12.0
9907521,12,4,8,13,1,11,50,3,7.0,2.0,5.0,9.0,0.0,7.0,29.0,27,12,15,15.0,7.0,8.0
9602269,11,4,7,10,4,7,16,15,4.0,3.0,1.0,1.0,2.0,2.0,4.0,15,11,4,8.0,5.0,3.0
9303321,11,5,6,16,11,0,0,176,11.0,5.0,6.0,16.0,11.0,0.0,0.0,11,11,0,11.0,11.0,0.0
9705210,4,4,0,0,0,4,23,10,1.0,1.0,0.0,0.0,0.0,1.0,11.0,37,4,33,11.0,1.0,10.0
11299,10,6,4,4,0,10,37,27,1.0,1.0,0.0,0.0,0.0,1.0,12.0,46,10,36,7.0,0.0,7.0
9909331,2,2,0,0,0,2,21,39,0.0,0.0,0.0,0.0,0.0,0.0,0.0,17,2,15,12.0,0.0,12.0
9903354,35,14,21,48,1,34,193,27,30.0,11.0,19.0,44.0,0.0,30.0,179.0,49,35,14,15.0,10.0,5.0
204288,16,11,5,6,1,15,74,46,4.0,4.0,0.0,0.0,0.0,4.0,27.0,74,16,58,16.0,2.0,14.0
8314,2,1,1,1,0,2,5,129,2.0,1.0,1.0,1.0,0.0,2.0,5.0,7,2,5,4.0,2.0,2.0
107161,7,1,6,10,0,7,44,0,2.0,1.0,1.0,1.0,0.0,2.0,5.0,22,7,15,9.0,4.0,5.0
9707445,14,3,11,29,1,13,21,3,8.0,3.0,5.0,8.0,0.0,8.0,8.0,22,14,8,7.0,6.0,1.0
205261,40,3,37,119,1,39,169,0,20.0,1.0,19.0,66.0,0.0,20.0,92.0,46,40,6,19.0,14.0,5.0
9811232,3,3,0,0,3,0,0,159,1.0,1.0,0.0,0.0,1.0,0.0,0.0,7,3,4,1.0,1.0,0.0
103046,20,7,13,27,0,20,110,92,1.0,1.0,0.0,0.0,0.0,1.0,10.0,51,20,31,13.0,1.0,12.0
12229,3,2,1,1,0,3,8,95,3.0,2.0,1.0,1.0,0.0,3.0,8.0,10,3,7,8.0,3.0,5.0
9608443,7,1,6,13,0,7,13,47,6.0,1.0,5.0,11.0,0.0,6.0,6.0,12,7,5,7.0,6.0,1.0
8232,12,6,6,7,1,11,73,3,7.0,3.0,4.0,5.0,0.0,7.0,49.0,57,12,45,2.0,1.0,1.0
9705315,18,8,10,24,3,15,41,41,5.0,3.0,2.0,3.0,0.0,5.0,15.0,29,18,11,9.0,8.0,1.0
111418,24,7,17,81,1,23,131,0,10.0,1.0,9.0,40.0,1.0,9.0,45.0,54,24,30,18.0,11.0,7.0
9908449,2,2,0,0,1,1,5,277,1.0,1.0,0.0,0.0,0.0,1.0,4.0,12,2,10,7.0,1.0,6.0
9911237,27,4,23,95,3,24,86,65,23.0,2.0,21.0,93.0,2.0,21.0,54.0,49,27,22,25.0,20.0,5.0
206055,4,3,1,1,0,4,36,28,4.0,3.0,1.0,1.0,0.0,4.0,23.0,16,4,12,1.0,1.0,0.0
9602335,8,5,3,4,1,7,24,1,4.0,3.0,1.0,2.0,0.0,4.0,14.0,21,8,13,2.0,2.0,0.0
9410286,9,2,7,15,1,8,8,52,8.0,1.0,7.0,15.0,1.0,7.0,7.0,10,9,1,8.0,7.0,1.0
9804322,8,7,1,1,3,5,19,35,3.0,2.0,1.0,1.0,1.0,2.0,3.0,39,8,31,5.0,1.0,4.0
9610310,10,2,8,16,2,8,14,101,9.0,1.0,8.0,14.0,1.0,8.0,12.0,22,10,12,9.0,7.0,2.0
110158,12,2,10,22,0,12,247,11,11.0,1.0,10.0,22.0,0.0,11.0,214.0,59,12,47,37.0,9.0,28.0
9612328,21,2,19,48,0,21,60,13,16.0,1.0,15.0,41.0,0.0,16.0,40.0,40,21,19,8.0,5.0,3.0
9807504,19,11,8,20,5,14,21,31,10.0,4.0,6.0,14.0,2.0,8.0,13.0,23,19,4,5.0,5.0,0.0
9401307,3,3,0,0,2,1,1,524,3.0,3.0,0.0,0.0,3.0,0.0,0.0,4,3,1,2.0,2.0,0.0
9712246,1,1,0,0,1,0,0,2132,,,,,,,,1,1,0,,,
110138,9,4,5,14,0,9,134,32,7.0,4.0,3.0,10.0,0.0,7.0,95.0,49,9,40,28.0,5.0,23.0
9602273,7,3,4,5,0,7,28,33,5.0,2.0,3.0,3.0,0.0,5.0,20.0,16,7,9,9.0,4.0,5.0
9811361,3,3,0,0,0,3,27,17,3.0,3.0,0.0,0.0,0.0,3.0,27.0,22,3,19,19.0,1.0,18.0
9702371,4,4,0,0,4,0,0,305,1.0,1.0,0.0,0.0,1.0,0.0,0.0,8,4,4,1.0,1.0,0.0
9907293,12,3,9,15,7,5,23,25,4.0,1.0,3.0,6.0,0.0,4.0,16.0,23,12,11,8.0,4.0,4.0
103001,7,3,4,7,1,6,28,25,4.0,1.0,3.0,6.0,0.0,4.0,22.0,22,7,15,8.0,4.0,4.0
9306244,17,8,9,24,1,16,28,62,15.0,6.0,9.0,24.0,0.0,15.0,26.0,19,17,2,11.0,9.0,2.0
9806537,18,2,16,60,0,18,155,8,14.0,2.0,12.0,49.0,0.0,14.0,123.0,38,18,20,26.0,13.0,13.0
9504375,14,3,11,42,2,12,70,6,7.0,2.0,5.0,14.0,0.0,7.0,53.0,28,14,14,13.0,12.0,1.0
9507359,7,1,6,6,0,7,28,10,4.0,2.0,2.0,2.0,0.0,4.0,18.0,14,7,7,6.0,3.0,3.0
210162,2,1,1,1,0,2,2,42,0.0,0.0,0.0,0.0,0.0,0.0,0.0,20,2,18,2.0,0.0,2.0
9810538,1,1,0,0,1,0,0,1308,,,,,,,,1,1,0,,,
9910278,23,1,22,142,2,21,67,109,22.0,1.0,21.0,140.0,1.0,21.0,67.0,28,23,5,25.0,21.0,4.0
9609347,6,4,2,3,0,6,18,41,0.0,0.0,0.0,0.0,0.0,0.0,0.0,15,6,9,6.0,2.0,4.0
9506406,8,3,5,6,0,8,36,13,5.0,2.0,3.0,4.0,0.0,5.0,12.0,18,8,10,7.0,4.0,3.0
9702222,10,4,6,9,2,8,16,157,5.0,1.0,4.0,4.0,0.0,5.0,7.0,20,10,10,7.0,5.0,2.0
9808245,1,1,0,0,0,1,3,629,1.0,1.0,0.0,0.0,0.0,1.0,3.0,6,1,5,1.0,0.0,1.0
105258,3,3,0,0,3,0,0,389,1.0,1.0,0.0,0.0,1.0,0.0,0.0,5,3,2,2.0,1.0,1.0
206081,3,3,0,0,1,2,4,210,0.0,0.0,0.0,0.0,0.0,0.0,0.0,15,3,12,6.0,0.0,6.0
5241,4,3,1,1,0,4,12,228,1.0,1.0,0.0,0.0,0.0,1.0,3.0,11,4,7,3.0,2.0,1.0
201131,9,5,4,6,0,9,65,2,5.0,1.0,4.0,5.0,0.0,5.0,27.0,45,9,36,15.0,6.0,9.0
105165,6,3,3,3,0,6,57,20,4.0,3.0,1.0,1.0,0.0,4.0,43.0,39,6,33,28.0,2.0,26.0
9803428,14,6,8,17,0,14,155,7,6.0,3.0,3.0,5.0,0.0,6.0,43.0,47,14,33,13.0,7.0,6.0
9607411,12,2,10,28,1,11,12,90,10.0,1.0,9.0,23.0,0.0,10.0,10.0,14,12,2,11.0,10.0,1.0
9701293,5,1,4,4,1,4,26,169,3.0,1.0,2.0,2.0,0.0,3.0,11.0,19,5,14,10.0,3.0,7.0
9504377,11,7,4,6,11,0,0,77,4.0,1.0,3.0,5.0,4.0,0.0,0.0,16,11,5,3.0,3.0,0.0
9711422,14,4,10,22,5,9,10,177,8.0,2.0,6.0,13.0,8.0,0.0,0.0,18,14,4,7.0,7.0,0.0
9910201,11,5,6,12,1,10,29,34,8.0,2.0,6.0,12.0,0.0,8.0,26.0,29,11,18,2.0,2.0,0.0
9711487,9,1,8,20,0,9,75,8,7.0,1.0,6.0,14.0,0.0,7.0,50.0,26,9,17,19.0,7.0,12.0
9507256,10,4,6,7,4,6,6,54,5.0,5.0,0.0,0.0,5.0,0.0,0.0,12,10,2,3.0,3.0,0.0
12238,8,7,1,1,8,0,0,197,2.0,1.0,1.0,1.0,2.0,0.0,0.0,8,8,0,1.0,1.0,0.0
9906223,12,5,7,17,0,12,23,27,12.0,5.0,7.0,17.0,0.0,12.0,23.0,16,12,4,6.0,4.0,2.0
9808348,3,2,1,1,0,3,7,20,0.0,0.0,0.0,0.0,0.0,0.0,0.0,25,3,22,5.0,1.0,4.0
9809497,3,3,0,0,0,3,6,51,3.0,3.0,0.0,0.0,0.0,3.0,6.0,11,3,8,4.0,0.0,4.0
9506281,19,8,11,26,1,18,65,57,14.0,3.0,11.0,26.0,0.0,14.0,59.0,28,19,9,14.0,10.0,4.0
9406215,2,2,0,0,1,1,1,417,1.0,1.0,0.0,0.0,1.0,0.0,0.0,4,2,2,1.0,1.0,0.0
9708292,3,2,1,1,1,2,10,94,0.0,0.0,0.0,0.0,0.0,0.0,0.0,13,3,10,4.0,0.0,4.0
207151,2,2,0,0,0,2,2,54,0.0,0.0,0.0,0.0,0.0,0.0,0.0,15,2,13,2.0,1.0,1.0
9211225,5,5,0,0,5,0,0,364,3.0,3.0,0.0,0.0,3.0,0.0,0.0,6,5,1,3.0,2.0,1.0
9703342,3,2,1,1,0,3,6,88,1.0,1.0,0.0,0.0,0.0,1.0,3.0,11,3,8,2.0,1.0,1.0
9612467,1,1,0,0,0,1,1,1488,0.0,0.0,0.0,0.0,0.0,0.0,0.0,2,1,1,,,
9806275,5,2,3,4,1,4,11,222,4.0,2.0,2.0,3.0,0.0,4.0,10.0,9,5,4,7.0,4.0,3.0
9612410,2,1,1,1,0,2,6,41,1.0,1.0,0.0,0.0,0.0,1.0,3.0,7,2,5,1.0,0.0,1.0
9804232,7,1,6,10,0,7,11,321,6.0,1.0,5.0,8.0,0.0,6.0,9.0,11,7,4,6.0,4.0,2.0
9410398,9,5,4,8,5,4,8,53,2.0,2.0,0.0,0.0,0.0,2.0,3.0,14,9,5,3.0,2.0,1.0
9608263,9,2,7,13,3,6,15,96,3.0,1.0,2.0,2.0,0.0,3.0,11.0,24,9,15,11.0,4.0,7.0
9410382,0,0,0,0,0,0,0,1569,,,,,,,,1,0,1,,,
9704285,3,3,0,0,3,0,0,230,2.0,2.0,0.0,0.0,2.0,0.0,0.0,4,3,1,1.0,1.0,0.0
9712313,0,0,0,0,0,0,0,115,0.0,0.0,0.0,0.0,0.0,0.0,0.0,8,0,8,5.0,0.0,5.0
9909298,8,4,4,4,2,6,16,1,1.0,1.0,0.0,0.0,1.0,0.0,0.0,17,8,9,2.0,1.0,1.0
9801378,4,4,0,0,4,0,0,426,2.0,2.0,0.0,0.0,2.0,0.0,0.0,4,4,0,1.0,1.0,0.0
9711382,3,2,1,1,0,3,6,14,2.0,2.0,0.0,0.0,0.0,2.0,3.0,9,3,6,3.0,1.0,2.0
101225,30,4,26,40,1,29,184,9,17.0,1.0,16.0,22.0,0.0,17.0,130.0,73,30,43,36.0,4.0,32.0
9712363,7,2,5,14,1,6,20,142,6.0,1.0,5.0,14.0,0.0,6.0,20.0,11,7,4,10.0,6.0,4.0
9502322,2,2,0,0,0,2,2,331,1.0,1.0,0.0,0.0,1.0,0.0,0.0,4,2,2,2.0,1.0,1.0
9605230,18,6,12,32,0,18,75,56,17.0,5.0,12.0,32.0,0.0,17.0,73.0,28,18,10,17.0,10.0,7.0
9509315,2,2,0,0,0,2,8,56,2.0,2.0,0.0,0.0,0.0,2.0,8.0,7,2,5,,,
9508305,4,3,1,2,3,1,2,38,2.0,1.0,1.0,1.0,1.0,1.0,1.0,6,4,2,1.0,1.0,0.0
9307365,4,2,2,2,4,0,0,116,2.0,1.0,1.0,1.0,2.0,0.0,0.0,4,4,0,,,
9805230,2,2,0,0,0,2,7,8,1.0,1.0,0.0,0.0,0.0,1.0,2.0,22,2,20,3.0,1.0,2.0
108009,10,1,9,21,1,9,20,38,6.0,1.0,5.0,10.0,2.0,4.0,4.0,17,10,7,9.0,7.0,2.0
10319,7,1,6,9,0,7,40,11,4.0,1.0,3.0,4.0,0.0,4.0,6.0,24,7,17,8.0,5.0,3.0
9807312,4,3,1,1,0,4,16,12,0.0,0.0,0.0,0.0,0.0,0.0,0.0,23,4,19,4.0,0.0,4.0
9801221,7,3,4,5,5,2,2,188,0.0,0.0,0.0,0.0,0.0,0.0,0.0,11,7,4,3.0,0.0,3.0
9409298,1,1,0,0,0,1,2,192,0.0,0.0,0.0,0.0,0.0,0.0,0.0,5,1,4,1.0,0.0,1.0
9502405,9,6,3,3,8,1,1,175,3.0,2.0,1.0,1.0,3.0,0.0,0.0,10,9,1,4.0,4.0,0.0
9503252,5,4,1,1,2,3,4,190,1.0,1.0,0.0,0.0,0.0,1.0,2.0,9,5,4,4.0,1.0,3.0
105160,19,4,15,37,0,19,243,7,14.0,4.0,10.0,22.0,0.0,14.0,195.0,58,19,39,35.0,12.0,23.0
9703441,8,1,7,11,3,5,6,63,7.0,1.0,6.0,10.0,2.0,5.0,6.0,12,8,4,5.0,4.0,1.0
9607240,4,3,1,1,1,3,6,94,3.0,2.0,1.0,1.0,3.0,0.0,0.0,10,4,6,5.0,3.0,2.0
9705393,4,2,2,2,4,0,0,105,,,,,,,,4,4,0,,,
9607311,5,3,2,2,3,2,3,348,2.0,2.0,0.0,0.0,1.0,1.0,2.0,9,5,4,3.0,2.0,1.0
9909387,11,4,7,15,1,10,43,21,7.0,1.0,6.0,12.0,0.0,7.0,25.0,23,11,12,13.0,7.0,6.0
9505217,9,2,7,24,9,0,0,49,8.0,2.0,6.0,19.0,8.0,0.0,0.0,9,9,0,7.0,7.0,0.0
9705404,7,2,5,8,0,7,29,1,0.0,0.0,0.0,0.0,0.0,0.0,0.0,15,7,8,2.0,0.0,2.0
9405231,3,2,1,1,3,0,0,1338,,,,,,,,3,3,0,1.0,1.0,0.0
107212,10,4,6,14,0,10,51,21,5.0,5.0,0.0,0.0,0.0,5.0,9.0,28,10,18,11.0,7.0,4.0
9811288,8,2,6,7,0,8,21,21,0.0,0.0,0.0,0.0,0.0,0.0,0.0,14,8,6,3.0,0.0,3.0
205044,7,3,4,4,0,7,123,73,5.0,1.0,4.0,4.0,0.0,5.0,71.0,84,7,77,14.0,3.0,11.0
9807243,8,4,4,4,3,5,24,20,0.0,0.0,0.0,0.0,0.0,0.0,0.0,23,8,15,7.0,0.0,7.0
2162,15,3,12,24,1,14,55,13,8.0,4.0,4.0,8.0,0.0,8.0,31.0,28,15,13,16.0,5.0,11.0
9903439,21,11,10,15,2,19,87,16,6.0,4.0,2.0,2.0,0.0,6.0,33.0,45,21,24,6.0,2.0,4.0
9406433,1,1,0,0,1,0,0,1515,,,,,,,,1,1,0,,,
1163,4,3,1,1,0,4,25,28,2.0,1.0,1.0,1.0,0.0,2.0,7.0,23,4,19,7.0,1.0,6.0
111176,10,5,5,9,1,9,35,46,7.0,2.0,5.0,8.0,0.0,7.0,24.0,27,10,17,12.0,6.0,6.0
9909308,1,1,0,0,0,1,7,50,0.0,0.0,0.0,0.0,0.0,0.0,0.0,8,1,7,4.0,0.0,4.0
9809551,2,2,0,0,2,0,0,195,1.0,1.0,0.0,0.0,1.0,0.0,0.0,3,2,1,1.0,1.0,0.0
9905410,8,2,6,14,2,6,16,147,5.0,1.0,4.0,8.0,2.0,3.0,3.0,22,8,14,6.0,5.0,1.0
9809227,10,2,8,9,5,5,6,187,8.0,2.0,6.0,7.0,5.0,3.0,3.0,15,10,5,7.0,6.0,1.0
9807384,9,4,5,7,1,8,21,13,4.0,1.0,3.0,3.0,1.0,3.0,11.0,17,9,8,8.0,4.0,4.0
9704241,5,2,3,3,2,3,14,36,3.0,1.0,2.0,2.0,0.0,3.0,12.0,13,5,8,1.0,1.0,0.0
9808450,2,2,0,0,0,2,5,11,1.0,1.0,0.0,0.0,0.0,1.0,1.0,5,2,3,1.0,1.0,0.0
9408254,12,6,6,12,3,9,9,71,4.0,2.0,2.0,2.0,1.0,3.0,3.0,14,12,2,5.0,4.0,1.0
9603226,3,1,2,2,0,3,6,214,2.0,1.0,1.0,1.0,0.0,2.0,4.0,8,3,5,5.0,2.0,3.0
9706273,24,14,10,19,6,18,25,167,6.0,5.0,1.0,2.0,0.0,6.0,6.0,32,24,8,5.0,5.0,0.0
9905439,13,5,8,10,2,11,44,22,4.0,3.0,1.0,1.0,2.0,2.0,8.0,34,13,21,8.0,6.0,2.0
9210264,5,2,3,4,5,0,0,111,4.0,2.0,2.0,3.0,4.0,0.0,0.0,5,5,0,3.0,3.0,0.0
9711289,9,3,6,9,4,5,9,51,1.0,1.0,0.0,0.0,0.0,1.0,3.0,19,9,10,7.0,0.0,7.0
9511231,3,3,0,0,1,2,2,90,1.0,1.0,0.0,0.0,1.0,0.0,0.0,6,3,3,2.0,1.0,1.0
9504388,11,3,8,15,7,4,6,101,6.0,1.0,5.0,8.0,6.0,0.0,0.0,15,11,4,5.0,5.0,0.0
9703451,1,1,0,0,0,1,1,72,0.0,0.0,0.0,0.0,0.0,0.0,0.0,3,1,2,1.0,0.0,1.0
209130,3,2,1,1,1,2,7,28,3.0,2.0,1.0,1.0,1.0,2.0,6.0,8,3,5,1.0,0.0,1.0
9407255,2,2,0,0,1,1,1,93,1.0,1.0,0.0,0.0,1.0,0.0,0.0,4,2,2,1.0,0.0,1.0
101087,2,2,0,0,0,2,6,70,2.0,2.0,0.0,0.0,0.0,2.0,6.0,7,2,5,1.0,0.0,1.0
203169,4,2,2,2,1,3,18,0,4.0,2.0,2.0,2.0,1.0,3.0,18.0,13,4,9,2.0,0.0,2.0
9611460,9,3,6,10,4,5,14,57,2.0,1.0,1.0,1.0,0.0,2.0,5.0,23,9,14,4.0,3.0,1.0
7223,38,17,21,52,5,33,163,65,16.0,5.0,11.0,29.0,0.0,16.0,82.0,78,38,40,21.0,12.0,9.0
9806388,1,1,0,0,1,0,0,1070,,,,,,,,1,1,0,,,
103124,12,6,6,12,0,12,66,51,10.0,4.0,6.0,12.0,0.0,10.0,40.0,29,12,17,15.0,8.0,7.0
206080,3,3,0,0,0,3,24,3,1.0,1.0,0.0,0.0,0.0,1.0,1.0,22,3,19,3.0,1.0,2.0
206163,7,5,2,3,2,5,14,50,0.0,0.0,0.0,0.0,0.0,0.0,0.0,30,7,23,6.0,0.0,6.0
103281,2,1,1,1,0,2,7,410,2.0,1.0,1.0,1.0,0.0,2.0,7.0,7,2,5,6.0,2.0,4.0
9303259,17,4,13,30,17,0,0,217,14.0,2.0,12.0,27.0,14.0,0.0,0.0,17,17,0,9.0,9.0,0.0
12232,31,6,25,52,0,31,110,108,20.0,2.0,18.0,39.0,0.0,20.0,70.0,46,31,15,15.0,10.0,5.0
209007,0,0,0,0,0,0,0,319,0.0,0.0,0.0,0.0,0.0,0.0,0.0,9,0,9,1.0,0.0,1.0
9803239,6,5,1,1,1,5,21,188,4.0,3.0,1.0,1.0,0.0,4.0,17.0,15,6,9,9.0,3.0,6.0
9610220,3,3,0,0,1,2,2,525,2.0,2.0,0.0,0.0,1.0,1.0,1.0,6,3,3,3.0,2.0,1.0
206058,12,6,6,9,1,11,34,29,1.0,1.0,0.0,0.0,0.0,1.0,4.0,24,12,12,6.0,1.0,5.0
203089,4,4,0,0,2,2,8,6,0.0,0.0,0.0,0.0,0.0,0.0,0.0,30,4,26,9.0,0.0,9.0
210049,1,1,0,0,1,0,0,424,1.0,1.0,0.0,0.0,1.0,0.0,0.0,4,1,3,1.0,0.0,1.0
9701385,4,2,2,3,1,3,5,315,3.0,1.0,2.0,3.0,0.0,3.0,5.0,9,4,5,6.0,3.0,3.0
9706447,4,4,0,0,0,4,16,19,1.0,1.0,0.0,0.0,0.0,1.0,8.0,16,4,12,7.0,1.0,6.0
9808345,1,1,0,0,1,0,0,851,1.0,1.0,0.0,0.0,1.0,0.0,0.0,2,1,1,1.0,0.0,1.0
108207,3,1,2,3,0,3,9,12,1.0,1.0,0.0,0.0,1.0,0.0,0.0,30,3,27,4.0,3.0,1.0
8313,1,1,0,0,0,1,2,191,0.0,0.0,0.0,0.0,0.0,0.0,0.0,4,1,3,1.0,1.0,0.0
9411376,1,1,0,0,1,0,0,602,1.0,1.0,0.0,0.0,1.0,0.0,0.0,2,1,1,,,
7257,6,3,3,5,1,5,10,209,3.0,1.0,2.0,3.0,0.0,3.0,3.0,10,6,4,4.0,3.0,1.0
9508299,3,2,1,2,0,3,14,54,1.0,1.0,0.0,0.0,0.0,1.0,5.0,10,3,7,3.0,1.0,2.0
106153,8,3,5,8,7,1,1,219,6.0,2.0,4.0,7.0,6.0,0.0,0.0,9,8,1,4.0,4.0,0.0
111094,8,6,2,2,0,8,54,1,4.0,3.0,1.0,1.0,0.0,4.0,21.0,35,8,27,9.0,3.0,6.0
9611360,2,2,0,0,1,1,1,434,1.0,1.0,0.0,0.0,0.0,1.0,1.0,6,2,4,2.0,1.0,1.0
9411424,2,2,0,0,2,0,0,267,1.0,1.0,0.0,0.0,1.0,0.0,0.0,2,2,0,1.0,1.0,0.0
106045,5,1,4,5,0,5,63,38,4.0,1.0,3.0,4.0,0.0,4.0,57.0,25,5,20,19.0,4.0,15.0
9501329,5,4,1,1,5,0,0,355,3.0,3.0,0.0,0.0,3.0,0.0,0.0,5,5,0,1.0,1.0,0.0
9703381,6,5,1,1,1,5,14,4,0.0,0.0,0.0,0.0,0.0,0.0,0.0,14,6,8,,,
9706464,8,4,4,5,0,8,26,49,3.0,2.0,1.0,2.0,0.0,3.0,8.0,26,8,18,5.0,3.0,2.0
205259,10,3,7,17,0,10,56,7,7.0,2.0,5.0,8.0,0.0,7.0,13.0,26,10,16,11.0,8.0,3.0
9604273,5,3,2,3,2,3,10,15,2.0,2.0,0.0,0.0,0.0,2.0,2.0,9,5,4,5.0,3.0,2.0
6350,2,1,1,1,0,2,4,1897,,,,,,,,6,2,4,,,
202115,1,1,0,0,0,1,3,536,1.0,1.0,0.0,0.0,0.0,1.0,1.0,11,1,10,2.0,1.0,1.0
108122,19,5,14,36,1,18,238,23,15.0,3.0,12.0,27.0,1.0,14.0,187.0,44,19,25,32.0,15.0,17.0
107318,8,6,2,3,1,7,20,23,4.0,3.0,1.0,2.0,0.0,4.0,11.0,19,8,11,2.0,1.0,1.0
9706276,5,4,1,1,2,3,11,216,4.0,3.0,1.0,1.0,1.0,3.0,6.0,10,5,5,3.0,1.0,2.0
9606347,8,4,4,10,5,3,6,72,6.0,2.0,4.0,10.0,6.0,0.0,0.0,12,8,4,6.0,6.0,0.0
9404340,6,3,3,5,6,0,0,58,5.0,3.0,2.0,2.0,5.0,0.0,0.0,6,6,0,4.0,4.0,0.0
107004,3,2,1,1,2,1,12,82,1.0,1.0,0.0,0.0,0.0,1.0,12.0,18,3,15,4.0,0.0,4.0
9707205,1,1,0,0,0,1,1,181,1.0,1.0,0.0,0.0,0.0,1.0,1.0,5,1,4,1.0,0.0,1.0
207014,2,2,0,0,0,2,8,80,1.0,1.0,0.0,0.0,0.0,1.0,2.0,11,2,9,3.0,1.0,2.0
12136,29,2,27,76,0,29,291,9,25.0,2.0,23.0,70.0,0.0,25.0,270.0,63,29,34,30.0,10.0,20.0
9507309,5,5,0,0,4,1,1,368,2.0,2.0,0.0,0.0,2.0,0.0,0.0,11,5,6,3.0,2.0,1.0
103010,4,3,1,1,3,1,2,185,4.0,3.0,1.0,1.0,4.0,0.0,0.0,7,4,3,3.0,3.0,0.0
207314,9,3,6,10,2,7,50,4,4.0,1.0,3.0,4.0,0.0,4.0,31.0,23,9,14,6.0,2.0,4.0
9903247,3,3,0,0,1,2,10,4,,,,,,,,10,3,7,1.0,1.0,0.0
9707418,5,4,1,1,0,5,21,14,3.0,3.0,0.0,0.0,0.0,3.0,4.0,16,5,11,5.0,4.0,1.0
10166,2,1,1,1,0,2,3,68,,,,,,,,5,2,3,,,
9812388,3,2,1,1,1,2,7,113,1.0,1.0,0.0,0.0,0.0,1.0,2.0,12,3,9,5.0,1.0,4.0
104147,8,7,1,1,8,0,0,283,1.0,1.0,0.0,0.0,1.0,0.0,0.0,10,8,2,2.0,2.0,0.0
9904454,9,3,6,10,1,8,41,29,2.0,1.0,1.0,1.0,0.0,2.0,18.0,25,9,16,11.0,2.0,9.0
109151,6,5,1,1,2,4,11,32,0.0,0.0,0.0,0.0,0.0,0.0,0.0,33,6,27,7.0,0.0,7.0
9710355,5,3,2,2,1,4,27,48,2.0,1.0,1.0,1.0,0.0,2.0,16.0,19,5,14,12.0,2.0,10.0
9806355,10,5,5,12,3,7,14,135,6.0,3.0,3.0,6.0,3.0,3.0,3.0,15,10,5,8.0,6.0,2.0
9510406,6,2,4,4,6,0,0,273,2.0,1.0,1.0,1.0,2.0,0.0,0.0,11,6,5,2.0,2.0,0.0
4234,8,4,4,5,0,8,47,17,5.0,2.0,3.0,4.0,0.0,5.0,37.0,23,8,15,2.0,2.0,0.0
9503477,22,7,15,20,13,9,10,180,11.0,3.0,8.0,12.0,8.0,3.0,3.0,25,22,3,6.0,5.0,1.0
103177,0,0,0,0,0,0,0,39,0.0,0.0,0.0,0.0,0.0,0.0,0.0,15,0,15,2.0,0.0,2.0
9510266,7,7,0,0,7,0,0,385,2.0,2.0,0.0,0.0,2.0,0.0,0.0,7,7,0,2.0,2.0,0.0
209304,0,0,0,0,0,0,0,1081,,,,,,,,1,0,1,,,
7056,14,6,8,21,1,13,59,13,6.0,3.0,3.0,6.0,0.0,6.0,18.0,33,14,19,8.0,2.0,6.0
9512217,2,1,1,1,2,0,0,74,0.0,0.0,0.0,0.0,0.0,0.0,0.0,6,2,4,2.0,2.0,0.0
9503286,2,2,0,0,0,2,4,49,1.0,1.0,0.0,0.0,0.0,1.0,3.0,7,2,5,4.0,1.0,3.0
6142,1,1,0,0,0,1,1,1347,1.0,1.0,0.0,0.0,1.0,0.0,0.0,2,1,1,1.0,1.0,0.0
9702413,9,6,3,3,7,2,4,35,4.0,2.0,2.0,2.0,4.0,0.0,0.0,12,9,3,1.0,1.0,0.0
9261,3,2,1,1,0,3,12,11,2.0,1.0,1.0,1.0,0.0,2.0,4.0,9,3,6,4.0,3.0,1.0
9505283,2,2,0,0,1,1,3,116,1.0,1.0,0.0,0.0,1.0,0.0,0.0,5,2,3,3.0,0.0,3.0
107040,12,4,8,18,0,12,177,32,9.0,2.0,7.0,16.0,0.0,9.0,125.0,51,12,39,25.0,6.0,19.0
9908410,1,1,0,0,1,0,0,406,1.0,1.0,0.0,0.0,1.0,0.0,0.0,3,1,2,1.0,1.0,0.0
302072,0,0,0,0,0,0,0,65,0.0,0.0,0.0,0.0,0.0,0.0,0.0,10,0,10,2.0,0.0,2.0
9402338,1,1,0,0,0,1,1,163,0.0,0.0,0.0,0.0,0.0,0.0,0.0,3,1,2,1.0,0.0,1.0
9902269,1,1,0,0,1,0,0,344,1.0,1.0,0.0,0.0,1.0,0.0,0.0,3,1,2,2.0,1.0,1.0
9710249,3,3,0,0,3,0,0,84,1.0,1.0,0.0,0.0,1.0,0.0,0.0,3,3,0,,,
9509386,2,1,1,1,2,0,0,82,0.0,0.0,0.0,0.0,0.0,0.0,0.0,4,2,2,,,
12255,3,2,1,1,1,2,5,2,0.0,0.0,0.0,0.0,0.0,0.0,0.0,23,3,20,3.0,1.0,2.0
108156,3,3,0,0,2,1,2,106,1.0,1.0,0.0,0.0,1.0,0.0,0.0,8,3,5,1.0,1.0,0.0
3096,6,2,4,5,0,6,32,145,5.0,1.0,4.0,5.0,0.0,5.0,19.0,34,6,28,12.0,5.0,7.0
9507457,2,2,0,0,1,1,1,96,1.0,1.0,0.0,0.0,1.0,0.0,0.0,7,2,5,3.0,2.0,1.0
9907493,1,1,0,0,1,0,0,557,1.0,1.0,0.0,0.0,1.0,0.0,0.0,2,1,1,1.0,1.0,0.0
301005,0,0,0,0,0,0,0,326,0.0,0.0,0.0,0.0,0.0,0.0,0.0,4,0,4,4.0,0.0,4.0
9804320,5,3,2,2,1,4,10,260,4.0,2.0,2.0,2.0,0.0,4.0,10.0,8,5,3,7.0,4.0,3.0
212227,2,2,0,0,1,1,4,18,1.0,1.0,0.0,0.0,1.0,0.0,0.0,20,2,18,1.0,0.0,1.0
112027,5,4,1,1,0,5,14,64,4.0,3.0,1.0,1.0,0.0,4.0,9.0,14,5,9,2.0,1.0,1.0
9712466,13,6,7,11,4,9,12,194,9.0,2.0,7.0,11.0,9.0,0.0,0.0,20,13,7,8.0,8.0,0.0
3267,4,2,2,2,1,3,3,42,0.0,0.0,0.0,0.0,0.0,0.0,0.0,24,4,20,2.0,0.0,2.0
1025,11,1,10,30,1,10,43,158,9.0,1.0,8.0,24.0,0.0,9.0,36.0,24,11,13,20.0,8.0,12.0
210323,7,6,1,2,0,7,208,1,5.0,4.0,1.0,2.0,0.0,5.0,131.0,120,7,113,33.0,2.0,31.0
9805239,7,3,4,5,1,6,12,49,3.0,1.0,2.0,3.0,0.0,3.0,7.0,19,7,12,1.0,0.0,1.0
9712357,6,3,3,4,2,4,16,33,3.0,1.0,2.0,2.0,0.0,3.0,12.0,13,6,7,7.0,3.0,4.0
9411445,6,3,3,5,0,6,12,35,6.0,3.0,3.0,5.0,0.0,6.0,10.0,10,6,4,3.0,3.0,0.0
201112,5,4,1,1,4,1,2,144,1.0,1.0,0.0,0.0,0.0,1.0,2.0,7,5,2,3.0,1.0,2.0
9610279,2,1,1,1,0,2,9,35,2.0,1.0,1.0,1.0,0.0,2.0,9.0,9,2,7,8.0,2.0,6.0
9803295,4,3,1,1,0,4,7,18,1.0,1.0,0.0,0.0,1.0,0.0,0.0,7,4,3,2.0,1.0,1.0
106013,2,2,0,0,1,1,1,273,0.0,0.0,0.0,0.0,0.0,0.0,0.0,9,2,7,3.0,1.0,2.0
109067,3,2,1,1,0,3,9,0,2.0,1.0,1.0,1.0,2.0,0.0,0.0,17,3,14,2.0,2.0,0.0
208123,7,6,1,1,3,4,16,59,2.0,2.0,0.0,0.0,0.0,2.0,13.0,57,7,50,21.0,0.0,21.0
9808362,4,4,0,0,3,1,1,205,1.0,1.0,0.0,0.0,1.0,0.0,0.0,11,4,7,4.0,0.0,4.0
12264,2,2,0,0,1,1,4,10,0.0,0.0,0.0,0.0,0.0,0.0,0.0,51,2,49,13.0,0.0,13.0
9807556,1,1,0,0,0,1,2,133,0.0,0.0,0.0,0.0,0.0,0.0,0.0,8,1,7,2.0,0.0,2.0
4229,1,1,0,0,0,1,3,110,0.0,0.0,0.0,0.0,0.0,0.0,0.0,21,1,20,7.0,0.0,7.0
9312270,1,1,0,0,1,0,0,1392,1.0,1.0,0.0,0.0,1.0,0.0,0.0,1,1,0,,,
111229,6,4,2,2,0,6,29,18,4.0,3.0,1.0,1.0,0.0,4.0,21.0,22,6,16,11.0,2.0,9.0
9606357,4,3,1,1,0,4,30,38,4.0,3.0,1.0,1.0,0.0,4.0,20.0,17,4,13,6.0,3.0,3.0
9909484,10,3,7,11,2,8,47,1,7.0,2.0,5.0,7.0,0.0,7.0,43.0,22,10,12,14.0,5.0,9.0
9709317,2,2,0,0,1,1,10,123,1.0,1.0,0.0,0.0,0.0,1.0,8.0,12,2,10,5.0,1.0,4.0
202113,1,1,0,0,0,1,3,91,1.0,1.0,0.0,0.0,0.0,1.0,3.0,7,1,6,6.0,1.0,5.0
9608471,1,1,0,0,0,1,1,52,1.0,1.0,0.0,0.0,0.0,1.0,1.0,2,1,1,,,
4156,2,2,0,0,1,1,1,324,1.0,1.0,0.0,0.0,0.0,1.0,1.0,5,2,3,2.0,1.0,1.0
9708224,2,2,0,0,0,2,11,288,1.0,1.0,0.0,0.0,0.0,1.0,3.0,8,2,6,5.0,1.0,4.0
9805410,1,1,0,0,0,1,4,27,1.0,1.0,0.0,0.0,0.0,1.0,3.0,9,1,8,1.0,1.0,0.0
210352,2,2,0,0,0,2,3,95,2.0,2.0,0.0,0.0,0.0,2.0,2.0,16,2,14,3.0,1.0,2.0
5106,8,2,6,9,1,7,25,31,5.0,1.0,4.0,5.0,1.0,4.0,18.0,26,8,18,9.0,0.0,9.0
206168,0,0,0,0,0,0,0,248,0.0,0.0,0.0,0.0,0.0,0.0,0.0,4,0,4,,,
210390,1,1,0,0,0,1,7,5,0.0,0.0,0.0,0.0,0.0,0.0,0.0,125,1,124,20.0,0.0,20.0
9708476,2,2,0,0,1,1,2,278,0.0,0.0,0.0,0.0,0.0,0.0,0.0,8,2,6,1.0,0.0,1.0
10145,1,1,0,0,0,1,1,100,0.0,0.0,0.0,0.0,0.0,0.0,0.0,7,1,6,2.0,1.0,1.0
9902441,10,7,3,6,3,7,10,156,8.0,5.0,3.0,6.0,1.0,7.0,10.0,13,10,3,4.0,4.0,0.0
9910330,1,1,0,0,0,1,2,128,1.0,1.0,0.0,0.0,0.0,1.0,2.0,3,1,2,1.0,0.0,1.0
4020,4,3,1,1,1,3,18,3,1.0,1.0,0.0,0.0,0.0,1.0,4.0,24,4,20,6.0,0.0,6.0
9703400,6,2,4,5,6,0,0,126,5.0,2.0,3.0,4.0,5.0,0.0,0.0,6,6,0,5.0,5.0,0.0
210075,1,1,0,0,0,1,2,76,1.0,1.0,0.0,0.0,0.0,1.0,2.0,23,1,22,8.0,1.0,7.0
205094,2,2,0,0,0,2,3,69,0.0,0.0,0.0,0.0,0.0,0.0,0.0,16,2,14,1.0,0.0,1.0
203181,6,1,5,10,1,5,15,0,2.0,1.0,1.0,1.0,0.0,2.0,4.0,15,6,9,8.0,4.0,4.0
9804449,4,3,1,1,0,4,11,21,0.0,0.0,0.0,0.0,0.0,0.0,0.0,30,4,26,9.0,2.0,7.0
10010,2,2,0,0,0,2,16,2,1.0,1.0,0.0,0.0,0.0,1.0,3.0,19,2,17,2.0,1.0,1.0
9902322,4,2,2,2,0,4,47,54,4.0,2.0,2.0,2.0,0.0,4.0,37.0,34,4,30,16.0,4.0,12.0
9204239,3,2,1,2,3,0,0,270,2.0,1.0,1.0,1.0,2.0,0.0,0.0,3,3,0,2.0,2.0,0.0
9402349,1,1,0,0,1,0,0,1333,1.0,1.0,0.0,0.0,1.0,0.0,0.0,1,1,0,1.0,1.0,0.0
101341,0,0,0,0,0,0,0,390,0.0,0.0,0.0,0.0,0.0,0.0,0.0,2,0,2,2.0,0.0,2.0
9905279,1,1,0,0,0,1,17,120,1.0,1.0,0.0,0.0,0.0,1.0,5.0,24,1,23,6.0,1.0,5.0
9909320,2,2,0,0,1,1,3,44,0.0,0.0,0.0,0.0,0.0,0.0,0.0,24,2,22,4.0,0.0,4.0
9607249,9,5,4,9,4,5,5,180,7.0,4.0,3.0,8.0,2.0,5.0,5.0,10,9,1,7.0,6.0,1.0
9810354,2,1,1,1,1,1,1,386,2.0,1.0,1.0,1.0,1.0,1.0,1.0,4,2,2,4.0,2.0,2.0
203025,7,3,4,6,0,7,43,16,6.0,3.0,3.0,4.0,0.0,6.0,37.0,26,7,19,10.0,4.0,6.0
9307232,15,11,4,6,13,2,3,225,8.0,7.0,1.0,3.0,8.0,0.0,0.0,18,15,3,3.0,3.0,0.0
9097,4,4,0,0,1,3,3,51,2.0,2.0,0.0,0.0,2.0,0.0,0.0,8,4,4,3.0,2.0,1.0
9501342,1,1,0,0,1,0,0,214,,,,,,,,1,1,0,,,
110149,6,4,2,2,0,6,21,106,5.0,3.0,2.0,2.0,0.0,5.0,13.0,26,6,20,6.0,3.0,3.0
9405416,11,4,7,14,9,2,2,483,7.0,3.0,4.0,7.0,7.0,0.0,0.0,12,11,1,7.0,7.0,0.0
208199,2,2,0,0,0,2,9,89,0.0,0.0,0.0,0.0,0.0,0.0,0.0,21,2,19,4.0,0.0,4.0
111077,4,3,1,1,0,4,16,47,3.0,3.0,0.0,0.0,0.0,3.0,13.0,17,4,13,9.0,3.0,6.0
9504202,1,1,0,0,1,0,0,368,0.0,0.0,0.0,0.0,0.0,0.0,0.0,3,1,2,1.0,0.0,1.0
9905270,1,1,0,0,1,0,0,185,,,,,,,,3,1,2,,,
103128,4,1,3,4,4,0,0,261,4.0,1.0,3.0,4.0,4.0,0.0,0.0,5,4,1,4.0,4.0,0.0
9706323,6,3,3,4,4,2,14,48,1.0,1.0,0.0,0.0,0.0,1.0,9.0,20,6,14,9.0,1.0,8.0
9709329,8,4,4,4,0,8,28,60,2.0,1.0,1.0,1.0,0.0,2.0,16.0,22,8,14,14.0,2.0,12.0
4258,2,2,0,0,1,1,1,76,0.0,0.0,0.0,0.0,0.0,0.0,0.0,5,2,3,2.0,1.0,1.0
9411441,3,3,0,0,2,1,1,93,0.0,0.0,0.0,0.0,0.0,0.0,0.0,7,3,4,1.0,0.0,1.0
9806373,7,4,3,6,0,7,32,33,3.0,3.0,0.0,0.0,1.0,2.0,13.0,25,7,18,6.0,4.0,2.0
108251,3,2,1,1,1,2,8,79,1.0,1.0,0.0,0.0,0.0,1.0,6.0,15,3,12,7.0,0.0,7.0
9909550,4,3,1,1,0,4,12,131,2.0,1.0,1.0,1.0,0.0,2.0,6.0,13,4,9,7.0,4.0,3.0
9607351,7,6,1,1,3,4,8,13,2.0,2.0,0.0,0.0,0.0,2.0,5.0,14,7,7,5.0,2.0,3.0
9609271,6,3,3,5,1,5,7,26,0.0,0.0,0.0,0.0,0.0,0.0,0.0,23,6,17,4.0,3.0,1.0
302193,0,0,0,0,0,0,0,78,0.0,0.0,0.0,0.0,0.0,0.0,0.0,24,0,24,9.0,0.0,9.0
1121,2,2,0,0,2,0,0,32,0.0,0.0,0.0,0.0,0.0,0.0,0.0,19,2,17,1.0,0.0,1.0
9611223,10,3,7,20,4,6,14,74,9.0,2.0,7.0,20.0,6.0,3.0,3.0,18,10,8,10.0,9.0,1.0
10250,1,1,0,0,0,1,7,112,1.0,1.0,0.0,0.0,0.0,1.0,4.0,15,1,14,4.0,1.0,3.0
302145,0,0,0,0,0,0,0,193,0.0,0.0,0.0,0.0,0.0,0.0,0.0,17,0,17,6.0,0.0,6.0
9812450,4,3,1,1,2,2,2,135,2.0,1.0,1.0,1.0,0.0,2.0,2.0,5,4,1,3.0,2.0,1.0
103038,2,2,0,0,2,0,0,26,0.0,0.0,0.0,0.0,0.0,0.0,0.0,19,2,17,4.0,0.0,4.0
9712453,2,1,1,1,0,2,4,175,2.0,1.0,1.0,1.0,0.0,2.0,3.0,9,2,7,3.0,0.0,3.0
101173,0,0,0,0,0,0,0,30,0.0,0.0,0.0,0.0,0.0,0.0,0.0,30,0,30,6.0,0.0,6.0
112296,1,1,0,0,1,0,0,154,0.0,0.0,0.0,0.0,0.0,0.0,0.0,13,1,12,7.0,0.0,7.0
9612275,3,3,0,0,3,0,0,211,2.0,2.0,0.0,0.0,2.0,0.0,0.0,3,3,0,1.0,1.0,0.0
209246,0,0,0,0,0,0,0,22,0.0,0.0,0.0,0.0,0.0,0.0,0.0,4,0,4,4.0,0.0,4.0
111405,1,1,0,0,1,0,0,39,0.0,0.0,0.0,0.0,0.0,0.0,0.0,6,1,5,,,
208176,3,3,0,0,1,2,6,56,2.0,2.0,0.0,0.0,0.0,2.0,6.0,12,3,9,2.0,1.0,1.0
9511463,2,1,1,1,2,0,0,384,1.0,1.0,0.0,0.0,1.0,0.0,0.0,3,2,1,1.0,1.0,0.0
105116,1,1,0,0,0,1,12,7,1.0,1.0,0.0,0.0,0.0,1.0,4.0,14,1,13,3.0,1.0,2.0
9912499,3,3,0,0,0,3,19,21,1.0,1.0,0.0,0.0,0.0,1.0,10.0,25,3,22,8.0,1.0,7.0
9704282,5,4,1,1,4,1,1,65,2.0,2.0,0.0,0.0,2.0,0.0,0.0,7,5,2,1.0,1.0,0.0
9806208,1,1,0,0,1,0,0,49,0.0,0.0,0.0,0.0,0.0,0.0,0.0,5,1,4,,,
9712367,7,3,4,4,1,6,9,4,6.0,2.0,4.0,4.0,2.0,4.0,6.0,15,7,8,2.0,0.0,2.0
9805423,6,5,1,1,0,6,32,85,4.0,3.0,1.0,1.0,0.0,4.0,14.0,18,6,12,7.0,1.0,6.0
10341,1,1,0,0,0,1,22,3,1.0,1.0,0.0,0.0,0.0,1.0,18.0,32,1,31,8.0,1.0,7.0
9508279,8,2,6,10,1,7,7,175,7.0,2.0,5.0,8.0,1.0,6.0,6.0,13,8,5,7.0,5.0,2.0
102055,2,1,1,1,0,2,2,457,2.0,1.0,1.0,1.0,0.0,2.0,2.0,3,2,1,3.0,2.0,1.0
9607340,5,5,0,0,1,4,5,113,1.0,1.0,0.0,0.0,1.0,0.0,0.0,8,5,3,1.0,1.0,0.0
111022,4,1,3,3,1,3,9,38,0.0,0.0,0.0,0.0,0.0,0.0,0.0,13,4,9,1.0,1.0,0.0
9811521,1,1,0,0,0,1,3,63,0.0,0.0,0.0,0.0,0.0,0.0,0.0,7,1,6,2.0,1.0,1.0
9604206,0,0,0,0,0,0,0,176,0.0,0.0,0.0,0.0,0.0,0.0,0.0,16,0,16,14.0,0.0,14.0
101082,0,0,0,0,0,0,0,185,0.0,0.0,0.0,0.0,0.0,0.0,0.0,4,0,4,3.0,0.0,3.0
7184,5,5,0,0,2,3,11,31,3.0,3.0,0.0,0.0,1.0,2.0,7.0,16,5,11,6.0,1.0,5.0
102124,8,3,5,6,0,8,25,8,7.0,3.0,4.0,5.0,0.0,7.0,23.0,15,8,7,9.0,5.0,4.0
102280,1,1,0,0,0,1,3,105,0.0,0.0,0.0,0.0,0.0,0.0,0.0,16,1,15,4.0,0.0,4.0
105042,8,3,5,8,1,7,14,312,6.0,3.0,3.0,6.0,3.0,3.0,3.0,11,8,3,7.0,6.0,1.0
9910526,2,2,0,0,0,2,5,269,2.0,2.0,0.0,0.0,0.0,2.0,3.0,13,2,11,4.0,2.0,2.0
111192,0,0,0,0,0,0,0,11,0.0,0.0,0.0,0.0,0.0,0.0,0.0,20,0,20,7.0,0.0,7.0
9904238,3,2,1,1,0,3,47,9,3.0,2.0,1.0,1.0,0.0,3.0,25.0,22,3,19,11.0,3.0,8.0
9902342,11,8,3,4,10,1,1,64,3.0,1.0,2.0,3.0,3.0,0.0,0.0,14,11,3,3.0,3.0,0.0
9801227,0,0,0,0,0,0,0,39,0.0,0.0,0.0,0.0,0.0,0.0,0.0,16,0,16,3.0,0.0,3.0
201053,6,2,4,10,0,6,18,40,5.0,1.0,4.0,10.0,0.0,5.0,5.0,10,6,4,6.0,5.0,1.0
104039,5,5,0,0,0,5,40,122,3.0,3.0,0.0,0.0,0.0,3.0,16.0,19,5,14,8.0,2.0,6.0
9904405,0,0,0,0,0,0,0,117,0.0,0.0,0.0,0.0,0.0,0.0,0.0,11,0,11,8.0,0.0,8.0
9409294,1,1,0,0,0,1,1,44,,,,,,,,2,1,1,,,
4138,8,3,5,13,1,7,7,64,6.0,1.0,5.0,13.0,4.0,2.0,2.0,16,8,8,8.0,6.0,2.0
9803260,0,0,0,0,0,0,0,387,0.0,0.0,0.0,0.0,0.0,0.0,0.0,1,0,1,,,
9906360,0,0,0,0,0,0,0,52,0.0,0.0,0.0,0.0,0.0,0.0,0.0,4,0,4,,,
9608258,3,3,0,0,1,2,3,174,0.0,0.0,0.0,0.0,0.0,0.0,0.0,8,3,5,1.0,0.0,1.0
9404268,3,3,0,0,3,0,0,275,2.0,2.0,0.0,0.0,2.0,0.0,0.0,4,3,1,2.0,2.0,0.0
9902231,3,2,1,1,0,3,12,21,2.0,2.0,0.0,0.0,0.0,2.0,7.0,8,3,5,,,
208151,0,0,0,0,0,0,0,16,0.0,0.0,0.0,0.0,0.0,0.0,0.0,25,0,25,8.0,0.0,8.0
9807256,5,1,4,7,0,5,36,7,5.0,1.0,4.0,7.0,0.0,5.0,25.0,25,5,20,6.0,1.0,5.0
9505357,9,3,6,11,0,9,10,96,7.0,3.0,4.0,5.0,0.0,7.0,7.0,11,9,2,8.0,7.0,1.0
207298,0,0,0,0,0,0,0,1827,0.0,0.0,0.0,0.0,0.0,0.0,0.0,2,0,2,1.0,0.0,1.0
9902439,3,3,0,0,1,2,3,290,1.0,1.0,0.0,0.0,0.0,1.0,1.0,8,3,5,2.0,1.0,1.0
211088,3,2,1,1,0,3,13,38,3.0,2.0,1.0,1.0,0.0,3.0,13.0,8,3,5,,,
107250,3,2,1,1,0,3,14,2,1.0,1.0,0.0,0.0,0.0,1.0,1.0,16,3,13,4.0,3.0,1.0
109092,4,2,2,3,0,4,22,66,0.0,0.0,0.0,0.0,0.0,0.0,0.0,43,4,39,8.0,0.0,8.0
5190,10,7,3,7,1,9,35,31,4.0,3.0,1.0,1.0,0.0,4.0,19.0,30,10,20,10.0,5.0,5.0
9911383,4,2,2,3,0,4,50,34,4.0,2.0,2.0,3.0,0.0,4.0,29.0,26,4,22,13.0,4.0,9.0
7300,5,1,4,7,0,5,9,428,4.0,1.0,3.0,5.0,0.0,4.0,8.0,8,5,3,7.0,4.0,3.0
9907346,3,3,0,0,0,3,7,9,1.0,1.0,0.0,0.0,0.0,1.0,3.0,31,3,28,4.0,1.0,3.0
9910473,0,0,0,0,0,0,0,91,0.0,0.0,0.0,0.0,0.0,0.0,0.0,2,0,2,1.0,0.0,1.0
112211,8,7,1,2,1,7,26,139,2.0,2.0,0.0,0.0,0.0,2.0,5.0,57,8,49,12.0,2.0,10.0
9309253,1,1,0,0,1,0,0,1921,,,,,,,,1,1,0,,,
11309,0,0,0,0,0,0,0,28,0.0,0.0,0.0,0.0,0.0,0.0,0.0,6,0,6,1.0,0.0,1.0
109249,0,0,0,0,0,0,0,23,0.0,0.0,0.0,0.0,0.0,0.0,0.0,16,0,16,3.0,0.0,3.0
9310352,0,0,0,0,0,0,0,1460,0.0,0.0,0.0,0.0,0.0,0.0,0.0,3,0,3,,,
109019,0,0,0,0,0,0,0,16,0.0,0.0,0.0,0.0,0.0,0.0,0.0,8,0,8,7.0,0.0,7.0
9707494,0,0,0,0,0,0,0,4,0.0,0.0,0.0,0.0,0.0,0.0,0.0,17,0,17,3.0,0.0,3.0
9504412,2,1,1,1,0,2,3,440,0.0,0.0,0.0,0.0,0.0,0.0,0.0,5,2,3,,,
9908273,1,1,0,0,1,0,0,226,1.0,1.0,0.0,0.0,1.0,0.0,0.0,4,1,3,1.0,0.0,1.0
9704216,4,1,3,6,0,4,7,147,4.0,1.0,3.0,6.0,0.0,4.0,7.0,8,4,4,6.0,4.0,2.0
2016,5,1,4,5,0,5,12,8,5.0,1.0,4.0,5.0,0.0,5.0,7.0,12,5,7,7.0,3.0,4.0
9607455,3,1,2,3,0,3,13,94,3.0,1.0,2.0,3.0,0.0,3.0,13.0,10,3,7,8.0,3.0,5.0
9504347,0,0,0,0,0,0,0,25,0.0,0.0,0.0,0.0,0.0,0.0,0.0,19,0,19,7.0,0.0,7.0
12005,0,0,0,0,0,0,0,27,0.0,0.0,0.0,0.0,0.0,0.0,0.0,8,0,8,3.0,0.0,3.0
9906533,4,4,0,0,4,0,0,408,2.0,2.0,0.0,0.0,2.0,0.0,0.0,6,4,2,2.0,1.0,1.0
9403308,1,1,0,0,1,0,0,1444,,,,,,,,1,1,0,,,
201120,2,2,0,0,0,2,4,7,0.0,0.0,0.0,0.0,0.0,0.0,0.0,29,2,27,8.0,0.0,8.0
9182,0,0,0,0,0,0,0,20,0.0,0.0,0.0,0.0,0.0,0.0,0.0,12,0,12,5.0,0.0,5.0
9702405,1,1,0,0,0,1,1,137,0.0,0.0,0.0,0.0,0.0,0.0,0.0,3,1,2,1.0,0.0,1.0
5100,2,2,0,0,1,1,1,271,0.0,0.0,0.0,0.0,0.0,0.0,0.0,8,2,6,2.0,0.0,2.0
9503288,6,2,4,5,3,3,4,134,1.0,1.0,0.0,0.0,0.0,1.0,1.0,9,6,3,2.0,1.0,1.0
9611314,0,0,0,0,0,0,0,323,0.0,0.0,0.0,0.0,0.0,0.0,0.0,4,0,4,2.0,0.0,2.0
112044,5,3,2,2,1,4,11,79,0.0,0.0,0.0,0.0,0.0,0.0,0.0,26,5,21,10.0,0.0,10.0
9712416,1,1,0,0,0,1,1,496,1.0,1.0,0.0,0.0,0.0,1.0,1.0,2,1,1,2.0,1.0,1.0
211258,2,1,1,1,0,2,9,35,2.0,1.0,1.0,1.0,0.0,2.0,5.0,9,2,7,5.0,2.0,3.0
9901402,2,2,0,0,0,2,8,25,1.0,1.0,0.0,0.0,0.0,1.0,3.0,17,2,15,12.0,1.0,11.0
9709331,0,0,0,0,0,0,0,38,0.0,0.0,0.0,0.0,0.0,0.0,0.0,40,0,40,3.0,0.0,3.0
7345,3,1,2,2,0,3,9,125,2.0,1.0,1.0,1.0,1.0,1.0,4.0,13,3,10,7.0,0.0,7.0
9905485,4,2,2,2,0,4,5,8,3.0,1.0,2.0,2.0,0.0,3.0,4.0,9,4,5,1.0,0.0,1.0
203023,2,1,1,1,0,2,2,166,2.0,1.0,1.0,1.0,0.0,2.0,2.0,6,2,4,4.0,2.0,2.0
8282,3,2,1,1,0,3,3,22,1.0,1.0,0.0,0.0,1.0,0.0,0.0,4,3,1,1.0,1.0,0.0
9704374,2,2,0,0,1,1,3,243,1.0,1.0,0.0,0.0,0.0,1.0,3.0,14,2,12,5.0,1.0,4.0
112263,1,1,0,0,0,1,1,63,0.0,0.0,0.0,0.0,0.0,0.0,0.0,7,1,6,1.0,0.0,1.0
9902397,7,3,4,4,2,5,12,22,2.0,1.0,1.0,1.0,0.0,2.0,4.0,13,7,6,4.0,2.0,2.0
9309291,0,0,0,0,0,0,0,1448,,,,,,,,2,0,2,,,
9308372,0,0,0,0,0,0,0,549,0.0,0.0,0.0,0.0,0.0,0.0,0.0,1,0,1,1.0,0.0,1.0
9512347,2,2,0,0,2,0,0,156,0.0,0.0,0.0,0.0,0.0,0.0,0.0,4,2,2,1.0,1.0,0.0
9901421,3,3,0,0,0,3,3,214,3.0,3.0,0.0,0.0,0.0,3.0,3.0,10,3,7,4.0,1.0,3.0
5115,5,5,0,0,0,5,26,68,4.0,4.0,0.0,0.0,0.0,4.0,10.0,18,5,13,4.0,3.0,1.0
9709277,4,2,2,2,0,4,11,30,3.0,1.0,2.0,2.0,0.0,3.0,5.0,15,4,11,6.0,2.0,4.0
9901448,3,2,1,1,0,3,8,17,2.0,1.0,1.0,1.0,0.0,2.0,7.0,10,3,7,7.0,2.0,5.0
211096,2,2,0,0,0,2,6,66,0.0,0.0,0.0,0.0,0.0,0.0,0.0,16,2,14,3.0,1.0,2.0
110379,0,0,0,0,0,0,0,275,0.0,0.0,0.0,0.0,0.0,0.0,0.0,12,0,12,4.0,0.0,4.0
205322,2,2,0,0,0,2,2,138,2.0,2.0,0.0,0.0,0.0,2.0,2.0,6,2,4,2.0,0.0,2.0
9610264,1,1,0,0,1,0,0,148,0.0,0.0,0.0,0.0,0.0,0.0,0.0,3,1,2,1.0,0.0,1.0
111145,0,0,0,0,0,0,0,93,,,,,,,,1,0,1,1.0,0.0,1.0
207339,1,1,0,0,0,1,4,73,0.0,0.0,0.0,0.0,0.0,0.0,0.0,41,1,40,11.0,0.0,11.0
9710519,0,0,0,0,0,0,0,41,0.0,0.0,0.0,0.0,0.0,0.0,0.0,10,0,10,4.0,0.0,4.0
9811309,3,2,1,1,3,0,0,157,2.0,1.0,1.0,1.0,2.0,0.0,0.0,10,3,7,2.0,2.0,0.0
9506229,1,1,0,0,1,0,0,207,1.0,1.0,0.0,0.0,1.0,0.0,0.0,1,1,0,1.0,1.0,0.0
9805253,0,0,0,0,0,0,0,114,0.0,0.0,0.0,0.0,0.0,0.0,0.0,13,0,13,7.0,0.0,7.0
9408311,1,1,0,0,1,0,0,1952,1.0,1.0,0.0,0.0,1.0,0.0,0.0,1,1,0,1.0,1.0,0.0
206155,1,1,0,0,0,1,2,1,1.0,1.0,0.0,0.0,0.0,1.0,2.0,17,1,16,5.0,1.0,4.0
10287,2,2,0,0,0,2,2,198,1.0,1.0,0.0,0.0,0.0,1.0,1.0,20,2,18,8.0,1.0,7.0
9611245,1,1,0,0,1,0,0,93,0.0,0.0,0.0,0.0,0.0,0.0,0.0,23,1,22,3.0,0.0,3.0
9503421,1,1,0,0,0,1,1,155,1.0,1.0,0.0,0.0,0.0,1.0,1.0,3,1,2,,,
106114,1,1,0,0,0,1,5,11,,,,,,,,9,1,8,1.0,1.0,0.0
102041,0,0,0,0,0,0,0,7,0.0,0.0,0.0,0.0,0.0,0.0,0.0,25,0,25,5.0,0.0,5.0
207238,2,2,0,0,0,2,7,0,0.0,0.0,0.0,0.0,0.0,0.0,0.0,25,2,23,9.0,0.0,9.0
12334,3,2,1,1,0,3,13,262,3.0,2.0,1.0,1.0,0.0,3.0,13.0,13,3,10,12.0,3.0,9.0
106253,3,1,2,3,0,3,34,92,3.0,1.0,2.0,3.0,0.0,3.0,20.0,21,3,18,10.0,3.0,7.0
9403355,1,1,0,0,1,0,0,266,1.0,1.0,0.0,0.0,1.0,0.0,0.0,1,1,0,1.0,1.0,0.0
9205224,0,0,0,0,0,0,0,461,0.0,0.0,0.0,0.0,0.0,0.0,0.0,1,0,1,1.0,0.0,1.0
9903537,2,2,0,0,2,0,0,84,1.0,1.0,0.0,0.0,1.0,0.0,0.0,3,2,1,1.0,1.0,0.0
9307339,3,3,0,0,3,0,0,272,2.0,2.0,0.0,0.0,2.0,0.0,0.0,3,3,0,2.0,2.0,0.0
9301245,3,3,0,0,3,0,0,162,2.0,2.0,0.0,0.0,2.0,0.0,0.0,3,3,0,1.0,1.0,0.0
9504416,0,0,0,0,0,0,0,677,0.0,0.0,0.0,0.0,0.0,0.0,0.0,1,0,1,1.0,0.0,1.0
9810238,2,1,1,1,1,1,1,104,1.0,1.0,0.0,0.0,0.0,1.0,1.0,5,2,3,1.0,1.0,0.0
103106,4,4,0,0,4,0,0,72,4.0,4.0,0.0,0.0,4.0,0.0,0.0,4,4,0,2.0,2.0,0.0
9709428,4,2,2,3,0,4,4,199,3.0,1.0,2.0,3.0,3.0,0.0,0.0,5,4,1,3.0,3.0,0.0
9905363,1,1,0,0,0,1,2,87,0.0,0.0,0.0,0.0,0.0,0.0,0.0,12,1,11,4.0,0.0,4.0
302260,0,0,0,0,0,0,0,1,0.0,0.0,0.0,0.0,0.0,0.0,0.0,42,0,42,10.0,0.0,10.0
101328,0,0,0,0,0,0,0,6,0.0,0.0,0.0,0.0,0.0,0.0,0.0,35,0,35,14.0,0.0,14.0
11361,0,0,0,0,0,0,0,27,,,,,,,,7,0,7,1.0,0.0,1.0
104068,4,4,0,0,0,4,17,24,0.0,0.0,0.0,0.0,0.0,0.0,0.0,18,4,14,8.0,0.0,8.0
209015,1,1,0,0,0,1,4,65,1.0,1.0,0.0,0.0,0.0,1.0,2.0,16,1,15,5.0,1.0,4.0
103021,0,0,0,0,0,0,0,70,0.0,0.0,0.0,0.0,0.0,0.0,0.0,15,0,15,13.0,0.0,13.0
101055,3,3,0,0,0,3,7,13,0.0,0.0,0.0,0.0,0.0,0.0,0.0,27,3,24,3.0,1.0,2.0
206240,0,0,0,0,0,0,0,554,0.0,0.0,0.0,0.0,0.0,0.0,0.0,3,0,3,1.0,0.0,1.0
110162,2,2,0,0,0,2,4,236,0.0,0.0,0.0,0.0,0.0,0.0,0.0,9,2,7,3.0,0.0,3.0
9907253,0,0,0,0,0,0,0,242,0.0,0.0,0.0,0.0,0.0,0.0,0.0,5,0,5,2.0,0.0,2.0
9506246,0,0,0,0,0,0,0,10,,,,,,,,6,0,6,,,
9803340,2,2,0,0,1,1,1,370,2.0,2.0,0.0,0.0,1.0,1.0,1.0,8,2,6,3.0,1.0,2.0
9707391,1,1,0,0,1,0,0,366,0.0,0.0,0.0,0.0,0.0,0.0,0.0,11,1,10,2.0,0.0,2.0
9910329,2,2,0,0,1,1,6,9,1.0,1.0,0.0,0.0,0.0,1.0,3.0,24,2,22,4.0,1.0,3.0
9809591,0,0,0,0,0,0,0,6,0.0,0.0,0.0,0.0,0.0,0.0,0.0,6,0,6,2.0,0.0,2.0
9912415,7,2,5,8,1,6,14,244,7.0,2.0,5.0,8.0,1.0,6.0,14.0,11,7,4,11.0,7.0,4.0
6088,2,2,0,0,1,1,2,146,1.0,1.0,0.0,0.0,0.0,1.0,2.0,9,2,7,4.0,1.0,3.0
9406216,2,2,0,0,2,0,0,787,1.0,1.0,0.0,0.0,1.0,0.0,0.0,3,2,1,1.0,1.0,0.0
9810390,2,2,0,0,0,2,12,17,1.0,1.0,0.0,0.0,0.0,1.0,7.0,15,2,13,3.0,2.0,1.0
9905569,1,1,0,0,0,1,7,22,1.0,1.0,0.0,0.0,0.0,1.0,7.0,17,1,16,13.0,1.0,12.0
211248,0,0,0,0,0,0,0,14,,,,,,,,8,0,8,1.0,0.0,1.0
212117,4,3,1,1,0,4,23,31,0.0,0.0,0.0,0.0,0.0,0.0,0.0,31,4,27,4.0,2.0,2.0
205260,2,2,0,0,0,2,2,109,1.0,1.0,0.0,0.0,1.0,0.0,0.0,4,2,2,2.0,2.0,0.0
212208,1,1,0,0,0,1,1,71,1.0,1.0,0.0,0.0,0.0,1.0,1.0,4,1,3,1.0,1.0,0.0
9412376,0,0,0,0,0,0,0,6,0.0,0.0,0.0,0.0,0.0,0.0,0.0,7,0,7,,,
9505287,2,1,1,1,2,0,0,171,2.0,1.0,1.0,1.0,2.0,0.0,0.0,2,2,0,2.0,2.0,0.0
9709204,1,1,0,0,0,1,2,56,0.0,0.0,0.0,0.0,0.0,0.0,0.0,10,1,9,7.0,1.0,6.0
9910276,4,2,2,3,1,3,6,40,3.0,2.0,1.0,1.0,0.0,3.0,3.0,11,4,7,5.0,3.0,2.0
9405222,3,3,0,0,3,0,0,509,2.0,2.0,0.0,0.0,2.0,0.0,0.0,3,3,0,2.0,2.0,0.0
202182,0,0,0,0,0,0,0,122,0.0,0.0,0.0,0.0,0.0,0.0,0.0,5,0,5,,,
9911218,2,1,1,1,2,0,0,569,2.0,1.0,1.0,1.0,2.0,0.0,0.0,4,2,2,2.0,2.0,0.0
9907407,0,0,0,0,0,0,0,8,,,,,,,,11,0,11,,,
101301,2,2,0,0,1,1,3,85,1.0,1.0,0.0,0.0,0.0,1.0,2.0,18,2,16,8.0,0.0,8.0
9912296,1,1,0,0,1,0,0,232,0.0,0.0,0.0,0.0,0.0,0.0,0.0,3,1,2,2.0,1.0,1.0
9608204,3,2,1,1,0,3,3,537,1.0,1.0,0.0,0.0,1.0,0.0,0.0,5,3,2,1.0,1.0,0.0
302054,1,1,0,0,0,1,16,46,1.0,1.0,0.0,0.0,0.0,1.0,13.0,54,1,53,30.0,1.0,29.0
107198,0,0,0,0,0,0,0,8,,,,,,,,6,0,6,,,
3156,3,2,1,1,2,1,1,105,1.0,1.0,0.0,0.0,0.0,1.0,1.0,4,3,1,2.0,1.0,1.0
211400,0,0,0,0,0,0,0,27,0.0,0.0,0.0,0.0,0.0,0.0,0.0,5,0,5,5.0,0.0,5.0
201234,2,2,0,0,0,2,35,17,2.0,2.0,0.0,0.0,0.0,2.0,32.0,24,2,22,8.0,2.0,6.0
301210,0,0,0,0,0,0,0,0,0.0,0.0,0.0,0.0,0.0,0.0,0.0,20,0,20,7.0,0.0,7.0
110351,0,0,0,0,0,0,0,19,,,,,,,,7,0,7,2.0,0.0,2.0
9235,6,4,2,3,0,6,48,9,1.0,1.0,0.0,0.0,0.0,1.0,2.0,26,6,20,4.0,2.0,2.0
204052,2,2,0,0,0,2,22,30,1.0,1.0,0.0,0.0,0.0,1.0,4.0,58,2,56,14.0,0.0,14.0
106220,2,2,0,0,0,2,7,70,1.0,1.0,0.0,0.0,1.0,0.0,0.0,11,2,9,1.0,0.0,1.0
201119,0,0,0,0,0,0,0,9,0.0,0.0,0.0,0.0,0.0,0.0,0.0,29,0,29,4.0,0.0,4.0
109074,0,0,0,0,0,0,0,89,0.0,0.0,0.0,0.0,0.0,0.0,0.0,13,0,13,9.0,0.0,9.0
9902297,1,1,0,0,0,1,9,73,1.0,1.0,0.0,0.0,0.0,1.0,5.0,12,1,11,2.0,1.0,1.0
9307343,1,1,0,0,1,0,0,229,1.0,1.0,0.0,0.0,1.0,0.0,0.0,1,1,0,1.0,1.0,0.0
211223,0,0,0,0,0,0,0,14,0.0,0.0,0.0,0.0,0.0,0.0,0.0,28,0,28,3.0,0.0,3.0
9410289,2,2,0,0,2,0,0,757,1.0,1.0,0.0,0.0,1.0,0.0,0.0,2,2,0,1.0,1.0,0.0
8170,1,1,0,0,1,0,0,86,0.0,0.0,0.0,0.0,0.0,0.0,0.0,8,1,7,6.0,0.0,6.0
110094,1,1,0,0,0,1,1,70,1.0,1.0,0.0,0.0,1.0,0.0,0.0,2,1,1,,,
301216,1,1,0,0,0,1,6,9,,,,,,,,10,1,9,2.0,0.0,2.0
9910289,0,0,0,0,0,0,0,220,0.0,0.0,0.0,0.0,0.0,0.0,0.0,3,0,3,2.0,0.0,2.0
210119,0,0,0,0,0,0,0,6,,,,,,,,10,0,10,,,
10307,5,2,3,8,4,1,2,375,5.0,2.0,3.0,8.0,5.0,0.0,0.0,7,5,2,5.0,5.0,0.0
211177,0,0,0,0,0,0,0,344,0.0,0.0,0.0,0.0,0.0,0.0,0.0,2,0,2,2.0,0.0,2.0
204015,0,0,0,0,0,0,0,72,0.0,0.0,0.0,0.0,0.0,0.0,0.0,5,0,5,2.0,0.0,2.0
105181,2,1,1,1,0,2,7,115,0.0,0.0,0.0,0.0,0.0,0.0,0.0,12,2,10,8.0,0.0,8.0
111118,0,0,0,0,0,0,0,58,0.0,0.0,0.0,0.0,0.0,0.0,0.0,12,0,12,3.0,0.0,3.0
3015,2,1,1,1,2,0,0,79,0.0,0.0,0.0,0.0,0.0,0.0,0.0,5,2,3,2.0,0.0,2.0
109219,0,0,0,0,0,0,0,14,0.0,0.0,0.0,0.0,0.0,0.0,0.0,18,0,18,5.0,0.0,5.0
1070,2,2,0,0,1,1,1,1516,1.0,1.0,0.0,0.0,1.0,0.0,0.0,3,2,1,,,
110228,2,1,1,1,1,1,1,93,0.0,0.0,0.0,0.0,0.0,0.0,0.0,5,2,3,2.0,0.0,2.0
9709508,4,2,2,3,0,4,7,74,4.0,2.0,2.0,3.0,0.0,4.0,4.0,14,4,10,5.0,4.0,1.0
112306,1,1,0,0,1,0,0,1874,,,,,,,,2,1,1,,,
111143,0,0,0,0,0,0,0,57,0.0,0.0,0.0,0.0,0.0,0.0,0.0,25,0,25,8.0,0.0,8.0
9606209,1,1,0,0,0,1,2,39,0.0,0.0,0.0,0.0,0.0,0.0,0.0,10,1,9,2.0,0.0,2.0
111449,0,0,0,0,0,0,0,11,0.0,0.0,0.0,0.0,0.0,0.0,0.0,9,0,9,3.0,0.0,3.0
211312,0,0,0,0,0,0,0,239,0.0,0.0,0.0,0.0,0.0,0.0,0.0,12,0,12,2.0,0.0,2.0
2304,1,1,0,0,0,1,2,319,1.0,1.0,0.0,0.0,0.0,1.0,1.0,4,1,3,3.0,1.0,2.0
9606255,0,0,0,0,0,0,0,433,0.0,0.0,0.0,0.0,0.0,0.0,0.0,1,0,1,1.0,0.0,1.0
112095,0,0,0,0,0,0,0,2029,,,,,,,,1,0,1,,,
201007,1,1,0,0,0,1,2,398,1.0,1.0,0.0,0.0,0.0,1.0,1.0,3,1,2,2.0,1.0,1.0
9309259,1,1,0,0,1,0,0,108,1.0,1.0,0.0,0.0,1.0,0.0,0.0,5,1,4,3.0,0.0,3.0
207170,1,1,0,0,1,0,0,498,1.0,1.0,0.0,0.0,1.0,0.0,0.0,5,1,4,1.0,1.0,0.0
9220,0,0,0,0,0,0,0,1,0.0,0.0,0.0,0.0,0.0,0.0,0.0,11,0,11,5.0,0.0,5.0
9810385,4,2,2,3,0,4,10,110,1.0,1.0,0.0,0.0,0.0,1.0,2.0,9,4,5,5.0,3.0,2.0
209320,0,0,0,0,0,0,0,47,0.0,0.0,0.0,0.0,0.0,0.0,0.0,23,0,23,7.0,0.0,7.0
9903231,0,0,0,0,0,0,0,542,0.0,0.0,0.0,0.0,0.0,0.0,0.0,7,0,7,2.0,0.0,2.0
207038,0,0,0,0,0,0,0,7,0.0,0.0,0.0,0.0,0.0,0.0,0.0,18,0,18,2.0,0.0,2.0
201073,2,2,0,0,0,2,3,257,1.0,1.0,0.0,0.0,1.0,0.0,0.0,12,2,10,3.0,2.0,1.0
301166,0,0,0,0,0,0,0,1139,,,,,,,,2,0,2,,,
9706432,0,0,0,0,0,0,0,59,0.0,0.0,0.0,0.0,0.0,0.0,0.0,4,0,4,2.0,0.0,2.0
9709228,0,0,0,0,0,0,0,1703,0.0,0.0,0.0,0.0,0.0,0.0,0.0,1,0,1,1.0,0.0,1.0
302097,0,0,0,0,0,0,0,3,0.0,0.0,0.0,0.0,0.0,0.0,0.0,22,0,22,3.0,0.0,3.0
9906521,0,0,0,0,0,0,0,12,0.0,0.0,0.0,0.0,0.0,0.0,0.0,25,0,25,17.0,0.0,17.0
9601314,0,0,0,0,0,0,0,51,,,,,,,,3,0,3,,,
9508216,0,0,0,0,0,0,0,29,0.0,0.0,0.0,0.0,0.0,0.0,0.0,9,0,9,2.0,0.0,2.0
210288,1,1,0,0,0,1,10,5,1.0,1.0,0.0,0.0,0.0,1.0,10.0,23,1,22,14.0,1.0,13.0
104119,1,1,0,0,1,0,0,173,1.0,1.0,0.0,0.0,1.0,0.0,0.0,2,1,1,1.0,1.0,0.0
9212228,1,1,0,0,1,0,0,219,1.0,1.0,0.0,0.0,1.0,0.0,0.0,1,1,0,1.0,1.0,0.0
9812500,1,1,0,0,1,0,0,79,0.0,0.0,0.0,0.0,0.0,0.0,0.0,11,1,10,5.0,0.0,5.0
7168,0,0,0,0,0,0,0,128,0.0,0.0,0.0,0.0,0.0,0.0,0.0,9,0,9,2.0,0.0,2.0
203175,2,2,0,0,2,0,0,113,2.0,2.0,0.0,0.0,2.0,0.0,0.0,3,2,1,2.0,1.0,1.0
9808494,0,0,0,0,0,0,0,232,0.0,0.0,0.0,0.0,0.0,0.0,0.0,3,0,3,1.0,0.0,1.0
207091,1,1,0,0,0,1,5,25,0.0,0.0,0.0,0.0,0.0,0.0,0.0,13,1,12,1.0,0.0,1.0
9412233,2,2,0,0,2,0,0,290,2.0,2.0,0.0,0.0,2.0,0.0,0.0,2,2,0,2.0,2.0,0.0
101185,2,2,0,0,0,2,7,142,1.0,1.0,0.0,0.0,0.0,1.0,3.0,9,2,7,6.0,2.0,4.0
207094,1,1,0,0,0,1,1,90,1.0,1.0,0.0,0.0,0.0,1.0,1.0,17,1,16,,,
9260,3,1,2,3,3,0,0,199,3.0,1.0,2.0,3.0,3.0,0.0,0.0,7,3,4,3.0,0.0,3.0
9906317,1,1,0,0,0,1,5,1,1.0,1.0,0.0,0.0,0.0,1.0,3.0,10,1,9,5.0,1.0,4.0
9410386,1,1,0,0,1,0,0,484,1.0,1.0,0.0,0.0,1.0,0.0,0.0,1,1,0,1.0,1.0,0.0
212173,0,0,0,0,0,0,0,43,0.0,0.0,0.0,0.0,0.0,0.0,0.0,20,0,20,2.0,0.0,2.0
10102,0,0,0,0,0,0,0,99,,,,,,,,3,0,3,,,
9508375,1,1,0,0,1,0,0,96,0.0,0.0,0.0,0.0,0.0,0.0,0.0,5,1,4,2.0,0.0,2.0
208022,0,0,0,0,0,0,0,335,0.0,0.0,0.0,0.0,0.0,0.0,0.0,2,0,2,2.0,0.0,2.0
110025,1,1,0,0,0,1,5,11,1.0,1.0,0.0,0.0,0.0,1.0,2.0,13,1,12,7.0,0.0,7.0
106001,0,0,0,0,0,0,0,35,0.0,0.0,0.0,0.0,0.0,0.0,0.0,17,0,17,3.0,0.0,3.0
9810218,0,0,0,0,0,0,0,481,0.0,0.0,0.0,0.0,0.0,0.0,0.0,1,0,1,1.0,0.0,1.0
202046,0,0,0,0,0,0,0,389,0.0,0.0,0.0,0.0,0.0,0.0,0.0,3,0,3,1.0,0.0,1.0
206108,0,0,0,0,0,0,0,292,0.0,0.0,0.0,0.0,0.0,0.0,0.0,1,0,1,1.0,0.0,1.0
9411360,1,1,0,0,1,0,0,2112,,,,,,,,1,1,0,1.0,1.0,0.0
211360,1,1,0,0,0,1,12,49,1.0,1.0,0.0,0.0,0.0,1.0,11.0,31,1,30,11.0,1.0,10.0
101101,0,0,0,0,0,0,0,278,0.0,0.0,0.0,0.0,0.0,0.0,0.0,4,0,4,,,
9904463,0,0,0,0,0,0,0,1387,0.0,0.0,0.0,0.0,0.0,0.0,0.0,5,0,5,,,
9808452,0,0,0,0,0,0,0,1031,0.0,0.0,0.0,0.0,0.0,0.0,0.0,4,0,4,4.0,0.0,4.0
9708317,0,0,0,0,0,0,0,15,0.0,0.0,0.0,0.0,0.0,0.0,0.0,4,0,4,1.0,0.0,1.0
204159,1,1,0,0,1,0,0,378,1.0,1.0,0.0,0.0,1.0,0.0,0.0,1,1,0,1.0,1.0,0.0
9312242,0,0,0,0,0,0,0,108,,,,,,,,1,0,1,,,
211345,3,3,0,0,2,1,3,67,1.0,1.0,0.0,0.0,1.0,0.0,0.0,6,3,3,1.0,1.0,0.0
9505243,0,0,0,0,0,0,0,703,0.0,0.0,0.0,0.0,0.0,0.0,0.0,2,0,2,2.0,0.0,2.0
210273,0,0,0,0,0,0,0,12,0.0,0.0,0.0,0.0,0.0,0.0,0.0,12,0,12,2.0,0.0,2.0
204096,0,0,0,0,0,0,0,45,0.0,0.0,0.0,0.0,0.0,0.0,0.0,13,0,13,8.0,0.0,8.0
106239,2,2,0,0,2,0,0,207,1.0,1.0,0.0,0.0,1.0,0.0,0.0,7,2,5,2.0,1.0,1.0
9906348,0,0,0,0,0,0,0,2022,,,,,,,,1,0,1,,,
211405,0,0,0,0,0,0,0,86,0.0,0.0,0.0,0.0,0.0,0.0,0.0,5,0,5,3.0,0.0,3.0
9911401,0,0,0,0,0,0,0,42,0.0,0.0,0.0,0.0,0.0,0.0,0.0,7,0,7,5.0,0.0,5.0
106167,0,0,0,0,0,0,0,1293,,,,,,,,1,0,1,,,
9311224,1,1,0,0,0,1,1,418,1.0,1.0,0.0,0.0,0.0,1.0,1.0,2,1,1,2.0,1.0,1.0
204047,0,0,0,0,0,0,0,9,0.0,0.0,0.0,0.0,0.0,0.0,0.0,21,0,21,6.0,0.0,6.0
10313,0,0,0,0,0,0,0,254,0.0,0.0,0.0,0.0,0.0,0.0,0.0,5,0,5,5.0,0.0,5.0
9906295,0,0,0,0,0,0,0,39,0.0,0.0,0.0,0.0,0.0,0.0,0.0,19,0,19,5.0,0.0,5.0
9606304,0,0,0,0,0,0,0,707,0.0,0.0,0.0,0.0,0.0,0.0,0.0,4,0,4,2.0,0.0,2.0
9905513,1,1,0,0,0,1,5,135,1.0,1.0,0.0,0.0,0.0,1.0,4.0,10,1,9,5.0,1.0,4.0
105112,0,0,0,0,0,0,0,173,0.0,0.0,0.0,0.0,0.0,0.0,0.0,1,0,1,1.0,0.0,1.0
3241,1,1,0,0,0,1,3,8,0.0,0.0,0.0,0.0,0.0,0.0,0.0,7,1,6,1.0,0.0,1.0
112325,0,0,0,0,0,0,0,1484,0.0,0.0,0.0,0.0,0.0,0.0,0.0,1,0,1,1.0,0.0,1.0
111241,0,0,0,0,0,0,0,2124,0.0,0.0,0.0,0.0,0.0,0.0,0.0,5,0,5,1.0,0.0,1.0
212219,1,1,0,0,0,1,1,219,0.0,0.0,0.0,0.0,0.0,0.0,0.0,2,1,1,1.0,0.0,1.0
9712356,0,0,0,0,0,0,0,173,0.0,0.0,0.0,0.0,0.0,0.0,0.0,7,0,7,1.0,0.0,1.0
11186,0,0,0,0,0,0,0,57,0.0,0.0,0.0,0.0,0.0,0.0,0.0,11,0,11,,,
102045,0,0,0,0,0,0,0,73,0.0,0.0,0.0,0.0,0.0,0.0,0.0,20,0,20,13.0,0.0,13.0
211092,0,0,0,0,0,0,0,1122,,,,,,,,1,0,1,1.0,0.0,1.0
106310,0,0,0,0,0,0,0,112,0.0,0.0,0.0,0.0,0.0,0.0,0.0,12,0,12,11.0,0.0,11.0
6094,0,0,0,0,0,0,0,44,,,,,,,,3,0,3,,,
9501397,1,1,0,0,0,1,1,490,1.0,1.0,0.0,0.0,0.0,1.0,1.0,2,1,1,2.0,1.0,1.0
212153,0,0,0,0,0,0,0,31,0.0,0.0,0.0,0.0,0.0,0.0,0.0,14,0,14,9.0,0.0,9.0
9187,0,0,0,0,0,0,0,56,0.0,0.0,0.0,0.0,0.0,0.0,0.0,16,0,16,11.0,0.0,11.0
9810508,1,1,0,0,0,1,2,106,1.0,1.0,0.0,0.0,0.0,1.0,2.0,3,1,2,3.0,1.0,2.0
212362,1,1,0,0,0,1,4,228,1.0,1.0,0.0,0.0,0.0,1.0,3.0,9,1,8,5.0,0.0,5.0
9071,0,0,0,0,0,0,0,197,0.0,0.0,0.0,0.0,0.0,0.0,0.0,1,0,1,1.0,0.0,1.0
209300,2,2,0,0,0,2,8,9,2.0,2.0,0.0,0.0,0.0,2.0,8.0,14,2,12,3.0,0.0,3.0
9804447,0,0,0,0,0,0,0,526,0.0,0.0,0.0,0.0,0.0,0.0,0.0,3,0,3,1.0,0.0,1.0
11152,0,0,0,0,0,0,0,79,0.0,0.0,0.0,0.0,0.0,0.0,0.0,4,0,4,4.0,0.0,4.0
9405312,0,0,0,0,0,0,0,378,0.0,0.0,0.0,0.0,0.0,0.0,0.0,2,0,2,1.0,0.0,1.0
210367,1,1,0,0,0,1,5,1,0.0,0.0,0.0,0.0,0.0,0.0,0.0,24,1,23,5.0,0.0,5.0
111422,0,0,0,0,0,0,0,8,0.0,0.0,0.0,0.0,0.0,0.0,0.0,47,0,47,17.0,0.0,17.0
210424,0,0,0,0,0,0,0,32,0.0,0.0,0.0,0.0,0.0,0.0,0.0,35,0,35,1.0,0.0,1.0
9402222,0,0,0,0,0,0,0,205,0.0,0.0,0.0,0.0,0.0,0.0,0.0,3,0,3,3.0,0.0,3.0
211157,0,0,0,0,0,0,0,14,0.0,0.0,0.0,0.0,0.0,0.0,0.0,7,0,7,,,
205118,0,0,0,0,0,0,0,178,0.0,0.0,0.0,0.0,0.0,0.0,0.0,5,0,5,5.0,0.0,5.0
9411364,1,1,0,0,0,1,4,116,1.0,1.0,0.0,0.0,0.0,1.0,2.0,5,1,4,3.0,1.0,2.0
5268,0,0,0,0,0,0,0,46,0.0,0.0,0.0,0.0,0.0,0.0,0.0,14,0,14,1.0,0.0,1.0
9612455,0,0,0,0,0,0,0,129,0.0,0.0,0.0,0.0,0.0,0.0,0.0,5,0,5,,,
207220,0,0,0,0,0,0,0,67,0.0,0.0,0.0,0.0,0.0,0.0,0.0,27,0,27,2.0,0.0,2.0
9611268,0,0,0,0,0,0,0,552,0.0,0.0,0.0,0.0,0.0,0.0,0.0,1,0,1,1.0,0.0,1.0
205120,0,0,0,0,0,0,0,8,,,,,,,,4,0,4,1.0,0.0,1.0
210298,1,1,0,0,0,1,7,43,1.0,1.0,0.0,0.0,0.0,1.0,1.0,17,1,16,4.0,1.0,3.0
9909557,0,0,0,0,0,0,0,57,0.0,0.0,0.0,0.0,0.0,0.0,0.0,10,0,10,6.0,0.0,6.0
9211275,0,0,0,0,0,0,0,407,0.0,0.0,0.0,0.0,0.0,0.0,0.0,2,0,2,2.0,0.0,2.0
209202,0,0,0,0,0,0,0,33,0.0,0.0,0.0,0.0,0.0,0.0,0.0,9,0,9,4.0,0.0,4.0
9602328,0,0,0,0,0,0,0,114,,,,,,,,1,0,1,,,
9912374,0,0,0,0,0,0,0,98,0.0,0.0,0.0,0.0,0.0,0.0,0.0,7,0,7,2.0,0.0,2.0
9801290,0,0,0,0,0,0,0,2033,,,,,,,,3,0,3,,,
9903271,0,0,0,0,0,0,0,76,0.0,0.0,0.0,0.0,0.0,0.0,0.0,4,0,4,1.0,0.0,1.0
7150,1,1,0,0,0,1,1,382,1.0,1.0,0.0,0.0,0.0,1.0,1.0,2,1,1,2.0,1.0,1.0
106006,1,1,0,0,1,0,0,113,1.0,1.0,0.0,0.0,1.0,0.0,0.0,4,1,3,1.0,1.0,0.0
12055,0,0,0,0,0,0,0,1248,,,,,,,,3,0,3,,,
110051,0,0,0,0,0,0,0,38,0.0,0.0,0.0,0.0,0.0,0.0,0.0,3,0,3,,,
211140,0,0,0,0,0,0,0,92,0.0,0.0,0.0,0.0,0.0,0.0,0.0,6,0,6,1.0,0.0,1.0
9701206,0,0,0,0,0,0,0,1124,,,,,,,,4,0,4,,,
11189,0,0,0,0,0,0,0,185,0.0,0.0,0.0,0.0,0.0,0.0,0.0,10,0,10,2.0,0.0,2.0
106051,0,0,0,0,0,0,0,122,0.0,0.0,0.0,0.0,0.0,0.0,0.0,12,0,12,6.0,0.0,6.0
302198,0,0,0,0,0,0,0,30,0.0,0.0,0.0,0.0,0.0,0.0,0.0,38,0,38,10.0,0.0,10.0
110352,0,0,0,0,0,0,0,20,0.0,0.0,0.0,0.0,0.0,0.0,0.0,24,0,24,21.0,0.0,21.0
212014,0,0,0,0,0,0,0,295,0.0,0.0,0.0,0.0,0.0,0.0,0.0,1,0,1,1.0,0.0,1.0
111033,0,0,0,0,0,0,0,1310,,,,,,,,1,0,1,,,
9604306,1,1,0,0,0,1,4,150,1.0,1.0,0.0,0.0,0.0,1.0,2.0,8,1,7,2.0,1.0,1.0
11037,0,0,0,0,0,0,0,454,0.0,0.0,0.0,0.0,0.0,0.0,0.0,1,0,1,,,
6269,1,1,0,0,1,0,0,388,1.0,1.0,0.0,0.0,1.0,0.0,0.0,6,1,5,1.0,1.0,0.0
211289,0,0,0,0,0,0,0,84,0.0,0.0,0.0,0.0,0.0,0.0,0.0,9,0,9,2.0,0.0,2.0
9710265,0,0,0,0,0,0,0,35,,,,,,,,4,0,4,,,
208021,0,0,0,0,0,0,0,28,0.0,0.0,0.0,0.0,0.0,0.0,0.0,7,0,7,,,
106224,0,0,0,0,0,0,0,127,0.0,0.0,0.0,0.0,0.0,0.0,0.0,14,0,14,7.0,0.0,7.0
9603385,0,0,0,0,0,0,0,443,0.0,0.0,0.0,0.0,0.0,0.0,0.0,2,0,2,1.0,0.0,1.0
9409305,0,0,0,0,0,0,0,26,0.0,0.0,0.0,0.0,0.0,0.0,0.0,4,0,4,2.0,0.0,2.0
201063,0,0,0,0,0,0,0,27,0.0,0.0,0.0,0.0,0.0,0.0,0.0,18,0,18,9.0,0.0,9.0
9707472,0,0,0,0,0,0,0,174,0.0,0.0,0.0,0.0,0.0,0.0,0.0,6,0,6,1.0,0.0,1.0
101346,1,1,0,0,1,0,0,727,1.0,1.0,0.0,0.0,1.0,0.0,0.0,2,1,1,1.0,1.0,0.0
9609391,0,0,0,0,0,0,0,75,0.0,0.0,0.0,0.0,0.0,0.0,0.0,22,0,22,1.0,0.0,1.0
9710360,0,0,0,0,0,0,0,132,0.0,0.0,0.0,0.0,0.0,0.0,0.0,4,0,4,1.0,0.0,1.0
9812315,0,0,0,0,0,0,0,731,0.0,0.0,0.0,0.0,0.0,0.0,0.0,1,0,1,1.0,0.0,1.0
212355,0,0,0,0,0,0,0,38,0.0,0.0,0.0,0.0,0.0,0.0,0.0,4,0,4,,,
9707339,0,0,0,0,0,0,0,27,0.0,0.0,0.0,0.0,0.0,0.0,0.0,5,0,5,2.0,0.0,2.0
9701395,0,0,0,0,0,0,0,16,0.0,0.0,0.0,0.0,0.0,0.0,0.0,16,0,16,1.0,0.0,1.0
9705473,1,1,0,0,0,1,3,97,1.0,1.0,0.0,0.0,0.0,1.0,2.0,4,1,3,2.0,1.0,1.0
9802333,0,0,0,0,0,0,0,103,0.0,0.0,0.0,0.0,0.0,0.0,0.0,3,0,3,2.0,0.0,2.0
9912433,0,0,0,0,0,0,0,4,0.0,0.0,0.0,0.0,0.0,0.0,0.0,18,0,18,1.0,0.0,1.0
9507454,0,0,0,0,0,0,0,35,0.0,0.0,0.0,0.0,0.0,0.0,0.0,7,0,7,,,
206273,1,1,0,0,0,1,2,28,1.0,1.0,0.0,0.0,0.0,1.0,2.0,6,1,5,,,
105329,0,0,0,0,0,0,0,84,,,,,,,,4,0,4,3.0,0.0,3.0
9610442,0,0,0,0,0,0,0,602,0.0,0.0,0.0,0.0,0.0,0.0,0.0,9,0,9,2.0,0.0,2.0
2296,0,0,0,0,0,0,0,55,0.0,0.0,0.0,0.0,0.0,0.0,0.0,21,0,21,1.0,0.0,1.0
210400,0,0,0,0,0,0,0,31,0.0,0.0,0.0,0.0,0.0,0.0,0.0,13,0,13,3.0,0.0,3.0
9608228,0,0,0,0,0,0,0,345,0.0,0.0,0.0,0.0,0.0,0.0,0.0,4,0,4,3.0,0.0,3.0
211323,0,0,0,0,0,0,0,753,0.0,0.0,0.0,0.0,0.0,0.0,0.0,6,0,6,1.0,0.0,1.0
9807455,0,0,0,0,0,0,0,269,0.0,0.0,0.0,0.0,0.0,0.0,0.0,1,0,1,1.0,0.0,1.0
9811517,0,0,0,0,0,0,0,15,0.0,0.0,0.0,0.0,0.0,0.0,0.0,87,0,87,23.0,0.0,23.0
9612379,0,0,0,0,0,0,0,910,0.0,0.0,0.0,0.0,0.0,0.0,0.0,3,0,3,,,
212188,0,0,0,0,0,0,0,13,0.0,0.0,0.0,0.0,0.0,0.0,0.0,22,0,22,8.0,0.0,8.0
2280,0,0,0,0,0,0,0,32,,,,,,,,14,0,14,,,
209293,0,0,0,0,0,0,0,13,0.0,0.0,0.0,0.0,0.0,0.0,0.0,6,0,6,5.0,0.0,5.0
207355,0,0,0,0,0,0,0,80,0.0,0.0,0.0,0.0,0.0,0.0,0.0,5,0,5,3.0,0.0,3.0
211453,0,0,0,0,0,0,0,32,0.0,0.0,0.0,0.0,0.0,0.0,0.0,25,0,25,3.0,0.0,3.0
9701220,0,0,0,0,0,0,0,1041,,,,,,,,3,0,3,,,
8253,0,0,0,0,0,0,0,108,0.0,0.0,0.0,0.0,0.0,0.0,0.0,5,0,5,2.0,0.0,2.0
9603419,0,0,0,0,0,0,0,2055,,,,,,,,1,0,1,,,
9303300,1,1,0,0,1,0,0,659,1.0,1.0,0.0,0.0,1.0,0.0,0.0,1,1,0,1.0,1.0,0.0
104149,0,0,0,0,0,0,0,2,,,,,,,,13,0,13,1.0,0.0,1.0
9511413,0,0,0,0,0,0,0,389,0.0,0.0,0.0,0.0,0.0,0.0,0.0,1,0,1,1.0,0.0,1.0
209317,0,0,0,0,0,0,0,27,0.0,0.0,0.0,0.0,0.0,0.0,0.0,10,0,10,2.0,0.0,2.0
9606352,0,0,0,0,0,0,0,116,0.0,0.0,0.0,0.0,0.0,0.0,0.0,2,0,2,,,
301116,0,0,0,0,0,0,0,48,0.0,0.0,0.0,0.0,0.0,0.0,0.0,16,0,16,10.0,0.0,10.0
9909525,0,0,0,0,0,0,0,1581,,,,,,,,1,0,1,,,
9812329,0,0,0,0,0,0,0,230,0.0,0.0,0.0,0.0,0.0,0.0,0.0,2,0,2,,,
9911443,0,0,0,0,0,0,0,114,0.0,0.0,0.0,0.0,0.0,0.0,0.0,12,0,12,10.0,0.0,10.0
9702259,0,0,0,0,0,0,0,180,0.0,0.0,0.0,0.0,0.0,0.0,0.0,1,0,1,,,
209312,0,0,0,0,0,0,0,8,0.0,0.0,0.0,0.0,0.0,0.0,0.0,16,0,16,15.0,0.0,15.0
9295,1,1,0,0,0,1,5,155,1.0,1.0,0.0,0.0,0.0,1.0,5.0,7,1,6,6.0,1.0,5.0
9809579,0,0,0,0,0,0,0,240,0.0,0.0,0.0,0.0,0.0,0.0,0.0,3,0,3,1.0,0.0,1.0
107240,0,0,0,0,0,0,0,212,0.0,0.0,0.0,0.0,0.0,0.0,0.0,9,0,9,4.0,0.0,4.0
9309255,0,0,0,0,0,0,0,302,0.0,0.0,0.0,0.0,0.0,0.0,0.0,2,0,2,1.0,0.0,1.0
9409321,0,0,0,0,0,0,0,206,0.0,0.0,0.0,0.0,0.0,0.0,0.0,1,0,1,,,
203105,0,0,0,0,0,0,0,1,,,,,,,,13,0,13,3.0,0.0,3.0
9609259,1,1,0,0,1,0,0,114,0.0,0.0,0.0,0.0,0.0,0.0,0.0,7,1,6,2.0,0.0,2.0
206048,0,0,0,0,0,0,0,3,0.0,0.0,0.0,0.0,0.0,0.0,0.0,22,0,22,9.0,0.0,9.0
9902285,0,0,0,0,0,0,0,96,0.0,0.0,0.0,0.0,0.0,0.0,0.0,4,0,4,1.0,0.0,1.0
9801313,0,0,0,0,0,0,0,137,0.0,0.0,0.0,0.0,0.0,0.0,0.0,13,0,13,9.0,0.0,9.0
203007,0,0,0,0,0,0,0,1835,0.0,0.0,0.0,0.0,0.0,0.0,0.0,1,0,1,1.0,0.0,1.0
9911234,0,0,0,0,0,0,0,338,0.0,0.0,0.0,0.0,0.0,0.0,0.0,4,0,4,1.0,0.0,1.0
203156,0,0,0,0,0,0,0,1229,0.0,0.0,0.0,0.0,0.0,0.0,0.0,5,0,5,3.0,0.0,3.0
209022,0,0,0,0,0,0,0,24,,,,,,,,10,0,10,4.0,0.0,4.0
302242,0,0,0,0,0,0,0,129,0.0,0.0,0.0,0.0,0.0,0.0,0.0,16,0,16,9.0,0.0,9.0
9405341,78,7,71,360,50,28,32,13,32.0,1.0,31.0,159.0,32.0,0.0,0.0,80,78,2,15.0,15.0,0.0
9211321,165,23,142,1099,165,0,0,34,69.0,6.0,63.0,716.0,69.0,0.0,0.0,165,165,0,51.0,51.0,0.0
9210,2,2,0,0,0,2,9,1,0.0,0.0,0.0,0.0,0.0,0.0,0.0,14,2,12,2.0,0.0,2.0
9806468,50,7,43,182,3,47,416,1,31.0,7.0,24.0,119.0,1.0,30.0,356.0,91,50,41,33.0,20.0,13.0
9307318,15,3,12,36,15,0,0,34,1.0,1.0,0.0,0.0,1.0,0.0,0.0,15,15,0,4.0,4.0,0.0
9408290,87,24,63,258,40,47,118,6,28.0,5.0,23.0,105.0,3.0,25.0,62.0,96,87,9,24.0,21.0,3.0
9308272,103,18,85,688,103,0,0,58,39.0,9.0,30.0,164.0,39.0,0.0,0.0,103,103,0,25.0,25.0,0.0
9807238,12,2,10,28,0,12,46,7,4.0,1.0,3.0,5.0,4.0,0.0,0.0,30,12,18,7.0,5.0,2.0
9802300,73,3,70,621,7,66,345,34,65.0,3.0,62.0,562.0,6.0,59.0,315.0,89,73,16,49.0,40.0,9.0
107002,50,14,36,123,0,50,138,193,18.0,1.0,17.0,73.0,0.0,18.0,51.0,57,50,7,20.0,17.0,3.0
9505393,11,7,4,4,2,9,16,74,8.0,4.0,4.0,4.0,1.0,7.0,13.0,13,11,2,8.0,6.0,2.0
207280,1,1,0,0,0,1,2,170,1.0,1.0,0.0,0.0,0.0,1.0,2.0,6,1,5,1.0,0.0,1.0
9505430,10,5,5,6,5,5,13,114,3.0,2.0,1.0,1.0,1.0,2.0,5.0,18,10,8,3.0,3.0,0.0
9812246,8,3,5,9,1,7,42,4,3.0,2.0,1.0,1.0,0.0,3.0,10.0,20,8,12,9.0,6.0,3.0
10017,106,59,47,108,59,47,80,80,16.0,4.0,12.0,32.0,6.0,10.0,19.0,144,106,38,12.0,9.0,3.0
1166,58,13,45,122,1,57,398,2,23.0,7.0,16.0,27.0,0.0,23.0,191.0,79,58,21,8.0,8.0,0.0
9606419,58,9,49,131,9,49,90,33,14.0,3.0,11.0,23.0,8.0,6.0,6.0,66,58,8,10.0,9.0,1.0
9412214,17,10,7,10,2,15,41,33,5.0,3.0,2.0,2.0,0.0,5.0,13.0,29,17,12,4.0,3.0,1.0
9611247,20,2,18,68,0,20,84,33,14.0,2.0,12.0,54.0,0.0,14.0,39.0,39,20,19,15.0,12.0,3.0
9708311,63,16,47,116,16,47,121,25,20.0,6.0,14.0,46.0,0.0,20.0,48.0,68,63,5,7.0,6.0,1.0
9807340,40,11,29,101,2,38,265,33,25.0,5.0,20.0,68.0,0.0,25.0,181.0,69,40,29,29.0,13.0,16.0
9907326,4,2,2,2,1,3,4,61,0.0,0.0,0.0,0.0,0.0,0.0,0.0,11,4,7,1.0,0.0,1.0
9303263,21,2,19,49,21,0,0,210,13.0,1.0,12.0,25.0,13.0,0.0,0.0,21,21,0,8.0,8.0,0.0
105323,19,5,14,50,1,18,69,37,2.0,1.0,1.0,1.0,0.0,2.0,20.0,50,19,31,6.0,6.0,0.0
9403305,10,5,5,8,3,7,13,170,3.0,3.0,0.0,0.0,0.0,3.0,4.0,14,10,4,4.0,3.0,1.0
9706238,21,10,11,25,7,14,30,116,9.0,3.0,6.0,17.0,0.0,9.0,15.0,27,21,6,9.0,7.0,2.0
9905221,449,46,403,2709,91,358,1303,2,91.0,1.0,90.0,844.0,91.0,0.0,0.0,465,449,16,37.0,37.0,0.0
9207258,9,4,5,10,9,0,0,35,5.0,1.0,4.0,7.0,5.0,0.0,0.0,9,9,0,4.0,4.0,0.0
9909232,38,8,30,86,0,38,722,2,23.0,5.0,18.0,41.0,0.0,23.0,510.0,147,38,109,48.0,2.0,46.0
9402278,57,13,44,138,21,36,79,69,17.0,3.0,14.0,35.0,2.0,15.0,41.0,61,57,4,13.0,10.0,3.0
9811337,219,12,207,2386,1,218,934,2,138.0,5.0,133.0,1752.0,0.0,138.0,632.0,228,219,9,67.0,61.0,6.0
9404280,82,13,69,282,24,58,81,93,21.0,5.0,16.0,35.0,1.0,20.0,32.0,86,82,4,14.0,12.0,2.0
107162,5,3,2,2,0,5,26,2,2.0,2.0,0.0,0.0,0.0,2.0,9.0,17,5,12,2.0,2.0,0.0
203091,16,7,9,13,0,16,150,2,8.0,3.0,5.0,8.0,0.0,8.0,89.0,41,16,25,22.0,7.0,15.0
3183,21,16,5,6,14,7,7,20,5.0,5.0,0.0,0.0,5.0,0.0,0.0,27,21,6,3.0,3.0,0.0
9301267,65,19,46,153,60,5,5,18,20.0,2.0,18.0,69.0,20.0,0.0,0.0,66,65,1,6.0,6.0,0.0
9511219,6,6,0,0,1,5,13,149,2.0,2.0,0.0,0.0,0.0,2.0,8.0,15,6,9,8.0,2.0,6.0
9602396,26,5,21,62,5,21,109,25,15.0,1.0,14.0,43.0,0.0,15.0,73.0,43,26,17,23.0,14.0,9.0
9509207,20,6,14,32,11,9,9,134,7.0,2.0,5.0,13.0,7.0,0.0,0.0,22,20,2,7.0,7.0,0.0
9502264,20,3,17,38,1,19,70,8,2.0,2.0,0.0,0.0,0.0,2.0,2.0,29,20,9,3.0,2.0,1.0
9602364,36,17,19,41,4,32,167,5,9.0,4.0,5.0,8.0,0.0,9.0,46.0,71,36,35,9.0,3.0,6.0
9501298,43,17,26,56,9,34,101,10,10.0,5.0,5.0,7.0,2.0,8.0,16.0,54,43,11,8.0,5.0,3.0
9411392,18,4,14,41,3,15,103,36,9.0,2.0,7.0,20.0,0.0,9.0,61.0,33,18,15,22.0,9.0,13.0
9409464,28,10,18,55,7,21,40,0,10.0,6.0,4.0,12.0,2.0,8.0,13.0,34,28,6,11.0,9.0,2.0
2246,29,6,23,74,8,21,32,0,14.0,3.0,11.0,35.0,0.0,14.0,14.0,33,29,4,14.0,13.0,1.0
9712537,84,10,74,515,1,83,562,0,30.0,2.0,28.0,127.0,0.0,30.0,300.0,111,84,27,39.0,25.0,14.0
9812273,44,13,31,73,1,43,429,0,12.0,6.0,6.0,9.0,0.0,12.0,139.0,128,44,84,31.0,5.0,26.0
9811299,18,6,12,33,6,12,71,3,5.0,2.0,3.0,3.0,0.0,5.0,27.0,36,18,18,10.0,5.0,5.0
9507352,24,13,11,19,9,15,34,0,3.0,3.0,0.0,0.0,0.0,3.0,10.0,33,24,9,3.0,2.0,1.0
9505319,58,16,42,162,49,9,9,50,13.0,2.0,11.0,50.0,13.0,0.0,0.0,59,58,1,5.0,5.0,0.0
9810308,74,8,66,310,10,64,197,46,26.0,3.0,23.0,95.0,0.0,26.0,117.0,85,74,11,22.0,16.0,6.0
9907452,11,3,8,18,0,11,40,3,2.0,1.0,1.0,1.0,1.0,1.0,1.0,30,11,19,6.0,6.0,0.0
9505385,132,17,115,659,86,46,76,0,53.0,3.0,50.0,271.0,45.0,8.0,8.0,142,132,10,27.0,27.0,0.0
9805281,45,11,34,77,5,40,118,0,16.0,4.0,12.0,27.0,0.0,16.0,28.0,71,45,26,9.0,5.0,4.0
9802201,56,9,47,180,31,25,69,0,24.0,5.0,19.0,98.0,24.0,0.0,0.0,71,56,15,10.0,10.0,0.0
9502263,21,4,17,46,0,21,47,0,11.0,3.0,8.0,22.0,0.0,11.0,22.0,31,21,10,7.0,5.0,2.0
9701306,5,4,1,2,0,5,9,0,1.0,1.0,0.0,0.0,1.0,0.0,0.0,9,5,4,2.0,1.0,1.0
9912231,106,17,89,384,21,85,297,0,33.0,2.0,31.0,155.0,2.0,31.0,79.0,134,106,28,18.0,16.0,2.0
9503215,29,7,22,44,6,23,57,10,6.0,2.0,4.0,4.0,0.0,6.0,11.0,37,29,8,7.0,4.0,3.0
9710289,19,2,17,69,2,17,89,82,16.0,1.0,15.0,60.0,1.0,15.0,82.0,33,19,14,23.0,14.0,9.0
9208241,20,10,10,15,20,0,0,317,3.0,1.0,2.0,2.0,3.0,0.0,0.0,20,20,0,3.0,3.0,0.0
3208,3,1,2,3,0,3,16,81,3.0,1.0,2.0,3.0,0.0,3.0,16.0,9,3,6,9.0,3.0,6.0
9509205,22,3,19,46,1,21,61,3,8.0,4.0,4.0,7.0,0.0,8.0,10.0,40,22,18,10.0,8.0,2.0
9606289,53,4,49,183,37,16,16,51,29.0,3.0,26.0,100.0,17.0,12.0,12.0,54,53,1,16.0,15.0,1.0
9611425,27,2,25,119,0,27,128,46,22.0,2.0,20.0,93.0,0.0,22.0,112.0,37,27,10,20.0,15.0,5.0
9503313,15,6,9,10,1,14,74,10,4.0,1.0,3.0,3.0,0.0,4.0,15.0,41,15,26,9.0,4.0,5.0
9410412,25,8,17,37,3,22,50,63,9.0,3.0,6.0,7.0,1.0,8.0,27.0,32,25,7,14.0,9.0,5.0
9507402,8,5,3,5,3,5,11,10,0.0,0.0,0.0,0.0,0.0,0.0,0.0,16,8,8,2.0,0.0,2.0
9710380,18,2,16,36,0,18,99,71,14.0,2.0,12.0,29.0,0.0,14.0,73.0,28,18,10,18.0,11.0,7.0
9704339,30,4,26,78,1,29,150,36,18.0,2.0,16.0,60.0,0.0,18.0,121.0,45,30,15,24.0,17.0,7.0
9712415,43,12,31,68,20,23,29,11,7.0,3.0,4.0,8.0,7.0,0.0,0.0,46,43,3,5.0,5.0,0.0
9609431,21,9,12,23,3,18,77,42,12.0,4.0,8.0,18.0,0.0,12.0,55.0,51,21,30,12.0,5.0,7.0
9501336,51,10,41,137,13,38,69,10,16.0,2.0,14.0,37.0,2.0,14.0,27.0,55,51,4,14.0,12.0,2.0
9304277,73,23,50,333,20,53,123,75,44.0,14.0,30.0,140.0,9.0,35.0,73.0,79,73,6,34.0,32.0,2.0
9702247,22,2,20,101,3,19,81,12,17.0,1.0,16.0,79.0,2.0,15.0,15.0,43,22,21,4.0,3.0,1.0
9705287,41,5,36,154,2,39,405,36,33.0,4.0,29.0,124.0,0.0,33.0,366.0,67,41,26,39.0,22.0,17.0
9308335,118,33,85,281,108,10,10,10,23.0,11.0,12.0,29.0,23.0,0.0,0.0,121,118,3,6.0,6.0,0.0
9808453,9,6,3,4,1,8,70,93,2.0,1.0,1.0,1.0,0.0,2.0,10.0,87,9,78,12.0,2.0,10.0
5189,43,5,38,175,0,43,620,34,40.0,5.0,35.0,167.0,0.0,40.0,589.0,91,43,48,53.0,25.0,28.0
9506260,30,2,28,121,20,10,19,1,28.0,2.0,26.0,117.0,28.0,0.0,0.0,34,30,4,14.0,14.0,0.0
9710509,43,3,40,153,0,43,156,1,36.0,4.0,32.0,112.0,0.0,36.0,140.0,49,43,6,28.0,22.0,6.0
9401277,134,21,113,620,60,74,129,7,29.0,2.0,27.0,118.0,5.0,24.0,24.0,144,134,10,15.0,14.0,1.0
9407226,28,13,15,31,23,5,7,34,4.0,4.0,0.0,0.0,4.0,0.0,0.0,33,28,5,4.0,4.0,0.0
8023,28,3,25,103,15,13,26,62,20.0,2.0,18.0,89.0,9.0,11.0,11.0,41,28,13,18.0,17.0,1.0
9503479,33,18,15,30,10,23,110,5,6.0,3.0,3.0,4.0,2.0,4.0,15.0,89,33,56,11.0,4.0,7.0
9612261,35,11,24,65,6,29,167,5,2.0,2.0,0.0,0.0,0.0,2.0,10.0,70,35,35,10.0,1.0,9.0
9706307,42,14,28,82,3,39,359,5,8.0,3.0,5.0,9.0,0.0,8.0,45.0,145,42,103,24.0,7.0,17.0
9707281,27,9,18,48,4,23,109,87,14.0,1.0,13.0,38.0,0.0,14.0,75.0,39,27,12,22.0,14.0,8.0
9408316,12,3,9,22,0,12,43,93,10.0,3.0,7.0,17.0,0.0,10.0,39.0,19,12,7,16.0,10.0,6.0
9701347,11,6,5,9,2,9,57,93,2.0,2.0,0.0,0.0,0.0,2.0,22.0,35,11,24,14.0,2.0,12.0
9907264,24,3,21,64,4,20,95,13,17.0,2.0,15.0,48.0,1.0,16.0,78.0,42,24,18,24.0,12.0,12.0
105217,12,3,9,22,1,11,59,6,3.0,1.0,2.0,3.0,0.0,3.0,30.0,45,12,33,5.0,0.0,5.0
9705252,31,8,23,43,2,29,120,6,11.0,3.0,8.0,13.0,0.0,11.0,46.0,57,31,26,21.0,8.0,13.0
9902205,14,3,11,28,2,12,55,1,12.0,2.0,10.0,27.0,0.0,12.0,45.0,26,14,12,14.0,8.0,6.0
9408229,68,13,55,164,68,0,0,32,18.0,2.0,16.0,39.0,18.0,0.0,0.0,68,68,0,9.0,9.0,0.0
9411422,22,6,16,52,1,21,41,1,4.0,2.0,2.0,3.0,0.0,4.0,8.0,30,22,8,5.0,4.0,1.0
9704287,61,10,51,220,11,50,132,1,18.0,2.0,16.0,51.0,2.0,16.0,34.0,70,61,9,13.0,10.0,3.0
9506448,32,5,27,94,2,30,43,13,15.0,1.0,14.0,46.0,0.0,15.0,15.0,37,32,5,12.0,11.0,1.0
9909455,14,6,8,12,3,11,22,86,5.0,3.0,2.0,2.0,1.0,4.0,4.0,20,14,6,2.0,2.0,0.0
9903314,4,3,1,1,3,1,1,269,1.0,1.0,0.0,0.0,1.0,0.0,0.0,10,4,6,3.0,0.0,3.0
9507326,71,19,52,143,24,47,62,59,20.0,4.0,16.0,51.0,5.0,15.0,15.0,76,71,5,13.0,12.0,1.0
9608458,86,1,85,573,4,82,329,21,58.0,1.0,57.0,384.0,2.0,56.0,253.0,98,86,12,40.0,32.0,8.0
9905528,5,2,3,6,0,5,21,7,2.0,1.0,1.0,1.0,1.0,1.0,1.0,13,5,8,1.0,0.0,1.0
9406389,76,15,61,311,22,54,201,18,19.0,10.0,9.0,18.0,0.0,19.0,74.0,89,76,13,23.0,18.0,5.0
9812267,23,4,19,50,0,23,111,7,11.0,3.0,8.0,21.0,0.0,11.0,33.0,47,23,24,4.0,2.0,2.0
9604320,100,3,97,943,6,94,578,15,79.0,1.0,78.0,807.0,4.0,75.0,499.0,128,100,28,65.0,53.0,12.0
9203203,217,49,168,1327,217,0,0,15,76.0,10.0,66.0,744.0,76.0,0.0,0.0,217,217,0,39.0,39.0,0.0
9512265,4,2,2,3,0,4,24,15,1.0,1.0,0.0,0.0,0.0,1.0,2.0,15,4,11,1.0,0.0,1.0
9811270,15,6,9,20,2,13,41,76,1.0,1.0,0.0,0.0,0.0,1.0,6.0,40,15,25,8.0,8.0,0.0
9405373,4,4,0,0,4,0,0,76,1.0,1.0,0.0,0.0,1.0,0.0,0.0,4,4,0,1.0,1.0,0.0
9503354,9,5,4,8,2,7,7,62,6.0,2.0,4.0,6.0,6.0,0.0,0.0,10,9,1,2.0,2.0,0.0
9302280,93,14,79,581,93,0,0,19,47.0,4.0,43.0,373.0,47.0,0.0,0.0,93,93,0,19.0,19.0,0.0
9205237,49,12,37,116,49,0,0,62,26.0,4.0,22.0,67.0,26.0,0.0,0.0,49,49,0,11.0,11.0,0.0
9605286,84,34,50,101,62,22,22,47,13.0,4.0,9.0,19.0,1.0,12.0,12.0,88,84,4,12.0,11.0,1.0
9911410,8,3,5,7,4,4,14,218,1.0,1.0,0.0,0.0,0.0,1.0,3.0,19,8,11,6.0,4.0,2.0
9607290,52,8,44,143,18,34,72,11,17.0,3.0,14.0,31.0,8.0,9.0,12.0,61,52,9,13.0,11.0,2.0
9608229,46,1,45,282,29,17,17,16,38.0,1.0,37.0,230.0,22.0,16.0,16.0,47,46,1,19.0,19.0,0.0
9603285,53,9,44,125,14,39,74,57,20.0,4.0,16.0,30.0,0.0,20.0,46.0,60,53,7,12.0,10.0,2.0
9604419,27,10,17,27,1,26,97,57,10.0,4.0,6.0,9.0,0.0,10.0,46.0,37,27,10,12.0,8.0,4.0
9909572,11,2,9,17,0,11,45,80,4.0,3.0,1.0,1.0,0.0,4.0,10.0,30,11,19,6.0,4.0,2.0
9706201,23,7,16,61,5,18,69,30,1.0,1.0,0.0,0.0,0.0,1.0,8.0,57,23,34,14.0,11.0,3.0
9802431,14,4,10,18,0,14,70,151,10.0,4.0,6.0,12.0,0.0,10.0,54.0,28,14,14,17.0,9.0,8.0
9507216,107,19,88,437,23,84,145,30,36.0,11.0,25.0,99.0,9.0,27.0,46.0,112,107,5,18.0,17.0,1.0
9507233,2,2,0,0,1,1,1,86,0.0,0.0,0.0,0.0,0.0,0.0,0.0,13,2,11,1.0,0.0,1.0
9309324,9,4,5,8,9,0,0,114,6.0,2.0,4.0,6.0,6.0,0.0,0.0,9,9,0,3.0,3.0,0.0
9601246,14,6,8,13,3,11,15,59,7.0,4.0,3.0,5.0,0.0,7.0,7.0,16,14,2,6.0,5.0,1.0
9812205,118,10,108,802,13,105,184,24,82.0,3.0,79.0,684.0,8.0,74.0,107.0,124,118,6,41.0,39.0,2.0
9511430,56,4,52,246,19,37,87,25,31.0,2.0,29.0,134.0,6.0,25.0,54.0,64,56,8,24.0,21.0,3.0
9410387,69,5,64,345,17,52,145,6,52.0,5.0,47.0,278.0,4.0,48.0,137.0,73,69,4,26.0,22.0,4.0
9406392,50,6,44,234,45,5,5,8,26.0,2.0,24.0,138.0,26.0,0.0,0.0,51,50,1,19.0,19.0,0.0
9503255,11,5,6,6,0,11,64,69,4.0,2.0,2.0,2.0,0.0,4.0,32.0,28,11,17,11.0,3.0,8.0
9411411,9,2,7,8,2,7,22,96,7.0,1.0,6.0,7.0,0.0,7.0,19.0,14,9,5,11.0,7.0,4.0
9409376,6,3,3,4,4,2,2,8,0.0,0.0,0.0,0.0,0.0,0.0,0.0,12,6,6,2.0,1.0,1.0
9907282,18,5,13,32,18,0,0,32,13.0,2.0,11.0,28.0,13.0,0.0,0.0,18,18,0,1.0,1.0,0.0
9909229,46,16,30,50,6,40,125,88,12.0,3.0,9.0,13.0,0.0,12.0,55.0,101,46,55,24.0,7.0,17.0
9905247,32,10,22,58,20,12,15,64,23.0,8.0,15.0,44.0,13.0,10.0,10.0,36,32,4,10.0,9.0,1.0
9905409,30,14,16,28,7,23,99,45,4.0,3.0,1.0,1.0,0.0,4.0,31.0,63,30,33,9.0,3.0,6.0
9303276,10,4,6,8,2,8,11,205,4.0,2.0,2.0,2.0,0.0,4.0,4.0,12,10,2,4.0,2.0,2.0
9401210,17,8,9,17,4,13,13,22,7.0,5.0,2.0,3.0,7.0,0.0,0.0,18,17,1,6.0,6.0,0.0
9809215,8,2,6,20,0,8,33,38,7.0,2.0,5.0,17.0,0.0,7.0,28.0,27,8,19,2.0,0.0,2.0
9307363,25,11,14,53,16,9,10,88,12.0,2.0,10.0,35.0,12.0,0.0,0.0,28,25,3,10.0,10.0,0.0
9702210,36,14,22,71,21,15,28,88,21.0,4.0,17.0,57.0,10.0,11.0,22.0,41,36,5,17.0,14.0,3.0
9911474,20,5,15,39,3,17,75,38,14.0,1.0,13.0,36.0,0.0,14.0,70.0,31,20,11,8.0,5.0,3.0
9507414,88,9,79,433,5,83,185,21,37.0,3.0,34.0,214.0,1.0,36.0,67.0,97,88,9,23.0,21.0,2.0
9507306,12,2,10,16,2,10,11,50,2.0,1.0,1.0,1.0,0.0,2.0,3.0,14,12,2,4.0,3.0,1.0
2032,16,9,7,15,1,15,77,19,7.0,3.0,4.0,9.0,0.0,7.0,25.0,34,16,18,10.0,4.0,6.0
9708334,5,1,4,4,1,4,5,287,1.0,1.0,0.0,0.0,0.0,1.0,2.0,10,5,5,3.0,1.0,2.0
9812363,20,2,18,51,6,14,31,43,14.0,2.0,12.0,33.0,3.0,11.0,23.0,28,20,8,7.0,6.0,1.0
9908523,42,5,37,222,3,39,355,19,34.0,3.0,31.0,205.0,0.0,34.0,320.0,64,42,22,32.0,23.0,9.0
7294,59,4,55,253,6,53,169,19,25.0,2.0,23.0,72.0,1.0,24.0,78.0,69,59,10,18.0,11.0,7.0
9501313,15,5,10,25,7,8,20,77,11.0,3.0,8.0,21.0,3.0,8.0,20.0,19,15,4,8.0,4.0,4.0
4095,45,6,39,185,0,45,133,20,41.0,6.0,35.0,173.0,0.0,41.0,127.0,50,45,5,27.0,22.0,5.0
9811473,119,9,110,1300,7,112,447,20,90.0,2.0,88.0,1207.0,3.0,87.0,389.0,125,119,6,73.0,67.0,6.0
9906551,52,4,48,413,1,51,514,20,50.0,4.0,46.0,397.0,1.0,49.0,508.0,70,52,18,54.0,38.0,16.0
9305340,8,5,3,4,4,4,4,162,3.0,1.0,2.0,3.0,3.0,0.0,0.0,10,8,2,3.0,3.0,0.0
9501257,9,5,4,10,2,7,19,179,4.0,2.0,2.0,3.0,0.0,4.0,10.0,17,9,8,10.0,5.0,5.0
9405262,32,3,29,150,32,0,0,136,30.0,2.0,28.0,149.0,30.0,0.0,0.0,32,32,0,24.0,24.0,0.0
12294,5,4,1,1,2,3,3,220,4.0,3.0,1.0,1.0,1.0,3.0,3.0,10,5,5,4.0,2.0,2.0
107223,3,3,0,0,0,3,10,136,3.0,3.0,0.0,0.0,0.0,3.0,10.0,10,3,7,8.0,2.0,6.0
206021,17,2,15,52,1,16,57,37,14.0,2.0,12.0,46.0,0.0,14.0,46.0,27,17,10,19.0,15.0,4.0
207275,0,0,0,0,0,0,0,379,0.0,0.0,0.0,0.0,0.0,0.0,0.0,4,0,4,,,
9612463,28,9,19,72,0,28,79,78,20.0,4.0,16.0,61.0,0.0,20.0,46.0,46,28,18,15.0,14.0,1.0
9607243,10,2,8,16,0,10,47,6,5.0,1.0,4.0,7.0,0.0,5.0,19.0,30,10,20,11.0,4.0,7.0
9512230,52,9,43,219,47,5,5,5,21.0,1.0,20.0,112.0,21.0,0.0,0.0,54,52,2,9.0,9.0,0.0
9407251,73,17,56,211,7,66,251,10,17.0,6.0,11.0,53.0,0.0,17.0,48.0,94,73,21,16.0,13.0,3.0
9307347,60,14,46,294,60,0,0,5,31.0,6.0,25.0,155.0,31.0,0.0,0.0,60,60,0,28.0,28.0,0.0
9410231,93,24,69,241,31,62,162,10,20.0,3.0,17.0,59.0,12.0,8.0,8.0,110,93,17,9.0,9.0,0.0
9702409,100,8,92,585,8,92,965,15,61.0,2.0,59.0,478.0,0.0,61.0,793.0,152,100,52,66.0,36.0,30.0
9503331,4,1,3,4,0,4,5,42,1.0,1.0,0.0,0.0,0.0,1.0,1.0,6,4,2,3.0,1.0,2.0
9803432,30,13,17,35,5,25,166,5,12.0,5.0,7.0,12.0,0.0,12.0,72.0,51,30,21,8.0,7.0,1.0
9603343,13,2,11,27,0,13,46,114,12.0,2.0,10.0,21.0,1.0,11.0,34.0,22,13,9,17.0,12.0,5.0
9604406,31,3,28,98,2,29,154,5,19.0,2.0,17.0,57.0,2.0,17.0,79.0,48,31,17,26.0,17.0,9.0
9508265,25,8,17,35,5,20,56,4,3.0,2.0,1.0,1.0,1.0,2.0,3.0,48,25,23,5.0,2.0,3.0
9505252,7,3,4,5,1,6,14,35,1.0,1.0,0.0,0.0,0.0,1.0,2.0,20,7,13,5.0,2.0,3.0
9206257,14,8,6,10,14,0,0,4,4.0,4.0,0.0,0.0,4.0,0.0,0.0,14,14,0,3.0,3.0,0.0
9610541,27,3,24,103,27,0,0,19,15.0,1.0,14.0,54.0,15.0,0.0,0.0,27,27,0,9.0,9.0,0.0
9909397,6,1,5,8,0,6,32,4,0.0,0.0,0.0,0.0,0.0,0.0,0.0,25,6,19,7.0,1.0,6.0
9612437,56,5,51,410,7,49,188,70,51.0,1.0,50.0,407.0,4.0,47.0,185.0,63,56,7,41.0,37.0,4.0
9612209,7,7,0,0,5,2,2,366,0.0,0.0,0.0,0.0,0.0,0.0,0.0,32,7,25,4.0,1.0,3.0
9903329,22,5,17,32,7,15,40,0,3.0,1.0,2.0,2.0,0.0,3.0,5.0,29,22,7,11.0,5.0,6.0
9802238,81,4,77,414,43,38,159,21,34.0,1.0,33.0,158.0,34.0,0.0,0.0,93,81,12,25.0,24.0,1.0
9510252,41,12,29,59,0,41,154,18,18.0,9.0,9.0,16.0,0.0,18.0,62.0,60,41,19,8.0,6.0,2.0
9501390,21,4,17,45,5,16,49,41,3.0,2.0,1.0,1.0,0.0,3.0,6.0,29,21,8,9.0,4.0,5.0
9904207,6,4,2,2,3,3,6,26,3.0,2.0,1.0,1.0,1.0,2.0,4.0,15,6,9,1.0,0.0,1.0
9609339,38,14,24,64,7,31,88,84,18.0,5.0,13.0,35.0,1.0,17.0,51.0,48,38,10,11.0,7.0,4.0
9601249,53,15,38,205,7,46,161,49,29.0,5.0,24.0,124.0,4.0,25.0,61.0,68,53,15,22.0,19.0,3.0
9401270,36,11,25,61,31,5,5,66,11.0,2.0,9.0,27.0,11.0,0.0,0.0,37,36,1,9.0,9.0,0.0
9901445,18,2,16,36,2,16,45,251,10.0,1.0,9.0,24.0,1.0,9.0,12.0,26,18,8,12.0,10.0,2.0
205102,11,4,7,15,0,11,127,23,8.0,2.0,6.0,11.0,0.0,8.0,94.0,42,11,31,25.0,7.0,18.0
9804430,13,3,10,37,3,10,16,105,5.0,1.0,4.0,9.0,0.0,5.0,7.0,18,13,5,7.0,5.0,2.0
9510304,53,6,47,215,37,16,21,9,18.0,2.0,16.0,66.0,12.0,6.0,6.0,57,53,4,15.0,15.0,0.0
9404330,17,5,12,38,3,14,26,93,6.0,3.0,3.0,5.0,1.0,5.0,10.0,25,17,8,2.0,0.0,2.0
9911370,56,5,51,258,5,51,196,55,27.0,2.0,25.0,119.0,7.0,20.0,50.0,82,56,26,21.0,18.0,3.0
9907520,66,9,57,249,0,66,564,2,13.0,4.0,9.0,13.0,0.0,13.0,238.0,105,66,39,34.0,29.0,5.0
5027,37,7,30,123,0,37,433,10,22.0,2.0,20.0,75.0,0.0,22.0,140.0,131,37,94,28.0,21.0,7.0
8056,24,5,19,38,8,16,27,0,17.0,3.0,14.0,33.0,5.0,12.0,16.0,28,24,4,1.0,1.0,0.0
9806409,14,4,10,21,5,9,27,116,7.0,1.0,6.0,9.0,0.0,7.0,23.0,19,14,5,11.0,7.0,4.0
9811410,28,16,12,18,9,19,69,84,8.0,6.0,2.0,2.0,0.0,8.0,35.0,61,28,33,12.0,4.0,8.0
102181,52,5,47,185,3,49,411,18,35.0,8.0,27.0,114.0,0.0,35.0,297.0,90,52,38,36.0,27.0,9.0
9301205,17,10,7,16,17,0,0,95,1.0,1.0,0.0,0.0,1.0,0.0,0.0,17,17,0,1.0,1.0,0.0
102211,11,3,8,42,0,11,21,23,11.0,3.0,8.0,42.0,0.0,11.0,21.0,16,11,5,11.0,10.0,1.0
9907475,21,3,18,47,1,20,101,27,17.0,3.0,14.0,40.0,0.0,17.0,95.0,34,21,13,18.0,14.0,4.0
103062,63,14,49,205,29,34,91,107,15.0,2.0,13.0,35.0,10.0,5.0,8.0,83,63,20,9.0,9.0,0.0
107316,37,8,29,69,0,37,553,18,18.0,3.0,15.0,35.0,0.0,18.0,188.0,162,37,125,30.0,14.0,16.0
103054,31,2,29,132,2,29,259,23,25.0,1.0,24.0,122.0,0.0,25.0,233.0,53,31,22,25.0,16.0,9.0
9407402,14,5,9,22,6,8,10,13,5.0,1.0,4.0,9.0,1.0,4.0,4.0,21,14,7,3.0,0.0,3.0
9407351,17,2,15,30,9,8,11,18,7.0,3.0,4.0,6.0,3.0,4.0,4.0,19,17,2,6.0,5.0,1.0
9805300,21,16,5,10,1,20,45,73,1.0,1.0,0.0,0.0,0.0,1.0,4.0,37,21,16,2.0,2.0,0.0
9903511,14,3,11,26,0,14,81,42,8.0,1.0,7.0,19.0,0.0,8.0,40.0,29,14,15,17.0,8.0,9.0
6319,30,8,22,84,0,30,336,0,11.0,1.0,10.0,32.0,0.0,11.0,141.0,118,30,88,37.0,8.0,29.0
104221,29,13,16,32,8,21,39,0,9.0,1.0,8.0,14.0,2.0,7.0,14.0,34,29,5,2.0,2.0,0.0
9907320,3,1,2,2,1,2,2,111,3.0,1.0,2.0,2.0,1.0,2.0,2.0,4,3,1,1.0,0.0,1.0
9604243,12,3,9,26,0,12,62,69,7.0,2.0,5.0,11.0,0.0,7.0,40.0,20,12,8,15.0,8.0,7.0
9099,2,2,0,0,1,1,1,51,0.0,0.0,0.0,0.0,0.0,0.0,0.0,22,2,20,3.0,0.0,3.0
9909417,6,5,1,1,6,0,0,64,3.0,2.0,1.0,1.0,3.0,0.0,0.0,6,6,0,2.0,2.0,0.0
9605430,10,7,3,5,9,1,1,252,4.0,4.0,0.0,0.0,4.0,0.0,0.0,13,10,3,2.0,1.0,1.0
9807443,155,37,118,379,16,139,1045,8,41.0,4.0,37.0,141.0,0.0,41.0,477.0,290,155,135,47.0,26.0,21.0
9912284,16,7,9,21,1,15,80,16,7.0,2.0,5.0,7.0,0.0,7.0,40.0,30,16,14,5.0,4.0,1.0
6255,8,4,4,5,1,7,21,43,2.0,1.0,1.0,1.0,2.0,0.0,0.0,20,8,12,2.0,2.0,0.0
2213,63,18,45,152,14,49,271,4,29.0,6.0,23.0,91.0,0.0,29.0,214.0,83,63,20,32.0,19.0,13.0
9711436,3,2,1,1,3,0,0,94,1.0,1.0,0.0,0.0,1.0,0.0,0.0,3,3,0,1.0,1.0,0.0
9907491,53,22,31,66,9,44,242,83,18.0,6.0,12.0,24.0,0.0,18.0,103.0,121,53,68,23.0,9.0,14.0
9712482,24,9,15,30,1,23,73,39,15.0,8.0,7.0,14.0,1.0,14.0,43.0,34,24,10,16.0,9.0,7.0
9511358,10,4,6,10,5,5,13,39,4.0,1.0,3.0,4.0,2.0,2.0,2.0,17,10,7,5.0,5.0,0.0
9808377,27,2,25,163,0,27,86,32,25.0,1.0,24.0,161.0,0.0,25.0,65.0,39,27,12,28.0,24.0,4.0
9503295,21,7,14,43,15,6,6,50,10.0,3.0,7.0,19.0,9.0,1.0,1.0,24,21,3,9.0,9.0,0.0
9907347,17,4,13,32,0,17,390,2,13.0,2.0,11.0,28.0,0.0,13.0,359.0,67,17,50,47.0,9.0,38.0
4014,59,6,53,342,0,59,739,11,51.0,5.0,46.0,327.0,0.0,51.0,651.0,94,59,35,64.0,45.0,19.0
9810206,16,8,8,22,2,14,44,11,5.0,2.0,3.0,4.0,0.0,5.0,25.0,39,16,23,12.0,3.0,9.0
12007,17,2,15,59,0,17,160,19,17.0,2.0,15.0,59.0,0.0,17.0,155.0,32,17,15,30.0,17.0,13.0
110004,10,5,5,13,0,10,46,8,2.0,2.0,0.0,0.0,0.0,2.0,10.0,33,10,23,8.0,5.0,3.0
208115,9,4,5,7,0,9,43,19,6.0,2.0,4.0,5.0,0.0,6.0,23.0,19,9,10,12.0,6.0,6.0
104052,24,8,16,27,2,22,95,66,13.0,6.0,7.0,10.0,1.0,12.0,50.0,39,24,15,16.0,10.0,6.0
9612353,29,5,24,70,4,25,126,8,17.0,1.0,16.0,50.0,0.0,17.0,102.0,45,29,16,21.0,16.0,5.0
210135,4,3,1,1,0,4,46,19,2.0,2.0,0.0,0.0,0.0,2.0,18.0,57,4,53,15.0,2.0,13.0
106071,18,5,13,27,0,18,140,28,6.0,3.0,3.0,4.0,0.0,6.0,32.0,51,18,33,12.0,4.0,8.0
9308269,17,4,13,25,15,2,2,108,4.0,1.0,3.0,5.0,2.0,2.0,2.0,19,17,2,5.0,4.0,1.0
201232,15,1,14,54,0,15,264,28,15.0,1.0,14.0,54.0,0.0,15.0,227.0,49,15,34,34.0,15.0,19.0
9703233,10,3,7,9,1,9,53,26,6.0,2.0,4.0,6.0,0.0,6.0,42.0,21,10,11,7.0,1.0,6.0
9406426,4,4,0,0,2,2,3,246,3.0,3.0,0.0,0.0,1.0,2.0,2.0,8,4,4,4.0,2.0,2.0
9912496,13,4,9,26,0,13,81,2,1.0,1.0,0.0,0.0,0.0,1.0,10.0,70,13,57,31.0,0.0,31.0
5055,2,2,0,0,0,2,14,2,0.0,0.0,0.0,0.0,0.0,0.0,0.0,17,2,15,2.0,1.0,1.0
109121,3,1,2,2,0,3,12,23,2.0,1.0,1.0,1.0,2.0,0.0,0.0,14,3,11,2.0,1.0,1.0
9211215,3,1,2,3,3,0,0,96,3.0,1.0,2.0,3.0,3.0,0.0,0.0,3,3,0,3.0,3.0,0.0
9808447,13,4,9,19,0,13,55,10,2.0,1.0,1.0,1.0,0.0,2.0,2.0,26,13,13,12.0,5.0,7.0
9603346,21,8,13,26,5,16,42,10,7.0,2.0,5.0,13.0,2.0,5.0,10.0,31,21,10,5.0,4.0,1.0
4175,6,2,4,5,0,6,51,10,5.0,1.0,4.0,5.0,0.0,5.0,36.0,28,6,22,15.0,4.0,11.0
9410405,22,7,15,24,18,4,4,85,6.0,2.0,4.0,5.0,6.0,0.0,0.0,23,22,1,4.0,4.0,0.0
9803487,6,2,4,6,2,4,6,119,1.0,1.0,0.0,0.0,0.0,1.0,2.0,17,6,11,2.0,1.0,1.0
9506369,10,5,5,7,10,0,0,12,4.0,4.0,0.0,0.0,4.0,0.0,0.0,10,10,0,2.0,2.0,0.0
9308209,9,7,2,2,5,4,9,75,2.0,1.0,1.0,1.0,2.0,0.0,0.0,27,9,18,2.0,2.0,0.0
9912467,6,3,3,3,0,6,27,86,4.0,2.0,2.0,2.0,0.0,4.0,12.0,23,6,17,5.0,4.0,1.0
9301201,4,2,2,3,4,0,0,1772,1.0,1.0,0.0,0.0,1.0,0.0,0.0,4,4,0,,,
9507416,53,9,44,162,11,42,104,48,32.0,5.0,27.0,96.0,3.0,29.0,71.0,61,53,8,22.0,19.0,3.0
109001,12,4,8,19,1,11,68,1,4.0,3.0,1.0,3.0,0.0,4.0,37.0,29,12,17,15.0,4.0,11.0
8071,12,3,9,14,1,11,131,6,6.0,1.0,5.0,6.0,0.0,6.0,40.0,41,12,29,9.0,3.0,6.0
101154,7,4,3,4,0,7,53,7,3.0,2.0,1.0,1.0,0.0,3.0,16.0,44,7,37,6.0,1.0,5.0
9904313,7,2,5,10,0,7,69,1,5.0,1.0,4.0,6.0,0.0,5.0,53.0,28,7,21,22.0,3.0,19.0
9502223,6,6,0,0,6,0,0,443,3.0,3.0,0.0,0.0,3.0,0.0,0.0,6,6,0,2.0,2.0,0.0
3105,19,2,17,77,4,15,46,21,16.0,1.0,15.0,75.0,1.0,15.0,30.0,25,19,6,15.0,14.0,1.0
9505259,37,13,24,59,16,21,36,72,14.0,3.0,11.0,29.0,5.0,9.0,15.0,48,37,11,8.0,5.0,3.0
9610423,14,8,6,9,7,7,14,11,3.0,3.0,0.0,0.0,0.0,3.0,6.0,30,14,16,2.0,2.0,0.0
9806212,22,9,13,33,4,18,26,11,7.0,2.0,5.0,13.0,7.0,0.0,0.0,32,22,10,4.0,4.0,0.0
9508347,293,36,257,1391,201,92,193,14,78.0,3.0,75.0,501.0,27.0,51.0,137.0,302,293,9,39.0,37.0,2.0
9602223,79,4,75,344,1,78,300,17,68.0,2.0,66.0,322.0,0.0,68.0,267.0,89,79,10,48.0,41.0,7.0
9702334,21,12,9,16,1,20,61,204,15.0,8.0,7.0,13.0,0.0,15.0,38.0,43,21,22,15.0,11.0,4.0
9609316,5,4,1,1,0,5,9,26,0.0,0.0,0.0,0.0,0.0,0.0,0.0,10,5,5,3.0,3.0,0.0
9608407,31,5,26,86,13,18,44,25,8.0,3.0,5.0,14.0,1.0,7.0,23.0,44,31,13,14.0,6.0,8.0
9408396,13,2,11,42,5,8,8,104,12.0,2.0,10.0,31.0,5.0,7.0,7.0,15,13,2,8.0,7.0,1.0
9607244,17,4,13,24,12,5,5,129,6.0,1.0,5.0,10.0,6.0,0.0,0.0,20,17,3,4.0,4.0,0.0
9506462,3,2,1,1,0,3,5,8,0.0,0.0,0.0,0.0,0.0,0.0,0.0,6,3,3,3.0,0.0,3.0
9407249,29,6,23,75,29,0,0,22,15.0,2.0,13.0,46.0,15.0,0.0,0.0,30,29,1,15.0,15.0,0.0
9708421,17,4,13,41,8,9,12,4,14.0,3.0,11.0,38.0,9.0,5.0,5.0,21,17,4,4.0,3.0,1.0
9905300,6,3,3,4,0,6,30,1,1.0,1.0,0.0,0.0,0.0,1.0,6.0,58,6,52,7.0,0.0,7.0
9706315,115,11,104,710,48,67,145,12,80.0,4.0,76.0,604.0,21.0,59.0,128.0,124,115,9,51.0,48.0,3.0
9311349,8,4,4,10,8,0,0,129,5.0,1.0,4.0,10.0,5.0,0.0,0.0,9,8,1,5.0,5.0,0.0
11156,2,2,0,0,0,2,3,28,2.0,2.0,0.0,0.0,2.0,0.0,0.0,6,2,4,2.0,2.0,0.0
9408331,12,8,4,4,5,7,7,192,6.0,4.0,2.0,2.0,0.0,6.0,6.0,13,12,1,6.0,5.0,1.0
9305306,79,26,53,163,52,27,30,14,20.0,3.0,17.0,65.0,20.0,0.0,0.0,82,79,3,8.0,8.0,0.0
9402277,14,7,7,13,1,13,13,129,9.0,5.0,4.0,7.0,0.0,9.0,9.0,15,14,1,6.0,5.0,1.0
9504277,48,11,37,118,15,33,67,14,20.0,4.0,16.0,52.0,3.0,17.0,38.0,52,48,4,3.0,2.0,1.0
9802373,17,2,15,35,3,14,49,24,13.0,1.0,12.0,29.0,0.0,13.0,44.0,24,17,7,3.0,3.0,0.0
9801330,27,9,18,43,1,26,97,8,7.0,2.0,5.0,6.0,1.0,6.0,6.0,45,27,18,9.0,5.0,4.0
9310345,1,1,0,0,0,1,1,64,1.0,1.0,0.0,0.0,0.0,1.0,1.0,2,1,1,,,
9807303,6,3,3,4,4,2,2,224,2.0,1.0,1.0,1.0,2.0,0.0,0.0,8,6,2,3.0,2.0,1.0
9403319,5,5,0,0,1,4,4,155,3.0,3.0,0.0,0.0,0.0,3.0,3.0,7,5,2,3.0,3.0,0.0
3075,20,10,10,16,0,20,127,14,11.0,7.0,4.0,5.0,0.0,11.0,51.0,52,20,32,18.0,2.0,16.0
9707220,36,12,24,53,9,27,50,54,7.0,5.0,2.0,4.0,6.0,1.0,1.0,44,36,8,5.0,5.0,0.0
9611401,10,3,7,14,2,8,16,14,7.0,3.0,4.0,5.0,0.0,7.0,15.0,17,10,7,1.0,0.0,1.0
9801205,12,5,7,10,5,7,8,178,3.0,1.0,2.0,3.0,0.0,3.0,3.0,16,12,4,4.0,3.0,1.0
9610429,8,1,7,17,8,0,0,189,7.0,1.0,6.0,16.0,7.0,0.0,0.0,9,8,1,7.0,7.0,0.0
9909446,9,5,4,4,2,7,25,140,2.0,1.0,1.0,1.0,0.0,2.0,4.0,22,9,13,4.0,2.0,2.0
9209294,8,5,3,7,8,0,0,33,3.0,2.0,1.0,1.0,3.0,0.0,0.0,8,8,0,2.0,2.0,0.0
9706224,3,3,0,0,0,3,8,179,2.0,2.0,0.0,0.0,1.0,1.0,3.0,8,3,5,5.0,2.0,3.0
204221,12,5,7,13,0,12,74,45,8.0,5.0,3.0,6.0,0.0,8.0,61.0,30,12,18,20.0,7.0,13.0
9908339,17,9,8,9,8,9,25,118,7.0,4.0,3.0,3.0,0.0,7.0,17.0,21,17,4,7.0,4.0,3.0
9803256,41,8,33,117,0,41,375,17,35.0,7.0,28.0,102.0,0.0,35.0,339.0,82,41,41,35.0,12.0,23.0
9504242,16,6,10,23,4,12,62,17,11.0,4.0,7.0,17.0,0.0,11.0,59.0,36,16,20,5.0,4.0,1.0
9512410,15,2,13,64,2,13,25,16,12.0,1.0,11.0,54.0,6.0,6.0,6.0,21,15,6,6.0,4.0,2.0
9612300,39,6,33,117,1,38,266,8,19.0,2.0,17.0,61.0,0.0,19.0,178.0,66,39,27,14.0,7.0,7.0
9605276,3,2,1,1,1,2,7,16,2.0,1.0,1.0,1.0,0.0,2.0,5.0,9,3,6,2.0,2.0,0.0
9706436,8,1,7,8,0,8,9,36,5.0,4.0,1.0,1.0,0.0,5.0,5.0,11,8,3,,,
9710559,2,2,0,0,1,1,1,16,,,,,,,,4,2,2,1.0,0.0,1.0
9511401,17,9,8,10,7,10,18,14,2.0,1.0,1.0,1.0,1.0,1.0,1.0,24,17,7,3.0,3.0,0.0
9412384,21,6,15,33,3,18,21,97,9.0,7.0,2.0,3.0,0.0,9.0,9.0,23,21,2,7.0,6.0,1.0
9405336,18,9,9,11,18,0,0,416,8.0,3.0,5.0,6.0,8.0,0.0,0.0,18,18,0,4.0,4.0,0.0
9305201,7,5,2,4,3,4,6,15,4.0,2.0,2.0,3.0,4.0,0.0,0.0,10,7,3,1.0,0.0,1.0
9403388,13,7,6,14,3,10,20,15,3.0,3.0,0.0,0.0,2.0,1.0,1.0,16,13,3,2.0,2.0,0.0
9506475,37,8,29,109,5,32,102,15,21.0,3.0,18.0,73.0,1.0,20.0,58.0,48,37,11,13.0,11.0,2.0
9609511,46,7,39,197,9,37,140,32,25.0,2.0,23.0,125.0,8.0,17.0,29.0,88,46,42,13.0,9.0,4.0
9907255,20,5,15,50,0,20,145,10,15.0,3.0,12.0,44.0,0.0,15.0,65.0,41,20,21,18.0,13.0,5.0
101263,1,1,0,0,0,1,2,86,0.0,0.0,0.0,0.0,0.0,0.0,0.0,26,1,25,7.0,0.0,7.0
9809499,4,2,2,3,0,4,8,336,1.0,1.0,0.0,0.0,0.0,1.0,3.0,10,4,6,4.0,1.0,3.0
9907408,24,2,22,57,1,23,42,122,16.0,1.0,15.0,39.0,0.0,16.0,29.0,26,24,2,18.0,16.0,2.0
105204,14,4,10,29,0,14,55,0,9.0,2.0,7.0,24.0,1.0,8.0,35.0,23,14,9,12.0,8.0,4.0
203014,1,1,0,0,1,0,0,10,0.0,0.0,0.0,0.0,0.0,0.0,0.0,10,1,9,1.0,1.0,0.0
9609277,12,5,7,9,10,2,4,356,5.0,2.0,3.0,3.0,5.0,0.0,0.0,16,12,4,3.0,3.0,0.0
9912452,9,4,5,12,0,9,44,52,8.0,4.0,4.0,8.0,0.0,8.0,38.0,20,9,11,13.0,4.0,9.0
9608350,39,6,33,161,0,39,186,15,22.0,2.0,20.0,102.0,2.0,20.0,35.0,64,39,25,6.0,6.0,0.0
9809304,13,8,5,8,4,9,82,46,7.0,4.0,3.0,6.0,0.0,7.0,65.0,28,13,15,14.0,4.0,10.0
9801386,21,3,18,41,0,21,59,1,13.0,2.0,11.0,31.0,0.0,13.0,39.0,29,21,8,4.0,4.0,0.0
9610301,14,4,10,37,14,0,0,120,11.0,2.0,9.0,31.0,11.0,0.0,0.0,15,14,1,10.0,10.0,0.0
6040,15,4,11,27,0,15,232,3,8.0,2.0,6.0,9.0,0.0,8.0,107.0,58,15,43,17.0,8.0,9.0
9407368,5,4,1,2,0,5,24,40,4.0,3.0,1.0,2.0,0.0,4.0,20.0,12,5,7,2.0,2.0,0.0
9605229,36,8,28,117,0,36,228,8,24.0,2.0,22.0,101.0,0.0,24.0,143.0,56,36,20,17.0,12.0,5.0
207126,6,4,2,5,0,6,55,10,0.0,0.0,0.0,0.0,0.0,0.0,0.0,55,6,49,9.0,2.0,7.0
11382,3,2,1,1,2,1,3,10,0.0,0.0,0.0,0.0,0.0,0.0,0.0,23,3,20,6.0,0.0,6.0
7281,10,4,6,12,1,9,37,0,5.0,1.0,4.0,6.0,5.0,0.0,0.0,18,10,8,8.0,7.0,1.0
9803367,7,5,2,3,2,5,10,123,4.0,2.0,2.0,3.0,1.0,3.0,5.0,13,7,6,3.0,2.0,1.0
9710543,15,6,9,13,0,15,115,22,13.0,6.0,7.0,11.0,0.0,13.0,83.0,36,15,21,17.0,4.0,13.0
9705354,12,5,7,30,1,11,18,21,11.0,4.0,7.0,30.0,2.0,9.0,9.0,15,12,3,9.0,9.0,0.0
9212220,4,4,0,0,4,0,0,183,2.0,2.0,0.0,0.0,2.0,0.0,0.0,5,4,1,2.0,2.0,0.0
9604434,8,5,3,5,8,0,0,114,5.0,2.0,3.0,5.0,5.0,0.0,0.0,13,8,5,1.0,1.0,0.0
9602377,10,3,7,15,3,7,7,105,7.0,2.0,5.0,11.0,3.0,4.0,4.0,18,10,8,4.0,3.0,1.0
9803306,31,2,29,105,0,31,132,30,28.0,2.0,26.0,97.0,0.0,28.0,119.0,41,31,10,25.0,19.0,6.0
9705430,10,6,4,5,6,4,5,30,6.0,3.0,3.0,4.0,4.0,2.0,2.0,12,10,2,2.0,2.0,0.0
12364,7,5,2,2,1,6,30,4,2.0,2.0,0.0,0.0,2.0,0.0,0.0,20,7,13,2.0,1.0,1.0
9510402,20,10,10,20,12,8,51,14,2.0,1.0,1.0,1.0,1.0,1.0,2.0,55,20,35,8.0,1.0,7.0
9907360,27,6,21,54,1,26,173,32,10.0,2.0,8.0,19.0,0.0,10.0,79.0,53,27,26,14.0,9.0,5.0
9810419,8,3,5,5,7,1,2,263,3.0,1.0,2.0,2.0,2.0,1.0,2.0,10,8,2,3.0,2.0,1.0
102308,13,3,10,25,0,13,71,18,11.0,3.0,8.0,19.0,0.0,11.0,55.0,29,13,16,15.0,8.0,7.0
9805389,59,15,44,192,4,55,280,13,31.0,3.0,28.0,125.0,0.0,31.0,183.0,82,59,23,29.0,18.0,11.0
8288,3,2,1,1,1,2,10,21,1.0,1.0,0.0,0.0,0.0,1.0,4.0,15,3,12,3.0,1.0,2.0
9410222,6,4,2,3,4,2,11,14,0.0,0.0,0.0,0.0,0.0,0.0,0.0,15,6,9,3.0,0.0,3.0
9502384,7,2,5,9,0,7,7,8,3.0,1.0,2.0,3.0,0.0,3.0,3.0,8,7,1,3.0,3.0,0.0
207136,4,3,1,2,0,4,12,55,0.0,0.0,0.0,0.0,0.0,0.0,0.0,25,4,21,5.0,3.0,2.0
9206208,1,1,0,0,1,0,0,1748,,,,,,,,1,1,0,,,
9805388,2,1,1,1,0,2,4,632,0.0,0.0,0.0,0.0,0.0,0.0,0.0,6,2,4,1.0,0.0,1.0
9810536,39,7,32,152,4,35,301,12,28.0,4.0,24.0,110.0,1.0,27.0,218.0,72,39,33,15.0,13.0,2.0
8155,12,7,5,7,3,9,32,0,4.0,2.0,2.0,2.0,4.0,0.0,0.0,20,12,8,5.0,5.0,0.0
9401291,30,11,19,30,7,23,45,62,18.0,7.0,11.0,22.0,2.0,16.0,35.0,36,30,6,9.0,8.0,1.0
101037,4,2,2,3,1,3,3,89,1.0,1.0,0.0,0.0,1.0,0.0,0.0,5,4,1,,,
9403348,4,2,2,2,4,0,0,89,1.0,1.0,0.0,0.0,1.0,0.0,0.0,4,4,0,1.0,1.0,0.0
9608406,15,8,7,9,1,14,128,6,11.0,7.0,4.0,6.0,0.0,11.0,109.0,36,15,21,20.0,6.0,14.0
9812276,14,4,10,28,0,14,76,46,11.0,3.0,8.0,22.0,0.0,11.0,67.0,34,14,20,13.0,2.0,11.0
109230,19,6,13,26,2,17,80,21,6.0,3.0,3.0,4.0,0.0,6.0,47.0,36,19,17,9.0,5.0,4.0
9612493,7,1,6,11,1,6,29,10,1.0,1.0,0.0,0.0,0.0,1.0,6.0,42,7,35,5.0,4.0,1.0
9605238,16,7,9,26,2,14,45,256,9.0,3.0,6.0,21.0,0.0,9.0,22.0,48,16,32,12.0,8.0,4.0
9206235,6,6,0,0,6,0,0,275,2.0,2.0,0.0,0.0,2.0,0.0,0.0,6,6,0,1.0,1.0,0.0
9806209,6,2,4,8,0,6,20,74,1.0,1.0,0.0,0.0,0.0,1.0,2.0,21,6,15,2.0,1.0,1.0
9806224,5,1,4,8,0,5,29,34,5.0,1.0,4.0,8.0,0.0,5.0,28.0,16,5,11,2.0,0.0,2.0
9611331,17,10,7,8,3,14,36,13,3.0,1.0,2.0,2.0,0.0,3.0,7.0,25,17,8,4.0,4.0,0.0
9704328,1,1,0,0,1,0,0,249,0.0,0.0,0.0,0.0,0.0,0.0,0.0,6,1,5,1.0,0.0,1.0
9910216,1,1,0,0,0,1,3,154,0.0,0.0,0.0,0.0,0.0,0.0,0.0,5,1,4,,,
9703210,31,4,27,91,11,20,20,143,22.0,2.0,20.0,73.0,6.0,16.0,16.0,32,31,1,13.0,12.0,1.0
112235,12,7,5,9,1,11,105,7,6.0,2.0,4.0,6.0,0.0,6.0,39.0,74,12,62,14.0,5.0,9.0
106356,23,3,20,59,0,23,73,165,14.0,2.0,12.0,35.0,0.0,14.0,34.0,30,23,7,14.0,11.0,3.0
108063,3,3,0,0,1,2,2,4,0.0,0.0,0.0,0.0,0.0,0.0,0.0,51,3,48,23.0,0.0,23.0
9609411,5,3,2,2,1,4,14,25,3.0,1.0,2.0,2.0,0.0,3.0,9.0,10,5,5,2.0,1.0,1.0
9410318,16,8,8,21,12,4,4,77,8.0,4.0,4.0,10.0,8.0,0.0,0.0,18,16,2,5.0,5.0,0.0
9302312,24,4,20,51,1,23,23,26,18.0,2.0,16.0,37.0,0.0,18.0,18.0,25,24,1,14.0,13.0,1.0
9801324,32,3,29,143,9,23,37,8,28.0,2.0,26.0,137.0,9.0,19.0,23.0,35,32,3,21.0,19.0,2.0
9403409,2,1,1,1,1,1,2,98,1.0,1.0,0.0,0.0,1.0,0.0,0.0,4,2,2,1.0,1.0,0.0
9607333,1,1,0,0,0,1,10,43,0.0,0.0,0.0,0.0,0.0,0.0,0.0,12,1,11,1.0,0.0,1.0
9331,6,3,3,8,0,6,27,22,5.0,2.0,3.0,8.0,0.0,5.0,18.0,21,6,15,8.0,5.0,3.0
9903542,19,8,11,29,1,18,97,21,2.0,2.0,0.0,0.0,0.0,2.0,6.0,67,19,48,16.0,2.0,14.0
105087,24,8,16,66,1,23,260,0,21.0,7.0,14.0,61.0,0.0,21.0,237.0,61,24,37,40.0,13.0,27.0
11259,0,0,0,0,0,0,0,200,0.0,0.0,0.0,0.0,0.0,0.0,0.0,11,0,11,1.0,0.0,1.0
9705462,7,2,5,7,3,4,4,152,5.0,1.0,4.0,6.0,1.0,4.0,4.0,8,7,1,5.0,4.0,1.0
9412305,14,3,11,20,11,3,3,8,7.0,2.0,5.0,7.0,6.0,1.0,1.0,21,14,7,3.0,0.0,3.0
9808331,6,3,3,6,1,5,6,3,0.0,0.0,0.0,0.0,0.0,0.0,0.0,20,6,14,2.0,0.0,2.0
9401346,3,3,0,0,2,1,4,69,1.0,1.0,0.0,0.0,1.0,0.0,0.0,9,3,6,2.0,1.0,1.0
9605280,3,2,1,1,3,0,0,350,2.0,1.0,1.0,1.0,2.0,0.0,0.0,3,3,0,2.0,2.0,0.0
112329,8,2,6,11,0,8,51,0,1.0,1.0,0.0,0.0,0.0,1.0,4.0,74,8,66,42.0,0.0,42.0
108100,23,11,12,31,2,21,94,0,10.0,4.0,6.0,14.0,0.0,10.0,32.0,39,23,16,13.0,9.0,4.0
102236,16,8,8,23,2,14,85,3,4.0,4.0,0.0,0.0,1.0,3.0,5.0,33,16,17,11.0,2.0,9.0
207135,5,1,4,8,0,5,19,393,5.0,1.0,4.0,8.0,5.0,0.0,0.0,10,5,5,5.0,5.0,0.0
9701371,8,5,3,4,2,6,16,27,3.0,3.0,0.0,0.0,2.0,1.0,3.0,21,8,13,5.0,1.0,4.0
12352,61,6,55,399,0,61,156,37,47.0,3.0,44.0,364.0,0.0,47.0,91.0,71,61,10,38.0,36.0,2.0
9410356,15,4,11,41,1,14,45,94,10.0,2.0,8.0,30.0,0.0,10.0,24.0,26,15,11,6.0,5.0,1.0
9909275,2,2,0,0,1,1,2,184,0.0,0.0,0.0,0.0,0.0,0.0,0.0,6,2,4,1.0,0.0,1.0
104141,10,5,5,7,0,10,179,23,7.0,3.0,4.0,6.0,0.0,7.0,160.0,47,10,37,21.0,4.0,17.0
9506391,15,5,10,18,4,11,21,30,14.0,5.0,9.0,17.0,3.0,11.0,21.0,19,15,4,4.0,4.0,0.0
9401299,18,10,8,15,8,10,14,133,6.0,2.0,4.0,8.0,6.0,0.0,0.0,20,18,2,5.0,5.0,0.0
9412304,10,4,6,11,0,10,61,56,10.0,4.0,6.0,11.0,0.0,10.0,59.0,23,10,13,14.0,8.0,6.0
9510399,15,9,6,10,13,2,2,141,3.0,3.0,0.0,0.0,3.0,0.0,0.0,16,15,1,2.0,2.0,0.0
9407235,4,3,1,1,1,3,3,25,3.0,2.0,1.0,1.0,0.0,3.0,3.0,7,4,3,,,
9902391,8,6,2,2,2,6,15,92,2.0,2.0,0.0,0.0,1.0,1.0,1.0,16,8,8,4.0,2.0,2.0
9905500,13,4,9,29,1,12,333,2,12.0,3.0,9.0,29.0,0.0,12.0,325.0,66,13,53,43.0,10.0,33.0
9507230,34,5,29,127,17,17,17,137,23.0,1.0,22.0,114.0,6.0,17.0,17.0,35,34,1,21.0,20.0,1.0
211462,6,5,1,1,0,6,32,0,2.0,2.0,0.0,0.0,0.0,2.0,12.0,74,6,68,11.0,1.0,10.0
9604258,2,2,0,0,0,2,4,29,0.0,0.0,0.0,0.0,0.0,0.0,0.0,8,2,6,,,
9608358,19,8,11,30,0,19,109,15,11.0,2.0,9.0,24.0,0.0,11.0,62.0,58,19,39,12.0,6.0,6.0
9303322,7,4,3,8,2,5,5,176,7.0,4.0,3.0,8.0,2.0,5.0,5.0,8,7,1,8.0,7.0,1.0
9160,5,2,3,5,0,5,31,74,4.0,1.0,3.0,5.0,0.0,4.0,25.0,18,5,13,14.0,3.0,11.0
1096,2,2,0,0,0,2,4,66,0.0,0.0,0.0,0.0,0.0,0.0,0.0,23,2,21,2.0,1.0,1.0
9908490,7,5,2,3,0,7,19,27,3.0,2.0,1.0,1.0,0.0,3.0,8.0,36,7,29,3.0,0.0,3.0
9902258,15,8,7,10,1,14,29,54,7.0,7.0,0.0,0.0,0.0,7.0,8.0,23,15,8,9.0,7.0,2.0
204291,9,2,7,14,0,9,50,3,0.0,0.0,0.0,0.0,0.0,0.0,0.0,44,9,35,16.0,0.0,16.0
101318,14,3,11,27,3,11,23,72,3.0,1.0,2.0,3.0,0.0,3.0,4.0,23,14,9,6.0,4.0,2.0
108020,4,3,1,1,1,3,5,3,0.0,0.0,0.0,0.0,0.0,0.0,0.0,25,4,21,5.0,0.0,5.0
9806518,18,4,14,30,3,15,28,3,9.0,4.0,5.0,8.0,0.0,9.0,21.0,25,18,7,8.0,4.0,4.0
206162,45,8,37,104,1,44,258,0,25.0,3.0,22.0,71.0,0.0,25.0,170.0,77,45,32,29.0,18.0,11.0
9812216,4,3,1,1,1,3,4,170,1.0,1.0,0.0,0.0,1.0,0.0,0.0,9,4,5,2.0,0.0,2.0
109126,3,2,1,1,0,3,16,4,2.0,1.0,1.0,1.0,0.0,2.0,11.0,22,3,19,1.0,0.0,1.0
104109,21,6,15,28,3,18,100,95,7.0,2.0,5.0,7.0,0.0,7.0,25.0,48,21,27,6.0,5.0,1.0
9707384,11,4,7,16,7,4,5,9,8.0,2.0,6.0,13.0,8.0,0.0,0.0,14,11,3,7.0,7.0,0.0
105140,1,1,0,0,0,1,9,10,0.0,0.0,0.0,0.0,0.0,0.0,0.0,28,1,27,8.0,1.0,7.0
9905252,17,4,13,24,1,16,96,5,6.0,3.0,3.0,6.0,0.0,6.0,39.0,43,17,26,10.0,3.0,7.0
112074,11,5,6,19,0,11,62,0,5.0,3.0,2.0,4.0,0.0,5.0,28.0,33,11,22,12.0,4.0,8.0
9709366,12,7,5,8,1,11,37,5,1.0,1.0,0.0,0.0,0.0,1.0,8.0,41,12,29,6.0,2.0,4.0
9912428,5,3,2,3,5,0,0,65,1.0,1.0,0.0,0.0,1.0,0.0,0.0,5,5,0,1.0,1.0,0.0
206060,9,2,7,23,0,9,128,28,9.0,2.0,7.0,23.0,0.0,9.0,88.0,40,9,31,23.0,8.0,15.0
9701218,13,6,7,20,2,11,29,85,8.0,3.0,5.0,16.0,1.0,7.0,7.0,22,13,9,11.0,9.0,2.0
9411269,6,4,2,2,6,0,0,480,2.0,1.0,1.0,1.0,2.0,0.0,0.0,6,6,0,2.0,2.0,0.0
9808219,4,4,0,0,2,2,12,23,0.0,0.0,0.0,0.0,0.0,0.0,0.0,16,4,12,1.0,0.0,1.0
9610331,28,7,21,55,2,26,64,101,22.0,4.0,18.0,49.0,4.0,18.0,31.0,40,28,12,13.0,12.0,1.0
110169,11,4,7,17,0,11,137,11,11.0,4.0,7.0,17.0,0.0,11.0,137.0,28,11,17,27.0,11.0,16.0
9704377,37,3,34,114,6,31,82,13,16.0,2.0,14.0,45.0,1.0,15.0,25.0,48,37,11,9.0,7.0,2.0
9908493,8,2,6,10,0,8,30,89,1.0,1.0,0.0,0.0,0.0,1.0,6.0,18,8,10,5.0,1.0,4.0
9208256,10,6,4,7,10,0,0,291,4.0,2.0,2.0,2.0,4.0,0.0,0.0,10,10,0,3.0,3.0,0.0
3113,15,6,9,25,7,8,22,59,11.0,5.0,6.0,19.0,3.0,8.0,22.0,22,15,7,13.0,8.0,5.0
9409206,1,1,0,0,0,1,3,93,0.0,0.0,0.0,0.0,0.0,0.0,0.0,7,1,6,2.0,0.0,2.0
9609379,14,6,8,15,2,12,25,135,3.0,3.0,0.0,0.0,0.0,3.0,8.0,21,14,7,8.0,6.0,2.0
9901286,1,1,0,0,0,1,9,17,1.0,1.0,0.0,0.0,0.0,1.0,8.0,15,1,14,1.0,0.0,1.0
9702390,6,3,3,3,1,5,54,61,4.0,1.0,3.0,3.0,0.0,4.0,20.0,46,6,40,15.0,3.0,12.0
9801355,9,3,6,8,9,0,0,168,6.0,3.0,3.0,4.0,6.0,0.0,0.0,9,9,0,3.0,3.0,0.0
106094,3,1,2,3,0,3,18,25,3.0,1.0,2.0,3.0,0.0,3.0,18.0,12,3,9,8.0,3.0,5.0
9401244,3,3,0,0,2,1,2,236,1.0,1.0,0.0,0.0,0.0,1.0,1.0,5,3,2,1.0,1.0,0.0
9203,3,2,1,1,0,3,14,6,1.0,1.0,0.0,0.0,0.0,1.0,3.0,15,3,12,5.0,1.0,4.0
9505247,2,1,1,1,0,2,2,75,0.0,0.0,0.0,0.0,0.0,0.0,0.0,7,2,5,1.0,1.0,0.0
9701368,3,3,0,0,1,2,6,30,1.0,1.0,0.0,0.0,0.0,1.0,2.0,14,3,11,2.0,0.0,2.0
210402,2,1,1,1,0,2,5,128,2.0,1.0,1.0,1.0,0.0,2.0,4.0,10,2,8,7.0,2.0,5.0
9807334,23,2,21,78,1,22,243,53,20.0,1.0,19.0,73.0,0.0,20.0,225.0,41,23,18,35.0,18.0,17.0
7096,12,2,10,36,0,12,45,109,12.0,2.0,10.0,36.0,0.0,12.0,45.0,18,12,6,17.0,11.0,6.0
9906215,10,6,4,5,1,9,36,26,2.0,2.0,0.0,0.0,0.0,2.0,5.0,34,10,24,8.0,3.0,5.0
9301219,7,4,3,4,7,0,0,196,1.0,1.0,0.0,0.0,1.0,0.0,0.0,7,7,0,2.0,2.0,0.0
9703268,22,4,18,89,2,20,76,8,13.0,1.0,12.0,51.0,0.0,13.0,31.0,35,22,13,16.0,13.0,3.0
9808446,5,3,2,4,3,2,2,70,,,,,,,,7,5,2,,,
9711210,8,4,4,4,1,7,22,58,6.0,2.0,4.0,4.0,0.0,6.0,16.0,22,8,14,8.0,4.0,4.0
9704353,14,5,9,19,2,12,46,25,12.0,3.0,9.0,19.0,0.0,12.0,43.0,24,14,10,16.0,9.0,7.0
8171,8,5,3,5,0,8,28,201,3.0,3.0,0.0,0.0,0.0,3.0,11.0,24,8,16,7.0,2.0,5.0
201300,12,3,9,25,0,12,103,2,3.0,3.0,0.0,0.0,0.0,3.0,46.0,68,12,56,23.0,0.0,23.0
105335,9,6,3,4,2,7,43,116,6.0,3.0,3.0,4.0,0.0,6.0,35.0,25,9,16,14.0,5.0,9.0
9303307,12,6,6,14,1,11,18,75,5.0,4.0,1.0,1.0,1.0,4.0,6.0,14,12,2,5.0,3.0,2.0
9704345,10,2,8,15,1,9,42,90,8.0,1.0,7.0,12.0,0.0,8.0,32.0,19,10,9,13.0,8.0,5.0
9702297,9,4,5,11,4,5,9,303,6.0,1.0,5.0,11.0,6.0,0.0,0.0,13,9,4,6.0,6.0,0.0
9908230,26,12,14,18,7,19,75,77,4.0,4.0,0.0,0.0,0.0,4.0,13.0,79,26,53,6.0,2.0,4.0
9601375,17,6,11,21,8,9,14,90,5.0,2.0,3.0,4.0,5.0,0.0,0.0,28,17,11,8.0,7.0,1.0
9510450,2,2,0,0,1,1,1,17,0.0,0.0,0.0,0.0,0.0,0.0,0.0,23,2,21,6.0,0.0,6.0
9602382,1,1,0,0,1,0,0,218,0.0,0.0,0.0,0.0,0.0,0.0,0.0,9,1,8,2.0,0.0,2.0
9901420,21,10,11,15,0,21,56,9,11.0,7.0,4.0,5.0,0.0,11.0,36.0,29,21,8,3.0,3.0,0.0
102254,9,4,5,9,0,9,53,8,7.0,3.0,4.0,7.0,0.0,7.0,44.0,31,9,22,21.0,5.0,16.0
9601256,2,1,1,1,0,2,2,27,,,,,,,,7,2,5,1.0,0.0,1.0
9906399,0,0,0,0,0,0,0,1085,,,,,,,,1,0,1,,,
9610371,5,3,2,3,1,4,6,57,3.0,1.0,2.0,3.0,3.0,0.0,0.0,10,5,5,3.0,2.0,1.0
105277,12,2,10,22,2,10,38,106,10.0,2.0,8.0,19.0,2.0,8.0,24.0,34,12,22,9.0,7.0,2.0
104170,0,0,0,0,0,0,0,3,0.0,0.0,0.0,0.0,0.0,0.0,0.0,12,0,12,6.0,0.0,6.0
9710484,9,6,3,3,7,2,2,210,2.0,2.0,0.0,0.0,1.0,1.0,1.0,10,9,1,3.0,3.0,0.0
209109,4,2,2,3,0,4,4,121,4.0,2.0,2.0,3.0,0.0,4.0,4.0,5,4,1,5.0,4.0,1.0
9303239,9,6,3,9,9,0,0,162,5.0,3.0,2.0,4.0,5.0,0.0,0.0,9,9,0,3.0,3.0,0.0
9303257,18,6,12,33,2,16,16,116,14.0,3.0,11.0,30.0,1.0,13.0,13.0,19,18,1,10.0,9.0,1.0
9412222,6,2,4,7,6,0,0,2118,1.0,1.0,0.0,0.0,1.0,0.0,0.0,6,6,0,1.0,1.0,0.0
9507226,0,0,0,0,0,0,0,1106,,,,,,,,2,0,2,,,
9702252,6,4,2,3,2,4,7,140,3.0,2.0,1.0,2.0,1.0,2.0,3.0,10,6,4,6.0,3.0,3.0
9805207,9,3,6,7,0,9,28,321,6.0,3.0,3.0,3.0,0.0,6.0,14.0,18,9,9,7.0,4.0,3.0
9506275,2,2,0,0,0,2,11,53,2.0,2.0,0.0,0.0,0.0,2.0,11.0,8,2,6,2.0,1.0,1.0
9702368,7,2,5,7,0,7,19,96,3.0,1.0,2.0,2.0,0.0,3.0,4.0,13,7,6,5.0,3.0,2.0
1090,6,3,3,8,0,6,20,294,5.0,2.0,3.0,8.0,0.0,5.0,19.0,10,6,4,9.0,5.0,4.0
9601291,11,6,5,8,11,0,0,101,5.0,1.0,4.0,5.0,5.0,0.0,0.0,13,11,2,4.0,4.0,0.0
9504293,10,2,8,13,1,9,16,115,7.0,1.0,6.0,9.0,1.0,6.0,10.0,12,10,2,1.0,1.0,0.0
7275,1,1,0,0,0,1,2,31,,,,,,,,5,1,4,,,
9803288,7,6,1,1,2,5,21,14,3.0,3.0,0.0,0.0,0.0,3.0,10.0,27,7,20,12.0,3.0,9.0
9712507,9,4,5,10,3,6,13,14,3.0,2.0,1.0,1.0,2.0,1.0,1.0,18,9,9,3.0,1.0,2.0
9701213,8,5,3,3,2,6,14,14,3.0,2.0,1.0,1.0,2.0,1.0,1.0,15,8,7,4.0,2.0,2.0
9804375,10,5,5,11,8,2,2,198,8.0,4.0,4.0,9.0,6.0,2.0,2.0,12,10,2,5.0,4.0,1.0
9604277,6,1,5,13,0,6,19,51,6.0,1.0,5.0,13.0,0.0,6.0,16.0,12,6,6,7.0,6.0,1.0
9612461,16,6,10,21,16,0,0,56,16.0,6.0,10.0,21.0,16.0,0.0,0.0,20,16,4,4.0,4.0,0.0
9609358,10,5,5,12,0,10,57,56,9.0,5.0,4.0,11.0,0.0,9.0,55.0,19,10,9,15.0,6.0,9.0
9803365,11,6,5,20,0,11,77,82,10.0,5.0,5.0,20.0,0.0,10.0,74.0,25,11,14,18.0,8.0,10.0
9608490,5,3,2,4,5,0,0,125,5.0,3.0,2.0,4.0,5.0,0.0,0.0,7,5,2,1.0,0.0,1.0
9901283,6,3,3,4,0,6,30,9,2.0,2.0,0.0,0.0,0.0,2.0,15.0,29,6,23,5.0,3.0,2.0
108026,7,1,6,11,0,7,13,38,5.0,2.0,3.0,5.0,0.0,5.0,5.0,9,7,2,8.0,6.0,2.0
12137,27,5,22,50,11,16,36,172,10.0,1.0,9.0,22.0,1.0,9.0,19.0,33,27,6,12.0,9.0,3.0
9905576,5,4,1,1,0,5,32,12,2.0,1.0,1.0,1.0,0.0,2.0,12.0,63,5,58,17.0,2.0,15.0
9901312,7,5,2,3,2,5,50,15,4.0,2.0,2.0,3.0,0.0,4.0,45.0,38,7,31,20.0,3.0,17.0
9507285,1,1,0,0,1,0,0,232,1.0,1.0,0.0,0.0,1.0,0.0,0.0,2,1,1,1.0,1.0,0.0
9504421,2,2,0,0,1,1,1,53,0.0,0.0,0.0,0.0,0.0,0.0,0.0,9,2,7,1.0,0.0,1.0
9505274,2,2,0,0,0,2,2,87,,,,,,,,3,2,1,,,
105292,33,8,25,49,1,32,182,7,16.0,5.0,11.0,26.0,1.0,15.0,95.0,74,33,41,23.0,13.0,10.0
9801339,2,2,0,0,0,2,2,431,1.0,1.0,0.0,0.0,1.0,0.0,0.0,3,2,1,1.0,1.0,0.0
9804392,1,1,0,0,0,1,1,94,1.0,1.0,0.0,0.0,0.0,1.0,1.0,7,1,6,2.0,1.0,1.0
9706399,10,9,1,1,0,10,38,108,7.0,6.0,1.0,1.0,0.0,7.0,29.0,15,10,5,10.0,5.0,5.0
9610427,5,1,4,6,0,5,22,14,3.0,1.0,2.0,2.0,0.0,3.0,13.0,15,5,10,8.0,3.0,5.0
9802221,4,4,0,0,1,3,16,5,1.0,1.0,0.0,0.0,0.0,1.0,11.0,31,4,27,1.0,1.0,0.0
9511285,2,2,0,0,1,1,2,297,1.0,1.0,0.0,0.0,0.0,1.0,1.0,4,2,2,1.0,1.0,0.0
9197,5,5,0,0,2,3,8,1,1.0,1.0,0.0,0.0,1.0,0.0,0.0,13,5,8,5.0,1.0,4.0
107189,5,3,2,4,0,5,38,1,4.0,2.0,2.0,4.0,0.0,4.0,35.0,23,5,18,14.0,3.0,11.0
111299,10,2,8,15,0,10,58,21,5.0,2.0,3.0,4.0,0.0,5.0,15.0,26,10,16,8.0,4.0,4.0
9912212,9,4,5,7,0,9,67,21,7.0,4.0,3.0,3.0,0.0,7.0,33.0,23,9,14,15.0,6.0,9.0
205302,1,1,0,0,0,1,14,73,1.0,1.0,0.0,0.0,0.0,1.0,14.0,15,1,14,15.0,1.0,14.0
9809442,9,6,3,5,3,6,9,51,4.0,1.0,3.0,4.0,2.0,2.0,2.0,14,9,5,5.0,4.0,1.0
8181,4,1,3,4,0,4,22,13,3.0,1.0,2.0,2.0,0.0,3.0,12.0,20,4,16,12.0,1.0,11.0
9904255,2,2,0,0,0,2,8,57,0.0,0.0,0.0,0.0,0.0,0.0,0.0,14,2,12,1.0,1.0,0.0
9703230,1,1,0,0,1,0,0,92,,,,,,,,7,1,6,3.0,0.0,3.0
2002,1,1,0,0,0,1,6,50,1.0,1.0,0.0,0.0,0.0,1.0,5.0,7,1,6,,,
111326,4,2,2,2,2,2,24,50,2.0,1.0,1.0,1.0,0.0,2.0,19.0,25,4,21,4.0,0.0,4.0
9910383,2,2,0,0,1,1,5,28,0.0,0.0,0.0,0.0,0.0,0.0,0.0,15,2,13,1.0,0.0,1.0
9706488,2,2,0,0,1,1,1,195,1.0,1.0,0.0,0.0,0.0,1.0,1.0,5,2,3,2.0,0.0,2.0
9906205,11,5,6,16,1,10,30,9,9.0,3.0,6.0,16.0,0.0,9.0,26.0,17,11,6,2.0,2.0,0.0
9810452,9,8,1,1,0,9,15,187,7.0,6.0,1.0,1.0,0.0,7.0,10.0,17,9,8,7.0,4.0,3.0
9707341,10,3,7,21,0,10,29,13,10.0,3.0,7.0,21.0,0.0,10.0,25.0,17,10,7,10.0,8.0,2.0
9706203,8,5,3,3,0,8,50,36,6.0,4.0,2.0,2.0,0.0,6.0,44.0,20,8,12,1.0,0.0,1.0
9808475,1,1,0,0,0,1,7,11,0.0,0.0,0.0,0.0,0.0,0.0,0.0,14,1,13,10.0,0.0,10.0
9209282,1,1,0,0,1,0,0,2131,1.0,1.0,0.0,0.0,1.0,0.0,0.0,1,1,0,,,
9608223,21,7,14,46,7,14,33,29,11.0,1.0,10.0,35.0,0.0,11.0,27.0,28,21,7,13.0,11.0,2.0
9801244,9,5,4,5,1,8,51,137,5.0,3.0,2.0,3.0,0.0,5.0,39.0,27,9,18,14.0,5.0,9.0
9909267,13,5,8,9,1,12,32,22,4.0,1.0,3.0,3.0,0.0,4.0,11.0,47,13,34,3.0,3.0,0.0
9511387,13,8,5,7,0,13,44,40,9.0,4.0,5.0,7.0,0.0,9.0,39.0,20,13,7,13.0,7.0,6.0
207140,0,0,0,0,0,0,0,39,0.0,0.0,0.0,0.0,0.0,0.0,0.0,10,0,10,,,
9403271,4,3,1,2,0,4,4,90,4.0,3.0,1.0,2.0,0.0,4.0,4.0,5,4,1,4.0,3.0,1.0
9803403,11,3,8,16,0,11,53,9,8.0,1.0,7.0,13.0,1.0,7.0,19.0,28,11,17,10.0,7.0,3.0
9705224,7,3,4,4,2,5,12,72,2.0,1.0,1.0,1.0,0.0,2.0,4.0,14,7,7,4.0,1.0,3.0
9812228,3,2,1,1,1,2,2,119,0.0,0.0,0.0,0.0,0.0,0.0,0.0,12,3,9,2.0,0.0,2.0
9501315,9,5,4,5,8,1,1,4,6.0,2.0,4.0,5.0,6.0,0.0,0.0,10,9,1,2.0,1.0,1.0
104120,17,3,14,50,0,17,291,70,16.0,3.0,13.0,49.0,0.0,16.0,288.0,41,17,24,35.0,16.0,19.0
203021,4,2,2,2,0,4,19,0,2.0,1.0,1.0,1.0,0.0,2.0,4.0,17,4,13,3.0,2.0,1.0
9808330,5,4,1,1,0,5,16,77,1.0,1.0,0.0,0.0,0.0,1.0,1.0,14,5,9,4.0,1.0,3.0
8043,16,2,14,40,0,16,61,201,14.0,1.0,13.0,33.0,0.0,14.0,52.0,27,16,11,20.0,14.0,6.0
9607222,11,2,9,29,0,11,104,43,10.0,1.0,9.0,29.0,0.0,10.0,84.0,38,11,27,22.0,9.0,13.0
110269,8,6,2,2,0,8,41,51,7.0,5.0,2.0,2.0,0.0,7.0,27.0,24,8,16,14.0,6.0,8.0
207352,6,5,1,1,0,6,39,107,2.0,2.0,0.0,0.0,0.0,2.0,13.0,24,6,18,5.0,2.0,3.0
205293,11,6,5,7,0,11,16,107,2.0,2.0,0.0,0.0,0.0,2.0,3.0,13,11,2,1.0,1.0,0.0
209148,1,1,0,0,1,0,0,182,0.0,0.0,0.0,0.0,0.0,0.0,0.0,15,1,14,12.0,0.0,12.0
9310375,1,1,0,0,0,1,1,217,0.0,0.0,0.0,0.0,0.0,0.0,0.0,2,1,1,1.0,0.0,1.0
208120,1,1,0,0,0,1,1,59,0.0,0.0,0.0,0.0,0.0,0.0,0.0,12,1,11,6.0,1.0,5.0
8157,6,6,0,0,1,5,13,41,3.0,3.0,0.0,0.0,0.0,3.0,8.0,16,6,10,3.0,2.0,1.0
9606406,9,6,3,4,1,8,19,16,3.0,3.0,0.0,0.0,0.0,3.0,8.0,24,9,15,3.0,2.0,1.0
6216,1,1,0,0,0,1,6,129,0.0,0.0,0.0,0.0,0.0,0.0,0.0,12,1,11,3.0,1.0,2.0
208243,3,2,1,1,1,2,4,424,0.0,0.0,0.0,0.0,0.0,0.0,0.0,31,3,28,4.0,0.0,4.0
205323,15,5,10,19,1,14,93,1,6.0,3.0,3.0,4.0,0.0,6.0,39.0,44,15,29,18.0,5.0,13.0
106083,2,1,1,1,0,2,23,1,2.0,1.0,1.0,1.0,0.0,2.0,7.0,20,2,18,4.0,2.0,2.0
9508306,2,1,1,1,2,0,0,315,2.0,1.0,1.0,1.0,2.0,0.0,0.0,2,2,0,2.0,2.0,0.0
9805344,18,2,16,29,5,13,59,24,6.0,1.0,5.0,7.0,0.0,6.0,27.0,36,18,18,3.0,3.0,0.0
9711509,7,2,5,7,0,7,17,26,4.0,2.0,2.0,3.0,0.0,4.0,11.0,13,7,6,6.0,4.0,2.0
9803410,5,5,0,0,1,4,7,33,1.0,1.0,0.0,0.0,1.0,0.0,0.0,11,5,6,1.0,1.0,0.0
6338,9,1,8,13,0,9,17,191,8.0,1.0,7.0,10.0,0.0,8.0,15.0,23,9,14,8.0,4.0,4.0
9411352,0,0,0,0,0,0,0,40,,,,,,,,3,0,3,,,
10030,14,3,11,32,0,14,58,209,11.0,1.0,10.0,31.0,3.0,8.0,24.0,27,14,13,15.0,10.0,5.0
9509283,16,4,12,23,3,13,37,54,5.0,2.0,3.0,7.0,0.0,5.0,6.0,25,16,9,1.0,1.0,0.0
9806202,6,4,2,2,6,0,0,219,3.0,2.0,1.0,1.0,3.0,0.0,0.0,7,6,1,2.0,2.0,0.0
104172,1,1,0,0,0,1,6,59,0.0,0.0,0.0,0.0,0.0,0.0,0.0,18,1,17,8.0,0.0,8.0
9502205,5,1,4,6,3,2,2,87,1.0,1.0,0.0,0.0,1.0,0.0,0.0,6,5,1,3.0,3.0,0.0
9610239,1,1,0,0,1,0,0,49,0.0,0.0,0.0,0.0,0.0,0.0,0.0,14,1,13,5.0,0.0,5.0
9708434,6,5,1,1,6,0,0,430,1.0,1.0,0.0,0.0,1.0,0.0,0.0,8,6,2,1.0,1.0,0.0
9607206,2,2,0,0,0,2,5,355,2.0,2.0,0.0,0.0,0.0,2.0,5.0,8,2,6,6.0,2.0,4.0
9704362,2,2,0,0,1,1,2,229,0.0,0.0,0.0,0.0,0.0,0.0,0.0,7,2,5,1.0,0.0,1.0
9708314,4,3,1,1,1,3,5,59,1.0,1.0,0.0,0.0,1.0,0.0,0.0,10,4,6,1.0,0.0,1.0
206101,19,8,11,28,0,19,136,4,15.0,5.0,10.0,24.0,0.0,15.0,114.0,46,19,27,19.0,9.0,10.0
9607335,1,1,0,0,0,1,3,15,0.0,0.0,0.0,0.0,0.0,0.0,0.0,6,1,5,4.0,1.0,3.0
7008,11,4,7,15,0,11,76,2,9.0,4.0,5.0,11.0,0.0,9.0,62.0,25,11,14,16.0,7.0,9.0
2164,3,2,1,1,0,3,9,536,3.0,2.0,1.0,1.0,2.0,1.0,1.0,9,3,6,2.0,2.0,0.0
112163,6,3,3,4,0,6,79,23,3.0,1.0,2.0,2.0,0.0,3.0,36.0,35,6,29,18.0,3.0,15.0
107327,10,4,6,11,0,10,32,126,3.0,3.0,0.0,0.0,0.0,3.0,14.0,31,10,21,7.0,2.0,5.0
204120,3,2,1,1,0,3,9,136,2.0,1.0,1.0,1.0,0.0,2.0,6.0,9,3,6,1.0,0.0,1.0
9606433,7,2,5,13,7,0,0,72,7.0,2.0,5.0,13.0,7.0,0.0,0.0,8,7,1,7.0,7.0,0.0
9508380,13,5,8,23,12,1,3,26,1.0,1.0,0.0,0.0,1.0,0.0,0.0,25,13,12,8.0,8.0,0.0
108131,4,1,3,5,0,4,43,37,4.0,1.0,3.0,5.0,0.0,4.0,35.0,32,4,28,15.0,4.0,11.0
9707234,1,1,0,0,0,1,3,181,1.0,1.0,0.0,0.0,0.0,1.0,3.0,6,1,5,5.0,1.0,4.0
207313,4,4,0,0,0,4,28,47,2.0,2.0,0.0,0.0,0.0,2.0,19.0,31,4,27,21.0,2.0,19.0
101335,31,8,23,56,1,30,160,9,20.0,5.0,15.0,42.0,0.0,20.0,126.0,46,31,15,5.0,3.0,2.0
9510452,1,1,0,0,1,0,0,101,1.0,1.0,0.0,0.0,1.0,0.0,0.0,4,1,3,,,
10221,6,4,2,2,3,3,4,64,2.0,1.0,1.0,1.0,2.0,0.0,0.0,8,6,2,1.0,1.0,0.0
211331,6,3,3,5,0,6,105,4,3.0,2.0,1.0,1.0,0.0,3.0,40.0,174,6,168,20.0,1.0,19.0
9406364,2,2,0,0,1,1,1,238,1.0,1.0,0.0,0.0,1.0,0.0,0.0,3,2,1,1.0,1.0,0.0
9403287,1,1,0,0,1,0,0,884,,,,,,,,1,1,0,,,
10199,3,3,0,0,0,3,11,27,2.0,2.0,0.0,0.0,0.0,2.0,10.0,21,3,18,5.0,0.0,5.0
9904496,4,3,1,1,0,4,40,113,4.0,3.0,1.0,1.0,0.0,4.0,38.0,29,4,25,20.0,4.0,16.0
106161,2,2,0,0,0,2,28,1,1.0,1.0,0.0,0.0,0.0,1.0,8.0,30,2,28,12.0,1.0,11.0
9907378,6,4,2,4,3,3,3,482,3.0,2.0,1.0,2.0,2.0,1.0,1.0,16,6,10,4.0,3.0,1.0
204081,3,3,0,0,0,3,27,55,2.0,2.0,0.0,0.0,0.0,2.0,14.0,30,3,27,3.0,0.0,3.0
9710358,13,3,10,37,0,13,48,33,13.0,3.0,10.0,37.0,1.0,12.0,34.0,20,13,7,15.0,12.0,3.0
9806320,1,1,0,0,1,0,0,115,0.0,0.0,0.0,0.0,0.0,0.0,0.0,8,1,7,5.0,0.0,5.0
12277,2,2,0,0,1,1,2,18,0.0,0.0,0.0,0.0,0.0,0.0,0.0,8,2,6,2.0,2.0,0.0
8301,5,2,3,4,0,5,61,17,3.0,2.0,1.0,1.0,0.0,3.0,43.0,28,5,23,19.0,2.0,17.0
9212230,4,3,1,2,1,3,3,29,4.0,3.0,1.0,2.0,1.0,3.0,3.0,5,4,1,3.0,3.0,0.0
9705249,8,3,5,8,2,6,10,140,3.0,1.0,2.0,2.0,2.0,1.0,2.0,15,8,7,6.0,3.0,3.0
9512226,6,2,4,5,3,3,3,275,4.0,1.0,3.0,4.0,4.0,0.0,0.0,7,6,1,1.0,1.0,0.0
203255,4,3,1,1,1,3,5,31,0.0,0.0,0.0,0.0,0.0,0.0,0.0,15,4,11,2.0,2.0,0.0
9709402,3,3,0,0,0,3,7,166,1.0,1.0,0.0,0.0,0.0,1.0,2.0,10,3,7,4.0,1.0,3.0
9712396,1,1,0,0,1,0,0,97,0.0,0.0,0.0,0.0,0.0,0.0,0.0,9,1,8,5.0,0.0,5.0
9503289,2,2,0,0,0,2,10,49,2.0,2.0,0.0,0.0,0.0,2.0,7.0,9,2,7,1.0,0.0,1.0
9901426,5,4,1,1,2,3,17,115,2.0,2.0,0.0,0.0,0.0,2.0,11.0,13,5,8,6.0,1.0,5.0
9705308,5,2,3,4,0,5,9,26,0.0,0.0,0.0,0.0,0.0,0.0,0.0,17,5,12,3.0,0.0,3.0
9907248,1,1,0,0,0,1,4,105,1.0,1.0,0.0,0.0,0.0,1.0,4.0,8,1,7,7.0,1.0,6.0
9703218,9,5,4,6,1,8,20,13,5.0,3.0,2.0,2.0,0.0,5.0,13.0,13,9,4,1.0,0.0,1.0
9801336,0,0,0,0,0,0,0,17,0.0,0.0,0.0,0.0,0.0,0.0,0.0,15,0,15,2.0,0.0,2.0
9406332,11,3,8,17,11,0,0,84,4.0,1.0,3.0,4.0,4.0,0.0,0.0,11,11,0,4.0,4.0,0.0
205165,7,6,1,1,0,7,45,65,4.0,3.0,1.0,1.0,0.0,4.0,36.0,31,7,24,14.0,4.0,10.0
9611435,1,1,0,0,1,0,0,0,0.0,0.0,0.0,0.0,0.0,0.0,0.0,23,1,22,12.0,0.0,12.0
9705232,1,1,0,0,1,0,0,344,1.0,1.0,0.0,0.0,1.0,0.0,0.0,4,1,3,1.0,1.0,0.0
9810424,24,6,18,50,0,24,88,8,10.0,2.0,8.0,24.0,1.0,9.0,17.0,39,24,15,11.0,9.0,2.0
9511294,3,1,2,2,2,1,1,82,0.0,0.0,0.0,0.0,0.0,0.0,0.0,4,3,1,2.0,1.0,1.0
9805376,13,7,6,13,4,9,28,48,3.0,2.0,1.0,1.0,0.0,3.0,9.0,19,13,6,5.0,4.0,1.0
9909381,7,3,4,7,2,5,24,16,5.0,2.0,3.0,5.0,1.0,4.0,7.0,27,7,20,2.0,2.0,0.0
9401233,9,7,2,3,9,0,0,236,2.0,2.0,0.0,0.0,2.0,0.0,0.0,9,9,0,2.0,2.0,0.0
9507466,5,5,0,0,4,1,3,96,2.0,2.0,0.0,0.0,1.0,1.0,3.0,8,5,3,3.0,2.0,1.0
204126,0,0,0,0,0,0,0,131,0.0,0.0,0.0,0.0,0.0,0.0,0.0,12,0,12,2.0,0.0,2.0
9601252,7,1,6,10,6,1,1,326,6.0,1.0,5.0,8.0,5.0,1.0,1.0,8,7,1,5.0,5.0,0.0
9706376,4,2,2,4,1,3,6,260,4.0,2.0,2.0,4.0,1.0,3.0,6.0,7,4,3,5.0,3.0,2.0
301042,1,1,0,0,0,1,3,79,1.0,1.0,0.0,0.0,0.0,1.0,1.0,8,1,7,3.0,1.0,2.0
112151,3,3,0,0,2,1,1,64,1.0,1.0,0.0,0.0,1.0,0.0,0.0,5,3,2,1.0,1.0,0.0
9410313,5,3,2,3,5,0,0,282,3.0,1.0,2.0,3.0,3.0,0.0,0.0,5,5,0,3.0,3.0,0.0
104086,5,1,4,8,0,5,56,5,5.0,1.0,4.0,8.0,0.0,5.0,48.0,28,5,23,16.0,3.0,13.0
5076,13,4,9,28,0,13,51,158,9.0,2.0,7.0,22.0,0.0,9.0,32.0,34,13,21,18.0,8.0,10.0
211432,3,2,1,1,0,3,40,49,3.0,2.0,1.0,1.0,0.0,3.0,31.0,53,3,50,24.0,2.0,22.0
9407400,5,1,4,7,5,0,0,267,3.0,1.0,2.0,2.0,3.0,0.0,0.0,6,5,1,3.0,3.0,0.0
9705374,6,4,2,3,3,3,4,435,4.0,2.0,2.0,3.0,4.0,0.0,0.0,15,6,9,4.0,4.0,0.0
9611353,10,4,6,10,2,8,8,63,7.0,3.0,4.0,6.0,2.0,5.0,5.0,12,10,2,7.0,6.0,1.0
9708444,2,1,1,1,1,1,3,164,1.0,1.0,0.0,0.0,0.0,1.0,2.0,11,2,9,2.0,2.0,0.0
9812437,2,1,1,1,0,2,11,35,2.0,1.0,1.0,1.0,0.0,2.0,5.0,22,2,20,6.0,2.0,4.0
9512440,3,1,2,3,3,0,0,14,0.0,0.0,0.0,0.0,0.0,0.0,0.0,28,3,25,2.0,0.0,2.0
104136,2,2,0,0,1,1,1,301,1.0,1.0,0.0,0.0,1.0,0.0,0.0,5,2,3,,,
9411381,1,1,0,0,1,0,0,1765,,,,,,,,1,1,0,,,
208215,2,1,1,1,0,2,4,216,2.0,1.0,1.0,1.0,2.0,0.0,0.0,8,2,6,4.0,2.0,2.0
9906443,6,5,1,1,2,4,11,20,3.0,2.0,1.0,1.0,1.0,2.0,2.0,24,6,18,3.0,0.0,3.0
102135,1,1,0,0,1,0,0,267,0.0,0.0,0.0,0.0,0.0,0.0,0.0,11,1,10,6.0,0.0,6.0
9412291,3,1,2,2,2,1,1,133,3.0,1.0,2.0,2.0,2.0,1.0,1.0,6,3,3,5.0,3.0,2.0
7340,8,3,5,9,0,8,51,161,8.0,3.0,5.0,9.0,0.0,8.0,51.0,37,8,29,12.0,4.0,8.0
9610494,6,2,4,7,2,4,6,82,4.0,1.0,3.0,4.0,2.0,2.0,2.0,9,6,3,5.0,4.0,1.0
9708284,0,0,0,0,0,0,0,18,0.0,0.0,0.0,0.0,0.0,0.0,0.0,17,0,17,3.0,0.0,3.0
209058,0,0,0,0,0,0,0,36,0.0,0.0,0.0,0.0,0.0,0.0,0.0,16,0,16,2.0,0.0,2.0
9711272,7,4,3,3,0,7,25,1,6.0,4.0,2.0,2.0,0.0,6.0,21.0,12,7,5,10.0,6.0,4.0
211158,1,1,0,0,0,1,2,178,1.0,1.0,0.0,0.0,0.0,1.0,2.0,4,1,3,3.0,1.0,2.0
202276,2,2,0,0,0,2,6,91,2.0,2.0,0.0,0.0,0.0,2.0,6.0,7,2,5,7.0,2.0,5.0
9905455,5,5,0,0,3,2,6,156,1.0,1.0,0.0,0.0,0.0,1.0,1.0,14,5,9,4.0,0.0,4.0
9712391,1,1,0,0,1,0,0,324,0.0,0.0,0.0,0.0,0.0,0.0,0.0,11,1,10,1.0,0.0,1.0
9711425,6,3,3,3,0,6,18,288,1.0,1.0,0.0,0.0,0.0,1.0,3.0,10,6,4,5.0,1.0,4.0
201091,5,4,1,1,0,5,24,27,4.0,4.0,0.0,0.0,0.0,4.0,20.0,33,5,28,9.0,1.0,8.0
211017,5,4,1,1,3,2,8,5,0.0,0.0,0.0,0.0,0.0,0.0,0.0,20,5,15,2.0,1.0,1.0
8135,16,6,10,14,4,12,30,31,8.0,4.0,4.0,7.0,0.0,8.0,25.0,25,16,9,8.0,6.0,2.0
9208217,6,6,0,0,6,0,0,248,6.0,6.0,0.0,0.0,6.0,0.0,0.0,6,6,0,3.0,3.0,0.0
101233,0,0,0,0,0,0,0,97,0.0,0.0,0.0,0.0,0.0,0.0,0.0,9,0,9,4.0,0.0,4.0
9611265,6,4,2,3,0,6,16,26,5.0,3.0,2.0,2.0,0.0,5.0,15.0,14,6,8,2.0,2.0,0.0
204149,6,4,2,2,0,6,29,31,2.0,2.0,0.0,0.0,0.0,2.0,9.0,31,6,25,5.0,1.0,4.0
302094,1,1,0,0,0,1,7,1,1.0,1.0,0.0,0.0,0.0,1.0,6.0,28,1,27,12.0,1.0,11.0
110085,0,0,0,0,0,0,0,17,,,,,,,,11,0,11,,,
9222,5,2,3,4,1,4,13,120,4.0,1.0,3.0,4.0,0.0,4.0,12.0,17,5,12,9.0,2.0,7.0
7217,5,5,0,0,2,3,3,126,3.0,3.0,0.0,0.0,1.0,2.0,2.0,9,5,4,4.0,3.0,1.0
1233,18,10,8,12,2,16,68,76,8.0,4.0,4.0,6.0,1.0,7.0,37.0,56,18,38,19.0,4.0,15.0
9806258,5,2,3,3,0,5,7,6,2.0,1.0,1.0,1.0,0.0,2.0,2.0,25,5,20,9.0,0.0,9.0
12082,7,2,5,8,2,5,9,283,7.0,2.0,5.0,8.0,2.0,5.0,9.0,9,7,2,3.0,3.0,0.0
9808477,5,4,1,1,1,4,11,21,1.0,1.0,0.0,0.0,0.0,1.0,1.0,15,5,10,2.0,1.0,1.0
9809488,1,1,0,0,0,1,2,23,0.0,0.0,0.0,0.0,0.0,0.0,0.0,17,1,16,1.0,0.0,1.0
9902390,5,1,4,4,0,5,51,54,5.0,1.0,4.0,4.0,0.0,5.0,49.0,16,5,11,15.0,5.0,10.0
11036,9,5,4,5,2,7,23,278,4.0,2.0,2.0,2.0,1.0,3.0,8.0,24,9,15,7.0,3.0,4.0
9906207,4,4,0,0,0,4,14,305,2.0,2.0,0.0,0.0,0.0,2.0,10.0,16,4,12,9.0,1.0,8.0
9804340,6,4,2,5,4,2,2,390,6.0,4.0,2.0,5.0,4.0,2.0,2.0,7,6,1,7.0,6.0,1.0
9404352,5,3,2,2,4,1,1,223,3.0,1.0,2.0,2.0,3.0,0.0,0.0,11,5,6,3.0,3.0,0.0
9803217,0,0,0,0,0,0,0,1879,0.0,0.0,0.0,0.0,0.0,0.0,0.0,5,0,5,,,
9504221,6,5,1,1,2,4,5,180,3.0,2.0,1.0,1.0,1.0,2.0,3.0,8,6,2,4.0,2.0,2.0
208154,0,0,0,0,0,0,0,16,0.0,0.0,0.0,0.0,0.0,0.0,0.0,16,0,16,4.0,0.0,4.0
203172,3,1,2,3,0,3,34,16,3.0,1.0,2.0,3.0,0.0,3.0,22.0,20,3,17,12.0,3.0,9.0
206063,5,4,1,1,1,4,13,9,2.0,2.0,0.0,0.0,0.0,2.0,3.0,13,5,8,4.0,2.0,2.0
12009,3,1,2,2,3,0,0,65,0.0,0.0,0.0,0.0,0.0,0.0,0.0,7,3,4,2.0,0.0,2.0
211122,1,1,0,0,0,1,1,37,0.0,0.0,0.0,0.0,0.0,0.0,0.0,34,1,33,8.0,1.0,7.0
111360,1,1,0,0,0,1,2,106,0.0,0.0,0.0,0.0,0.0,0.0,0.0,12,1,11,8.0,0.0,8.0
9501294,2,1,1,1,2,0,0,567,0.0,0.0,0.0,0.0,0.0,0.0,0.0,3,2,1,1.0,0.0,1.0
209224,1,1,0,0,0,1,8,23,0.0,0.0,0.0,0.0,0.0,0.0,0.0,12,1,11,5.0,0.0,5.0
9912402,5,2,3,4,0,5,22,47,5.0,2.0,3.0,4.0,0.0,5.0,20.0,21,5,16,4.0,0.0,4.0
9409336,1,1,0,0,0,1,2,341,1.0,1.0,0.0,0.0,0.0,1.0,2.0,5,1,4,4.0,1.0,3.0
9712545,1,1,0,0,1,0,0,183,0.0,0.0,0.0,0.0,0.0,0.0,0.0,8,1,7,3.0,0.0,3.0
101119,5,4,1,1,2,3,31,21,2.0,1.0,1.0,1.0,0.0,2.0,21.0,30,5,25,8.0,1.0,7.0
9310293,0,0,0,0,0,0,0,2051,,,,,,,,1,0,1,1.0,0.0,1.0
103161,7,2,5,7,1,6,36,55,4.0,2.0,2.0,3.0,0.0,4.0,29.0,18,7,11,8.0,4.0,4.0
9810306,3,3,0,0,1,2,2,64,2.0,2.0,0.0,0.0,0.0,2.0,2.0,7,3,4,1.0,1.0,0.0
9809228,2,1,1,1,2,0,0,152,2.0,1.0,1.0,1.0,2.0,0.0,0.0,3,2,1,2.0,2.0,0.0
9904319,6,3,3,8,0,6,33,33,1.0,1.0,0.0,0.0,0.0,1.0,3.0,22,6,16,6.0,1.0,5.0
103233,7,4,3,3,2,5,5,72,4.0,4.0,0.0,0.0,3.0,1.0,1.0,10,7,3,4.0,3.0,1.0
9603358,3,1,2,3,3,0,0,161,3.0,1.0,2.0,3.0,3.0,0.0,0.0,3,3,0,3.0,3.0,0.0
9706418,2,1,1,1,0,2,3,13,0.0,0.0,0.0,0.0,0.0,0.0,0.0,4,2,2,,,
9903345,8,4,4,9,0,8,16,26,2.0,1.0,1.0,1.0,2.0,0.0,0.0,12,8,4,7.0,6.0,1.0
2034,6,2,4,5,0,6,32,78,4.0,2.0,2.0,3.0,0.0,4.0,18.0,17,6,11,8.0,4.0,4.0
4239,0,0,0,0,0,0,0,87,0.0,0.0,0.0,0.0,0.0,0.0,0.0,46,0,46,17.0,0.0,17.0
9903204,9,4,5,15,0,9,14,74,6.0,3.0,3.0,7.0,0.0,6.0,8.0,17,9,8,8.0,6.0,2.0
9905245,5,2,3,3,2,3,8,22,2.0,2.0,0.0,0.0,0.0,2.0,4.0,13,5,8,4.0,1.0,3.0
9410348,8,5,3,4,6,2,2,63,2.0,1.0,1.0,1.0,2.0,0.0,0.0,10,8,2,4.0,4.0,0.0
9207276,2,2,0,0,2,0,0,171,1.0,1.0,0.0,0.0,1.0,0.0,0.0,2,2,0,,,
6224,3,3,0,0,1,2,6,359,0.0,0.0,0.0,0.0,0.0,0.0,0.0,14,3,11,1.0,1.0,0.0
9602359,24,10,14,33,20,4,5,175,13.0,2.0,11.0,29.0,13.0,0.0,0.0,29,24,5,9.0,9.0,0.0
9603312,9,6,3,3,6,3,4,160,5.0,5.0,0.0,0.0,3.0,2.0,2.0,11,9,2,5.0,4.0,1.0
9806479,2,1,1,1,0,2,3,154,2.0,1.0,1.0,1.0,0.0,2.0,2.0,9,2,7,3.0,2.0,1.0
9707312,3,3,0,0,0,3,8,36,1.0,1.0,0.0,0.0,0.0,1.0,4.0,47,3,44,24.0,0.0,24.0
8335,1,1,0,0,0,1,3,22,1.0,1.0,0.0,0.0,0.0,1.0,3.0,22,1,21,5.0,1.0,4.0
203260,2,2,0,0,1,1,1,209,1.0,1.0,0.0,0.0,1.0,0.0,0.0,6,2,4,1.0,1.0,0.0
204106,0,0,0,0,0,0,0,171,0.0,0.0,0.0,0.0,0.0,0.0,0.0,10,0,10,7.0,0.0,7.0
9902473,4,3,1,1,0,4,12,384,3.0,3.0,0.0,0.0,0.0,3.0,6.0,11,4,7,4.0,2.0,2.0
9910413,1,1,0,0,1,0,0,423,1.0,1.0,0.0,0.0,1.0,0.0,0.0,2,1,1,2.0,1.0,1.0
110387,0,0,0,0,0,0,0,223,0.0,0.0,0.0,0.0,0.0,0.0,0.0,2,0,2,1.0,0.0,1.0
9712413,1,1,0,0,0,1,2,90,0.0,0.0,0.0,0.0,0.0,0.0,0.0,8,1,7,,,
9806374,7,6,1,1,2,5,9,152,6.0,5.0,1.0,1.0,2.0,4.0,8.0,10,7,3,7.0,4.0,3.0
9812536,5,3,2,2,0,5,13,141,0.0,0.0,0.0,0.0,0.0,0.0,0.0,28,5,23,3.0,0.0,3.0
9610312,2,2,0,0,2,0,0,370,2.0,2.0,0.0,0.0,2.0,0.0,0.0,3,2,1,1.0,1.0,0.0
4118,5,5,0,0,1,4,11,3,0.0,0.0,0.0,0.0,0.0,0.0,0.0,19,5,14,2.0,2.0,0.0
9805296,5,3,2,3,0,5,20,175,4.0,2.0,2.0,3.0,0.0,4.0,19.0,12,5,7,9.0,4.0,5.0
102056,1,1,0,0,0,1,4,457,1.0,1.0,0.0,0.0,0.0,1.0,4.0,6,1,5,5.0,1.0,4.0
5315,5,2,3,3,2,3,13,66,2.0,1.0,1.0,1.0,0.0,2.0,3.0,19,5,14,4.0,2.0,2.0
111100,6,3,3,4,1,5,11,20,2.0,1.0,1.0,1.0,0.0,2.0,2.0,13,6,7,5.0,1.0,4.0
105191,0,0,0,0,0,0,0,926,,,,,,,,4,0,4,,,
9508220,4,2,2,3,0,4,18,176,4.0,2.0,2.0,3.0,0.0,4.0,16.0,11,4,7,9.0,3.0,6.0
9910331,2,2,0,0,1,1,2,185,1.0,1.0,0.0,0.0,0.0,1.0,2.0,4,2,2,3.0,1.0,2.0
11107,4,3,1,1,0,4,6,31,1.0,1.0,0.0,0.0,0.0,1.0,2.0,12,4,8,5.0,1.0,4.0
102203,9,1,8,14,0,9,23,8,8.0,1.0,7.0,12.0,0.0,8.0,21.0,18,9,9,9.0,6.0,3.0
9606240,2,1,1,1,2,0,0,105,2.0,1.0,1.0,1.0,2.0,0.0,0.0,4,2,2,1.0,0.0,1.0
109082,6,4,2,2,3,3,11,312,2.0,1.0,1.0,1.0,0.0,2.0,4.0,11,6,5,5.0,2.0,3.0
9607270,1,1,0,0,1,0,0,269,1.0,1.0,0.0,0.0,1.0,0.0,0.0,1,1,0,,,
4033,4,4,0,0,0,4,35,16,4.0,4.0,0.0,0.0,0.0,4.0,35.0,16,4,12,6.0,2.0,4.0
9907371,2,2,0,0,0,2,25,9,2.0,2.0,0.0,0.0,0.0,2.0,15.0,29,2,27,12.0,2.0,10.0
6348,5,1,4,7,0,5,9,83,5.0,1.0,4.0,7.0,0.0,5.0,5.0,7,5,2,7.0,5.0,2.0
9706390,2,2,0,0,1,1,1,8,0.0,0.0,0.0,0.0,0.0,0.0,0.0,29,2,27,1.0,0.0,1.0
9501226,0,0,0,0,0,0,0,6,,,,,,,,6,0,6,1.0,0.0,1.0
106015,1,1,0,0,0,1,2,122,1.0,1.0,0.0,0.0,0.0,1.0,1.0,3,1,2,,,
9803490,2,2,0,0,0,2,6,117,2.0,2.0,0.0,0.0,0.0,2.0,3.0,8,2,6,2.0,1.0,1.0
201097,0,0,0,0,0,0,0,103,0.0,0.0,0.0,0.0,0.0,0.0,0.0,13,0,13,7.0,0.0,7.0
7247,2,1,1,1,0,2,5,224,1.0,1.0,0.0,0.0,0.0,1.0,2.0,8,2,6,5.0,1.0,4.0
204136,9,4,5,6,1,8,59,32,4.0,2.0,2.0,2.0,0.0,4.0,31.0,39,9,30,6.0,3.0,3.0
9502389,0,0,0,0,0,0,0,359,0.0,0.0,0.0,0.0,0.0,0.0,0.0,3,0,3,2.0,0.0,2.0
112294,2,1,1,1,0,2,7,1,0.0,0.0,0.0,0.0,0.0,0.0,0.0,16,2,14,5.0,2.0,3.0
9909443,1,1,0,0,0,1,1,12,0.0,0.0,0.0,0.0,0.0,0.0,0.0,8,1,7,,,
9912505,5,3,2,4,0,5,31,21,2.0,1.0,1.0,1.0,0.0,2.0,15.0,26,5,21,2.0,1.0,1.0
7119,13,4,9,15,13,0,0,16,11.0,3.0,8.0,14.0,11.0,0.0,0.0,13,13,0,5.0,5.0,0.0
9909258,2,1,1,1,0,2,14,7,2.0,1.0,1.0,1.0,0.0,2.0,6.0,11,2,9,8.0,2.0,6.0
9207256,6,4,2,2,6,0,0,409,4.0,2.0,2.0,2.0,4.0,0.0,0.0,6,6,0,3.0,3.0,0.0
9809276,0,0,0,0,0,0,0,174,0.0,0.0,0.0,0.0,0.0,0.0,0.0,2,0,2,1.0,0.0,1.0
9908256,1,1,0,0,0,1,1,280,1.0,1.0,0.0,0.0,0.0,1.0,1.0,3,1,2,2.0,1.0,1.0
301011,1,1,0,0,0,1,5,38,1.0,1.0,0.0,0.0,0.0,1.0,4.0,23,1,22,5.0,0.0,5.0
5298,2,2,0,0,1,1,3,2,0.0,0.0,0.0,0.0,0.0,0.0,0.0,11,2,9,4.0,0.0,4.0
2233,1,1,0,0,1,0,0,77,0.0,0.0,0.0,0.0,0.0,0.0,0.0,5,1,4,3.0,0.0,3.0
5251,3,3,0,0,0,3,10,31,2.0,2.0,0.0,0.0,0.0,2.0,8.0,8,3,5,2.0,1.0,1.0
9512256,3,1,2,2,3,0,0,240,3.0,1.0,2.0,2.0,3.0,0.0,0.0,3,3,0,2.0,2.0,0.0
7301,4,1,3,3,0,4,7,428,3.0,1.0,2.0,2.0,0.0,3.0,5.0,6,4,2,5.0,3.0,2.0
9909221,2,2,0,0,0,2,25,17,2.0,2.0,0.0,0.0,0.0,2.0,19.0,24,2,22,2.0,1.0,1.0
9902357,1,1,0,0,1,0,0,91,0.0,0.0,0.0,0.0,0.0,0.0,0.0,6,1,5,2.0,1.0,1.0
204162,1,1,0,0,0,1,1,106,0.0,0.0,0.0,0.0,0.0,0.0,0.0,3,1,2,1.0,0.0,1.0
9606268,0,0,0,0,0,0,0,94,,,,,,,,2,0,2,,,
11043,1,1,0,0,0,1,4,28,1.0,1.0,0.0,0.0,1.0,0.0,0.0,12,1,11,1.0,1.0,0.0
108167,3,3,0,0,0,3,23,23,1.0,1.0,0.0,0.0,0.0,1.0,1.0,18,3,15,3.0,1.0,2.0
9712217,0,0,0,0,0,0,0,1323,0.0,0.0,0.0,0.0,0.0,0.0,0.0,4,0,4,,,
201077,4,4,0,0,1,3,71,109,3.0,3.0,0.0,0.0,0.0,3.0,70.0,46,4,42,35.0,2.0,33.0
205177,1,1,0,0,0,1,12,129,1.0,1.0,0.0,0.0,0.0,1.0,6.0,19,1,18,8.0,1.0,7.0
9811223,0,0,0,0,0,0,0,9,0.0,0.0,0.0,0.0,0.0,0.0,0.0,16,0,16,1.0,0.0,1.0
1081,0,0,0,0,0,0,0,98,,,,,,,,1,0,1,,,
204269,0,0,0,0,0,0,0,57,0.0,0.0,0.0,0.0,0.0,0.0,0.0,10,0,10,1.0,0.0,1.0
110344,2,1,1,1,0,2,6,8,2.0,1.0,1.0,1.0,0.0,2.0,5.0,18,2,16,7.0,2.0,5.0
9402273,0,0,0,0,0,0,0,256,0.0,0.0,0.0,0.0,0.0,0.0,0.0,2,0,2,,,
6261,1,1,0,0,0,1,2,162,0.0,0.0,0.0,0.0,0.0,0.0,0.0,11,1,10,4.0,1.0,3.0
209253,0,0,0,0,0,0,0,143,,,,,,,,1,0,1,,,
112225,3,2,1,1,1,2,9,27,2.0,1.0,1.0,1.0,0.0,2.0,9.0,32,3,29,8.0,0.0,8.0
210060,1,1,0,0,0,1,14,21,1.0,1.0,0.0,0.0,0.0,1.0,11.0,24,1,23,10.0,1.0,9.0
9503370,0,0,0,0,0,0,0,1040,,,,,,,,5,0,5,,,
110092,0,0,0,0,0,0,0,28,0.0,0.0,0.0,0.0,0.0,0.0,0.0,25,0,25,6.0,0.0,6.0
9704427,2,2,0,0,2,0,0,235,1.0,1.0,0.0,0.0,1.0,0.0,0.0,2,2,0,,,
9802321,1,1,0,0,1,0,0,315,1.0,1.0,0.0,0.0,1.0,0.0,0.0,1,1,0,1.0,1.0,0.0
9506444,3,2,1,1,0,3,12,134,1.0,1.0,0.0,0.0,0.0,1.0,2.0,12,3,9,3.0,1.0,2.0
9308345,3,2,1,1,0,3,3,323,3.0,2.0,1.0,1.0,0.0,3.0,3.0,4,3,1,4.0,3.0,1.0
211277,1,1,0,0,0,1,2,79,1.0,1.0,0.0,0.0,1.0,0.0,0.0,6,1,5,1.0,1.0,0.0
9510351,1,1,0,0,1,0,0,874,,,,,,,,1,1,0,,,
211301,1,1,0,0,0,1,4,35,1.0,1.0,0.0,0.0,0.0,1.0,3.0,6,1,5,5.0,1.0,4.0
9910422,4,1,3,6,0,4,12,25,4.0,1.0,3.0,6.0,0.0,4.0,8.0,13,4,9,7.0,4.0,3.0
9609288,0,0,0,0,0,0,0,97,0.0,0.0,0.0,0.0,0.0,0.0,0.0,1,0,1,1.0,0.0,1.0
9812204,4,3,1,1,4,0,0,125,0.0,0.0,0.0,0.0,0.0,0.0,0.0,7,4,3,3.0,0.0,3.0
110415,1,1,0,0,1,0,0,59,0.0,0.0,0.0,0.0,0.0,0.0,0.0,10,1,9,5.0,0.0,5.0
204272,1,1,0,0,0,1,1,166,1.0,1.0,0.0,0.0,0.0,1.0,1.0,5,1,4,3.0,1.0,2.0
112298,0,0,0,0,0,0,0,28,0.0,0.0,0.0,0.0,0.0,0.0,0.0,18,0,18,10.0,0.0,10.0
210245,0,0,0,0,0,0,0,1467,,,,,,,,1,0,1,,,
9506466,1,1,0,0,0,1,1,1911,0.0,0.0,0.0,0.0,0.0,0.0,0.0,6,1,5,1.0,0.0,1.0
9911325,1,1,0,0,0,1,9,22,1.0,1.0,0.0,0.0,0.0,1.0,3.0,13,1,12,4.0,1.0,3.0
9410315,4,3,1,1,4,0,0,266,2.0,1.0,1.0,1.0,2.0,0.0,0.0,4,4,0,1.0,1.0,0.0
104087,3,2,1,2,0,3,14,31,3.0,2.0,1.0,2.0,0.0,3.0,13.0,17,3,14,3.0,1.0,2.0
9807458,1,1,0,0,1,0,0,458,0.0,0.0,0.0,0.0,0.0,0.0,0.0,8,1,7,3.0,0.0,3.0
111469,0,0,0,0,0,0,0,140,0.0,0.0,0.0,0.0,0.0,0.0,0.0,4,0,4,3.0,0.0,3.0
9907554,15,6,9,10,5,10,17,199,6.0,1.0,5.0,5.0,6.0,0.0,0.0,32,15,17,4.0,4.0,0.0
9911318,2,2,0,0,0,2,7,30,1.0,1.0,0.0,0.0,0.0,1.0,1.0,10,2,8,4.0,1.0,3.0
9809260,1,1,0,0,0,1,4,17,1.0,1.0,0.0,0.0,0.0,1.0,3.0,16,1,15,4.0,1.0,3.0
9809561,0,0,0,0,0,0,0,138,0.0,0.0,0.0,0.0,0.0,0.0,0.0,3,0,3,2.0,0.0,2.0
209095,1,1,0,0,0,1,1,124,0.0,0.0,0.0,0.0,0.0,0.0,0.0,6,1,5,2.0,1.0,1.0
204281,1,1,0,0,1,0,0,361,0.0,0.0,0.0,0.0,0.0,0.0,0.0,4,1,3,1.0,1.0,0.0
9612296,1,1,0,0,0,1,4,30,0.0,0.0,0.0,0.0,0.0,0.0,0.0,7,1,6,1.0,0.0,1.0
9805464,1,1,0,0,0,1,3,135,0.0,0.0,0.0,0.0,0.0,0.0,0.0,5,1,4,4.0,1.0,3.0
12203,6,2,4,10,0,6,31,0,6.0,2.0,4.0,10.0,0.0,6.0,26.0,92,6,86,12.0,6.0,6.0
302256,0,0,0,0,0,0,0,239,0.0,0.0,0.0,0.0,0.0,0.0,0.0,2,0,2,1.0,0.0,1.0
6125,5,5,0,0,1,4,14,135,0.0,0.0,0.0,0.0,0.0,0.0,0.0,27,5,22,7.0,0.0,7.0
9402319,3,3,0,0,1,2,2,207,2.0,2.0,0.0,0.0,0.0,2.0,2.0,4,3,1,2.0,1.0,1.0
9905344,0,0,0,0,0,0,0,151,0.0,0.0,0.0,0.0,0.0,0.0,0.0,9,0,9,6.0,0.0,6.0
1300,1,1,0,0,0,1,2,15,,,,,,,,9,1,8,1.0,1.0,0.0
9404309,1,1,0,0,0,1,1,329,1.0,1.0,0.0,0.0,0.0,1.0,1.0,3,1,2,2.0,1.0,1.0
9308293,1,1,0,0,1,0,0,198,1.0,1.0,0.0,0.0,1.0,0.0,0.0,1,1,0,1.0,1.0,0.0
9608439,2,2,0,0,0,2,5,93,2.0,2.0,0.0,0.0,0.0,2.0,5.0,7,2,5,5.0,2.0,3.0
9502218,1,1,0,0,1,0,0,155,0.0,0.0,0.0,0.0,0.0,0.0,0.0,2,1,1,1.0,0.0,1.0
211072,0,0,0,0,0,0,0,56,0.0,0.0,0.0,0.0,0.0,0.0,0.0,18,0,18,3.0,0.0,3.0
208045,3,1,2,2,3,0,0,53,3.0,1.0,2.0,2.0,3.0,0.0,0.0,3,3,0,3.0,3.0,0.0
111247,2,1,1,1,0,2,4,0,0.0,0.0,0.0,0.0,0.0,0.0,0.0,9,2,7,1.0,0.0,1.0
4003,4,2,2,3,0,4,17,262,4.0,2.0,2.0,3.0,0.0,4.0,17.0,11,4,7,11.0,4.0,7.0
202259,1,1,0,0,0,1,9,12,0.0,0.0,0.0,0.0,0.0,0.0,0.0,54,1,53,7.0,0.0,7.0
210024,0,0,0,0,0,0,0,83,0.0,0.0,0.0,0.0,0.0,0.0,0.0,14,0,14,2.0,0.0,2.0
302120,0,0,0,0,0,0,0,4,0.0,0.0,0.0,0.0,0.0,0.0,0.0,14,0,14,8.0,0.0,8.0
210041,2,1,1,1,0,2,11,18,2.0,1.0,1.0,1.0,0.0,2.0,11.0,12,2,10,2.0,0.0,2.0
9802325,6,4,2,3,2,4,7,79,5.0,3.0,2.0,3.0,2.0,3.0,5.0,8,6,2,6.0,5.0,1.0
9135,0,0,0,0,0,0,0,676,0.0,0.0,0.0,0.0,0.0,0.0,0.0,3,0,3,1.0,0.0,1.0
9501256,1,1,0,0,1,0,0,677,1.0,1.0,0.0,0.0,1.0,0.0,0.0,1,1,0,1.0,1.0,0.0
9906391,4,2,2,3,0,4,4,357,3.0,2.0,1.0,2.0,0.0,3.0,3.0,5,4,1,4.0,3.0,1.0
208188,1,1,0,0,0,1,13,66,1.0,1.0,0.0,0.0,0.0,1.0,12.0,38,1,37,17.0,1.0,16.0
9908498,4,4,0,0,1,3,9,152,1.0,1.0,0.0,0.0,0.0,1.0,4.0,16,4,12,5.0,1.0,4.0
9506384,1,1,0,0,1,0,0,1260,1.0,1.0,0.0,0.0,1.0,0.0,0.0,1,1,0,1.0,1.0,0.0
209230,1,1,0,0,0,1,7,1,1.0,1.0,0.0,0.0,0.0,1.0,2.0,18,1,17,2.0,0.0,2.0
9608445,0,0,0,0,0,0,0,1548,0.0,0.0,0.0,0.0,0.0,0.0,0.0,1,0,1,,,
9812406,3,3,0,0,0,3,14,15,1.0,1.0,0.0,0.0,0.0,1.0,3.0,26,3,23,4.0,2.0,2.0
204290,9,5,4,7,0,9,104,24,7.0,5.0,2.0,4.0,0.0,7.0,77.0,50,9,41,20.0,2.0,18.0
105333,0,0,0,0,0,0,0,11,0.0,0.0,0.0,0.0,0.0,0.0,0.0,8,0,8,,,
106076,0,0,0,0,0,0,0,1103,,,,,,,,1,0,1,,,
9702422,1,1,0,0,0,1,2,222,1.0,1.0,0.0,0.0,0.0,1.0,1.0,3,1,2,1.0,0.0,1.0
9305243,0,0,0,0,0,0,0,530,0.0,0.0,0.0,0.0,0.0,0.0,0.0,2,0,2,1.0,0.0,1.0
111221,5,1,4,4,0,5,17,226,4.0,1.0,3.0,3.0,1.0,3.0,5.0,21,5,16,6.0,4.0,2.0
9410215,0,0,0,0,0,0,0,291,0.0,0.0,0.0,0.0,0.0,0.0,0.0,2,0,2,,,
102296,0,0,0,0,0,0,0,1684,0.0,0.0,0.0,0.0,0.0,0.0,0.0,4,0,4,1.0,0.0,1.0
9707473,1,1,0,0,1,0,0,370,1.0,1.0,0.0,0.0,1.0,0.0,0.0,4,1,3,1.0,1.0,0.0
9909330,1,1,0,0,1,0,0,310,1.0,1.0,0.0,0.0,1.0,0.0,0.0,3,1,2,1.0,0.0,1.0
9610300,0,0,0,0,0,0,0,1267,0.0,0.0,0.0,0.0,0.0,0.0,0.0,3,0,3,1.0,0.0,1.0
302216,0,0,0,0,0,0,0,87,0.0,0.0,0.0,0.0,0.0,0.0,0.0,12,0,12,1.0,0.0,1.0
9805505,2,2,0,0,1,1,3,98,0.0,0.0,0.0,0.0,0.0,0.0,0.0,20,2,18,12.0,0.0,12.0
9209233,1,1,0,0,0,1,1,90,1.0,1.0,0.0,0.0,1.0,0.0,0.0,3,1,2,1.0,1.0,0.0
109163,1,1,0,0,0,1,2,288,0.0,0.0,0.0,0.0,0.0,0.0,0.0,17,1,16,4.0,0.0,4.0
8267,1,1,0,0,0,1,2,194,1.0,1.0,0.0,0.0,0.0,1.0,2.0,4,1,3,3.0,1.0,2.0
9911494,4,3,1,1,2,2,5,22,1.0,1.0,0.0,0.0,1.0,0.0,0.0,13,4,9,2.0,2.0,0.0
210442,4,1,3,3,0,4,27,14,3.0,1.0,2.0,2.0,0.0,3.0,16.0,30,4,26,1.0,1.0,0.0
207022,2,2,0,0,0,2,5,31,1.0,1.0,0.0,0.0,0.0,1.0,1.0,22,2,20,5.0,0.0,5.0
9707526,0,0,0,0,0,0,0,145,,,,,,,,1,0,1,1.0,0.0,1.0
12105,0,0,0,0,0,0,0,100,0.0,0.0,0.0,0.0,0.0,0.0,0.0,6,0,6,2.0,0.0,2.0
9502357,0,0,0,0,0,0,0,133,0.0,0.0,0.0,0.0,0.0,0.0,0.0,14,0,14,5.0,0.0,5.0
204007,0,0,0,0,0,0,0,31,0.0,0.0,0.0,0.0,0.0,0.0,0.0,19,0,19,3.0,0.0,3.0
302166,0,0,0,0,0,0,0,52,0.0,0.0,0.0,0.0,0.0,0.0,0.0,5,0,5,1.0,0.0,1.0
9709260,1,1,0,0,0,1,5,40,0.0,0.0,0.0,0.0,0.0,0.0,0.0,8,1,7,1.0,0.0,1.0
9410211,3,3,0,0,0,3,3,96,2.0,2.0,0.0,0.0,0.0,2.0,2.0,5,3,2,1.0,1.0,0.0
107008,0,0,0,0,0,0,0,38,0.0,0.0,0.0,0.0,0.0,0.0,0.0,3,0,3,1.0,0.0,1.0
9306311,3,3,0,0,2,1,1,1574,,,,,,,,5,3,2,1.0,1.0,0.0
101130,0,0,0,0,0,0,0,146,0.0,0.0,0.0,0.0,0.0,0.0,0.0,3,0,3,3.0,0.0,3.0
212148,0,0,0,0,0,0,0,45,0.0,0.0,0.0,0.0,0.0,0.0,0.0,18,0,18,5.0,0.0,5.0
9807444,1,1,0,0,0,1,3,8,0.0,0.0,0.0,0.0,0.0,0.0,0.0,10,1,9,4.0,0.0,4.0
209307,0,0,0,0,0,0,0,87,0.0,0.0,0.0,0.0,0.0,0.0,0.0,34,0,34,13.0,0.0,13.0
210377,1,1,0,0,0,1,1,0,0.0,0.0,0.0,0.0,0.0,0.0,0.0,26,1,25,6.0,0.0,6.0
9806517,0,0,0,0,0,0,0,16,0.0,0.0,0.0,0.0,0.0,0.0,0.0,41,0,41,4.0,0.0,4.0
208208,1,1,0,0,0,1,3,27,1.0,1.0,0.0,0.0,0.0,1.0,1.0,8,1,7,2.0,1.0,1.0
210396,1,1,0,0,0,1,4,27,1.0,1.0,0.0,0.0,0.0,1.0,2.0,5,1,4,5.0,1.0,4.0
9910446,0,0,0,0,0,0,0,90,,,,,,,,3,0,3,,,
208066,1,1,0,0,0,1,4,156,1.0,1.0,0.0,0.0,0.0,1.0,4.0,6,1,5,5.0,1.0,4.0
111175,1,1,0,0,0,1,3,191,1.0,1.0,0.0,0.0,0.0,1.0,3.0,8,1,7,2.0,0.0,2.0
9707534,3,3,0,0,0,3,4,79,2.0,2.0,0.0,0.0,0.0,2.0,3.0,6,3,3,4.0,2.0,2.0
111213,2,1,1,1,1,1,1,102,,,,,,,,5,2,3,,,
201184,4,1,3,3,0,4,7,70,3.0,1.0,2.0,2.0,0.0,3.0,3.0,7,4,3,6.0,4.0,2.0
110080,2,2,0,0,0,2,14,9,2.0,2.0,0.0,0.0,0.0,2.0,14.0,27,2,25,1.0,0.0,1.0
208015,1,1,0,0,0,1,2,20,0.0,0.0,0.0,0.0,0.0,0.0,0.0,15,1,14,1.0,1.0,0.0
9910503,0,0,0,0,0,0,0,54,0.0,0.0,0.0,0.0,0.0,0.0,0.0,16,0,16,13.0,0.0,13.0
101137,0,0,0,0,0,0,0,314,0.0,0.0,0.0,0.0,0.0,0.0,0.0,8,0,8,4.0,0.0,4.0
210190,1,1,0,0,0,1,5,14,1.0,1.0,0.0,0.0,0.0,1.0,4.0,13,1,12,5.0,1.0,4.0
207145,0,0,0,0,0,0,0,2,0.0,0.0,0.0,0.0,0.0,0.0,0.0,9,0,9,1.0,0.0,1.0
9910400,1,1,0,0,0,1,1,141,0.0,0.0,0.0,0.0,0.0,0.0,0.0,8,1,7,3.0,0.0,3.0
9807366,0,0,0,0,0,0,0,27,0.0,0.0,0.0,0.0,0.0,0.0,0.0,7,0,7,2.0,0.0,2.0
9711255,1,1,0,0,0,1,1,97,1.0,1.0,0.0,0.0,0.0,1.0,1.0,7,1,6,5.0,0.0,5.0
109048,2,2,0,0,0,2,17,2,2.0,2.0,0.0,0.0,0.0,2.0,10.0,19,2,17,14.0,2.0,12.0
301077,0,0,0,0,0,0,0,226,0.0,0.0,0.0,0.0,0.0,0.0,0.0,8,0,8,5.0,0.0,5.0
204232,3,1,2,3,0,3,20,66,3.0,1.0,2.0,3.0,0.0,3.0,17.0,15,3,12,6.0,3.0,3.0
9050,2,1,1,1,1,1,1,344,2.0,1.0,1.0,1.0,1.0,1.0,1.0,3,2,1,2.0,2.0,0.0
206016,0,0,0,0,0,0,0,171,0.0,0.0,0.0,0.0,0.0,0.0,0.0,2,0,2,,,
201208,0,0,0,0,0,0,0,438,0.0,0.0,0.0,0.0,0.0,0.0,0.0,2,0,2,1.0,0.0,1.0
9907479,1,1,0,0,0,1,3,58,,,,,,,,4,1,3,3.0,1.0,2.0
211006,0,0,0,0,0,0,0,65,0.0,0.0,0.0,0.0,0.0,0.0,0.0,5,0,5,2.0,0.0,2.0
9312206,0,0,0,0,0,0,0,75,0.0,0.0,0.0,0.0,0.0,0.0,0.0,6,0,6,2.0,0.0,2.0
1071,1,1,0,0,1,0,0,1383,,,,,,,,1,1,0,,,
8192,1,1,0,0,0,1,13,69,1.0,1.0,0.0,0.0,0.0,1.0,13.0,60,1,59,24.0,0.0,24.0
104281,1,1,0,0,0,1,5,199,1.0,1.0,0.0,0.0,0.0,1.0,2.0,8,1,7,3.0,1.0,2.0
9345,1,1,0,0,1,0,0,109,,,,,,,,2,1,1,1.0,1.0,0.0
9188,1,1,0,0,0,1,8,57,1.0,1.0,0.0,0.0,0.0,1.0,8.0,12,1,11,1.0,0.0,1.0
9901275,0,0,0,0,0,0,0,821,0.0,0.0,0.0,0.0,0.0,0.0,0.0,9,0,9,1.0,0.0,1.0
105343,0,0,0,0,0,0,0,20,0.0,0.0,0.0,0.0,0.0,0.0,0.0,19,0,19,2.0,0.0,2.0
210351,1,1,0,0,0,1,9,2,1.0,1.0,0.0,0.0,0.0,1.0,2.0,34,1,33,7.0,0.0,7.0
9212313,1,1,0,0,1,0,0,626,1.0,1.0,0.0,0.0,1.0,0.0,0.0,1,1,0,1.0,1.0,0.0
9404328,2,2,0,0,2,0,0,341,2.0,2.0,0.0,0.0,2.0,0.0,0.0,2,2,0,2.0,2.0,0.0
9409252,0,0,0,0,0,0,0,1004,,,,,,,,1,0,1,,,
101159,1,1,0,0,0,1,11,5,1.0,1.0,0.0,0.0,0.0,1.0,10.0,19,1,18,14.0,1.0,13.0
9912286,0,0,0,0,0,0,0,232,0.0,0.0,0.0,0.0,0.0,0.0,0.0,1,0,1,1.0,0.0,1.0
212226,0,0,0,0,0,0,0,18,0.0,0.0,0.0,0.0,0.0,0.0,0.0,38,0,38,18.0,0.0,18.0
211152,0,0,0,0,0,0,0,37,0.0,0.0,0.0,0.0,0.0,0.0,0.0,13,0,13,1.0,0.0,1.0
9903533,2,1,1,1,0,2,14,110,2.0,1.0,1.0,1.0,0.0,2.0,8.0,11,2,9,9.0,2.0,7.0
105082,1,1,0,0,0,1,5,47,1.0,1.0,0.0,0.0,0.0,1.0,5.0,20,1,19,1.0,0.0,1.0
9207201,0,0,0,0,0,0,0,630,0.0,0.0,0.0,0.0,0.0,0.0,0.0,3,0,3,1.0,0.0,1.0
203016,2,2,0,0,0,2,6,52,1.0,1.0,0.0,0.0,0.0,1.0,5.0,7,2,5,6.0,1.0,5.0
111076,2,1,1,1,0,2,5,219,1.0,1.0,0.0,0.0,0.0,1.0,2.0,17,2,15,2.0,2.0,0.0
9179,0,0,0,0,0,0,0,24,0.0,0.0,0.0,0.0,0.0,0.0,0.0,23,0,23,17.0,0.0,17.0
9712522,1,1,0,0,0,1,3,36,1.0,1.0,0.0,0.0,0.0,1.0,3.0,9,1,8,1.0,0.0,1.0
9404269,1,1,0,0,1,0,0,155,1.0,1.0,0.0,0.0,1.0,0.0,0.0,1,1,0,1.0,1.0,0.0
212195,1,1,0,0,0,1,13,3,1.0,1.0,0.0,0.0,0.0,1.0,4.0,28,1,27,6.0,0.0,6.0
201252,0,0,0,0,0,0,0,260,0.0,0.0,0.0,0.0,0.0,0.0,0.0,14,0,14,7.0,0.0,7.0
212249,0,0,0,0,0,0,0,43,0.0,0.0,0.0,0.0,0.0,0.0,0.0,8,0,8,2.0,0.0,2.0
208206,0,0,0,0,0,0,0,308,0.0,0.0,0.0,0.0,0.0,0.0,0.0,4,0,4,2.0,0.0,2.0
205161,2,2,0,0,0,2,17,8,2.0,2.0,0.0,0.0,0.0,2.0,15.0,24,2,22,6.0,0.0,6.0
9701204,0,0,0,0,0,0,0,1150,0.0,0.0,0.0,0.0,0.0,0.0,0.0,3,0,3,,,
9807208,0,0,0,0,0,0,0,111,0.0,0.0,0.0,0.0,0.0,0.0,0.0,1,0,1,1.0,0.0,1.0
9609492,2,2,0,0,1,1,1,39,1.0,1.0,0.0,0.0,1.0,0.0,0.0,3,2,1,2.0,2.0,0.0
9904451,1,1,0,0,0,1,5,119,0.0,0.0,0.0,0.0,0.0,0.0,0.0,12,1,11,2.0,1.0,1.0
9305217,0,0,0,0,0,0,0,1489,,,,,,,,1,0,1,,,
204259,0,0,0,0,0,0,0,83,0.0,0.0,0.0,0.0,0.0,0.0,0.0,22,0,22,3.0,0.0,3.0
9908368,0,0,0,0,0,0,0,1854,,,,,,,,1,0,1,,,
9608427,0,0,0,0,0,0,0,47,0.0,0.0,0.0,0.0,0.0,0.0,0.0,2,0,2,1.0,0.0,1.0
1117,0,0,0,0,0,0,0,119,0.0,0.0,0.0,0.0,0.0,0.0,0.0,8,0,8,,,
12186,0,0,0,0,0,0,0,36,0.0,0.0,0.0,0.0,0.0,0.0,0.0,9,0,9,2.0,0.0,2.0
108106,3,1,2,2,1,2,4,199,3.0,1.0,2.0,2.0,1.0,2.0,2.0,7,3,4,3.0,3.0,0.0
9307293,0,0,0,0,0,0,0,893,,,,,,,,2,0,2,,,
105167,0,0,0,0,0,0,0,9,0.0,0.0,0.0,0.0,0.0,0.0,0.0,52,0,52,33.0,0.0,33.0
207142,2,1,1,1,0,2,20,43,1.0,1.0,0.0,0.0,0.0,1.0,14.0,22,2,20,14.0,1.0,13.0
207146,0,0,0,0,0,0,0,357,0.0,0.0,0.0,0.0,0.0,0.0,0.0,1,0,1,,,
211428,1,1,0,0,0,1,11,102,1.0,1.0,0.0,0.0,0.0,1.0,7.0,12,1,11,8.0,1.0,7.0
206298,0,0,0,0,0,0,0,57,0.0,0.0,0.0,0.0,0.0,0.0,0.0,2,0,2,1.0,0.0,1.0
9811445,0,0,0,0,0,0,0,760,0.0,0.0,0.0,0.0,0.0,0.0,0.0,3,0,3,1.0,0.0,1.0
9904401,1,1,0,0,0,1,1,35,1.0,1.0,0.0,0.0,1.0,0.0,0.0,6,1,5,1.0,1.0,0.0
9506336,0,0,0,0,0,0,0,15,0.0,0.0,0.0,0.0,0.0,0.0,0.0,13,0,13,1.0,0.0,1.0
9509330,0,0,0,0,0,0,0,493,0.0,0.0,0.0,0.0,0.0,0.0,0.0,1,0,1,1.0,0.0,1.0
108082,0,0,0,0,0,0,0,23,0.0,0.0,0.0,0.0,0.0,0.0,0.0,35,0,35,15.0,0.0,15.0
9709469,0,0,0,0,0,0,0,39,0.0,0.0,0.0,0.0,0.0,0.0,0.0,7,0,7,1.0,0.0,1.0
105138,0,0,0,0,0,0,0,79,,,,,,,,1,0,1,,,
9806283,0,0,0,0,0,0,0,45,0.0,0.0,0.0,0.0,0.0,0.0,0.0,5,0,5,1.0,0.0,1.0
207073,0,0,0,0,0,0,0,8,0.0,0.0,0.0,0.0,0.0,0.0,0.0,11,0,11,,,
9602215,0,0,0,0,0,0,0,114,0.0,0.0,0.0,0.0,0.0,0.0,0.0,2,0,2,1.0,0.0,1.0
212254,0,0,0,0,0,0,0,2,0.0,0.0,0.0,0.0,0.0,0.0,0.0,30,0,30,7.0,0.0,7.0
9406282,1,1,0,0,1,0,0,378,1.0,1.0,0.0,0.0,1.0,0.0,0.0,2,1,1,1.0,1.0,0.0
208278,1,1,0,0,0,1,2,11,1.0,1.0,0.0,0.0,0.0,1.0,2.0,37,1,36,3.0,0.0,3.0
111083,0,0,0,0,0,0,0,23,0.0,0.0,0.0,0.0,0.0,0.0,0.0,21,0,21,4.0,0.0,4.0
209299,0,0,0,0,0,0,0,312,0.0,0.0,0.0,0.0,0.0,0.0,0.0,7,0,7,6.0,0.0,6.0
209228,0,0,0,0,0,0,0,7,0.0,0.0,0.0,0.0,0.0,0.0,0.0,6,0,6,,,
9407232,0,0,0,0,0,0,0,1270,0.0,0.0,0.0,0.0,0.0,0.0,0.0,1,0,1,1.0,0.0,1.0
3197,1,1,0,0,1,0,0,128,1.0,1.0,0.0,0.0,1.0,0.0,0.0,8,1,7,2.0,0.0,2.0
208254,1,1,0,0,0,1,1,162,1.0,1.0,0.0,0.0,0.0,1.0,1.0,14,1,13,7.0,0.0,7.0
7028,0,0,0,0,0,0,0,788,0.0,0.0,0.0,0.0,0.0,0.0,0.0,3,0,3,1.0,0.0,1.0
9807553,0,0,0,0,0,0,0,1503,,,,,,,,1,0,1,,,
201165,0,0,0,0,0,0,0,9,0.0,0.0,0.0,0.0,0.0,0.0,0.0,69,0,69,8.0,0.0,8.0
9506312,0,0,0,0,0,0,0,10,0.0,0.0,0.0,0.0,0.0,0.0,0.0,5,0,5,,,
9806456,1,1,0,0,0,1,2,57,0.0,0.0,0.0,0.0,0.0,0.0,0.0,19,1,18,8.0,0.0,8.0
112122,0,0,0,0,0,0,0,64,0.0,0.0,0.0,0.0,0.0,0.0,0.0,5,0,5,1.0,0.0,1.0
2265,0,0,0,0,0,0,0,58,0.0,0.0,0.0,0.0,0.0,0.0,0.0,29,0,29,8.0,0.0,8.0
9707314,0,0,0,0,0,0,0,10,0.0,0.0,0.0,0.0,0.0,0.0,0.0,16,0,16,1.0,0.0,1.0
9511235,0,0,0,0,0,0,0,1673,0.0,0.0,0.0,0.0,0.0,0.0,0.0,1,0,1,1.0,0.0,1.0
9308316,0,0,0,0,0,0,0,1227,0.0,0.0,0.0,0.0,0.0,0.0,0.0,1,0,1,,,
109164,0,0,0,0,0,0,0,39,0.0,0.0,0.0,0.0,0.0,0.0,0.0,11,0,11,8.0,0.0,8.0
9510395,0,0,0,0,0,0,0,96,0.0,0.0,0.0,0.0,0.0,0.0,0.0,10,0,10,2.0,0.0,2.0
7104,0,0,0,0,0,0,0,70,0.0,0.0,0.0,0.0,0.0,0.0,0.0,20,0,20,12.0,0.0,12.0
302035,3,1,2,3,0,3,31,2,3.0,1.0,2.0,3.0,2.0,1.0,10.0,35,3,32,10.0,1.0,9.0
111202,0,0,0,0,0,0,0,518,0.0,0.0,0.0,0.0,0.0,0.0,0.0,1,0,1,1.0,0.0,1.0
301243,0,0,0,0,0,0,0,19,0.0,0.0,0.0,0.0,0.0,0.0,0.0,86,0,86,8.0,0.0,8.0
9806492,0,0,0,0,0,0,0,0,0.0,0.0,0.0,0.0,0.0,0.0,0.0,11,0,11,1.0,0.0,1.0
301226,0,0,0,0,0,0,0,244,0.0,0.0,0.0,0.0,0.0,0.0,0.0,6,0,6,6.0,0.0,6.0
9902288,1,1,0,0,0,1,4,112,1.0,1.0,0.0,0.0,0.0,1.0,4.0,6,1,5,6.0,1.0,5.0
207163,0,0,0,0,0,0,0,108,0.0,0.0,0.0,0.0,0.0,0.0,0.0,16,0,16,6.0,0.0,6.0
9810541,0,0,0,0,0,0,0,396,0.0,0.0,0.0,0.0,0.0,0.0,0.0,2,0,2,1.0,0.0,1.0
9511377,0,0,0,0,0,0,0,228,0.0,0.0,0.0,0.0,0.0,0.0,0.0,2,0,2,1.0,0.0,1.0
9901311,0,0,0,0,0,0,0,716,0.0,0.0,0.0,0.0,0.0,0.0,0.0,1,0,1,1.0,0.0,1.0
9406353,0,0,0,0,0,0,0,417,0.0,0.0,0.0,0.0,0.0,0.0,0.0,1,0,1,1.0,0.0,1.0
103030,2,1,1,1,1,1,5,228,0.0,0.0,0.0,0.0,0.0,0.0,0.0,16,2,14,5.0,1.0,4.0
9905238,0,0,0,0,0,0,0,11,0.0,0.0,0.0,0.0,0.0,0.0,0.0,16,0,16,4.0,0.0,4.0
12121,0,0,0,0,0,0,0,14,0.0,0.0,0.0,0.0,0.0,0.0,0.0,14,0,14,1.0,0.0,1.0
9904482,0,0,0,0,0,0,0,70,0.0,0.0,0.0,0.0,0.0,0.0,0.0,9,0,9,,,
9905492,1,1,0,0,0,1,17,14,1.0,1.0,0.0,0.0,0.0,1.0,8.0,20,1,19,7.0,1.0,6.0
1197,0,0,0,0,0,0,0,123,0.0,0.0,0.0,0.0,0.0,0.0,0.0,17,0,17,6.0,0.0,6.0
204346,1,1,0,0,0,1,4,1,0.0,0.0,0.0,0.0,0.0,0.0,0.0,32,1,31,10.0,0.0,10.0
110401,0,0,0,0,0,0,0,463,0.0,0.0,0.0,0.0,0.0,0.0,0.0,2,0,2,1.0,0.0,1.0
9605371,0,0,0,0,0,0,0,265,0.0,0.0,0.0,0.0,0.0,0.0,0.0,2,0,2,2.0,0.0,2.0
109261,0,0,0,0,0,0,0,21,0.0,0.0,0.0,0.0,0.0,0.0,0.0,10,0,10,1.0,0.0,1.0
6318,0,0,0,0,0,0,0,10,0.0,0.0,0.0,0.0,0.0,0.0,0.0,7,0,7,3.0,0.0,3.0
203100,0,0,0,0,0,0,0,266,0.0,0.0,0.0,0.0,0.0,0.0,0.0,1,0,1,1.0,0.0,1.0
9908468,2,1,1,1,0,2,6,125,2.0,1.0,1.0,1.0,0.0,2.0,6.0,7,2,5,7.0,2.0,5.0
9311334,0,0,0,0,0,0,0,15,0.0,0.0,0.0,0.0,0.0,0.0,0.0,6,0,6,,,
12144,0,0,0,0,0,0,0,284,0.0,0.0,0.0,0.0,0.0,0.0,0.0,8,0,8,3.0,0.0,3.0
10271,0,0,0,0,0,0,0,65,0.0,0.0,0.0,0.0,0.0,0.0,0.0,14,0,14,4.0,0.0,4.0
101242,0,0,0,0,0,0,0,2,0.0,0.0,0.0,0.0,0.0,0.0,0.0,7,0,7,,,
211408,0,0,0,0,0,0,0,113,,,,,,,,3,0,3,,,
302061,0,0,0,0,0,0,0,68,0.0,0.0,0.0,0.0,0.0,0.0,0.0,15,0,15,2.0,0.0,2.0
9168,0,0,0,0,0,0,0,59,0.0,0.0,0.0,0.0,0.0,0.0,0.0,4,0,4,1.0,0.0,1.0
9907308,0,0,0,0,0,0,0,53,0.0,0.0,0.0,0.0,0.0,0.0,0.0,13,0,13,4.0,0.0,4.0
102328,0,0,0,0,0,0,0,43,0.0,0.0,0.0,0.0,0.0,0.0,0.0,8,0,8,1.0,0.0,1.0
111281,0,0,0,0,0,0,0,100,0.0,0.0,0.0,0.0,0.0,0.0,0.0,17,0,17,9.0,0.0,9.0
9503309,0,0,0,0,0,0,0,1903,,,,,,,,1,0,1,,,
9225,0,0,0,0,0,0,0,73,0.0,0.0,0.0,0.0,0.0,0.0,0.0,4,0,4,,,
9610388,0,0,0,0,0,0,0,27,,,,,,,,4,0,4,2.0,0.0,2.0
9608302,0,0,0,0,0,0,0,35,0.0,0.0,0.0,0.0,0.0,0.0,0.0,12,0,12,4.0,0.0,4.0
9810455,0,0,0,0,0,0,0,285,0.0,0.0,0.0,0.0,0.0,0.0,0.0,5,0,5,3.0,0.0,3.0
208267,0,0,0,0,0,0,0,219,0.0,0.0,0.0,0.0,0.0,0.0,0.0,10,0,10,3.0,0.0,3.0
9602437,0,0,0,0,0,0,0,53,0.0,0.0,0.0,0.0,0.0,0.0,0.0,7,0,7,2.0,0.0,2.0
111347,0,0,0,0,0,0,0,70,0.0,0.0,0.0,0.0,0.0,0.0,0.0,5,0,5,,,
9610391,0,0,0,0,0,0,0,104,0.0,0.0,0.0,0.0,0.0,0.0,0.0,7,0,7,1.0,0.0,1.0
9412364,0,0,0,0,0,0,0,1784,,,,,,,,2,0,2,1.0,0.0,1.0
205104,0,0,0,0,0,0,0,4,0.0,0.0,0.0,0.0,0.0,0.0,0.0,25,0,25,14.0,0.0,14.0
9501322,0,0,0,0,0,0,0,265,0.0,0.0,0.0,0.0,0.0,0.0,0.0,6,0,6,5.0,0.0,5.0
105074,0,0,0,0,0,0,0,277,0.0,0.0,0.0,0.0,0.0,0.0,0.0,4,0,4,1.0,0.0,1.0
9410264,0,0,0,0,0,0,0,90,0.0,0.0,0.0,0.0,0.0,0.0,0.0,1,0,1,1.0,0.0,1.0
9803247,0,0,0,0,0,0,0,6,0.0,0.0,0.0,0.0,0.0,0.0,0.0,24,0,24,4.0,0.0,4.0
106238,0,0,0,0,0,0,0,1226,,,,,,,,1,0,1,,,
9502343,0,0,0,0,0,0,0,210,0.0,0.0,0.0,0.0,0.0,0.0,0.0,2,0,2,2.0,0.0,2.0
9909339,1,1,0,0,1,0,0,388,1.0,1.0,0.0,0.0,1.0,0.0,0.0,1,1,0,1.0,1.0,0.0
9608236,0,0,0,0,0,0,0,74,0.0,0.0,0.0,0.0,0.0,0.0,0.0,6,0,6,2.0,0.0,2.0
9912550,0,0,0,0,0,0,0,105,0.0,0.0,0.0,0.0,0.0,0.0,0.0,7,0,7,6.0,0.0,6.0
202148,0,0,0,0,0,0,0,180,0.0,0.0,0.0,0.0,0.0,0.0,0.0,3,0,3,1.0,0.0,1.0
201241,0,0,0,0,0,0,0,126,0.0,0.0,0.0,0.0,0.0,0.0,0.0,13,0,13,8.0,0.0,8.0
9810413,0,0,0,0,0,0,0,726,0.0,0.0,0.0,0.0,0.0,0.0,0.0,1,0,1,1.0,0.0,1.0
302052,0,0,0,0,0,0,0,271,0.0,0.0,0.0,0.0,0.0,0.0,0.0,3,0,3,2.0,0.0,2.0
102208,0,0,0,0,0,0,0,158,0.0,0.0,0.0,0.0,0.0,0.0,0.0,9,0,9,1.0,0.0,1.0
9507431,1,1,0,0,1,0,0,174,,,,,,,,2,1,1,1.0,1.0,0.0
106157,0,0,0,0,0,0,0,3,0.0,0.0,0.0,0.0,0.0,0.0,0.0,14,0,14,4.0,0.0,4.0
9282,0,0,0,0,0,0,0,22,,,,,,,,4,0,4,1.0,0.0,1.0
206213,0,0,0,0,0,0,0,213,0.0,0.0,0.0,0.0,0.0,0.0,0.0,6,0,6,2.0,0.0,2.0
9711286,1,1,0,0,1,0,0,731,1.0,1.0,0.0,0.0,1.0,0.0,0.0,6,1,5,1.0,1.0,0.0
204169,0,0,0,0,0,0,0,7,,,,,,,,7,0,7,,,
9812482,0,0,0,0,0,0,0,104,0.0,0.0,0.0,0.0,0.0,0.0,0.0,13,0,13,7.0,0.0,7.0
211104,1,1,0,0,0,1,20,109,1.0,1.0,0.0,0.0,0.0,1.0,20.0,27,1,26,22.0,1.0,21.0
212204,0,0,0,0,0,0,0,5,0.0,0.0,0.0,0.0,0.0,0.0,0.0,15,0,15,2.0,0.0,2.0
9609505,0,0,0,0,0,0,0,156,0.0,0.0,0.0,0.0,0.0,0.0,0.0,3,0,3,1.0,0.0,1.0
208169,0,0,0,0,0,0,0,121,0.0,0.0,0.0,0.0,0.0,0.0,0.0,12,0,12,8.0,0.0,8.0
112289,0,0,0,0,0,0,0,88,0.0,0.0,0.0,0.0,0.0,0.0,0.0,6,0,6,1.0,0.0,1.0
211210,0,0,0,0,0,0,0,339,0.0,0.0,0.0,0.0,0.0,0.0,0.0,8,0,8,3.0,0.0,3.0
301013,0,0,0,0,0,0,0,19,0.0,0.0,0.0,0.0,0.0,0.0,0.0,14,0,14,3.0,0.0,3.0
110168,0,0,0,0,0,0,0,239,0.0,0.0,0.0,0.0,0.0,0.0,0.0,5,0,5,,,
9501242,0,0,0,0,0,0,0,953,,,,,,,,1,0,1,,,
9611269,0,0,0,0,0,0,0,1889,0.0,0.0,0.0,0.0,0.0,0.0,0.0,1,0,1,1.0,0.0,1.0
9606479,0,0,0,0,0,0,0,149,0.0,0.0,0.0,0.0,0.0,0.0,0.0,3,0,3,3.0,0.0,3.0
9506249,0,0,0,0,0,0,0,15,0.0,0.0,0.0,0.0,0.0,0.0,0.0,12,0,12,7.0,0.0,7.0
209110,0,0,0,0,0,0,0,395,0.0,0.0,0.0,0.0,0.0,0.0,0.0,5,0,5,2.0,0.0,2.0
9608257,0,0,0,0,0,0,0,817,,,,,,,,1,0,1,,,
9610314,0,0,0,0,0,0,0,14,0.0,0.0,0.0,0.0,0.0,0.0,0.0,5,0,5,,,
208145,0,0,0,0,0,0,0,45,0.0,0.0,0.0,0.0,0.0,0.0,0.0,16,0,16,1.0,0.0,1.0
205017,1,1,0,0,0,1,3,68,1.0,1.0,0.0,0.0,0.0,1.0,2.0,14,1,13,2.0,1.0,1.0
9905306,0,0,0,0,0,0,0,125,,,,,,,,1,0,1,1.0,0.0,1.0
9809416,0,0,0,0,0,0,0,42,,,,,,,,2,0,2,1.0,0.0,1.0
9810310,0,0,0,0,0,0,0,70,0.0,0.0,0.0,0.0,0.0,0.0,0.0,5,0,5,,,
7273,0,0,0,0,0,0,0,1065,,,,,,,,2,0,2,,,
211447,0,0,0,0,0,0,0,7,0.0,0.0,0.0,0.0,0.0,0.0,0.0,24,0,24,13.0,0.0,13.0
2281,0,0,0,0,0,0,0,218,0.0,0.0,0.0,0.0,0.0,0.0,0.0,5,0,5,1.0,0.0,1.0
209157,0,0,0,0,0,0,0,178,0.0,0.0,0.0,0.0,0.0,0.0,0.0,13,0,13,6.0,0.0,6.0
9608238,0,0,0,0,0,0,0,589,0.0,0.0,0.0,0.0,0.0,0.0,0.0,19,0,19,2.0,0.0,2.0
9808310,0,0,0,0,0,0,0,409,0.0,0.0,0.0,0.0,0.0,0.0,0.0,2,0,2,1.0,0.0,1.0
9812374,0,0,0,0,0,0,0,8,0.0,0.0,0.0,0.0,0.0,0.0,0.0,30,0,30,9.0,0.0,9.0
9601251,0,0,0,0,0,0,0,114,,,,,,,,3,0,3,,,
9710378,0,0,0,0,0,0,0,14,0.0,0.0,0.0,0.0,0.0,0.0,0.0,7,0,7,1.0,0.0,1.0
4112,0,0,0,0,0,0,0,179,0.0,0.0,0.0,0.0,0.0,0.0,0.0,6,0,6,3.0,0.0,3.0
208064,1,1,0,0,0,1,1,285,1.0,1.0,0.0,0.0,0.0,1.0,1.0,2,1,1,2.0,1.0,1.0
9506362,0,0,0,0,0,0,0,99,0.0,0.0,0.0,0.0,0.0,0.0,0.0,5,0,5,1.0,0.0,1.0
302086,0,0,0,0,0,0,0,24,,,,,,,,9,0,9,,,
208028,0,0,0,0,0,0,0,60,0.0,0.0,0.0,0.0,0.0,0.0,0.0,47,0,47,16.0,0.0,16.0
9504251,0,0,0,0,0,0,0,1020,,,,,,,,1,0,1,,,
9708235,1,1,0,0,1,0,0,240,1.0,1.0,0.0,0.0,1.0,0.0,0.0,1,1,0,1.0,1.0,0.0
9511303,0,0,0,0,0,0,0,132,0.0,0.0,0.0,0.0,0.0,0.0,0.0,2,0,2,1.0,0.0,1.0
109136,0,0,0,0,0,0,0,294,0.0,0.0,0.0,0.0,0.0,0.0,0.0,3,0,3,2.0,0.0,2.0
201221,0,0,0,0,0,0,0,262,0.0,0.0,0.0,0.0,0.0,0.0,0.0,8,0,8,8.0,0.0,8.0
9309288,0,0,0,0,0,0,0,36,0.0,0.0,0.0,0.0,0.0,0.0,0.0,5,0,5,,,
211356,0,0,0,0,0,0,0,110,,,,,,,,1,0,1,,,
104089,0,0,0,0,0,0,0,142,0.0,0.0,0.0,0.0,0.0,0.0,0.0,2,0,2,2.0,0.0,2.0
302062,0,0,0,0,0,0,0,83,0.0,0.0,0.0,0.0,0.0,0.0,0.0,16,0,16,6.0,0.0,6.0
209092,0,0,0,0,0,0,0,34,,,,,,,,5,0,5,1.0,0.0,1.0
9902257,0,0,0,0,0,0,0,25,0.0,0.0,0.0,0.0,0.0,0.0,0.0,4,0,4,,,
12341,0,0,0,0,0,0,0,54,0.0,0.0,0.0,0.0,0.0,0.0,0.0,3,0,3,2.0,0.0,2.0
9309233,0,0,0,0,0,0,0,280,0.0,0.0,0.0,0.0,0.0,0.0,0.0,1,0,1,1.0,0.0,1.0
9911320,0,0,0,0,0,0,0,315,0.0,0.0,0.0,0.0,0.0,0.0,0.0,2,0,2,1.0,0.0,1.0
212287,0,0,0,0,0,0,0,64,0.0,0.0,0.0,0.0,0.0,0.0,0.0,12,0,12,5.0,0.0,5.0
9409335,108,14,94,609,70,38,63,67,49.0,3.0,46.0,340.0,35.0,14.0,14.0,115,108,7,33.0,33.0,0.0
9212203,131,7,124,1056,131,0,0,34,61.0,2.0,59.0,669.0,61.0,0.0,0.0,131,131,0,47.0,47.0,0.0
11238,21,3,18,48,0,21,135,1,18.0,1.0,17.0,47.0,0.0,18.0,92.0,40,21,19,19.0,12.0,7.0
9808493,107,6,101,775,8,99,609,1,68.0,2.0,66.0,517.0,3.0,65.0,478.0,123,107,16,56.0,46.0,10.0
9307364,172,23,149,1060,172,0,0,7,59.0,3.0,56.0,475.0,59.0,0.0,0.0,172,172,0,25.0,25.0,0.0
9408306,84,7,77,454,7,77,412,6,32.0,4.0,28.0,146.0,1.0,31.0,221.0,105,84,21,29.0,14.0,15.0
6056,32,4,28,96,4,28,260,34,19.0,1.0,18.0,55.0,0.0,19.0,229.0,54,32,22,35.0,17.0,18.0
9901288,66,11,55,202,14,52,247,1,18.0,6.0,12.0,28.0,0.0,18.0,78.0,78,66,12,22.0,14.0,8.0
9811472,58,4,54,391,3,55,400,34,47.0,2.0,45.0,332.0,0.0,47.0,336.0,95,58,37,39.0,28.0,11.0
107074,24,16,8,17,2,22,199,6,5.0,4.0,1.0,1.0,0.0,5.0,72.0,63,24,39,16.0,3.0,13.0
103230,17,6,11,17,15,2,3,34,5.0,3.0,2.0,3.0,5.0,0.0,0.0,19,17,2,5.0,5.0,0.0
211047,3,1,2,2,0,3,12,4,2.0,2.0,0.0,0.0,0.0,2.0,6.0,11,3,8,5.0,2.0,3.0
9506351,27,4,23,72,19,8,12,33,6.0,1.0,5.0,8.0,1.0,5.0,9.0,30,27,3,8.0,6.0,2.0
9812472,169,27,142,813,29,140,806,4,74.0,4.0,70.0,476.0,0.0,74.0,551.0,191,169,22,56.0,44.0,12.0
12351,31,7,24,72,3,28,105,4,13.0,3.0,10.0,19.0,0.0,13.0,52.0,45,31,14,11.0,3.0,8.0
7107,36,8,28,82,4,32,147,95,14.0,4.0,10.0,19.0,1.0,13.0,17.0,62,36,26,10.0,9.0,1.0
9702305,47,6,41,117,7,40,153,33,18.0,3.0,15.0,44.0,8.0,10.0,21.0,66,47,19,12.0,8.0,4.0
9412250,15,7,8,17,11,4,4,48,5.0,4.0,1.0,1.0,2.0,3.0,3.0,16,15,1,5.0,4.0,1.0
9611302,14,4,10,23,5,9,24,61,6.0,3.0,3.0,6.0,6.0,0.0,0.0,27,14,13,2.0,2.0,0.0
9708349,22,8,14,45,0,22,173,17,18.0,6.0,12.0,43.0,0.0,18.0,153.0,54,22,32,28.0,7.0,21.0
9807420,3,2,1,1,0,3,7,33,0.0,0.0,0.0,0.0,0.0,0.0,0.0,8,3,5,2.0,1.0,1.0
9907375,1,1,0,0,0,1,6,48,0.0,0.0,0.0,0.0,0.0,0.0,0.0,14,1,13,2.0,0.0,2.0
9305272,10,7,3,4,8,2,2,93,1.0,1.0,0.0,0.0,0.0,1.0,1.0,12,10,2,1.0,1.0,0.0
106044,15,1,14,39,2,13,57,37,7.0,2.0,5.0,14.0,5.0,2.0,3.0,30,15,15,13.0,9.0,4.0
9406375,11,6,5,9,8,3,4,168,3.0,2.0,1.0,1.0,2.0,1.0,1.0,13,11,2,3.0,2.0,1.0
9706267,8,2,6,10,0,8,44,26,8.0,2.0,6.0,10.0,0.0,8.0,40.0,22,8,14,7.0,1.0,6.0
9905347,23,8,15,37,0,23,126,26,15.0,5.0,10.0,24.0,0.0,15.0,93.0,38,23,15,24.0,15.0,9.0
9211223,7,5,2,3,0,7,12,35,3.0,2.0,1.0,1.0,0.0,3.0,5.0,10,7,3,7.0,4.0,3.0
9912224,6,5,1,1,1,5,45,35,1.0,1.0,0.0,0.0,0.0,1.0,2.0,37,6,31,7.0,0.0,7.0
9409263,23,8,15,33,12,11,12,86,5.0,4.0,1.0,2.0,0.0,5.0,5.0,25,23,2,4.0,3.0,1.0
9812320,98,6,92,601,22,76,530,4,55.0,1.0,54.0,399.0,0.0,55.0,441.0,117,98,19,53.0,40.0,13.0
9406430,52,14,38,155,28,24,56,4,8.0,3.0,5.0,12.0,3.0,5.0,11.0,67,52,15,6.0,6.0,0.0
107228,3,3,0,0,3,0,0,158,1.0,1.0,0.0,0.0,1.0,0.0,0.0,3,3,0,1.0,1.0,0.0
203123,19,7,12,19,2,17,98,4,4.0,1.0,3.0,4.0,0.0,4.0,35.0,36,19,17,8.0,5.0,3.0
8047,4,3,1,1,0,4,4,456,3.0,3.0,0.0,0.0,0.0,3.0,3.0,7,4,3,5.0,4.0,1.0
9301286,8,6,2,2,8,0,0,63,2.0,1.0,1.0,1.0,2.0,0.0,0.0,8,8,0,1.0,1.0,0.0
9212239,13,7,6,10,13,0,0,149,7.0,1.0,6.0,10.0,7.0,0.0,0.0,13,13,0,4.0,4.0,0.0
9603374,87,10,77,382,33,54,103,25,40.0,4.0,36.0,179.0,7.0,33.0,69.0,93,87,6,30.0,27.0,3.0
9509378,25,6,19,61,25,0,0,23,13.0,4.0,9.0,20.0,13.0,0.0,0.0,28,25,3,2.0,2.0,0.0
9503434,15,4,11,14,1,14,52,25,4.0,2.0,2.0,2.0,0.0,4.0,8.0,31,15,16,4.0,2.0,2.0
9602424,44,8,36,134,3,41,69,41,22.0,1.0,21.0,66.0,0.0,22.0,40.0,55,44,11,19.0,18.0,1.0
9205230,86,26,60,209,80,6,6,0,17.0,2.0,15.0,46.0,17.0,0.0,0.0,87,86,1,12.0,12.0,0.0
9411429,33,12,21,37,6,27,93,60,9.0,2.0,7.0,15.0,0.0,9.0,25.0,53,33,20,4.0,4.0,0.0
9501219,1,1,0,0,1,0,0,2108,1.0,1.0,0.0,0.0,1.0,0.0,0.0,4,1,3,,,
3058,81,27,54,156,3,78,691,3,37.0,11.0,26.0,76.0,1.0,36.0,421.0,189,81,108,45.0,8.0,37.0
9801327,12,3,9,20,5,7,26,0,1.0,1.0,0.0,0.0,0.0,1.0,3.0,23,12,11,5.0,2.0,3.0
9812282,114,12,102,619,10,104,490,3,58.0,4.0,54.0,269.0,1.0,57.0,371.0,133,114,19,37.0,26.0,11.0
9503430,19,8,11,22,16,3,4,288,6.0,2.0,4.0,8.0,6.0,0.0,0.0,25,19,6,4.0,4.0,0.0
9906244,49,25,24,44,19,30,77,0,1.0,1.0,0.0,0.0,0.0,1.0,6.0,87,49,38,4.0,4.0,0.0
9602333,24,5,19,56,5,19,68,0,3.0,2.0,1.0,1.0,0.0,3.0,16.0,39,24,15,13.0,4.0,9.0
9810542,10,5,5,8,0,10,50,0,0.0,0.0,0.0,0.0,0.0,0.0,0.0,38,10,28,5.0,2.0,3.0
9907499,64,8,56,241,3,61,369,12,37.0,3.0,34.0,144.0,0.0,37.0,252.0,87,64,23,29.0,18.0,11.0
9507371,58,12,46,170,3,55,135,0,22.0,3.0,19.0,64.0,1.0,21.0,50.0,72,58,14,6.0,6.0,0.0
105344,15,3,12,49,15,0,0,50,8.0,2.0,6.0,16.0,8.0,0.0,0.0,15,15,0,11.0,11.0,0.0
9802420,13,4,9,17,5,8,22,191,9.0,1.0,8.0,16.0,2.0,7.0,7.0,19,13,6,10.0,8.0,2.0
9502400,31,9,22,46,31,0,0,0,2.0,2.0,0.0,0.0,2.0,0.0,0.0,31,31,0,4.0,4.0,0.0
9602383,9,5,4,10,2,7,17,0,2.0,2.0,0.0,0.0,0.0,2.0,5.0,15,9,6,1.0,1.0,0.0
9702355,10,2,8,10,3,7,41,134,4.0,1.0,3.0,3.0,0.0,4.0,14.0,34,10,24,5.0,3.0,2.0
9503488,15,10,5,12,4,11,65,10,4.0,4.0,0.0,0.0,0.0,4.0,21.0,29,15,14,9.0,2.0,7.0
9711340,6,2,4,5,3,3,8,0,1.0,1.0,0.0,0.0,0.0,1.0,2.0,11,6,5,4.0,2.0,2.0
9411219,27,4,23,76,21,6,12,0,12.0,1.0,11.0,30.0,12.0,0.0,0.0,37,27,10,11.0,11.0,0.0
6331,14,5,9,23,1,13,61,81,12.0,4.0,8.0,22.0,0.0,12.0,58.0,26,14,12,15.0,9.0,6.0
9511280,8,4,4,10,2,6,9,81,3.0,2.0,1.0,2.0,1.0,2.0,2.0,13,8,5,2.0,1.0,1.0
9612217,73,23,50,134,14,59,199,51,30.0,7.0,23.0,53.0,2.0,28.0,96.0,87,73,14,18.0,13.0,5.0
9707235,68,6,62,316,3,65,369,46,46.0,3.0,43.0,226.0,1.0,45.0,206.0,100,68,32,18.0,12.0,6.0
9504208,11,4,7,10,0,11,39,3,3.0,3.0,0.0,0.0,0.0,3.0,8.0,19,11,8,10.0,4.0,6.0
9502296,15,6,9,18,3,12,31,63,5.0,4.0,1.0,1.0,1.0,4.0,12.0,21,15,6,11.0,6.0,5.0
9605445,18,4,14,30,0,18,50,42,11.0,2.0,9.0,23.0,0.0,11.0,30.0,28,18,10,5.0,3.0,2.0
9710389,21,6,15,25,6,15,37,55,1.0,1.0,0.0,0.0,1.0,0.0,0.0,34,21,13,6.0,4.0,2.0
9706497,6,5,1,1,1,5,29,3,2.0,2.0,0.0,0.0,0.0,2.0,12.0,42,6,36,10.0,2.0,8.0
9209205,343,79,264,924,343,0,0,11,24.0,2.0,22.0,98.0,24.0,0.0,0.0,343,343,0,18.0,18.0,0.0
3007,10,4,6,6,0,10,35,10,1.0,1.0,0.0,0.0,0.0,1.0,4.0,34,10,24,8.0,1.0,7.0
9209251,153,7,146,1312,153,0,0,12,51.0,3.0,48.0,317.0,51.0,0.0,0.0,153,153,0,30.0,30.0,0.0
9307301,133,21,112,639,85,48,92,75,32.0,8.0,24.0,85.0,8.0,24.0,46.0,135,133,2,30.0,28.0,2.0
9702392,104,2,102,1181,42,62,211,36,69.0,2.0,67.0,924.0,45.0,24.0,31.0,119,104,15,56.0,56.0,0.0
9706387,14,2,12,42,0,14,188,36,12.0,2.0,10.0,33.0,0.0,12.0,162.0,45,14,31,30.0,12.0,18.0
201137,5,5,0,0,1,4,9,1,0.0,0.0,0.0,0.0,0.0,0.0,0.0,67,5,62,7.0,0.0,7.0
9808487,62,6,56,319,5,57,203,58,19.0,2.0,17.0,46.0,0.0,19.0,60.0,77,62,15,17.0,12.0,5.0
7320,24,3,21,47,0,24,228,32,8.0,2.0,6.0,9.0,0.0,8.0,90.0,59,24,35,20.0,9.0,11.0
9507460,44,5,39,225,3,41,290,1,36.0,3.0,33.0,178.0,2.0,34.0,264.0,60,44,16,30.0,19.0,11.0
9711428,38,4,34,107,0,38,157,1,31.0,4.0,27.0,81.0,0.0,31.0,134.0,51,38,13,27.0,20.0,7.0
9506242,81,11,70,258,6,75,187,7,13.0,2.0,11.0,40.0,0.0,13.0,24.0,98,81,17,13.0,11.0,2.0
9511465,23,4,19,68,8,15,51,34,17.0,1.0,16.0,64.0,5.0,12.0,35.0,29,23,6,6.0,6.0,0.0
12001,43,11,32,116,14,29,72,62,21.0,3.0,18.0,88.0,2.0,19.0,44.0,57,43,14,22.0,18.0,4.0
9504296,29,19,10,15,19,10,23,5,5.0,4.0,1.0,1.0,2.0,3.0,5.0,33,29,4,5.0,3.0,2.0
9612396,9,3,6,8,2,7,19,5,4.0,2.0,2.0,2.0,0.0,4.0,4.0,15,9,6,4.0,3.0,1.0
9706382,12,4,8,15,2,10,128,5,6.0,1.0,5.0,10.0,0.0,6.0,108.0,64,12,52,28.0,5.0,23.0
9911375,16,10,6,10,7,9,27,155,2.0,2.0,0.0,0.0,1.0,1.0,1.0,47,16,31,4.0,0.0,4.0
9409243,38,5,33,163,8,30,40,33,29.0,3.0,26.0,139.0,6.0,23.0,32.0,40,38,2,23.0,21.0,2.0
9703212,71,10,61,422,0,71,794,15,55.0,6.0,49.0,352.0,0.0,55.0,686.0,121,71,50,60.0,35.0,25.0
9509325,41,5,36,169,5,36,110,1,35.0,4.0,31.0,155.0,3.0,32.0,103.0,46,41,5,23.0,19.0,4.0
105247,4,3,1,1,0,4,15,85,2.0,2.0,0.0,0.0,0.0,2.0,11.0,18,4,14,8.0,1.0,7.0
9705467,46,12,34,94,5,41,120,6,19.0,3.0,16.0,40.0,4.0,15.0,25.0,63,46,17,15.0,13.0,2.0
9902482,34,13,21,49,0,34,427,1,29.0,11.0,18.0,39.0,0.0,29.0,389.0,58,34,24,42.0,22.0,20.0
9509346,16,5,11,22,4,12,39,1,3.0,2.0,1.0,1.0,3.0,0.0,0.0,29,16,13,2.0,2.0,0.0
9605441,37,6,31,113,4,33,49,1,17.0,3.0,14.0,48.0,1.0,16.0,16.0,47,37,10,5.0,4.0,1.0
9308222,104,24,80,307,104,0,0,92,11.0,3.0,8.0,16.0,11.0,0.0,0.0,104,104,0,5.0,5.0,0.0
2167,33,14,19,54,7,26,91,1,12.0,3.0,9.0,16.0,2.0,10.0,19.0,64,33,31,13.0,9.0,4.0
9309294,94,18,76,253,81,13,14,4,20.0,3.0,17.0,30.0,20.0,0.0,0.0,98,94,4,12.0,12.0,0.0
9904266,48,5,43,280,1,47,736,2,34.0,3.0,31.0,249.0,0.0,34.0,664.0,91,48,43,51.0,29.0,22.0
9510229,1,1,0,0,1,0,0,59,0.0,0.0,0.0,0.0,0.0,0.0,0.0,4,1,3,,,
9610396,33,5,28,104,2,31,153,21,15.0,4.0,11.0,25.0,1.0,14.0,32.0,44,33,11,19.0,16.0,3.0
9304263,20,13,7,9,11,9,9,75,3.0,2.0,1.0,1.0,3.0,0.0,0.0,21,20,1,3.0,3.0,0.0
9406390,74,10,64,352,21,53,111,18,31.0,3.0,28.0,145.0,6.0,25.0,49.0,80,74,6,16.0,13.0,3.0
9312341,45,13,32,110,17,28,58,36,17.0,8.0,9.0,20.0,2.0,15.0,36.0,51,45,6,18.0,13.0,5.0
9604440,67,4,63,510,13,54,265,15,50.0,1.0,49.0,418.0,1.0,49.0,253.0,78,67,11,50.0,41.0,9.0
9204228,48,10,38,215,48,0,0,15,24.0,5.0,19.0,165.0,24.0,0.0,0.0,48,48,0,21.0,21.0,0.0
9504280,2,2,0,0,2,0,0,890,,,,,,,,2,2,0,,,
9901341,10,3,7,14,8,2,6,76,5.0,1.0,4.0,7.0,3.0,2.0,4.0,13,10,3,7.0,5.0,2.0
9407252,25,12,13,21,2,23,95,40,21.0,9.0,12.0,20.0,0.0,21.0,89.0,38,25,13,11.0,5.0,6.0
9601392,11,2,9,29,5,6,7,12,6.0,2.0,4.0,10.0,3.0,3.0,3.0,19,11,8,8.0,8.0,0.0
9305239,65,8,57,303,65,0,0,19,31.0,2.0,29.0,207.0,31.0,0.0,0.0,65,65,0,10.0,10.0,0.0
9303273,61,16,45,167,21,40,41,62,25.0,3.0,22.0,70.0,6.0,19.0,19.0,63,61,2,15.0,14.0,1.0
9305296,5,4,1,1,5,0,0,98,3.0,2.0,1.0,1.0,3.0,0.0,0.0,5,5,0,2.0,2.0,0.0
9911414,38,5,33,169,0,38,530,24,35.0,4.0,31.0,155.0,0.0,35.0,480.0,75,38,37,50.0,21.0,29.0
9608203,57,14,43,203,19,38,83,11,24.0,1.0,23.0,123.0,1.0,23.0,46.0,64,57,7,22.0,19.0,3.0
9612235,39,4,35,157,9,30,100,16,24.0,1.0,23.0,103.0,3.0,21.0,53.0,51,39,12,19.0,16.0,3.0
9606443,68,19,49,146,29,39,60,57,19.0,2.0,17.0,42.0,2.0,17.0,17.0,72,68,4,8.0,8.0,0.0
9605231,41,7,34,83,5,36,114,57,10.0,1.0,9.0,15.0,0.0,10.0,48.0,53,41,12,13.0,7.0,6.0
9912292,4,4,0,0,0,4,8,98,0.0,0.0,0.0,0.0,0.0,0.0,0.0,16,4,12,2.0,0.0,2.0
9806306,12,8,4,7,3,9,37,133,4.0,2.0,2.0,2.0,0.0,4.0,23.0,23,12,11,14.0,7.0,7.0
1040,28,6,22,78,4,24,87,80,18.0,4.0,14.0,52.0,3.0,15.0,61.0,36,28,8,23.0,16.0,7.0
9509341,25,8,17,43,3,22,102,30,17.0,3.0,14.0,35.0,0.0,17.0,80.0,39,25,14,13.0,7.0,6.0
9605334,13,3,10,18,3,10,28,93,1.0,1.0,0.0,0.0,0.0,1.0,2.0,22,13,9,4.0,1.0,3.0
9404235,8,3,5,9,8,0,0,93,3.0,1.0,2.0,3.0,3.0,0.0,0.0,8,8,0,2.0,2.0,0.0
102170,1,1,0,0,0,1,3,6,0.0,0.0,0.0,0.0,0.0,0.0,0.0,24,1,23,1.0,0.0,1.0
9903355,58,5,53,342,2,56,170,24,43.0,2.0,41.0,264.0,0.0,43.0,122.0,65,58,7,16.0,16.0,0.0
9611388,27,3,24,120,3,24,72,24,22.0,2.0,20.0,106.0,2.0,20.0,25.0,41,27,14,5.0,1.0,4.0
9503209,46,5,41,247,33,13,32,24,32.0,1.0,31.0,179.0,32.0,0.0,0.0,52,46,6,21.0,21.0,0.0
9408222,101,6,95,953,101,0,0,8,68.0,3.0,65.0,730.0,68.0,0.0,0.0,101,101,0,42.0,42.0,0.0
9509256,42,1,41,191,4,38,79,87,29.0,1.0,28.0,133.0,1.0,28.0,62.0,46,42,4,27.0,24.0,3.0
9608206,12,4,8,11,2,10,20,103,8.0,3.0,5.0,8.0,0.0,8.0,8.0,21,12,9,4.0,3.0,1.0
9502348,109,16,93,459,74,35,47,8,27.0,4.0,23.0,111.0,24.0,3.0,3.0,117,109,8,13.0,13.0,0.0
9307269,21,10,11,21,21,0,0,93,7.0,3.0,4.0,5.0,7.0,0.0,0.0,21,21,0,2.0,2.0,0.0
9911367,27,6,21,75,7,20,50,22,18.0,2.0,16.0,62.0,3.0,15.0,37.0,35,27,8,15.0,14.0,1.0
9905572,7,3,4,5,1,6,44,40,3.0,3.0,0.0,0.0,0.0,3.0,22.0,29,7,22,7.0,2.0,5.0
9906257,22,5,17,70,0,22,136,45,14.0,2.0,12.0,46.0,0.0,14.0,96.0,44,22,22,21.0,13.0,8.0
9306219,24,8,16,83,18,6,6,22,19.0,6.0,13.0,64.0,13.0,6.0,6.0,25,24,1,13.0,13.0,0.0
9401211,37,8,29,100,12,25,50,22,23.0,4.0,19.0,64.0,9.0,14.0,32.0,40,37,3,20.0,17.0,3.0
9810216,64,6,58,353,2,62,241,22,50.0,3.0,47.0,311.0,1.0,49.0,154.0,82,64,18,36.0,31.0,5.0
9312245,27,12,15,28,21,6,6,88,7.0,2.0,5.0,6.0,7.0,0.0,0.0,28,27,1,3.0,3.0,0.0
9704398,31,13,18,39,13,18,28,88,9.0,2.0,7.0,8.0,1.0,8.0,10.0,38,31,7,9.0,8.0,1.0
9405234,43,15,28,113,11,32,92,15,18.0,4.0,14.0,49.0,6.0,12.0,30.0,49,43,6,8.0,6.0,2.0
9606431,6,2,4,6,0,6,41,21,4.0,1.0,3.0,5.0,0.0,4.0,26.0,20,6,14,3.0,0.0,3.0
9510204,84,20,64,245,17,67,183,99,28.0,7.0,21.0,69.0,1.0,27.0,73.0,100,84,16,23.0,19.0,4.0
2078,33,6,27,52,0,33,234,43,15.0,6.0,9.0,15.0,0.0,15.0,126.0,55,33,22,15.0,8.0,7.0
9708464,6,4,2,2,2,4,10,19,1.0,1.0,0.0,0.0,0.0,1.0,2.0,18,6,12,2.0,1.0,1.0
9812366,60,7,53,231,2,58,282,16,43.0,5.0,38.0,174.0,0.0,43.0,214.0,74,60,14,32.0,25.0,7.0
9909464,26,6,20,50,5,21,221,19,17.0,1.0,16.0,44.0,0.0,17.0,160.0,65,26,39,19.0,10.0,9.0
7362,56,7,49,191,4,52,234,19,15.0,4.0,11.0,23.0,0.0,15.0,65.0,68,56,12,15.0,9.0,6.0
9501373,7,5,2,2,4,3,3,39,1.0,1.0,0.0,0.0,1.0,0.0,0.0,9,7,2,1.0,1.0,0.0
4207,23,1,22,81,0,23,324,20,23.0,1.0,22.0,81.0,0.0,23.0,303.0,65,23,42,45.0,14.0,31.0
9812287,150,9,141,1672,5,145,689,20,124.0,3.0,121.0,1575.0,1.0,123.0,611.0,158,150,8,82.0,74.0,8.0
9906555,19,9,10,21,5,14,67,116,6.0,5.0,1.0,1.0,1.0,5.0,26.0,36,19,17,11.0,4.0,7.0
9306310,22,8,14,39,10,12,18,29,9.0,3.0,6.0,12.0,1.0,8.0,13.0,24,22,2,5.0,3.0,2.0
9502311,8,5,3,4,4,4,19,29,3.0,1.0,2.0,3.0,0.0,3.0,15.0,15,8,7,5.0,2.0,3.0
9412257,23,1,22,82,1,22,22,136,22.0,1.0,21.0,81.0,0.0,22.0,22.0,24,23,1,20.0,19.0,1.0
103088,38,21,17,34,11,27,141,13,11.0,5.0,6.0,10.0,0.0,11.0,76.0,75,38,37,16.0,0.0,16.0
9809290,7,5,2,4,1,6,49,33,4.0,2.0,2.0,4.0,0.0,4.0,39.0,29,7,22,13.0,4.0,9.0
211124,8,2,6,16,0,8,40,37,7.0,1.0,6.0,16.0,0.0,7.0,39.0,32,8,24,18.0,7.0,11.0
9411206,19,10,9,13,19,0,0,379,8.0,3.0,5.0,8.0,8.0,0.0,0.0,19,19,0,6.0,6.0,0.0
9701212,10,3,7,9,10,0,0,78,7.0,2.0,5.0,7.0,7.0,0.0,0.0,10,10,0,1.0,1.0,0.0
9607418,13,4,9,22,1,12,70,6,7.0,3.0,4.0,11.0,1.0,6.0,12.0,33,13,20,7.0,7.0,0.0
9607421,66,19,47,218,8,58,169,5,18.0,3.0,15.0,82.0,1.0,17.0,17.0,89,66,23,9.0,8.0,1.0
9412379,45,10,35,76,8,37,93,10,11.0,4.0,7.0,9.0,7.0,4.0,4.0,55,45,10,4.0,4.0,0.0
9503443,81,9,72,447,16,65,121,4,51.0,2.0,49.0,358.0,9.0,42.0,80.0,86,81,5,36.0,33.0,3.0
9505302,26,10,16,30,7,19,49,10,5.0,2.0,3.0,4.0,2.0,3.0,3.0,39,26,13,3.0,2.0,1.0
9704273,43,2,41,258,40,3,4,73,38.0,1.0,37.0,250.0,38.0,0.0,0.0,45,43,2,30.0,30.0,0.0
9510275,7,4,3,5,3,4,4,42,3.0,1.0,2.0,2.0,1.0,2.0,2.0,8,7,1,1.0,1.0,0.0
9804214,14,2,12,23,0,14,75,42,12.0,2.0,10.0,16.0,0.0,12.0,54.0,32,14,18,12.0,4.0,8.0
9607241,14,3,11,28,0,14,58,114,13.0,3.0,10.0,22.0,1.0,12.0,42.0,24,14,10,18.0,12.0,6.0
9609374,29,16,13,29,4,25,131,5,8.0,5.0,3.0,4.0,3.0,5.0,12.0,67,29,38,4.0,0.0,4.0
9512245,1,1,0,0,0,1,1,99,0.0,0.0,0.0,0.0,0.0,0.0,0.0,10,1,9,1.0,0.0,1.0
101331,5,4,1,1,0,5,14,4,1.0,1.0,0.0,0.0,0.0,1.0,2.0,24,5,19,9.0,2.0,7.0
9608376,5,2,3,3,5,0,0,210,2.0,2.0,0.0,0.0,2.0,0.0,0.0,7,5,2,2.0,2.0,0.0
9701398,31,8,23,65,4,27,118,92,15.0,3.0,12.0,28.0,1.0,14.0,52.0,46,31,15,17.0,12.0,5.0
9911295,6,2,4,10,0,6,48,4,3.0,1.0,2.0,3.0,0.0,3.0,12.0,22,6,16,10.0,4.0,6.0
9707364,60,4,56,428,1,59,289,70,59.0,3.0,56.0,428.0,1.0,58.0,288.0,66,60,6,46.0,40.0,6.0
9810471,33,5,28,148,1,32,128,3,27.0,4.0,23.0,122.0,0.0,27.0,97.0,67,33,34,9.0,9.0,0.0
9903473,19,2,17,38,5,14,62,0,1.0,1.0,0.0,0.0,0.0,1.0,4.0,31,19,12,10.0,4.0,6.0
9802304,46,2,44,191,5,41,102,21,22.0,1.0,21.0,74.0,0.0,22.0,22.0,54,46,8,19.0,18.0,1.0
9603342,36,11,25,84,11,25,88,18,19.0,4.0,15.0,51.0,4.0,15.0,29.0,57,36,21,12.0,11.0,1.0
9212218,8,4,4,5,8,0,0,113,4.0,2.0,2.0,2.0,4.0,0.0,0.0,8,8,0,1.0,1.0,0.0
9811331,1,1,0,0,0,1,1,238,1.0,1.0,0.0,0.0,0.0,1.0,1.0,3,1,2,2.0,0.0,2.0
9610250,6,4,2,2,2,4,17,84,5.0,3.0,2.0,2.0,1.0,4.0,16.0,14,6,8,7.0,3.0,4.0
9602347,14,5,9,35,0,14,115,49,10.0,3.0,7.0,24.0,0.0,10.0,77.0,31,14,17,18.0,10.0,8.0
9502383,5,2,3,4,1,4,8,8,1.0,1.0,0.0,0.0,0.0,1.0,2.0,16,5,11,1.0,0.0,1.0
9903293,6,3,3,5,1,5,21,251,4.0,2.0,2.0,2.0,4.0,0.0,0.0,13,6,7,9.0,4.0,5.0
207310,9,2,7,10,0,9,34,23,7.0,1.0,6.0,8.0,0.0,7.0,18.0,26,9,17,7.0,3.0,4.0
9805384,9,4,5,11,1,8,26,105,7.0,2.0,5.0,11.0,0.0,7.0,22.0,15,9,6,11.0,7.0,4.0
9602201,11,5,6,8,0,11,52,6,5.0,2.0,3.0,5.0,0.0,5.0,17.0,32,11,21,3.0,1.0,2.0
9512354,6,4,2,3,0,6,14,55,0.0,0.0,0.0,0.0,0.0,0.0,0.0,17,6,11,2.0,2.0,0.0
9912317,40,6,34,187,0,40,258,55,24.0,5.0,19.0,83.0,0.0,24.0,152.0,61,40,21,31.0,22.0,9.0
9910474,48,5,43,192,0,48,326,2,29.0,2.0,27.0,133.0,2.0,27.0,72.0,79,48,31,32.0,25.0,7.0
5303,19,7,12,16,0,19,203,32,7.0,3.0,4.0,6.0,0.0,7.0,66.0,82,19,63,14.0,7.0,7.0
8222,28,7,21,67,16,12,14,0,20.0,4.0,16.0,58.0,10.0,10.0,12.0,30,28,2,1.0,1.0,0.0
9808469,20,6,14,32,1,19,64,125,18.0,5.0,13.0,31.0,0.0,18.0,57.0,32,20,12,21.0,14.0,7.0
9902238,15,3,12,29,3,12,131,31,9.0,2.0,7.0,18.0,0.0,9.0,105.0,40,15,25,25.0,7.0,18.0
102344,89,6,83,663,0,89,684,23,55.0,4.0,51.0,437.0,0.0,55.0,328.0,118,89,29,53.0,43.0,10.0
9310374,13,7,6,11,12,1,3,12,2.0,2.0,0.0,0.0,2.0,0.0,0.0,16,13,3,2.0,2.0,0.0
102222,21,3,18,103,1,20,138,23,18.0,2.0,16.0,101.0,0.0,18.0,136.0,32,21,11,18.0,14.0,4.0
9912490,13,8,5,11,0,13,56,27,13.0,8.0,5.0,11.0,0.0,13.0,55.0,23,13,10,9.0,4.0,5.0
103074,24,11,13,24,10,14,56,3,5.0,1.0,4.0,5.0,1.0,4.0,6.0,39,24,15,5.0,2.0,3.0
108104,42,16,26,54,7,35,144,37,10.0,3.0,7.0,18.0,0.0,10.0,60.0,66,42,24,9.0,7.0,2.0
103218,23,4,19,83,0,23,333,23,19.0,3.0,16.0,67.0,0.0,19.0,280.0,87,23,64,24.0,5.0,19.0
9703319,57,12,45,150,31,26,94,25,19.0,1.0,18.0,61.0,4.0,15.0,46.0,77,57,20,19.0,10.0,9.0
9408246,10,1,9,20,4,6,6,18,5.0,1.0,4.0,8.0,5.0,0.0,0.0,11,10,1,5.0,5.0,0.0
111243,5,3,2,2,0,5,26,23,4.0,3.0,1.0,1.0,0.0,4.0,23.0,34,5,29,17.0,3.0,14.0
9905484,2,2,0,0,1,1,1,115,1.0,1.0,0.0,0.0,0.0,1.0,1.0,12,2,10,3.0,1.0,2.0
10231,13,3,10,17,5,8,27,0,5.0,3.0,2.0,2.0,1.0,4.0,15.0,23,13,10,9.0,4.0,5.0
105080,8,2,6,9,0,8,46,0,6.0,1.0,5.0,7.0,0.0,6.0,28.0,28,8,20,7.0,0.0,7.0
9805242,13,6,7,12,4,9,24,69,4.0,2.0,2.0,3.0,0.0,4.0,9.0,31,13,18,2.0,2.0,0.0
9606361,2,2,0,0,1,1,2,69,1.0,1.0,0.0,0.0,1.0,0.0,0.0,5,2,3,,,
11241,79,4,75,517,2,77,1057,11,68.0,4.0,64.0,487.0,0.0,68.0,960.0,114,79,35,76.0,53.0,23.0
1260,5,4,1,1,1,4,23,11,2.0,2.0,0.0,0.0,0.0,2.0,18.0,42,5,37,3.0,0.0,3.0
9606312,21,11,10,15,9,12,41,8,5.0,2.0,3.0,6.0,1.0,4.0,8.0,45,21,24,3.0,2.0,1.0
9807528,21,8,13,35,0,21,114,16,15.0,4.0,11.0,31.0,0.0,15.0,87.0,42,21,21,8.0,7.0,1.0
5226,10,7,3,3,0,10,35,43,1.0,1.0,0.0,0.0,0.0,1.0,3.0,54,10,44,12.0,0.0,12.0
9310281,32,3,29,89,21,11,19,94,12.0,3.0,9.0,21.0,3.0,9.0,15.0,34,32,2,8.0,8.0,0.0
3022,34,8,26,88,0,34,350,4,31.0,6.0,25.0,87.0,0.0,31.0,322.0,67,34,33,37.0,19.0,18.0
12140,30,8,22,99,0,30,163,1,24.0,4.0,20.0,92.0,0.0,24.0,133.0,50,30,20,27.0,18.0,9.0
9209264,1,1,0,0,1,0,0,1688,,,,,,,,1,1,0,,,
9511396,3,2,1,1,0,3,7,39,1.0,1.0,0.0,0.0,1.0,0.0,0.0,8,3,5,,,
9603305,5,3,2,3,1,4,7,39,3.0,1.0,2.0,3.0,3.0,0.0,0.0,9,5,4,2.0,0.0,2.0
9810350,14,4,10,19,14,0,0,278,6.0,2.0,4.0,9.0,6.0,0.0,0.0,15,14,1,5.0,5.0,0.0
9511357,11,3,8,19,2,9,19,12,5.0,2.0,3.0,8.0,0.0,5.0,5.0,23,11,12,7.0,6.0,1.0
9907355,52,5,47,178,0,52,466,2,36.0,2.0,34.0,105.0,0.0,36.0,317.0,72,52,20,27.0,16.0,11.0
4029,12,1,11,21,0,12,96,16,10.0,1.0,9.0,18.0,0.0,10.0,66.0,27,12,15,17.0,9.0,8.0
9812523,24,6,18,64,0,24,107,16,5.0,2.0,3.0,5.0,0.0,5.0,27.0,42,24,18,18.0,15.0,3.0
101124,37,8,29,114,0,37,438,19,29.0,6.0,23.0,100.0,0.0,29.0,392.0,60,37,23,44.0,24.0,20.0
201161,24,4,20,78,0,24,413,19,22.0,3.0,19.0,77.0,0.0,22.0,386.0,77,24,53,45.0,22.0,23.0
9705305,17,2,15,39,2,15,41,140,9.0,3.0,6.0,14.0,1.0,8.0,14.0,28,17,11,11.0,8.0,3.0
105041,18,7,11,19,2,16,117,43,8.0,4.0,4.0,7.0,0.0,8.0,75.0,59,18,41,29.0,4.0,25.0
9702270,9,3,6,6,1,8,52,8,5.0,2.0,3.0,3.0,0.0,5.0,36.0,19,9,10,3.0,1.0,2.0
210369,2,1,1,1,0,2,22,19,2.0,1.0,1.0,1.0,0.0,2.0,17.0,20,2,18,13.0,2.0,11.0
107057,14,3,11,38,0,14,126,28,11.0,3.0,8.0,27.0,0.0,11.0,18.0,37,14,23,6.0,4.0,2.0
9409344,6,3,3,4,2,4,22,176,4.0,2.0,2.0,3.0,0.0,4.0,20.0,25,6,19,14.0,4.0,10.0
202072,13,3,10,23,0,13,56,28,6.0,1.0,5.0,7.0,0.0,6.0,21.0,22,13,9,12.0,6.0,6.0
9707452,3,2,1,1,0,3,13,26,0.0,0.0,0.0,0.0,0.0,0.0,0.0,30,3,27,3.0,0.0,3.0
9305308,12,4,8,15,12,0,0,91,7.0,2.0,5.0,10.0,7.0,0.0,0.0,12,12,0,6.0,6.0,0.0
1059,12,5,7,11,0,12,120,33,6.0,3.0,3.0,5.0,0.0,6.0,60.0,54,12,42,20.0,5.0,15.0
11132,17,11,6,15,1,16,58,2,9.0,5.0,4.0,10.0,1.0,8.0,13.0,40,17,23,12.0,9.0,3.0
9409436,12,2,10,22,3,9,18,35,9.0,1.0,8.0,19.0,1.0,8.0,15.0,16,12,4,11.0,9.0,2.0
9212286,2,1,1,1,0,2,4,96,2.0,1.0,1.0,1.0,0.0,2.0,4.0,4,2,2,4.0,2.0,2.0
9411241,25,5,20,53,8,17,34,10,14.0,3.0,11.0,25.0,4.0,10.0,22.0,33,25,8,6.0,6.0,0.0
9706494,11,2,9,18,0,11,35,10,9.0,1.0,8.0,15.0,0.0,9.0,32.0,24,11,13,8.0,7.0,1.0
5265,1,1,0,0,0,1,11,10,1.0,1.0,0.0,0.0,0.0,1.0,10.0,23,1,22,11.0,1.0,10.0
9309284,7,7,0,0,7,0,0,380,2.0,2.0,0.0,0.0,2.0,0.0,0.0,7,7,0,2.0,2.0,0.0
9806392,4,1,3,3,0,4,16,28,4.0,1.0,3.0,3.0,0.0,4.0,12.0,10,4,6,8.0,4.0,4.0
9606418,3,2,1,1,0,3,17,12,2.0,1.0,1.0,1.0,0.0,2.0,10.0,24,3,21,3.0,1.0,2.0
9401271,16,4,12,39,16,0,0,18,10.0,2.0,8.0,28.0,10.0,0.0,0.0,16,16,0,9.0,9.0,0.0
9706508,4,3,1,1,1,3,12,86,1.0,1.0,0.0,0.0,0.0,1.0,3.0,34,4,30,6.0,1.0,5.0
9805443,4,3,1,1,2,2,5,454,1.0,1.0,0.0,0.0,0.0,1.0,2.0,8,4,4,4.0,2.0,2.0
9602438,43,23,20,36,9,34,132,61,10.0,9.0,1.0,1.0,0.0,10.0,29.0,65,43,22,11.0,5.0,6.0
109090,16,10,6,11,1,15,110,1,3.0,3.0,0.0,0.0,0.0,3.0,16.0,128,16,112,10.0,0.0,10.0
8338,3,1,2,2,0,3,7,34,,,,,,,,6,3,3,,,
101212,9,3,6,9,0,9,132,34,5.0,2.0,3.0,3.0,0.0,5.0,114.0,51,9,42,32.0,5.0,27.0
9904321,12,5,7,10,5,7,58,1,5.0,3.0,2.0,2.0,0.0,5.0,41.0,27,12,15,17.0,2.0,15.0
9305310,26,12,14,29,26,0,0,61,9.0,2.0,7.0,16.0,9.0,0.0,0.0,27,26,1,3.0,3.0,0.0
9412315,17,5,12,26,15,2,2,79,8.0,5.0,3.0,8.0,8.0,0.0,0.0,18,17,1,7.0,7.0,0.0
9506320,4,4,0,0,4,0,0,197,2.0,2.0,0.0,0.0,2.0,0.0,0.0,4,4,0,2.0,2.0,0.0
9704201,42,5,37,218,0,42,194,11,35.0,2.0,33.0,206.0,0.0,35.0,163.0,52,42,10,14.0,13.0,1.0
9806367,11,6,5,11,1,10,18,11,3.0,3.0,0.0,0.0,0.0,3.0,4.0,16,11,5,8.0,5.0,3.0
9609504,15,4,11,26,0,15,107,17,12.0,2.0,10.0,24.0,0.0,12.0,98.0,37,15,22,19.0,3.0,16.0
9610401,17,6,11,23,0,17,62,17,13.0,5.0,8.0,15.0,0.0,13.0,55.0,25,17,8,7.0,3.0,4.0
9506480,10,5,5,6,0,10,29,26,4.0,2.0,2.0,3.0,0.0,4.0,22.0,17,10,7,9.0,3.0,6.0
9609318,7,5,2,2,0,7,10,26,1.0,1.0,0.0,0.0,1.0,0.0,0.0,14,7,7,3.0,3.0,0.0
9703357,21,2,19,56,8,13,13,25,8.0,1.0,7.0,16.0,8.0,0.0,0.0,23,21,2,4.0,4.0,0.0
9410372,27,8,19,34,22,5,8,104,3.0,3.0,0.0,0.0,1.0,2.0,4.0,29,27,2,3.0,3.0,0.0
9702293,8,3,5,8,2,6,13,52,6.0,2.0,4.0,6.0,6.0,0.0,0.0,12,8,4,3.0,3.0,0.0
9510207,21,4,17,38,5,16,36,8,10.0,1.0,9.0,18.0,1.0,9.0,10.0,26,21,5,10.0,9.0,1.0
9410415,18,8,10,38,1,17,17,22,12.0,5.0,7.0,25.0,0.0,12.0,12.0,20,18,2,12.0,11.0,1.0
9901432,22,4,18,81,2,20,41,4,18.0,2.0,16.0,70.0,0.0,18.0,29.0,27,22,5,19.0,17.0,2.0
9706337,12,9,3,3,4,8,17,169,2.0,1.0,1.0,1.0,0.0,2.0,2.0,29,12,17,3.0,2.0,1.0
9707395,66,7,59,453,2,64,425,12,58.0,5.0,53.0,422.0,0.0,58.0,393.0,84,66,18,51.0,41.0,10.0
9410228,11,5,6,13,4,7,19,129,4.0,1.0,3.0,6.0,0.0,4.0,8.0,17,11,6,9.0,5.0,4.0
105348,4,4,0,0,0,4,24,28,3.0,3.0,0.0,0.0,0.0,3.0,20.0,17,4,13,1.0,0.0,1.0
9409428,16,5,11,19,6,10,14,192,3.0,2.0,1.0,1.0,0.0,3.0,4.0,18,16,2,5.0,3.0,2.0
9305322,7,3,4,4,5,2,2,413,4.0,1.0,3.0,3.0,4.0,0.0,0.0,8,7,1,4.0,4.0,0.0
9402286,32,7,25,56,32,0,0,129,19.0,4.0,15.0,34.0,19.0,0.0,0.0,32,32,0,7.0,7.0,0.0
9506280,46,8,38,220,21,25,40,68,27.0,1.0,26.0,162.0,27.0,0.0,0.0,51,46,5,20.0,20.0,0.0
9803337,15,3,12,19,2,13,35,24,10.0,2.0,8.0,10.0,1.0,9.0,25.0,21,15,6,2.0,1.0,1.0
9809485,16,6,10,13,9,7,12,8,5.0,2.0,3.0,5.0,5.0,0.0,0.0,24,16,8,7.0,3.0,4.0
9711324,7,5,2,2,0,7,12,64,7.0,5.0,2.0,2.0,0.0,7.0,12.0,11,7,4,7.0,5.0,2.0
9809385,2,2,0,0,0,2,2,224,2.0,2.0,0.0,0.0,2.0,0.0,0.0,4,2,2,3.0,2.0,1.0
9603289,52,12,40,146,26,26,54,9,22.0,2.0,20.0,78.0,9.0,13.0,15.0,64,52,12,19.0,18.0,1.0
5132,5,3,2,3,0,5,11,14,0.0,0.0,0.0,0.0,0.0,0.0,0.0,14,5,9,3.0,1.0,2.0
9708335,35,10,25,89,3,32,131,14,23.0,7.0,16.0,64.0,0.0,23.0,98.0,49,35,14,24.0,17.0,7.0
9702227,28,13,15,31,1,27,117,14,7.0,3.0,4.0,8.0,0.0,7.0,36.0,110,28,82,5.0,4.0,1.0
9305240,4,4,0,0,4,0,0,607,1.0,1.0,0.0,0.0,1.0,0.0,0.0,4,4,0,1.0,1.0,0.0
9612270,13,6,7,16,2,11,43,14,6.0,1.0,5.0,9.0,1.0,5.0,23.0,27,13,14,3.0,2.0,1.0
9911207,25,8,17,48,0,25,109,27,20.0,5.0,15.0,41.0,0.0,20.0,79.0,40,25,15,11.0,7.0,4.0
9912386,0,0,0,0,0,0,0,337,0.0,0.0,0.0,0.0,0.0,0.0,0.0,5,0,5,5.0,0.0,5.0
9708345,8,7,1,1,1,7,8,8,3.0,3.0,0.0,0.0,3.0,0.0,0.0,23,8,15,1.0,0.0,1.0
9707345,42,16,26,61,5,37,116,44,8.0,4.0,4.0,9.0,0.0,8.0,17.0,57,42,15,14.0,9.0,5.0
9909407,17,12,5,9,13,4,6,64,2.0,2.0,0.0,0.0,2.0,0.0,0.0,23,17,6,2.0,2.0,0.0
9911276,14,6,8,20,0,14,106,17,5.0,3.0,2.0,3.0,0.0,5.0,55.0,57,14,43,27.0,1.0,26.0
9304270,5,2,3,4,5,0,0,17,1.0,1.0,0.0,0.0,1.0,0.0,0.0,5,5,0,1.0,1.0,0.0
9605207,12,4,8,44,0,12,28,16,11.0,3.0,8.0,43.0,0.0,11.0,16.0,18,12,6,6.0,3.0,3.0
9612489,4,3,1,1,0,4,18,8,2.0,1.0,1.0,1.0,0.0,2.0,5.0,28,4,24,6.0,2.0,4.0
9605281,50,17,33,70,3,47,89,47,18.0,2.0,16.0,30.0,2.0,16.0,18.0,65,50,15,16.0,15.0,1.0
9706437,8,2,6,9,1,7,18,150,2.0,1.0,1.0,1.0,0.0,2.0,7.0,15,8,7,1.0,1.0,0.0
9711224,14,8,6,10,2,12,58,150,3.0,3.0,0.0,0.0,0.0,3.0,10.0,50,14,36,12.0,1.0,11.0
9710257,15,5,10,24,3,12,59,8,6.0,2.0,4.0,9.0,1.0,5.0,14.0,36,15,21,13.0,8.0,5.0
9501345,7,7,0,0,6,1,1,97,3.0,3.0,0.0,0.0,3.0,0.0,0.0,8,7,1,3.0,3.0,0.0
9312350,52,24,28,53,50,2,2,156,31.0,6.0,25.0,50.0,31.0,0.0,0.0,53,52,1,12.0,12.0,0.0
9210227,33,9,24,58,26,7,7,22,8.0,1.0,7.0,22.0,8.0,0.0,0.0,34,33,1,8.0,8.0,0.0
9403391,17,11,6,10,6,11,17,15,6.0,4.0,2.0,2.0,6.0,0.0,0.0,19,17,2,3.0,3.0,0.0
9508352,7,1,6,9,2,5,18,15,2.0,1.0,1.0,1.0,2.0,0.0,0.0,15,7,8,6.0,2.0,4.0
9206227,28,15,13,31,28,0,0,15,6.0,4.0,2.0,3.0,6.0,0.0,0.0,28,28,0,5.0,5.0,0.0
9210238,7,3,4,5,7,0,0,10,7.0,3.0,4.0,5.0,7.0,0.0,0.0,7,7,0,4.0,4.0,0.0
10006,5,5,0,0,0,5,25,86,1.0,1.0,0.0,0.0,0.0,1.0,5.0,28,5,23,7.0,1.0,6.0
9810468,8,7,1,2,3,5,8,159,1.0,1.0,0.0,0.0,1.0,0.0,0.0,13,8,5,1.0,0.0,1.0
9907450,8,2,6,8,0,8,20,122,7.0,2.0,5.0,5.0,0.0,7.0,17.0,11,8,3,9.0,7.0,2.0
9808498,10,3,7,15,4,6,9,0,7.0,1.0,6.0,12.0,7.0,0.0,0.0,18,10,8,,,
7355,49,18,31,90,9,40,154,52,19.0,4.0,15.0,57.0,1.0,18.0,71.0,125,49,76,23.0,15.0,8.0
9702369,1,1,0,0,0,1,1,289,0.0,0.0,0.0,0.0,0.0,0.0,0.0,5,1,4,2.0,0.0,2.0
9404243,11,2,9,19,2,9,12,10,8.0,2.0,6.0,13.0,2.0,6.0,6.0,14,11,3,7.0,6.0,1.0
9612282,7,3,4,6,0,7,52,15,2.0,2.0,0.0,0.0,0.0,2.0,23.0,38,7,31,7.0,0.0,7.0
9811339,3,2,1,2,0,3,14,255,1.0,1.0,0.0,0.0,0.0,1.0,5.0,17,3,14,5.0,1.0,4.0
10115,8,3,5,5,1,7,11,1,,,,,,,,15,8,7,1.0,1.0,0.0
9709249,7,1,6,13,0,7,7,120,6.0,1.0,5.0,9.0,0.0,6.0,6.0,8,7,1,7.0,6.0,1.0
6173,8,5,3,3,0,8,107,12,1.0,1.0,0.0,0.0,0.0,1.0,20.0,56,8,48,15.0,1.0,14.0
9305207,12,2,10,26,3,9,18,40,10.0,2.0,8.0,22.0,2.0,8.0,16.0,15,12,3,6.0,6.0,0.0
9608394,35,3,32,105,0,35,247,8,27.0,2.0,25.0,92.0,0.0,27.0,189.0,56,35,21,12.0,8.0,4.0
9501349,10,7,3,3,1,9,44,10,3.0,2.0,1.0,1.0,0.0,3.0,11.0,39,10,29,10.0,2.0,8.0
104254,12,1,11,20,1,11,89,23,6.0,1.0,5.0,8.0,0.0,6.0,55.0,40,12,28,19.0,3.0,16.0
8010,19,9,10,25,3,16,80,3,10.0,5.0,5.0,11.0,0.0,10.0,53.0,42,19,23,5.0,4.0,1.0
9804206,6,3,3,4,0,6,11,123,5.0,3.0,2.0,3.0,0.0,5.0,7.0,9,6,3,6.0,4.0,2.0
9805264,31,6,25,55,4,27,210,15,11.0,3.0,8.0,15.0,0.0,11.0,73.0,68,31,37,21.0,6.0,15.0
9812413,17,3,14,34,3,14,53,21,10.0,2.0,8.0,19.0,2.0,8.0,20.0,32,17,15,9.0,2.0,7.0
9310263,2,1,1,1,1,1,2,419,0.0,0.0,0.0,0.0,0.0,0.0,0.0,4,2,2,2.0,0.0,2.0
9605311,2,2,0,0,1,1,1,25,1.0,1.0,0.0,0.0,0.0,1.0,1.0,7,2,5,1.0,0.0,1.0
9703254,10,5,5,12,1,9,54,14,3.0,1.0,2.0,3.0,0.0,3.0,14.0,52,10,42,7.0,3.0,4.0
9809256,4,2,2,3,0,4,6,71,2.0,1.0,1.0,1.0,2.0,0.0,0.0,9,4,5,3.0,3.0,0.0
9711439,3,1,2,2,0,3,19,30,2.0,1.0,1.0,1.0,0.0,2.0,10.0,18,3,15,4.0,2.0,2.0
106155,10,8,2,5,2,8,26,95,2.0,2.0,0.0,0.0,0.0,2.0,9.0,31,10,21,10.0,2.0,8.0
9907446,43,6,37,212,0,43,475,32,36.0,7.0,29.0,196.0,0.0,36.0,421.0,72,43,29,46.0,29.0,17.0
9907368,10,4,6,12,0,10,25,32,1.0,1.0,0.0,0.0,0.0,1.0,2.0,24,10,14,4.0,1.0,3.0
9812314,1,1,0,0,0,1,4,55,1.0,1.0,0.0,0.0,0.0,1.0,4.0,8,1,7,2.0,0.0,2.0
104145,21,8,13,41,0,21,84,4,7.0,2.0,5.0,15.0,0.0,7.0,14.0,43,21,22,8.0,7.0,1.0
9812269,54,10,44,116,2,52,207,83,17.0,2.0,15.0,49.0,0.0,17.0,74.0,74,54,20,24.0,15.0,9.0
1231,4,3,1,1,1,3,12,21,1.0,1.0,0.0,0.0,0.0,1.0,2.0,25,4,21,2.0,1.0,1.0
9503419,4,4,0,0,2,2,2,413,1.0,1.0,0.0,0.0,1.0,0.0,0.0,5,4,1,,,
9605401,11,2,9,19,0,11,30,8,9.0,2.0,7.0,16.0,0.0,9.0,21.0,17,11,6,7.0,5.0,2.0
207160,1,1,0,0,0,1,1,12,0.0,0.0,0.0,0.0,0.0,0.0,0.0,12,1,11,2.0,0.0,2.0
9812481,3,2,1,1,0,3,3,36,2.0,2.0,0.0,0.0,2.0,0.0,0.0,11,3,8,1.0,1.0,0.0
1224,10,2,8,17,0,10,57,12,8.0,1.0,7.0,14.0,2.0,6.0,10.0,26,10,16,8.0,7.0,1.0
9903250,2,2,0,0,2,0,0,3,0.0,0.0,0.0,0.0,0.0,0.0,0.0,39,2,37,21.0,0.0,21.0
11375,9,3,6,16,0,9,48,0,5.0,1.0,4.0,10.0,0.0,5.0,16.0,29,9,20,6.0,3.0,3.0
9405357,6,5,1,1,4,2,8,81,2.0,2.0,0.0,0.0,0.0,2.0,8.0,12,6,6,6.0,1.0,5.0
9607266,11,3,8,17,0,11,18,89,8.0,2.0,6.0,15.0,0.0,8.0,13.0,15,11,4,2.0,2.0,0.0
9302219,16,3,13,32,16,0,0,13,5.0,3.0,2.0,2.0,5.0,0.0,0.0,16,16,0,2.0,2.0,0.0
9610363,12,7,5,9,2,10,108,6,5.0,4.0,1.0,1.0,0.0,5.0,94.0,38,12,26,25.0,5.0,20.0
9906307,5,4,1,1,2,3,25,46,1.0,1.0,0.0,0.0,0.0,1.0,14.0,45,5,40,5.0,0.0,5.0
111101,5,3,2,2,0,5,13,42,2.0,1.0,1.0,1.0,2.0,0.0,0.0,10,5,5,1.0,1.0,0.0
9712530,1,1,0,0,0,1,9,10,0.0,0.0,0.0,0.0,0.0,0.0,0.0,25,1,24,4.0,0.0,4.0
9802219,3,1,2,2,0,3,8,204,3.0,1.0,2.0,2.0,0.0,3.0,5.0,7,3,4,4.0,2.0,2.0
9503244,2,2,0,0,1,1,1,275,0.0,0.0,0.0,0.0,0.0,0.0,0.0,6,2,4,1.0,0.0,1.0
9808303,19,4,15,24,8,11,28,1,2.0,2.0,0.0,0.0,0.0,2.0,4.0,27,19,8,4.0,1.0,3.0
9806336,42,6,36,108,0,42,173,83,24.0,2.0,22.0,73.0,0.0,24.0,83.0,63,42,21,19.0,13.0,6.0
9802419,29,18,11,24,9,20,137,53,14.0,6.0,8.0,21.0,0.0,14.0,126.0,61,29,32,33.0,12.0,21.0
9507347,3,3,0,0,3,0,0,249,3.0,3.0,0.0,0.0,3.0,0.0,0.0,4,3,1,2.0,2.0,0.0
9911300,3,3,0,0,2,1,1,125,1.0,1.0,0.0,0.0,1.0,0.0,0.0,5,3,2,2.0,1.0,1.0
9806499,16,2,14,29,1,15,36,143,14.0,1.0,13.0,28.0,0.0,14.0,34.0,20,16,4,12.0,9.0,3.0
9710216,13,5,8,13,9,4,5,29,4.0,1.0,3.0,6.0,4.0,0.0,0.0,15,13,2,6.0,6.0,0.0
107291,27,5,22,82,2,25,75,165,21.0,4.0,17.0,74.0,1.0,20.0,56.0,36,27,9,23.0,19.0,4.0
108233,6,2,4,5,0,6,35,24,5.0,1.0,4.0,5.0,0.0,5.0,30.0,22,6,16,1.0,1.0,0.0
9708386,8,6,2,2,0,8,37,8,4.0,3.0,1.0,1.0,0.0,4.0,27.0,32,8,24,10.0,0.0,10.0
9503315,8,7,1,1,8,0,0,203,2.0,2.0,0.0,0.0,2.0,0.0,0.0,15,8,7,2.0,1.0,1.0
9504320,15,6,9,19,2,13,26,18,6.0,2.0,4.0,9.0,1.0,5.0,5.0,23,15,8,7.0,5.0,2.0
9806530,19,5,14,23,2,17,73,43,7.0,2.0,5.0,8.0,0.0,7.0,30.0,33,19,14,5.0,5.0,0.0
4233,3,3,0,0,0,3,22,2,1.0,1.0,0.0,0.0,0.0,1.0,7.0,17,3,14,10.0,1.0,9.0
9607347,6,1,5,9,3,3,3,151,4.0,1.0,3.0,5.0,1.0,3.0,3.0,7,6,1,5.0,4.0,1.0
204250,4,2,2,2,1,3,21,65,3.0,1.0,2.0,2.0,0.0,3.0,20.0,19,4,15,4.0,0.0,4.0
3068,8,2,6,14,0,8,104,21,7.0,1.0,6.0,14.0,0.0,7.0,97.0,27,8,19,24.0,7.0,17.0
106064,2,2,0,0,2,0,0,3,0.0,0.0,0.0,0.0,0.0,0.0,0.0,17,2,15,1.0,1.0,0.0
9511382,11,3,8,13,5,6,17,200,11.0,3.0,8.0,13.0,5.0,6.0,17.0,16,11,5,11.0,6.0,5.0
9805430,14,5,9,16,2,12,15,152,8.0,3.0,5.0,7.0,4.0,4.0,4.0,21,14,7,5.0,4.0,1.0
9703208,19,1,18,76,1,18,39,8,12.0,1.0,11.0,43.0,12.0,0.0,0.0,26,19,7,12.0,12.0,0.0
9903497,4,2,2,5,0,4,28,3,,,,,,,,15,4,11,5.0,0.0,5.0
9410347,14,4,10,26,9,5,5,169,5.0,1.0,4.0,7.0,2.0,3.0,3.0,15,14,1,6.0,5.0,1.0
9610405,11,4,7,9,4,7,7,350,6.0,2.0,4.0,4.0,3.0,3.0,3.0,16,11,5,3.0,2.0,1.0
202145,5,3,2,2,1,4,15,0,3.0,2.0,1.0,1.0,1.0,2.0,8.0,13,5,8,1.0,0.0,1.0
108145,17,3,14,44,1,16,63,0,12.0,3.0,9.0,31.0,0.0,12.0,35.0,34,17,17,11.0,6.0,5.0
103322,14,7,7,12,3,11,47,122,5.0,2.0,3.0,3.0,0.0,5.0,19.0,25,14,11,13.0,6.0,7.0
209028,5,2,3,4,5,0,0,393,4.0,1.0,3.0,4.0,4.0,0.0,0.0,6,5,1,4.0,4.0,0.0
9707250,6,4,2,3,1,5,24,27,4.0,2.0,2.0,3.0,0.0,4.0,17.0,16,6,10,10.0,3.0,7.0
110346,9,4,5,6,0,9,129,2,6.0,3.0,3.0,3.0,0.0,6.0,89.0,55,9,46,18.0,4.0,14.0
9705419,1,1,0,0,1,0,0,59,0.0,0.0,0.0,0.0,0.0,0.0,0.0,7,1,6,2.0,0.0,2.0
5260,28,7,21,61,0,28,163,60,3.0,2.0,1.0,1.0,0.0,3.0,24.0,102,28,74,21.0,1.0,20.0
104151,17,3,14,33,0,17,276,23,16.0,2.0,14.0,33.0,0.0,16.0,261.0,64,17,47,29.0,11.0,18.0
9508257,1,1,0,0,0,1,2,35,0.0,0.0,0.0,0.0,0.0,0.0,0.0,9,1,8,2.0,0.0,2.0
9606472,3,2,1,1,0,3,20,17,3.0,2.0,1.0,1.0,0.0,3.0,20.0,18,3,15,1.0,1.0,0.0
9607439,26,7,19,53,0,26,55,56,26.0,7.0,19.0,53.0,0.0,26.0,55.0,30,26,4,21.0,18.0,3.0
9611240,2,2,0,0,1,1,2,33,0.0,0.0,0.0,0.0,0.0,0.0,0.0,35,2,33,1.0,0.0,1.0
9303234,22,7,15,73,22,0,0,94,18.0,3.0,15.0,73.0,18.0,0.0,0.0,22,22,0,15.0,15.0,0.0
9903257,8,4,4,4,0,8,56,92,6.0,3.0,3.0,3.0,0.0,6.0,44.0,54,8,46,14.0,2.0,12.0
3259,1,1,0,0,1,0,0,2,0.0,0.0,0.0,0.0,0.0,0.0,0.0,20,1,19,2.0,0.0,2.0
9508269,7,4,3,4,7,0,0,87,2.0,1.0,1.0,1.0,2.0,0.0,0.0,8,7,1,2.0,2.0,0.0
212126,27,8,19,56,13,14,14,0,8.0,2.0,6.0,17.0,3.0,5.0,5.0,29,27,2,2.0,2.0,0.0
9510212,24,9,15,31,5,19,22,29,8.0,4.0,4.0,9.0,0.0,8.0,8.0,33,24,9,8.0,7.0,1.0
9704359,10,7,3,5,0,10,43,15,9.0,6.0,3.0,5.0,0.0,9.0,27.0,23,10,13,10.0,4.0,6.0
9307213,5,2,3,7,0,5,10,176,5.0,2.0,3.0,7.0,0.0,5.0,10.0,7,5,2,7.0,5.0,2.0
103110,13,8,5,8,2,11,43,74,5.0,2.0,3.0,5.0,0.0,5.0,16.0,25,13,12,14.0,6.0,8.0
1130,12,5,7,15,6,6,27,130,5.0,3.0,2.0,3.0,0.0,5.0,24.0,22,12,10,10.0,5.0,5.0
9412310,38,5,33,166,32,6,8,130,27.0,2.0,25.0,122.0,27.0,0.0,0.0,40,38,2,20.0,20.0,0.0
206202,0,0,0,0,0,0,0,135,0.0,0.0,0.0,0.0,0.0,0.0,0.0,12,0,12,5.0,0.0,5.0
205022,36,10,26,62,1,35,259,0,4.0,1.0,3.0,5.0,0.0,4.0,61.0,76,36,40,23.0,4.0,19.0
102245,11,5,6,10,2,9,16,72,4.0,1.0,3.0,4.0,0.0,4.0,10.0,15,11,4,8.0,5.0,3.0
108168,26,11,15,32,1,25,298,3,13.0,6.0,7.0,12.0,0.0,13.0,185.0,89,26,63,26.0,2.0,24.0
9806523,6,4,2,2,1,5,18,3,4.0,2.0,2.0,2.0,0.0,4.0,14.0,17,6,11,4.0,1.0,3.0
206193,5,4,1,1,0,5,21,0,4.0,4.0,0.0,0.0,0.0,4.0,13.0,15,5,10,8.0,1.0,7.0
9703362,3,3,0,0,0,3,4,484,1.0,1.0,0.0,0.0,0.0,1.0,1.0,7,3,4,2.0,1.0,1.0
1044,3,1,2,2,0,3,15,4,2.0,1.0,1.0,1.0,0.0,2.0,8.0,25,3,22,1.0,1.0,0.0
105178,1,1,0,0,0,1,1,4,0.0,0.0,0.0,0.0,0.0,0.0,0.0,62,1,61,11.0,0.0,11.0
9805268,55,14,41,83,17,38,93,47,11.0,4.0,7.0,8.0,0.0,11.0,41.0,67,55,12,13.0,8.0,5.0
112287,10,5,5,8,0,10,97,3,4.0,3.0,1.0,1.0,0.0,4.0,45.0,53,10,43,14.0,4.0,10.0
12092,5,4,1,1,0,5,32,2,1.0,1.0,0.0,0.0,0.0,1.0,6.0,35,5,30,14.0,0.0,14.0
201099,12,5,7,9,1,11,54,0,5.0,2.0,3.0,4.0,0.0,5.0,35.0,39,12,27,14.0,4.0,10.0
9807526,2,1,1,1,2,0,0,5,0.0,0.0,0.0,0.0,0.0,0.0,0.0,17,2,15,1.0,0.0,1.0
9212226,45,10,35,107,35,10,11,166,18.0,2.0,16.0,53.0,18.0,0.0,0.0,48,45,3,12.0,12.0,0.0
1202,18,4,14,36,1,17,106,11,8.0,2.0,6.0,13.0,1.0,7.0,17.0,38,18,20,9.0,6.0,3.0
9712445,23,4,19,40,1,22,78,1,8.0,1.0,7.0,11.0,0.0,8.0,32.0,35,23,12,5.0,5.0,0.0
9605234,19,4,15,58,7,12,15,82,18.0,3.0,15.0,56.0,6.0,12.0,15.0,21,19,2,16.0,14.0,2.0
9410391,2,2,0,0,0,2,4,25,1.0,1.0,0.0,0.0,0.0,1.0,3.0,14,2,12,1.0,0.0,1.0
9708290,8,4,4,8,2,6,9,101,5.0,3.0,2.0,2.0,1.0,4.0,4.0,11,8,3,4.0,3.0,1.0
9910492,31,15,16,26,3,28,146,16,11.0,6.0,5.0,6.0,0.0,11.0,71.0,58,31,27,23.0,2.0,21.0
9706450,33,1,32,147,2,31,132,13,29.0,1.0,28.0,127.0,4.0,25.0,64.0,47,33,14,22.0,21.0,1.0
9807564,1,1,0,0,0,1,3,13,1.0,1.0,0.0,0.0,0.0,1.0,3.0,4,1,3,,,
9306305,5,4,1,1,3,2,2,592,3.0,3.0,0.0,0.0,2.0,1.0,1.0,6,5,1,3.0,3.0,0.0
9412355,16,10,6,7,13,3,4,180,5.0,2.0,3.0,4.0,5.0,0.0,0.0,19,16,3,3.0,3.0,0.0
9501271,3,3,0,0,3,0,0,218,1.0,1.0,0.0,0.0,1.0,0.0,0.0,3,3,0,1.0,1.0,0.0
1098,10,5,5,8,1,9,45,46,6.0,3.0,3.0,6.0,0.0,6.0,24.0,33,10,23,9.0,1.0,8.0
102134,10,7,3,4,0,10,15,39,6.0,4.0,2.0,2.0,0.0,6.0,9.0,14,10,4,6.0,5.0,1.0
9711254,5,4,1,1,3,2,11,25,0.0,0.0,0.0,0.0,0.0,0.0,0.0,21,5,16,2.0,2.0,0.0
9206204,2,1,1,1,2,0,0,1929,2.0,1.0,1.0,1.0,2.0,0.0,0.0,2,2,0,2.0,2.0,0.0
202131,19,7,12,30,1,18,123,25,9.0,2.0,7.0,17.0,0.0,9.0,55.0,61,19,42,26.0,7.0,19.0
9405327,8,4,4,5,3,5,6,61,2.0,1.0,1.0,1.0,1.0,1.0,1.0,11,8,3,4.0,3.0,1.0
4246,6,2,4,6,0,6,17,6,2.0,1.0,1.0,1.0,1.0,1.0,1.0,18,6,12,4.0,3.0,1.0
9807510,1,1,0,0,0,1,2,103,0.0,0.0,0.0,0.0,0.0,0.0,0.0,3,1,2,2.0,1.0,1.0
9803465,1,1,0,0,1,0,0,263,0.0,0.0,0.0,0.0,0.0,0.0,0.0,2,1,1,1.0,0.0,1.0
210427,2,2,0,0,0,2,7,128,2.0,2.0,0.0,0.0,1.0,1.0,4.0,15,2,13,6.0,1.0,5.0
9204213,7,4,3,3,7,0,0,461,5.0,3.0,2.0,2.0,5.0,0.0,0.0,7,7,0,4.0,4.0,0.0
11196,1,1,0,0,1,0,0,18,0.0,0.0,0.0,0.0,0.0,0.0,0.0,9,1,8,1.0,0.0,1.0
9505439,1,1,0,0,1,0,0,61,0.0,0.0,0.0,0.0,0.0,0.0,0.0,10,1,9,1.0,0.0,1.0
9308317,16,9,7,12,9,7,10,195,5.0,3.0,2.0,3.0,5.0,0.0,0.0,19,16,3,3.0,3.0,0.0
9301293,8,4,4,5,8,0,0,384,3.0,2.0,1.0,1.0,3.0,0.0,0.0,8,8,0,1.0,1.0,0.0
9809546,4,4,0,0,1,3,10,21,1.0,1.0,0.0,0.0,0.0,1.0,3.0,13,4,9,1.0,0.0,1.0
9905420,4,3,1,2,1,3,9,58,1.0,1.0,0.0,0.0,1.0,0.0,0.0,11,4,7,7.0,3.0,4.0
9911475,2,2,0,0,0,2,4,19,1.0,1.0,0.0,0.0,0.0,1.0,1.0,11,2,9,1.0,1.0,0.0
101180,13,8,5,5,4,9,37,16,5.0,2.0,3.0,3.0,0.0,5.0,24.0,27,13,14,13.0,6.0,7.0
211123,0,0,0,0,0,0,0,1919,0.0,0.0,0.0,0.0,0.0,0.0,0.0,5,0,5,2.0,0.0,2.0
107211,3,3,0,0,0,3,16,20,1.0,1.0,0.0,0.0,0.0,1.0,8.0,20,3,17,1.0,0.0,1.0
4248,4,1,3,3,0,4,16,4,4.0,1.0,3.0,3.0,0.0,4.0,12.0,19,4,15,11.0,2.0,9.0
9808263,8,2,6,13,1,7,40,90,7.0,2.0,5.0,12.0,1.0,6.0,23.0,19,8,11,11.0,7.0,4.0
9703216,5,3,2,2,0,5,12,411,3.0,1.0,2.0,2.0,0.0,3.0,9.0,12,5,7,7.0,3.0,4.0
9810331,7,1,6,11,0,7,26,77,5.0,1.0,4.0,6.0,2.0,3.0,7.0,16,7,9,8.0,5.0,3.0
9805493,5,1,4,5,0,5,18,90,3.0,1.0,2.0,2.0,0.0,3.0,7.0,15,5,10,7.0,4.0,3.0
9911429,3,3,0,0,0,3,41,1,3.0,3.0,0.0,0.0,0.0,3.0,33.0,42,3,39,22.0,1.0,21.0
9805375,4,4,0,0,4,0,0,139,1.0,1.0,0.0,0.0,1.0,0.0,0.0,4,4,0,1.0,1.0,0.0
111156,2,1,1,1,0,2,10,0,2.0,1.0,1.0,1.0,0.0,2.0,7.0,16,2,14,9.0,2.0,7.0
9501344,14,3,11,36,11,3,3,8,11.0,2.0,9.0,28.0,9.0,2.0,2.0,15,14,1,12.0,11.0,1.0
204010,1,1,0,0,0,1,10,177,1.0,1.0,0.0,0.0,0.0,1.0,8.0,12,1,11,10.0,1.0,9.0
9611308,3,1,2,2,0,3,11,97,3.0,1.0,2.0,2.0,0.0,3.0,9.0,11,3,8,7.0,3.0,4.0
9806284,9,4,5,10,4,5,8,189,2.0,1.0,1.0,1.0,0.0,2.0,5.0,13,9,4,5.0,2.0,3.0
9707485,25,4,21,101,0,25,199,53,19.0,2.0,17.0,91.0,0.0,19.0,179.0,46,25,21,33.0,18.0,15.0
10097,6,3,3,3,1,5,12,0,1.0,1.0,0.0,0.0,0.0,1.0,1.0,22,6,16,3.0,1.0,2.0
9711302,13,6,7,7,2,11,23,35,0.0,0.0,0.0,0.0,0.0,0.0,0.0,33,13,20,6.0,0.0,6.0
9702248,2,2,0,0,2,0,0,121,1.0,1.0,0.0,0.0,1.0,0.0,0.0,3,2,1,,,
9402356,1,1,0,0,1,0,0,243,0.0,0.0,0.0,0.0,0.0,0.0,0.0,5,1,4,1.0,0.0,1.0
9401218,7,5,2,2,7,0,0,116,5.0,3.0,2.0,2.0,5.0,0.0,0.0,10,7,3,2.0,0.0,2.0
201236,1,1,0,0,0,1,4,8,0.0,0.0,0.0,0.0,0.0,0.0,0.0,19,1,18,9.0,0.0,9.0
9404252,0,0,0,0,0,0,0,1816,,,,,,,,1,0,1,,,
9702344,2,2,0,0,2,0,0,30,0.0,0.0,0.0,0.0,0.0,0.0,0.0,11,2,9,1.0,1.0,0.0
9812485,2,1,1,1,1,1,4,321,2.0,1.0,1.0,1.0,2.0,0.0,0.0,8,2,6,1.0,0.0,1.0
9712262,0,0,0,0,0,0,0,138,0.0,0.0,0.0,0.0,0.0,0.0,0.0,11,0,11,4.0,0.0,4.0
9310336,9,1,8,23,9,0,0,167,9.0,1.0,8.0,23.0,9.0,0.0,0.0,9,9,0,9.0,9.0,0.0
1100,4,4,0,0,2,2,10,9,,,,,,,,9,4,5,,,
9601363,17,8,9,20,14,3,3,209,7.0,2.0,5.0,12.0,7.0,0.0,0.0,19,17,2,3.0,3.0,0.0
9508259,35,2,33,110,0,35,65,115,34.0,2.0,32.0,104.0,0.0,34.0,63.0,38,35,3,19.0,18.0,1.0
9501391,2,2,0,0,0,2,2,1895,,,,,,,,3,2,1,,,
9901244,16,10,6,8,3,13,44,14,3.0,1.0,2.0,3.0,0.0,3.0,10.0,39,16,23,5.0,2.0,3.0
9710400,3,1,2,3,0,3,7,14,2.0,1.0,1.0,1.0,2.0,0.0,0.0,6,3,3,2.0,2.0,0.0
4172,9,7,2,2,3,6,28,135,1.0,1.0,0.0,0.0,0.0,1.0,5.0,28,9,19,7.0,1.0,6.0
9806417,5,3,2,2,2,3,3,198,2.0,2.0,0.0,0.0,0.0,2.0,2.0,6,5,1,1.0,1.0,0.0
9604282,7,3,4,8,0,7,40,17,6.0,2.0,4.0,8.0,0.0,6.0,21.0,36,7,29,7.0,5.0,2.0
9707298,10,4,6,22,0,10,39,56,5.0,4.0,1.0,1.0,0.0,5.0,21.0,15,10,5,5.0,5.0,0.0
9705351,5,1,4,9,0,5,11,243,2.0,1.0,1.0,1.0,0.0,2.0,4.0,14,5,9,4.0,2.0,2.0
9507427,12,5,7,21,12,0,0,50,5.0,3.0,2.0,3.0,5.0,0.0,0.0,12,12,0,4.0,4.0,0.0
211358,1,1,0,0,0,1,2,193,0.0,0.0,0.0,0.0,0.0,0.0,0.0,12,1,11,6.0,0.0,6.0
9906261,4,3,1,1,0,4,13,9,1.0,1.0,0.0,0.0,0.0,1.0,2.0,11,4,7,7.0,2.0,5.0
109100,6,4,2,3,0,6,26,38,4.0,3.0,1.0,1.0,0.0,4.0,18.0,21,6,15,3.0,3.0,0.0
101136,22,11,11,22,5,17,39,172,11.0,4.0,7.0,14.0,2.0,9.0,27.0,28,22,6,13.0,9.0,4.0
9910542,5,4,1,1,1,4,9,377,3.0,2.0,1.0,1.0,0.0,3.0,3.0,9,5,4,3.0,2.0,1.0
205202,0,0,0,0,0,0,0,22,0.0,0.0,0.0,0.0,0.0,0.0,0.0,19,0,19,15.0,0.0,15.0
301132,0,0,0,0,0,0,0,1278,,,,,,,,1,0,1,,,
9401341,3,2,1,2,2,1,1,295,2.0,1.0,1.0,1.0,1.0,1.0,1.0,4,3,1,3.0,2.0,1.0
9511297,4,2,2,2,4,0,0,63,,,,,,,,4,4,0,,,
9911362,4,1,3,6,4,0,0,412,1.0,1.0,0.0,0.0,1.0,0.0,0.0,7,4,3,1.0,0.0,1.0
103061,0,0,0,0,0,0,0,31,0.0,0.0,0.0,0.0,0.0,0.0,0.0,5,0,5,,,
9504321,2,2,0,0,0,2,8,94,1.0,1.0,0.0,0.0,0.0,1.0,4.0,8,2,6,2.0,1.0,1.0
9706400,6,6,0,0,0,6,20,108,3.0,3.0,0.0,0.0,0.0,3.0,10.0,12,6,6,4.0,3.0,1.0
9608470,15,8,7,10,0,15,81,14,8.0,4.0,4.0,6.0,1.0,7.0,31.0,37,15,22,11.0,8.0,3.0
9909517,1,1,0,0,0,1,5,17,1.0,1.0,0.0,0.0,0.0,1.0,5.0,18,1,17,5.0,0.0,5.0
9511461,9,2,7,23,1,8,16,49,8.0,2.0,6.0,19.0,1.0,7.0,15.0,14,9,5,2.0,0.0,2.0
9811488,2,1,1,1,2,0,0,299,1.0,1.0,0.0,0.0,1.0,0.0,0.0,3,2,1,1.0,1.0,0.0
9908464,13,9,4,6,8,5,9,258,7.0,4.0,3.0,5.0,5.0,2.0,3.0,20,13,7,4.0,1.0,3.0
201209,8,3,5,6,0,8,71,2,1.0,1.0,0.0,0.0,0.0,1.0,14.0,41,8,33,9.0,1.0,8.0
9912313,10,7,3,3,1,9,40,21,6.0,4.0,2.0,2.0,1.0,5.0,19.0,24,10,14,12.0,4.0,8.0
206026,10,5,5,9,0,10,50,219,6.0,4.0,2.0,3.0,0.0,6.0,21.0,23,10,13,10.0,6.0,4.0
9901375,6,5,1,1,2,4,5,51,0.0,0.0,0.0,0.0,0.0,0.0,0.0,13,6,7,1.0,0.0,1.0
108134,4,3,1,2,0,4,11,392,2.0,1.0,1.0,1.0,0.0,2.0,4.0,12,4,8,4.0,2.0,2.0
9908374,4,3,1,1,0,4,23,17,2.0,1.0,1.0,1.0,0.0,2.0,12.0,25,4,21,11.0,2.0,9.0
9710439,1,1,0,0,0,1,8,4,0.0,0.0,0.0,0.0,0.0,0.0,0.0,21,1,20,2.0,0.0,2.0
2086,4,2,2,3,0,4,41,50,4.0,2.0,2.0,3.0,0.0,4.0,41.0,22,4,18,20.0,4.0,16.0
112158,2,1,1,1,0,2,17,50,1.0,1.0,0.0,0.0,0.0,1.0,13.0,21,2,19,14.0,1.0,13.0
9911366,12,1,11,33,0,12,76,50,12.0,1.0,11.0,33.0,0.0,12.0,76.0,20,12,8,19.0,11.0,8.0
9509297,5,4,1,2,1,4,10,58,3.0,2.0,1.0,2.0,1.0,2.0,2.0,9,5,4,4.0,3.0,1.0
9906409,6,3,3,6,0,6,61,9,6.0,3.0,3.0,6.0,0.0,6.0,59.0,23,6,17,20.0,6.0,14.0
9301275,3,2,1,1,3,0,0,188,2.0,1.0,1.0,1.0,2.0,0.0,0.0,3,3,0,2.0,2.0,0.0
9710468,2,2,0,0,2,0,0,432,1.0,1.0,0.0,0.0,1.0,0.0,0.0,7,2,5,4.0,0.0,4.0
9704327,18,4,14,54,1,17,174,36,16.0,3.0,13.0,52.0,0.0,16.0,166.0,36,18,18,27.0,14.0,13.0
9809344,10,5,5,6,2,8,19,115,3.0,2.0,1.0,1.0,0.0,3.0,5.0,16,10,6,2.0,2.0,0.0
9308227,13,3,10,20,13,0,0,71,4.0,1.0,3.0,4.0,4.0,0.0,0.0,13,13,0,4.0,4.0,0.0
9612420,3,3,0,0,3,0,0,279,2.0,2.0,0.0,0.0,2.0,0.0,0.0,3,3,0,1.0,1.0,0.0
9509334,2,2,0,0,2,0,0,1518,1.0,1.0,0.0,0.0,1.0,0.0,0.0,2,2,0,,,
3196,8,3,5,9,4,4,4,205,5.0,2.0,3.0,5.0,2.0,3.0,3.0,9,8,1,6.0,5.0,1.0
9609375,16,4,12,20,5,11,20,40,12.0,1.0,11.0,18.0,3.0,9.0,18.0,24,16,8,4.0,1.0,3.0
107261,11,10,1,1,5,6,12,77,1.0,1.0,0.0,0.0,0.0,1.0,2.0,21,11,10,4.0,2.0,2.0
207087,2,2,0,0,1,1,24,48,1.0,1.0,0.0,0.0,0.0,1.0,21.0,29,2,27,18.0,1.0,17.0
9803464,12,7,5,7,0,12,57,9,6.0,4.0,2.0,3.0,0.0,6.0,31.0,23,12,11,1.0,1.0,0.0
9908492,4,3,1,1,1,3,3,214,2.0,2.0,0.0,0.0,2.0,0.0,0.0,7,4,3,3.0,3.0,0.0
9902222,2,1,1,1,1,1,2,242,0.0,0.0,0.0,0.0,0.0,0.0,0.0,6,2,4,1.0,0.0,1.0
9804247,4,1,3,3,2,2,4,141,1.0,1.0,0.0,0.0,0.0,1.0,2.0,11,4,7,2.0,0.0,2.0
9704264,4,2,2,5,0,4,19,70,4.0,2.0,2.0,5.0,1.0,3.0,18.0,11,4,7,10.0,4.0,6.0
205235,3,3,0,0,0,3,17,66,1.0,1.0,0.0,0.0,0.0,1.0,12.0,20,3,17,15.0,1.0,14.0
9812341,2,2,0,0,0,2,6,77,1.0,1.0,0.0,0.0,0.0,1.0,3.0,9,2,7,2.0,0.0,2.0
10057,8,2,6,7,8,0,0,201,4.0,1.0,3.0,4.0,4.0,0.0,0.0,8,8,0,2.0,2.0,0.0
9906426,3,2,1,1,3,0,0,642,1.0,1.0,0.0,0.0,1.0,0.0,0.0,3,3,0,1.0,1.0,0.0
2300,23,11,12,18,11,12,23,51,5.0,5.0,0.0,0.0,1.0,4.0,8.0,38,23,15,5.0,4.0,1.0
207366,8,4,4,5,0,8,58,3,0.0,0.0,0.0,0.0,0.0,0.0,0.0,45,8,37,6.0,0.0,6.0
201105,9,6,3,3,1,8,42,0,1.0,1.0,0.0,0.0,0.0,1.0,10.0,59,9,50,26.0,0.0,26.0
209169,1,1,0,0,1,0,0,0,0.0,0.0,0.0,0.0,0.0,0.0,0.0,22,1,21,2.0,0.0,2.0
9408260,19,5,14,22,9,10,10,217,11.0,3.0,8.0,16.0,1.0,10.0,10.0,20,19,1,9.0,8.0,1.0
9310344,6,4,2,3,6,0,0,145,3.0,2.0,1.0,2.0,3.0,0.0,0.0,6,6,0,2.0,2.0,0.0
105238,2,2,0,0,1,1,4,35,0.0,0.0,0.0,0.0,0.0,0.0,0.0,21,2,19,9.0,0.0,9.0
9505411,0,0,0,0,0,0,0,1192,,,,,,,,2,0,2,1.0,0.0,1.0
9612462,14,3,11,23,1,13,23,260,13.0,3.0,10.0,22.0,0.0,13.0,23.0,16,14,2,15.0,13.0,2.0
209188,5,4,1,1,1,4,14,1,0.0,0.0,0.0,0.0,0.0,0.0,0.0,14,5,9,1.0,0.0,1.0
208203,7,5,2,2,0,7,108,7,2.0,2.0,0.0,0.0,0.0,2.0,23.0,125,7,118,28.0,1.0,27.0
106250,1,1,0,0,0,1,9,1,1.0,1.0,0.0,0.0,0.0,1.0,3.0,27,1,26,4.0,1.0,3.0
9601329,6,4,2,3,6,0,0,315,4.0,2.0,2.0,3.0,4.0,0.0,0.0,9,6,3,3.0,3.0,0.0
9911411,3,1,2,2,0,3,12,25,2.0,1.0,1.0,1.0,0.0,2.0,4.0,10,3,7,4.0,2.0,2.0
9803248,5,2,3,3,0,5,18,26,2.0,1.0,1.0,1.0,0.0,2.0,6.0,14,5,9,6.0,3.0,3.0
4047,8,4,4,5,4,4,4,80,4.0,1.0,3.0,4.0,2.0,2.0,2.0,9,8,1,3.0,3.0,0.0
7004,8,4,4,5,0,8,19,191,7.0,4.0,3.0,3.0,0.0,7.0,18.0,14,8,6,9.0,3.0,6.0
301102,0,0,0,0,0,0,0,100,0.0,0.0,0.0,0.0,0.0,0.0,0.0,10,0,10,6.0,0.0,6.0
102229,13,4,9,20,0,13,59,209,10.0,1.0,9.0,20.0,0.0,10.0,34.0,32,13,19,17.0,9.0,8.0
9509366,5,4,1,1,1,4,4,54,2.0,2.0,0.0,0.0,0.0,2.0,2.0,7,5,2,2.0,1.0,1.0
9904437,2,2,0,0,1,1,6,50,0.0,0.0,0.0,0.0,0.0,0.0,0.0,32,2,30,12.0,0.0,12.0
207106,1,1,0,0,0,1,4,1,0.0,0.0,0.0,0.0,0.0,0.0,0.0,15,1,14,,,
9703394,2,1,1,1,2,0,0,261,1.0,1.0,0.0,0.0,1.0,0.0,0.0,4,2,2,2.0,0.0,2.0
9611346,2,2,0,0,0,2,2,58,0.0,0.0,0.0,0.0,0.0,0.0,0.0,16,2,14,4.0,0.0,4.0
9801344,10,3,7,11,1,9,30,38,9.0,2.0,7.0,11.0,0.0,9.0,30.0,17,10,7,5.0,5.0,0.0
9812477,0,0,0,0,0,0,0,101,0.0,0.0,0.0,0.0,0.0,0.0,0.0,4,0,4,1.0,0.0,1.0
9712343,12,3,9,28,0,12,36,158,9.0,2.0,7.0,20.0,0.0,9.0,31.0,25,12,13,18.0,9.0,9.0
9709461,3,2,1,1,2,1,1,83,2.0,2.0,0.0,0.0,1.0,1.0,1.0,12,3,9,4.0,1.0,3.0
12353,2,1,1,1,0,2,6,4,0.0,0.0,0.0,0.0,0.0,0.0,0.0,12,2,10,3.0,0.0,3.0
9610290,1,1,0,0,0,1,4,15,0.0,0.0,0.0,0.0,0.0,0.0,0.0,6,1,5,4.0,1.0,3.0
101068,2,2,0,0,0,2,21,2,1.0,1.0,0.0,0.0,0.0,1.0,4.0,17,2,15,2.0,1.0,1.0
9404347,6,5,1,1,6,0,0,783,1.0,1.0,0.0,0.0,1.0,0.0,0.0,6,6,0,1.0,1.0,0.0
203135,16,10,6,8,1,15,71,7,10.0,6.0,4.0,5.0,0.0,10.0,53.0,26,16,10,16.0,7.0,9.0
108065,5,2,3,3,1,4,15,23,4.0,1.0,3.0,3.0,1.0,3.0,9.0,13,5,8,2.0,2.0,0.0
9204224,3,3,0,0,3,0,0,148,1.0,1.0,0.0,0.0,1.0,0.0,0.0,3,3,0,2.0,2.0,0.0
8186,28,10,18,31,0,28,142,27,16.0,4.0,12.0,21.0,0.0,16.0,92.0,51,28,23,18.0,10.0,8.0
9408351,5,4,1,1,5,0,0,75,4.0,3.0,1.0,1.0,4.0,0.0,0.0,7,5,2,2.0,2.0,0.0
108238,1,1,0,0,0,1,17,37,1.0,1.0,0.0,0.0,0.0,1.0,16.0,28,1,27,21.0,1.0,20.0
9810388,6,3,3,4,2,4,12,181,6.0,3.0,3.0,4.0,2.0,4.0,12.0,10,6,4,7.0,3.0,4.0
9704390,7,4,3,3,4,3,8,5,0.0,0.0,0.0,0.0,0.0,0.0,0.0,13,7,6,1.0,1.0,0.0
102026,1,1,0,0,0,1,3,130,0.0,0.0,0.0,0.0,0.0,0.0,0.0,18,1,17,3.0,0.0,3.0
9405291,7,4,3,5,6,1,1,3,0.0,0.0,0.0,0.0,0.0,0.0,0.0,9,7,2,1.0,1.0,0.0
9803462,26,8,18,31,9,17,26,64,10.0,5.0,5.0,6.0,2.0,8.0,11.0,35,26,9,5.0,5.0,0.0
211366,5,3,2,5,0,5,68,4,5.0,3.0,2.0,5.0,0.0,5.0,63.0,27,5,22,20.0,4.0,16.0
205060,0,0,0,0,0,0,0,259,0.0,0.0,0.0,0.0,0.0,0.0,0.0,3,0,3,2.0,0.0,2.0
9505218,3,2,1,2,3,0,0,28,,,,,,,,3,3,0,,,
10291,2,2,0,0,0,2,8,27,,,,,,,,10,2,8,1.0,0.0,1.0
9908393,9,4,5,8,0,9,36,113,7.0,2.0,5.0,8.0,0.0,7.0,25.0,23,9,14,12.0,7.0,5.0
9712202,6,4,2,3,1,5,11,29,0.0,0.0,0.0,0.0,0.0,0.0,0.0,15,6,9,4.0,0.0,4.0
9603323,3,2,1,1,2,1,2,308,2.0,1.0,1.0,1.0,2.0,0.0,0.0,7,3,4,2.0,2.0,0.0
105254,10,3,7,10,2,8,36,5,3.0,2.0,1.0,1.0,0.0,3.0,7.0,31,10,21,6.0,4.0,2.0
9802293,3,3,0,0,1,2,4,61,1.0,1.0,0.0,0.0,0.0,1.0,2.0,9,3,6,1.0,0.0,1.0
9904350,1,1,0,0,0,1,4,6,,,,,,,,16,1,15,,,
9801454,1,1,0,0,0,1,5,18,1.0,1.0,0.0,0.0,0.0,1.0,5.0,15,1,14,5.0,1.0,4.0
9279,1,1,0,0,0,1,10,17,1.0,1.0,0.0,0.0,0.0,1.0,5.0,28,1,27,4.0,0.0,4.0
210092,0,0,0,0,0,0,0,13,0.0,0.0,0.0,0.0,0.0,0.0,0.0,16,0,16,7.0,0.0,7.0
9609478,1,1,0,0,0,1,3,39,1.0,1.0,0.0,0.0,0.0,1.0,3.0,10,1,9,1.0,0.0,1.0
9512286,3,2,1,1,0,3,10,275,2.0,1.0,1.0,1.0,0.0,2.0,6.0,7,3,4,1.0,0.0,1.0
106108,12,5,7,13,3,9,27,31,3.0,1.0,2.0,3.0,0.0,3.0,4.0,20,12,8,7.0,3.0,4.0
9602251,11,6,5,10,2,9,11,166,7.0,4.0,3.0,7.0,0.0,7.0,7.0,14,11,3,8.0,7.0,1.0
9502337,7,4,3,3,5,2,6,1,3.0,3.0,0.0,0.0,3.0,0.0,0.0,20,7,13,2.0,1.0,1.0
9503471,2,2,0,0,0,2,4,110,1.0,1.0,0.0,0.0,0.0,1.0,1.0,4,2,2,1.0,1.0,0.0
9911210,1,1,0,0,0,1,1,328,0.0,0.0,0.0,0.0,0.0,0.0,0.0,5,1,4,1.0,1.0,0.0
9609482,15,7,8,10,0,15,41,35,4.0,3.0,1.0,1.0,0.0,4.0,16.0,38,15,23,6.0,4.0,2.0
9612203,8,1,7,22,4,4,5,105,8.0,1.0,7.0,22.0,8.0,0.0,0.0,10,8,2,8.0,8.0,0.0
9710510,4,4,0,0,2,2,5,31,1.0,1.0,0.0,0.0,0.0,1.0,2.0,10,4,6,1.0,1.0,0.0
9701235,7,6,1,1,0,7,21,17,0.0,0.0,0.0,0.0,0.0,0.0,0.0,15,7,8,2.0,1.0,1.0
9507300,4,4,0,0,4,0,0,307,0.0,0.0,0.0,0.0,0.0,0.0,0.0,6,4,2,1.0,1.0,0.0
302067,2,2,0,0,1,1,1,65,1.0,1.0,0.0,0.0,1.0,0.0,0.0,11,2,9,2.0,1.0,1.0
9311244,2,2,0,0,1,1,2,253,1.0,1.0,0.0,0.0,0.0,1.0,2.0,5,2,3,3.0,1.0,2.0
4007,4,4,0,0,1,3,8,1,1.0,1.0,0.0,0.0,0.0,1.0,3.0,32,4,28,2.0,1.0,1.0
9904374,1,1,0,0,1,0,0,1183,,,,,,,,1,1,0,,,
9601354,5,4,1,1,0,5,8,82,2.0,2.0,0.0,0.0,0.0,2.0,4.0,8,5,3,1.0,1.0,0.0
9705296,13,6,7,9,1,12,50,115,9.0,3.0,6.0,7.0,0.0,9.0,33.0,28,13,15,6.0,6.0,0.0
9910379,13,5,8,26,1,12,39,209,8.0,1.0,7.0,21.0,1.0,7.0,19.0,23,13,10,11.0,8.0,3.0
9609303,4,3,1,2,1,3,6,17,0.0,0.0,0.0,0.0,0.0,0.0,0.0,34,4,30,1.0,0.0,1.0
9702360,11,4,7,11,1,10,10,103,7.0,2.0,5.0,8.0,0.0,7.0,7.0,18,11,7,8.0,7.0,1.0
4113,4,4,0,0,0,4,20,136,3.0,3.0,0.0,0.0,0.0,3.0,14.0,15,4,11,8.0,2.0,6.0
9610328,6,3,3,4,0,6,16,326,5.0,3.0,2.0,3.0,0.0,5.0,8.0,14,6,8,6.0,4.0,2.0
9608303,3,2,1,1,0,3,5,195,2.0,2.0,0.0,0.0,0.0,2.0,3.0,10,3,7,5.0,1.0,4.0
211062,4,3,1,1,0,4,54,0,2.0,1.0,1.0,1.0,0.0,2.0,29.0,59,4,55,18.0,2.0,16.0
105104,9,5,4,5,2,7,33,64,6.0,4.0,2.0,3.0,1.0,5.0,27.0,20,9,11,10.0,4.0,6.0
9709233,2,2,0,0,2,0,0,227,1.0,1.0,0.0,0.0,1.0,0.0,0.0,3,2,1,,,
104217,14,9,5,10,2,12,129,5,10.0,5.0,5.0,10.0,0.0,10.0,108.0,54,14,40,25.0,5.0,20.0
5246,3,2,1,1,0,3,14,300,2.0,1.0,1.0,1.0,0.0,2.0,4.0,12,3,9,6.0,2.0,4.0
9705423,16,6,10,36,0,16,16,78,10.0,4.0,6.0,22.0,0.0,10.0,10.0,21,16,5,12.0,11.0,1.0
9609217,6,2,4,5,5,1,1,66,2.0,2.0,0.0,0.0,2.0,0.0,0.0,7,6,1,4.0,4.0,0.0
9708259,7,5,2,2,2,5,11,30,1.0,1.0,0.0,0.0,0.0,1.0,2.0,18,7,11,3.0,2.0,1.0
1033,5,2,3,6,0,5,103,12,5.0,2.0,3.0,6.0,0.0,5.0,86.0,36,5,31,23.0,4.0,19.0
205215,0,0,0,0,0,0,0,20,0.0,0.0,0.0,0.0,0.0,0.0,0.0,9,0,9,4.0,0.0,4.0
9812254,5,2,3,4,1,4,10,40,4.0,1.0,3.0,4.0,3.0,1.0,1.0,12,5,7,5.0,4.0,1.0
9709222,1,1,0,0,1,0,0,11,0.0,0.0,0.0,0.0,0.0,0.0,0.0,9,1,8,,,
8079,12,3,9,26,3,9,20,78,9.0,1.0,8.0,22.0,9.0,0.0,0.0,19,12,7,10.0,9.0,1.0
105015,1,1,0,0,0,1,3,8,0.0,0.0,0.0,0.0,0.0,0.0,0.0,19,1,18,7.0,0.0,7.0
108118,4,2,2,3,0,4,8,216,4.0,2.0,2.0,3.0,0.0,4.0,8.0,12,4,8,5.0,3.0,2.0
3071,0,0,0,0,0,0,0,122,,,,,,,,1,0,1,,,
102223,2,2,0,0,1,1,10,67,1.0,1.0,0.0,0.0,0.0,1.0,10.0,37,2,35,10.0,1.0,9.0
9411371,1,1,0,0,0,1,3,1108,1.0,1.0,0.0,0.0,0.0,1.0,2.0,4,1,3,,,
9812224,8,4,4,4,5,3,5,110,2.0,2.0,0.0,0.0,0.0,2.0,4.0,10,8,2,1.0,1.0,0.0
9611231,4,2,2,2,0,4,6,82,3.0,2.0,1.0,1.0,0.0,3.0,4.0,6,4,2,5.0,3.0,2.0
9207203,3,2,1,1,3,0,0,280,2.0,1.0,1.0,1.0,2.0,0.0,0.0,3,3,0,2.0,2.0,0.0
104165,5,3,2,2,5,0,0,321,3.0,1.0,2.0,2.0,3.0,0.0,0.0,9,5,4,3.0,3.0,0.0
9810300,1,1,0,0,0,1,8,1,1.0,1.0,0.0,0.0,0.0,1.0,7.0,23,1,22,17.0,0.0,17.0
110374,4,1,3,5,3,1,1,178,4.0,1.0,3.0,5.0,4.0,0.0,0.0,11,4,7,4.0,4.0,0.0
9902447,10,1,9,28,10,0,0,91,10.0,1.0,9.0,28.0,10.0,0.0,0.0,12,10,2,10.0,10.0,0.0
104142,2,1,1,1,0,2,17,8,2.0,1.0,1.0,1.0,0.0,2.0,12.0,36,2,34,14.0,1.0,13.0
9703223,1,1,0,0,0,1,2,6,1.0,1.0,0.0,0.0,1.0,0.0,0.0,26,1,25,3.0,0.0,3.0
9501327,2,2,0,0,2,0,0,288,1.0,1.0,0.0,0.0,1.0,0.0,0.0,2,2,0,1.0,1.0,0.0
12225,6,5,1,1,0,6,28,27,3.0,3.0,0.0,0.0,0.0,3.0,17.0,21,6,15,5.0,2.0,3.0
9904260,5,4,1,1,0,5,27,95,4.0,3.0,1.0,1.0,0.0,4.0,19.0,18,5,13,9.0,2.0,7.0
9905260,5,4,1,1,1,4,11,31,2.0,2.0,0.0,0.0,0.0,2.0,9.0,14,5,9,3.0,0.0,3.0
9512304,1,1,0,0,0,1,6,112,1.0,1.0,0.0,0.0,0.0,1.0,4.0,9,1,8,3.0,1.0,2.0
9804316,2,2,0,0,1,1,4,97,1.0,1.0,0.0,0.0,0.0,1.0,4.0,10,2,8,3.0,1.0,2.0
9710495,3,3,0,0,0,3,7,229,1.0,1.0,0.0,0.0,0.0,1.0,3.0,8,3,5,4.0,1.0,3.0
9508388,3,3,0,0,3,0,0,102,1.0,1.0,0.0,0.0,1.0,0.0,0.0,3,3,0,1.0,1.0,0.0
212023,6,1,5,9,0,6,59,1,6.0,1.0,5.0,9.0,0.0,6.0,34.0,39,6,33,15.0,6.0,9.0
9601267,7,6,1,1,0,7,20,13,6.0,5.0,1.0,1.0,0.0,6.0,17.0,13,7,6,6.0,3.0,3.0
102167,2,2,0,0,2,0,0,0,0.0,0.0,0.0,0.0,0.0,0.0,0.0,54,2,52,8.0,0.0,8.0
4244,3,2,1,1,3,0,0,580,0.0,0.0,0.0,0.0,0.0,0.0,0.0,6,3,3,2.0,0.0,2.0
11292,4,2,2,3,2,2,4,76,1.0,1.0,0.0,0.0,0.0,1.0,2.0,11,4,7,1.0,0.0,1.0
7037,4,2,2,3,1,3,6,40,0.0,0.0,0.0,0.0,0.0,0.0,0.0,31,4,27,11.0,0.0,11.0
112125,10,3,7,14,2,8,44,0,8.0,2.0,6.0,12.0,1.0,7.0,29.0,25,10,15,12.0,7.0,5.0
9209235,3,3,0,0,3,0,0,550,2.0,2.0,0.0,0.0,2.0,0.0,0.0,3,3,0,2.0,2.0,0.0
9902466,2,2,0,0,2,0,0,222,0.0,0.0,0.0,0.0,0.0,0.0,0.0,8,2,6,1.0,0.0,1.0
9607367,4,3,1,1,1,3,3,175,1.0,1.0,0.0,0.0,0.0,1.0,1.0,8,4,4,2.0,2.0,0.0
9910215,6,6,0,0,1,5,35,3,2.0,2.0,0.0,0.0,0.0,2.0,11.0,24,6,18,11.0,2.0,9.0
9610547,6,4,2,2,1,5,5,180,3.0,1.0,2.0,2.0,3.0,0.0,0.0,8,6,2,1.0,1.0,0.0
9804341,7,5,2,7,7,0,0,390,7.0,5.0,2.0,7.0,7.0,0.0,0.0,7,7,0,7.0,7.0,0.0
9408201,5,3,2,2,3,2,2,231,1.0,1.0,0.0,0.0,1.0,0.0,0.0,6,5,1,1.0,1.0,0.0
204097,0,0,0,0,0,0,0,87,0.0,0.0,0.0,0.0,0.0,0.0,0.0,15,0,15,5.0,0.0,5.0
9505432,5,4,1,1,2,3,3,180,4.0,3.0,1.0,1.0,1.0,3.0,3.0,7,5,2,5.0,4.0,1.0
9102,26,4,22,55,2,24,112,16,19.0,3.0,16.0,41.0,0.0,19.0,99.0,42,26,16,12.0,7.0,5.0
9506403,5,1,4,5,5,0,0,252,0.0,0.0,0.0,0.0,0.0,0.0,0.0,8,5,3,,,
9212243,3,2,1,2,3,0,0,1407,3.0,2.0,1.0,2.0,3.0,0.0,0.0,3,3,0,3.0,3.0,0.0
101128,5,4,1,1,0,5,26,11,1.0,1.0,0.0,0.0,0.0,1.0,6.0,23,5,18,8.0,1.0,7.0
204258,10,3,7,13,0,10,42,146,9.0,3.0,6.0,11.0,0.0,9.0,39.0,18,10,8,15.0,8.0,7.0
111396,1,1,0,0,0,1,2,11,0.0,0.0,0.0,0.0,0.0,0.0,0.0,11,1,10,1.0,0.0,1.0
9609376,2,1,1,1,0,2,4,34,2.0,1.0,1.0,1.0,2.0,0.0,0.0,6,2,4,1.0,0.0,1.0
210322,2,2,0,0,0,2,11,23,1.0,1.0,0.0,0.0,0.0,1.0,8.0,16,2,14,2.0,0.0,2.0
6227,2,2,0,0,1,1,4,47,0.0,0.0,0.0,0.0,0.0,0.0,0.0,7,2,5,5.0,0.0,5.0
9403234,0,0,0,0,0,0,0,110,0.0,0.0,0.0,0.0,0.0,0.0,0.0,1,0,1,1.0,0.0,1.0
9710502,2,2,0,0,2,0,0,183,1.0,1.0,0.0,0.0,1.0,0.0,0.0,2,2,0,1.0,1.0,0.0
107107,2,2,0,0,1,1,1,55,0.0,0.0,0.0,0.0,0.0,0.0,0.0,16,2,14,1.0,0.0,1.0
9910308,7,4,3,4,1,6,8,215,3.0,1.0,2.0,3.0,2.0,1.0,1.0,12,7,5,3.0,3.0,0.0
201284,5,4,1,1,0,5,44,55,2.0,2.0,0.0,0.0,0.0,2.0,27.0,25,5,20,11.0,2.0,9.0
105206,2,2,0,0,2,0,0,233,0.0,0.0,0.0,0.0,0.0,0.0,0.0,7,2,5,4.0,0.0,4.0
9904476,0,0,0,0,0,0,0,220,0.0,0.0,0.0,0.0,0.0,0.0,0.0,13,0,13,2.0,0.0,2.0
9911249,5,3,2,3,0,5,25,133,1.0,1.0,0.0,0.0,0.0,1.0,7.0,15,5,10,9.0,2.0,7.0
112322,9,1,8,26,0,9,81,9,9.0,1.0,8.0,26.0,0.0,9.0,81.0,20,9,11,9.0,8.0,1.0
9605315,16,5,11,18,7,9,9,161,7.0,1.0,6.0,11.0,1.0,6.0,6.0,17,16,1,4.0,4.0,0.0
1279,1,1,0,0,0,1,6,13,0.0,0.0,0.0,0.0,0.0,0.0,0.0,9,1,8,1.0,0.0,1.0
9802232,2,2,0,0,0,2,5,26,0.0,0.0,0.0,0.0,0.0,0.0,0.0,15,2,13,4.0,0.0,4.0
201183,1,1,0,0,0,1,12,6,0.0,0.0,0.0,0.0,0.0,0.0,0.0,38,1,37,8.0,1.0,7.0
9904388,4,4,0,0,0,4,56,87,3.0,3.0,0.0,0.0,0.0,3.0,49.0,45,4,41,19.0,3.0,16.0
9607429,4,3,1,1,2,2,5,58,2.0,1.0,1.0,1.0,1.0,1.0,1.0,15,4,11,3.0,1.0,2.0
9904390,3,3,0,0,0,3,7,112,0.0,0.0,0.0,0.0,0.0,0.0,0.0,28,3,25,5.0,0.0,5.0
9310265,1,1,0,0,1,0,0,342,1.0,1.0,0.0,0.0,1.0,0.0,0.0,5,1,4,,,
9908496,0,0,0,0,0,0,0,89,0.0,0.0,0.0,0.0,0.0,0.0,0.0,9,0,9,,,
209183,0,0,0,0,0,0,0,105,,,,,,,,1,0,1,,,
9603273,6,5,1,1,3,3,5,175,2.0,2.0,0.0,0.0,1.0,1.0,2.0,9,6,3,4.0,2.0,2.0
9805329,1,1,0,0,0,1,4,5,0.0,0.0,0.0,0.0,0.0,0.0,0.0,15,1,14,3.0,0.0,3.0
9807550,1,1,0,0,0,1,3,154,1.0,1.0,0.0,0.0,0.0,1.0,3.0,8,1,7,5.0,1.0,4.0
9406244,2,2,0,0,0,2,2,116,,,,,,,,3,2,1,,,
9710549,4,1,3,6,2,2,4,22,4.0,1.0,3.0,6.0,2.0,2.0,4.0,6,4,2,4.0,4.0,0.0
9905318,8,5,3,3,2,6,6,185,5.0,3.0,2.0,2.0,0.0,5.0,5.0,9,8,1,6.0,5.0,1.0
101286,6,3,3,6,6,0,0,171,6.0,3.0,3.0,6.0,6.0,0.0,0.0,10,6,4,5.0,5.0,0.0
1191,3,1,2,3,0,3,13,24,3.0,1.0,2.0,3.0,0.0,3.0,13.0,10,3,7,2.0,2.0,0.0
12285,0,0,0,0,0,0,0,82,0.0,0.0,0.0,0.0,0.0,0.0,0.0,11,0,11,3.0,0.0,3.0
9609493,1,1,0,0,0,1,2,46,1.0,1.0,0.0,0.0,1.0,0.0,0.0,3,1,2,,,
201025,4,3,1,1,3,1,1,209,0.0,0.0,0.0,0.0,0.0,0.0,0.0,11,4,7,1.0,0.0,1.0
9408203,0,0,0,0,0,0,0,1036,,,,,,,,3,0,3,,,
9711336,0,0,0,0,0,0,0,30,0.0,0.0,0.0,0.0,0.0,0.0,0.0,20,0,20,3.0,0.0,3.0
9304301,2,2,0,0,2,0,0,160,1.0,1.0,0.0,0.0,1.0,0.0,0.0,2,2,0,,,
8095,1,1,0,0,1,0,0,1786,,,,,,,,6,1,5,1.0,0.0,1.0
9906323,0,0,0,0,0,0,0,16,,,,,,,,11,0,11,,,
9904441,6,3,3,4,4,2,3,51,2.0,1.0,1.0,1.0,1.0,1.0,1.0,10,6,4,4.0,2.0,2.0
12193,5,3,2,2,2,3,5,178,3.0,2.0,1.0,1.0,0.0,3.0,5.0,8,5,3,4.0,2.0,2.0
111120,6,3,3,3,0,6,39,116,5.0,2.0,3.0,3.0,0.0,5.0,34.0,21,6,15,13.0,5.0,8.0
9405406,0,0,0,0,0,0,0,1002,,,,,,,,1,0,1,,,
9512342,1,1,0,0,0,1,5,176,1.0,1.0,0.0,0.0,0.0,1.0,5.0,10,1,9,9.0,1.0,8.0
7189,3,3,0,0,1,2,16,30,2.0,2.0,0.0,0.0,0.0,2.0,15.0,16,3,13,10.0,1.0,9.0
11109,1,1,0,0,0,1,2,31,1.0,1.0,0.0,0.0,0.0,1.0,2.0,9,1,8,4.0,0.0,4.0
6039,1,1,0,0,0,1,2,322,1.0,1.0,0.0,0.0,0.0,1.0,1.0,4,1,3,3.0,1.0,2.0
9710261,2,2,0,0,2,0,0,105,2.0,2.0,0.0,0.0,2.0,0.0,0.0,3,2,1,1.0,1.0,0.0
205083,4,1,3,4,0,4,21,312,4.0,1.0,3.0,4.0,0.0,4.0,11.0,15,4,11,9.0,4.0,5.0
9705349,2,2,0,0,2,0,0,269,2.0,2.0,0.0,0.0,2.0,0.0,0.0,2,2,0,1.0,1.0,0.0
9808437,6,4,2,2,0,6,29,115,4.0,3.0,1.0,1.0,0.0,4.0,16.0,22,6,16,10.0,3.0,7.0
9910414,2,1,1,1,0,2,3,47,0.0,0.0,0.0,0.0,0.0,0.0,0.0,9,2,7,3.0,1.0,2.0
208128,0,0,0,0,0,0,0,7,0.0,0.0,0.0,0.0,0.0,0.0,0.0,13,0,13,1.0,0.0,1.0
9608411,2,2,0,0,2,0,0,16,0.0,0.0,0.0,0.0,0.0,0.0,0.0,17,2,15,1.0,1.0,0.0
9512284,3,2,1,1,0,3,4,1605,2.0,1.0,1.0,1.0,2.0,0.0,0.0,6,3,3,2.0,2.0,0.0
9504391,1,1,0,0,1,0,0,122,,,,,,,,1,1,0,,,
9909513,0,0,0,0,0,0,0,103,0.0,0.0,0.0,0.0,0.0,0.0,0.0,6,0,6,2.0,0.0,2.0
212316,0,0,0,0,0,0,0,11,0.0,0.0,0.0,0.0,0.0,0.0,0.0,33,0,33,26.0,0.0,26.0
9809257,1,1,0,0,0,1,1,2047,,,,,,,,2,1,1,,,
111013,8,5,3,4,2,6,12,312,4.0,2.0,2.0,3.0,3.0,1.0,1.0,18,8,10,3.0,3.0,0.0
9302235,3,3,0,0,3,0,0,359,2.0,2.0,0.0,0.0,2.0,0.0,0.0,3,3,0,1.0,1.0,0.0
206061,1,1,0,0,0,1,4,1,0.0,0.0,0.0,0.0,0.0,0.0,0.0,40,1,39,10.0,0.0,10.0
204347,0,0,0,0,0,0,0,174,0.0,0.0,0.0,0.0,0.0,0.0,0.0,3,0,3,1.0,0.0,1.0
9903324,2,1,1,1,0,2,8,21,2.0,1.0,1.0,1.0,0.0,2.0,8.0,9,2,7,1.0,1.0,0.0
207296,3,1,2,2,0,3,50,16,3.0,1.0,2.0,2.0,0.0,3.0,46.0,50,3,47,14.0,2.0,12.0
106136,1,1,0,0,0,1,11,7,0.0,0.0,0.0,0.0,0.0,0.0,0.0,29,1,28,16.0,0.0,16.0
10210,1,1,0,0,0,1,2,347,1.0,1.0,0.0,0.0,0.0,1.0,2.0,8,1,7,4.0,1.0,3.0
9607212,2,2,0,0,1,1,1,174,1.0,1.0,0.0,0.0,1.0,0.0,0.0,3,2,1,1.0,1.0,0.0
9512431,1,1,0,0,1,0,0,290,1.0,1.0,0.0,0.0,1.0,0.0,0.0,2,1,1,1.0,0.0,1.0
106090,3,2,1,1,0,3,23,38,3.0,2.0,1.0,1.0,0.0,3.0,22.0,19,3,16,4.0,2.0,2.0
12223,3,2,1,1,0,3,14,2,3.0,2.0,1.0,1.0,0.0,3.0,4.0,15,3,12,4.0,2.0,2.0
5102,1,1,0,0,1,0,0,455,0.0,0.0,0.0,0.0,0.0,0.0,0.0,7,1,6,5.0,0.0,5.0
2095,3,2,1,1,3,0,0,31,1.0,1.0,0.0,0.0,1.0,0.0,0.0,3,3,0,1.0,1.0,0.0
9709475,1,1,0,0,0,1,3,240,1.0,1.0,0.0,0.0,0.0,1.0,2.0,13,1,12,2.0,0.0,2.0
7302,3,3,0,0,0,3,11,428,2.0,2.0,0.0,0.0,0.0,2.0,8.0,8,3,5,7.0,2.0,5.0
9904280,18,5,13,42,2,16,55,127,14.0,3.0,11.0,36.0,1.0,13.0,39.0,31,18,13,16.0,12.0,4.0
9801398,0,0,0,0,0,0,0,1129,,,,,,,,1,0,1,,,
5178,0,0,0,0,0,0,0,173,0.0,0.0,0.0,0.0,0.0,0.0,0.0,3,0,3,2.0,0.0,2.0
210357,0,0,0,0,0,0,0,241,0.0,0.0,0.0,0.0,0.0,0.0,0.0,12,0,12,3.0,0.0,3.0
9903376,6,3,3,3,0,6,24,95,3.0,2.0,1.0,1.0,0.0,3.0,4.0,22,6,16,3.0,1.0,2.0
101316,2,1,1,1,0,2,12,2,2.0,1.0,1.0,1.0,0.0,2.0,2.0,11,2,9,3.0,2.0,1.0
12242,1,1,0,0,0,1,6,191,1.0,1.0,0.0,0.0,0.0,1.0,5.0,15,1,14,9.0,1.0,8.0
102160,4,3,1,1,1,3,6,241,0.0,0.0,0.0,0.0,0.0,0.0,0.0,15,4,11,2.0,0.0,2.0
202226,1,1,0,0,0,1,10,129,1.0,1.0,0.0,0.0,0.0,1.0,5.0,25,1,24,6.0,1.0,5.0
9904254,2,2,0,0,0,2,3,31,0.0,0.0,0.0,0.0,0.0,0.0,0.0,8,2,6,2.0,1.0,1.0
9612311,0,0,0,0,0,0,0,164,0.0,0.0,0.0,0.0,0.0,0.0,0.0,5,0,5,1.0,0.0,1.0
9509300,1,1,0,0,0,1,1,133,1.0,1.0,0.0,0.0,0.0,1.0,1.0,5,1,4,1.0,0.0,1.0
203201,7,3,4,4,0,7,54,8,3.0,2.0,1.0,1.0,0.0,3.0,15.0,39,7,32,6.0,3.0,3.0
9505344,0,0,0,0,0,0,0,776,0.0,0.0,0.0,0.0,0.0,0.0,0.0,1,0,1,1.0,0.0,1.0
9402339,2,2,0,0,1,1,1,210,1.0,1.0,0.0,0.0,1.0,0.0,0.0,11,2,9,2.0,1.0,1.0
210376,1,1,0,0,0,1,3,12,1.0,1.0,0.0,0.0,0.0,1.0,3.0,30,1,29,5.0,0.0,5.0
111453,0,0,0,0,0,0,0,11,0.0,0.0,0.0,0.0,0.0,0.0,0.0,5,0,5,3.0,0.0,3.0
207346,4,1,3,5,0,4,25,21,4.0,1.0,3.0,5.0,0.0,4.0,25.0,13,4,9,13.0,4.0,9.0
9512350,0,0,0,0,0,0,0,54,0.0,0.0,0.0,0.0,0.0,0.0,0.0,5,0,5,4.0,0.0,4.0
9608219,1,1,0,0,0,1,1,71,1.0,1.0,0.0,0.0,0.0,1.0,1.0,10,1,9,3.0,1.0,2.0
9612330,0,0,0,0,0,0,0,563,0.0,0.0,0.0,0.0,0.0,0.0,0.0,1,0,1,1.0,0.0,1.0
9605247,1,1,0,0,0,1,1,100,1.0,1.0,0.0,0.0,0.0,1.0,1.0,5,1,4,2.0,1.0,1.0
301253,0,0,0,0,0,0,0,144,0.0,0.0,0.0,0.0,0.0,0.0,0.0,7,0,7,4.0,0.0,4.0
103144,1,1,0,0,0,1,6,34,1.0,1.0,0.0,0.0,0.0,1.0,6.0,10,1,9,5.0,0.0,5.0
107208,2,2,0,0,0,2,3,226,1.0,1.0,0.0,0.0,0.0,1.0,1.0,5,2,3,2.0,1.0,1.0
9911478,0,0,0,0,0,0,0,839,0.0,0.0,0.0,0.0,0.0,0.0,0.0,5,0,5,,,
9311351,0,0,0,0,0,0,0,407,0.0,0.0,0.0,0.0,0.0,0.0,0.0,2,0,2,1.0,0.0,1.0
103262,1,1,0,0,0,1,2,442,1.0,1.0,0.0,0.0,0.0,1.0,2.0,3,1,2,3.0,1.0,2.0
9122,0,0,0,0,0,0,0,76,0.0,0.0,0.0,0.0,0.0,0.0,0.0,6,0,6,,,
9807477,1,1,0,0,0,1,1,127,1.0,1.0,0.0,0.0,0.0,1.0,1.0,4,1,3,4.0,1.0,3.0
111344,2,2,0,0,0,2,13,65,2.0,2.0,0.0,0.0,0.0,2.0,13.0,18,2,16,13.0,2.0,11.0
209068,0,0,0,0,0,0,0,1449,,,,,,,,1,0,1,,,
209324,0,0,0,0,0,0,0,136,0.0,0.0,0.0,0.0,0.0,0.0,0.0,14,0,14,11.0,0.0,11.0
108105,2,2,0,0,2,0,0,351,2.0,2.0,0.0,0.0,2.0,0.0,0.0,5,2,3,1.0,1.0,0.0
9712509,0,0,0,0,0,0,0,115,0.0,0.0,0.0,0.0,0.0,0.0,0.0,15,0,15,3.0,0.0,3.0
9909505,2,2,0,0,0,2,15,22,1.0,1.0,0.0,0.0,0.0,1.0,9.0,22,2,20,15.0,1.0,14.0
9902425,0,0,0,0,0,0,0,42,0.0,0.0,0.0,0.0,0.0,0.0,0.0,3,0,3,,,
5327,0,0,0,0,0,0,0,181,0.0,0.0,0.0,0.0,0.0,0.0,0.0,1,0,1,1.0,0.0,1.0
9311202,4,2,2,2,4,0,0,96,1.0,1.0,0.0,0.0,1.0,0.0,0.0,4,4,0,1.0,1.0,0.0
1292,5,4,1,1,0,5,18,131,3.0,2.0,1.0,1.0,0.0,3.0,4.0,14,5,9,3.0,1.0,2.0
108198,1,1,0,0,0,1,13,2,1.0,1.0,0.0,0.0,0.0,1.0,8.0,21,1,20,13.0,1.0,12.0
210122,0,0,0,0,0,0,0,8,0.0,0.0,0.0,0.0,0.0,0.0,0.0,9,0,9,5.0,0.0,5.0
105092,5,5,0,0,1,4,21,8,3.0,3.0,0.0,0.0,0.0,3.0,8.0,17,5,12,6.0,1.0,5.0
211438,2,2,0,0,0,2,6,4,0.0,0.0,0.0,0.0,0.0,0.0,0.0,15,2,13,6.0,0.0,6.0
9310343,1,1,0,0,1,0,0,2019,,,,,,,,1,1,0,1.0,1.0,0.0
7312,6,1,5,8,0,6,46,16,6.0,1.0,5.0,8.0,0.0,6.0,46.0,15,6,9,12.0,6.0,6.0
9902367,0,0,0,0,0,0,0,211,0.0,0.0,0.0,0.0,0.0,0.0,0.0,3,0,3,2.0,0.0,2.0
9609516,0,0,0,0,0,0,0,28,0.0,0.0,0.0,0.0,0.0,0.0,0.0,3,0,3,1.0,0.0,1.0
210037,3,1,2,3,0,3,45,0,3.0,1.0,2.0,3.0,0.0,3.0,42.0,26,3,23,19.0,3.0,16.0
9409306,0,0,0,0,0,0,0,85,0.0,0.0,0.0,0.0,0.0,0.0,0.0,7,0,7,1.0,0.0,1.0
12200,1,1,0,0,1,0,0,133,0.0,0.0,0.0,0.0,0.0,0.0,0.0,6,1,5,2.0,0.0,2.0
9016,1,1,0,0,0,1,7,145,1.0,1.0,0.0,0.0,0.0,1.0,6.0,8,1,7,7.0,1.0,6.0
9611431,0,0,0,0,0,0,0,71,0.0,0.0,0.0,0.0,0.0,0.0,0.0,5,0,5,2.0,0.0,2.0
9806465,0,0,0,0,0,0,0,30,0.0,0.0,0.0,0.0,0.0,0.0,0.0,9,0,9,6.0,0.0,6.0
204276,0,0,0,0,0,0,0,1690,,,,,,,,2,0,2,,,
302223,0,0,0,0,0,0,0,98,,,,,,,,2,0,2,,,
9609304,1,1,0,0,1,0,0,12,0.0,0.0,0.0,0.0,0.0,0.0,0.0,11,1,10,2.0,0.0,2.0
9801325,2,2,0,0,0,2,7,14,1.0,1.0,0.0,0.0,0.0,1.0,2.0,9,2,7,4.0,0.0,4.0
8088,5,3,2,2,0,5,12,197,4.0,2.0,2.0,2.0,0.0,4.0,6.0,13,5,8,4.0,2.0,2.0
9503385,2,2,0,0,1,1,1,433,2.0,2.0,0.0,0.0,1.0,1.0,1.0,3,2,1,2.0,2.0,0.0
201012,1,1,0,0,0,1,2,0,0.0,0.0,0.0,0.0,0.0,0.0,0.0,19,1,18,7.0,0.0,7.0
211053,1,1,0,0,0,1,4,159,0.0,0.0,0.0,0.0,0.0,0.0,0.0,18,1,17,6.0,0.0,6.0
207363,1,1,0,0,0,1,15,92,1.0,1.0,0.0,0.0,0.0,1.0,9.0,26,1,25,12.0,1.0,11.0
102141,4,4,0,0,1,3,6,60,1.0,1.0,0.0,0.0,0.0,1.0,3.0,7,4,3,2.0,1.0,1.0
105081,1,1,0,0,1,0,0,1216,,,,,,,,1,1,0,,,
203108,5,2,3,4,0,5,113,18,4.0,1.0,3.0,4.0,0.0,4.0,94.0,47,5,42,24.0,4.0,20.0
110236,0,0,0,0,0,0,0,68,0.0,0.0,0.0,0.0,0.0,0.0,0.0,8,0,8,2.0,0.0,2.0
9310287,1,1,0,0,1,0,0,676,1.0,1.0,0.0,0.0,1.0,0.0,0.0,1,1,0,1.0,1.0,0.0
208037,0,0,0,0,0,0,0,20,,,,,,,,7,0,7,,,
9712474,3,3,0,0,1,2,4,204,2.0,2.0,0.0,0.0,0.0,2.0,4.0,11,3,8,6.0,1.0,5.0
204179,4,2,2,3,0,4,9,66,3.0,1.0,2.0,3.0,0.0,3.0,6.0,10,4,6,,,
9906410,2,1,1,1,0,2,5,105,2.0,1.0,1.0,1.0,0.0,2.0,4.0,8,2,6,5.0,2.0,3.0
207023,2,2,0,0,0,2,12,46,1.0,1.0,0.0,0.0,0.0,1.0,5.0,28,2,26,8.0,0.0,8.0
212304,3,3,0,0,0,3,58,7,1.0,1.0,0.0,0.0,0.0,1.0,18.0,200,3,197,48.0,1.0,47.0
9610482,0,0,0,0,0,0,0,422,0.0,0.0,0.0,0.0,0.0,0.0,0.0,7,0,7,1.0,0.0,1.0
9206201,4,2,2,2,4,0,0,103,3.0,2.0,1.0,1.0,3.0,0.0,0.0,4,4,0,4.0,4.0,0.0
209041,0,0,0,0,0,0,0,16,0.0,0.0,0.0,0.0,0.0,0.0,0.0,15,0,15,1.0,0.0,1.0
9911343,0,0,0,0,0,0,0,321,0.0,0.0,0.0,0.0,0.0,0.0,0.0,5,0,5,3.0,0.0,3.0
9611279,0,0,0,0,0,0,0,273,0.0,0.0,0.0,0.0,0.0,0.0,0.0,5,0,5,1.0,0.0,1.0
104092,0,0,0,0,0,0,0,3,0.0,0.0,0.0,0.0,0.0,0.0,0.0,27,0,27,4.0,0.0,4.0
212312,1,1,0,0,0,1,13,21,1.0,1.0,0.0,0.0,0.0,1.0,10.0,20,1,19,12.0,1.0,11.0
204175,4,3,1,2,0,4,16,226,3.0,2.0,1.0,2.0,0.0,3.0,8.0,14,4,10,7.0,3.0,4.0
208262,2,2,0,0,1,1,11,19,1.0,1.0,0.0,0.0,0.0,1.0,8.0,21,2,19,8.0,1.0,7.0
9412241,0,0,0,0,0,0,0,149,0.0,0.0,0.0,0.0,0.0,0.0,0.0,1,0,1,1.0,0.0,1.0
204220,0,0,0,0,0,0,0,3,0.0,0.0,0.0,0.0,0.0,0.0,0.0,10,0,10,1.0,0.0,1.0
9605248,1,1,0,0,0,1,1,366,1.0,1.0,0.0,0.0,1.0,0.0,0.0,8,1,7,4.0,0.0,4.0
9510454,2,2,0,0,0,2,2,1898,,,,,,,,3,2,1,,,
108196,3,3,0,0,1,2,3,137,0.0,0.0,0.0,0.0,0.0,0.0,0.0,10,3,7,2.0,2.0,0.0
111035,3,2,1,2,0,3,3,244,3.0,2.0,1.0,2.0,0.0,3.0,3.0,5,3,2,5.0,3.0,2.0
101094,1,1,0,0,0,1,1,388,0.0,0.0,0.0,0.0,0.0,0.0,0.0,7,1,6,2.0,0.0,2.0
5079,1,1,0,0,0,1,1,288,1.0,1.0,0.0,0.0,0.0,1.0,1.0,12,1,11,1.0,0.0,1.0
9910458,6,3,3,4,0,6,11,194,6.0,3.0,3.0,4.0,0.0,6.0,6.0,12,6,6,8.0,6.0,2.0
9809296,1,1,0,0,0,1,1,22,1.0,1.0,0.0,0.0,0.0,1.0,1.0,15,1,14,5.0,0.0,5.0
211007,3,3,0,0,0,3,24,14,2.0,2.0,0.0,0.0,0.0,2.0,13.0,34,3,31,13.0,0.0,13.0
209272,6,4,2,3,0,6,14,74,2.0,1.0,1.0,1.0,2.0,0.0,0.0,15,6,9,2.0,1.0,1.0
206263,3,3,0,0,1,2,2,31,1.0,1.0,0.0,0.0,1.0,0.0,0.0,6,3,3,3.0,2.0,1.0
9803318,1,1,0,0,0,1,3,55,0.0,0.0,0.0,0.0,0.0,0.0,0.0,19,1,18,4.0,0.0,4.0
204107,0,0,0,0,0,0,0,53,0.0,0.0,0.0,0.0,0.0,0.0,0.0,5,0,5,2.0,0.0,2.0
8317,4,4,0,0,0,4,27,31,4.0,4.0,0.0,0.0,0.0,4.0,20.0,14,4,10,6.0,3.0,3.0
9309327,1,1,0,0,1,0,0,458,1.0,1.0,0.0,0.0,1.0,0.0,0.0,2,1,1,1.0,0.0,1.0
9605244,0,0,0,0,0,0,0,1697,,,,,,,,1,0,1,,,
9505386,2,2,0,0,2,0,0,96,,,,,,,,2,2,0,,,
205217,2,1,1,1,2,0,0,328,0.0,0.0,0.0,0.0,0.0,0.0,0.0,5,2,3,3.0,0.0,3.0
109060,1,1,0,0,0,1,3,77,0.0,0.0,0.0,0.0,0.0,0.0,0.0,14,1,13,2.0,0.0,2.0
9910312,0,0,0,0,0,0,0,72,0.0,0.0,0.0,0.0,0.0,0.0,0.0,1,0,1,,,
201311,2,2,0,0,1,1,5,45,1.0,1.0,0.0,0.0,0.0,1.0,4.0,8,2,6,5.0,1.0,4.0
212061,0,0,0,0,0,0,0,45,0.0,0.0,0.0,0.0,0.0,0.0,0.0,17,0,17,5.0,0.0,5.0
105031,1,1,0,0,1,0,0,32,0.0,0.0,0.0,0.0,0.0,0.0,0.0,15,1,14,,,
212089,1,1,0,0,0,1,12,46,1.0,1.0,0.0,0.0,0.0,1.0,12.0,25,1,24,14.0,1.0,13.0
9805310,1,1,0,0,1,0,0,287,0.0,0.0,0.0,0.0,0.0,0.0,0.0,10,1,9,3.0,0.0,3.0
210434,1,1,0,0,1,0,0,27,0.0,0.0,0.0,0.0,0.0,0.0,0.0,6,1,5,5.0,0.0,5.0
9906302,0,0,0,0,0,0,0,16,0.0,0.0,0.0,0.0,0.0,0.0,0.0,7,0,7,1.0,0.0,1.0
109063,0,0,0,0,0,0,0,8,0.0,0.0,0.0,0.0,0.0,0.0,0.0,14,0,14,2.0,0.0,2.0
12078,3,3,0,0,0,3,14,12,0.0,0.0,0.0,0.0,0.0,0.0,0.0,23,3,20,3.0,1.0,2.0
302176,0,0,0,0,0,0,0,37,0.0,0.0,0.0,0.0,0.0,0.0,0.0,39,0,39,26.0,0.0,26.0
9708278,1,1,0,0,1,0,0,232,0.0,0.0,0.0,0.0,0.0,0.0,0.0,3,1,2,1.0,0.0,1.0
9903379,1,1,0,0,0,1,3,30,1.0,1.0,0.0,0.0,0.0,1.0,2.0,14,1,13,1.0,0.0,1.0
9610474,3,3,0,0,3,0,0,571,2.0,2.0,0.0,0.0,2.0,0.0,0.0,3,3,0,2.0,2.0,0.0
107312,4,4,0,0,0,4,10,9,3.0,3.0,0.0,0.0,0.0,3.0,3.0,21,4,17,2.0,1.0,1.0
112213,2,2,0,0,1,1,2,197,1.0,1.0,0.0,0.0,0.0,1.0,2.0,14,2,12,7.0,0.0,7.0
212098,1,1,0,0,0,1,5,79,0.0,0.0,0.0,0.0,0.0,0.0,0.0,23,1,22,5.0,0.0,5.0
9906328,2,2,0,0,0,2,4,314,2.0,2.0,0.0,0.0,0.0,2.0,4.0,7,2,5,5.0,2.0,3.0
11117,0,0,0,0,0,0,0,336,0.0,0.0,0.0,0.0,0.0,0.0,0.0,2,0,2,2.0,0.0,2.0
205213,0,0,0,0,0,0,0,1016,,,,,,,,2,0,2,,,
112026,1,1,0,0,0,1,2,887,,,,,,,,3,1,2,,,
5207,0,0,0,0,0,0,0,138,0.0,0.0,0.0,0.0,0.0,0.0,0.0,2,0,2,1.0,0.0,1.0
9503387,1,1,0,0,0,1,1,35,,,,,,,,2,1,1,,,
110188,2,2,0,0,0,2,20,2,1.0,1.0,0.0,0.0,0.0,1.0,14.0,34,2,32,17.0,1.0,16.0
210303,2,1,1,1,0,2,4,226,2.0,1.0,1.0,1.0,0.0,2.0,4.0,10,2,8,6.0,2.0,4.0
6273,5,1,4,10,0,5,28,66,5.0,1.0,4.0,10.0,0.0,5.0,12.0,15,5,10,7.0,5.0,2.0
9052,1,1,0,0,0,1,1,344,1.0,1.0,0.0,0.0,0.0,1.0,1.0,4,1,3,3.0,1.0,2.0
9802301,2,2,0,0,1,1,2,14,0.0,0.0,0.0,0.0,0.0,0.0,0.0,9,2,7,1.0,0.0,1.0
103349,1,1,0,0,1,0,0,438,1.0,1.0,0.0,0.0,1.0,0.0,0.0,2,1,1,2.0,1.0,1.0
9809317,0,0,0,0,0,0,0,15,0.0,0.0,0.0,0.0,0.0,0.0,0.0,9,0,9,3.0,0.0,3.0
302206,0,0,0,0,0,0,0,101,0.0,0.0,0.0,0.0,0.0,0.0,0.0,10,0,10,,,
111381,3,3,0,0,0,3,9,50,1.0,1.0,0.0,0.0,0.0,1.0,1.0,18,3,15,9.0,0.0,9.0
102011,1,1,0,0,1,0,0,18,0.0,0.0,0.0,0.0,0.0,0.0,0.0,12,1,11,,,
110347,2,1,1,1,0,2,4,375,2.0,1.0,1.0,1.0,0.0,2.0,4.0,4,2,2,4.0,2.0,2.0
9612466,2,2,0,0,1,1,1,266,2.0,2.0,0.0,0.0,1.0,1.0,1.0,3,2,1,2.0,2.0,0.0
9912387,3,3,0,0,0,3,9,99,0.0,0.0,0.0,0.0,0.0,0.0,0.0,19,3,16,4.0,0.0,4.0
9609268,0,0,0,0,0,0,0,17,0.0,0.0,0.0,0.0,0.0,0.0,0.0,26,0,26,21.0,0.0,21.0
112012,1,1,0,0,1,0,0,221,1.0,1.0,0.0,0.0,1.0,0.0,0.0,2,1,1,1.0,0.0,1.0
9609214,1,1,0,0,0,1,5,301,1.0,1.0,0.0,0.0,1.0,0.0,0.0,8,1,7,2.0,1.0,1.0
5277,1,1,0,0,1,0,0,109,0.0,0.0,0.0,0.0,0.0,0.0,0.0,9,1,8,1.0,0.0,1.0
211268,4,2,2,3,1,3,9,160,3.0,1.0,2.0,3.0,0.0,3.0,5.0,10,4,6,6.0,3.0,3.0
9711370,0,0,0,0,0,0,0,90,0.0,0.0,0.0,0.0,0.0,0.0,0.0,8,0,8,4.0,0.0,4.0
9409366,0,0,0,0,0,0,0,141,0.0,0.0,0.0,0.0,0.0,0.0,0.0,1,0,1,1.0,0.0,1.0
202229,1,1,0,0,0,1,7,206,1.0,1.0,0.0,0.0,0.0,1.0,5.0,9,1,8,6.0,1.0,5.0
9904289,0,0,0,0,0,0,0,199,0.0,0.0,0.0,0.0,0.0,0.0,0.0,2,0,2,,,
9911359,1,1,0,0,0,1,1,109,0.0,0.0,0.0,0.0,0.0,0.0,0.0,8,1,7,5.0,0.0,5.0
9709463,0,0,0,0,0,0,0,72,0.0,0.0,0.0,0.0,0.0,0.0,0.0,9,0,9,2.0,0.0,2.0
202146,0,0,0,0,0,0,0,27,0.0,0.0,0.0,0.0,0.0,0.0,0.0,15,0,15,5.0,0.0,5.0
102092,1,1,0,0,1,0,0,47,,,,,,,,2,1,1,1.0,1.0,0.0
9205226,1,1,0,0,1,0,0,630,1.0,1.0,0.0,0.0,1.0,0.0,0.0,1,1,0,1.0,1.0,0.0
112217,0,0,0,0,0,0,0,66,0.0,0.0,0.0,0.0,0.0,0.0,0.0,8,0,8,1.0,0.0,1.0
4230,3,3,0,0,0,3,6,21,0.0,0.0,0.0,0.0,0.0,0.0,0.0,41,3,38,25.0,0.0,25.0
9906543,2,2,0,0,0,2,10,13,2.0,2.0,0.0,0.0,0.0,2.0,10.0,21,2,19,7.0,0.0,7.0
9411391,0,0,0,0,0,0,0,796,0.0,0.0,0.0,0.0,0.0,0.0,0.0,2,0,2,1.0,0.0,1.0
12065,0,0,0,0,0,0,0,42,0.0,0.0,0.0,0.0,0.0,0.0,0.0,16,0,16,5.0,0.0,5.0
9602370,0,0,0,0,0,0,0,287,0.0,0.0,0.0,0.0,0.0,0.0,0.0,1,0,1,1.0,0.0,1.0
9604449,0,0,0,0,0,0,0,29,0.0,0.0,0.0,0.0,0.0,0.0,0.0,7,0,7,2.0,0.0,2.0
203152,2,1,1,1,2,0,0,1,0.0,0.0,0.0,0.0,0.0,0.0,0.0,22,2,20,4.0,0.0,4.0
109203,1,1,0,0,0,1,1,36,1.0,1.0,0.0,0.0,1.0,0.0,0.0,19,1,18,6.0,1.0,5.0
9405319,0,0,0,0,0,0,0,15,0.0,0.0,0.0,0.0,0.0,0.0,0.0,15,0,15,1.0,0.0,1.0
212174,0,0,0,0,0,0,0,1618,,,,,,,,1,0,1,,,
9808226,1,1,0,0,0,1,2,6,1.0,1.0,0.0,0.0,0.0,1.0,2.0,5,1,4,4.0,1.0,3.0
9912486,1,1,0,0,0,1,3,258,1.0,1.0,0.0,0.0,0.0,1.0,3.0,6,1,5,5.0,1.0,4.0
9704365,1,1,0,0,1,0,0,143,0.0,0.0,0.0,0.0,0.0,0.0,0.0,4,1,3,1.0,1.0,0.0
9612382,0,0,0,0,0,0,0,110,0.0,0.0,0.0,0.0,0.0,0.0,0.0,7,0,7,4.0,0.0,4.0
2200,3,3,0,0,0,3,4,117,2.0,2.0,0.0,0.0,2.0,0.0,0.0,9,3,6,3.0,1.0,2.0
111261,2,2,0,0,0,2,5,64,0.0,0.0,0.0,0.0,0.0,0.0,0.0,17,2,15,7.0,0.0,7.0
211311,0,0,0,0,0,0,0,23,0.0,0.0,0.0,0.0,0.0,0.0,0.0,9,0,9,3.0,0.0,3.0
211149,0,0,0,0,0,0,0,415,0.0,0.0,0.0,0.0,0.0,0.0,0.0,5,0,5,1.0,0.0,1.0
210006,0,0,0,0,0,0,0,189,0.0,0.0,0.0,0.0,0.0,0.0,0.0,7,0,7,1.0,0.0,1.0
108259,2,2,0,0,0,2,4,199,2.0,2.0,0.0,0.0,0.0,2.0,3.0,5,2,3,3.0,2.0,1.0
9712295,0,0,0,0,0,0,0,97,0.0,0.0,0.0,0.0,0.0,0.0,0.0,3,0,3,,,
9072,4,4,0,0,0,4,18,9,1.0,1.0,0.0,0.0,0.0,1.0,1.0,12,4,8,,,
208056,1,1,0,0,0,1,5,43,0.0,0.0,0.0,0.0,0.0,0.0,0.0,19,1,18,13.0,0.0,13.0
5091,1,1,0,0,0,1,4,103,1.0,1.0,0.0,0.0,0.0,1.0,4.0,8,1,7,6.0,1.0,5.0
211335,3,2,1,1,2,1,6,26,0.0,0.0,0.0,0.0,0.0,0.0,0.0,51,3,48,16.0,0.0,16.0
2251,1,1,0,0,0,1,1,786,1.0,1.0,0.0,0.0,0.0,1.0,1.0,2,1,1,1.0,1.0,0.0
101228,0,0,0,0,0,0,0,250,0.0,0.0,0.0,0.0,0.0,0.0,0.0,3,0,3,1.0,0.0,1.0
1221,0,0,0,0,0,0,0,513,0.0,0.0,0.0,0.0,0.0,0.0,0.0,3,0,3,1.0,0.0,1.0
6308,0,0,0,0,0,0,0,190,0.0,0.0,0.0,0.0,0.0,0.0,0.0,8,0,8,2.0,0.0,2.0
9703426,0,0,0,0,0,0,0,10,0.0,0.0,0.0,0.0,0.0,0.0,0.0,16,0,16,8.0,0.0,8.0
11199,0,0,0,0,0,0,0,299,0.0,0.0,0.0,0.0,0.0,0.0,0.0,8,0,8,3.0,0.0,3.0
9705285,0,0,0,0,0,0,0,137,0.0,0.0,0.0,0.0,0.0,0.0,0.0,7,0,7,6.0,0.0,6.0
9905556,0,0,0,0,0,0,0,180,0.0,0.0,0.0,0.0,0.0,0.0,0.0,7,0,7,5.0,0.0,5.0
112064,0,0,0,0,0,0,0,76,0.0,0.0,0.0,0.0,0.0,0.0,0.0,13,0,13,9.0,0.0,9.0
110042,0,0,0,0,0,0,0,76,0.0,0.0,0.0,0.0,0.0,0.0,0.0,3,0,3,1.0,0.0,1.0
111062,1,1,0,0,1,0,0,269,0.0,0.0,0.0,0.0,0.0,0.0,0.0,5,1,4,3.0,0.0,3.0
9705256,0,0,0,0,0,0,0,183,0.0,0.0,0.0,0.0,0.0,0.0,0.0,8,0,8,3.0,0.0,3.0
9901434,0,0,0,0,0,0,0,21,0.0,0.0,0.0,0.0,0.0,0.0,0.0,7,0,7,,,
9907459,0,0,0,0,0,0,0,216,0.0,0.0,0.0,0.0,0.0,0.0,0.0,8,0,8,3.0,0.0,3.0
9406240,0,0,0,0,0,0,0,341,0.0,0.0,0.0,0.0,0.0,0.0,0.0,4,0,4,3.0,0.0,3.0
207024,1,1,0,0,0,1,6,312,1.0,1.0,0.0,0.0,0.0,1.0,6.0,7,1,6,6.0,1.0,5.0
209024,1,1,0,0,0,1,9,66,1.0,1.0,0.0,0.0,0.0,1.0,5.0,12,1,11,4.0,0.0,4.0
210440,0,0,0,0,0,0,0,257,0.0,0.0,0.0,0.0,0.0,0.0,0.0,2,0,2,,,
9307346,1,1,0,0,1,0,0,207,1.0,1.0,0.0,0.0,1.0,0.0,0.0,1,1,0,1.0,1.0,0.0
9807409,2,1,1,1,0,2,11,162,2.0,1.0,1.0,1.0,0.0,2.0,9.0,18,2,16,7.0,1.0,6.0
5047,1,1,0,0,1,0,0,788,1.0,1.0,0.0,0.0,1.0,0.0,0.0,1,1,0,1.0,1.0,0.0
1263,1,1,0,0,0,1,2,142,1.0,1.0,0.0,0.0,0.0,1.0,1.0,3,1,2,3.0,1.0,2.0
1105,2,2,0,0,0,2,4,14,0.0,0.0,0.0,0.0,0.0,0.0,0.0,12,2,10,2.0,0.0,2.0
212011,0,0,0,0,0,0,0,27,0.0,0.0,0.0,0.0,0.0,0.0,0.0,12,0,12,5.0,0.0,5.0
9805504,1,1,0,0,0,1,7,57,1.0,1.0,0.0,0.0,0.0,1.0,5.0,22,1,21,7.0,1.0,6.0
11369,0,0,0,0,0,0,0,3,0.0,0.0,0.0,0.0,0.0,0.0,0.0,22,0,22,4.0,0.0,4.0
212403,0,0,0,0,0,0,0,146,0.0,0.0,0.0,0.0,0.0,0.0,0.0,5,0,5,,,
109185,0,0,0,0,0,0,0,144,0.0,0.0,0.0,0.0,0.0,0.0,0.0,7,0,7,5.0,0.0,5.0
301278,0,0,0,0,0,0,0,12,0.0,0.0,0.0,0.0,0.0,0.0,0.0,42,0,42,5.0,0.0,5.0
10333,0,0,0,0,0,0,0,11,0.0,0.0,0.0,0.0,0.0,0.0,0.0,6,0,6,,,
208099,0,0,0,0,0,0,0,463,0.0,0.0,0.0,0.0,0.0,0.0,0.0,7,0,7,3.0,0.0,3.0
9511393,0,0,0,0,0,0,0,1611,0.0,0.0,0.0,0.0,0.0,0.0,0.0,3,0,3,1.0,0.0,1.0
9906258,0,0,0,0,0,0,0,38,,,,,,,,2,0,2,,,
9507243,0,0,0,0,0,0,0,1121,,,,,,,,5,0,5,1.0,0.0,1.0
9212251,0,0,0,0,0,0,0,200,,,,,,,,1,0,1,,,
9905335,2,1,1,1,1,1,1,25,2.0,1.0,1.0,1.0,1.0,1.0,1.0,16,2,14,2.0,0.0,2.0
9807296,0,0,0,0,0,0,0,154,0.0,0.0,0.0,0.0,0.0,0.0,0.0,17,0,17,5.0,0.0,5.0
301185,1,1,0,0,0,1,4,244,1.0,1.0,0.0,0.0,0.0,1.0,4.0,10,1,9,7.0,1.0,6.0
9407240,0,0,0,0,0,0,0,116,,,,,,,,4,0,4,,,
9305330,0,0,0,0,0,0,0,523,0.0,0.0,0.0,0.0,0.0,0.0,0.0,3,0,3,1.0,0.0,1.0
9510432,2,1,1,1,2,0,0,280,1.0,1.0,0.0,0.0,1.0,0.0,0.0,6,2,4,1.0,0.0,1.0
106028,0,0,0,0,0,0,0,285,0.0,0.0,0.0,0.0,0.0,0.0,0.0,2,0,2,1.0,0.0,1.0
9505367,1,1,0,0,1,0,0,716,1.0,1.0,0.0,0.0,1.0,0.0,0.0,1,1,0,1.0,1.0,0.0
9804203,0,0,0,0,0,0,0,15,0.0,0.0,0.0,0.0,0.0,0.0,0.0,9,0,9,,,
111275,3,1,2,2,0,3,6,228,3.0,1.0,2.0,2.0,0.0,3.0,5.0,6,3,3,4.0,2.0,2.0
9702347,1,1,0,0,0,1,1,382,1.0,1.0,0.0,0.0,0.0,1.0,1.0,3,1,2,3.0,1.0,2.0
9707479,1,1,0,0,0,1,1,434,1.0,1.0,0.0,0.0,0.0,1.0,1.0,4,1,3,2.0,1.0,1.0
9805491,0,0,0,0,0,0,0,233,0.0,0.0,0.0,0.0,0.0,0.0,0.0,2,0,2,1.0,0.0,1.0
211067,2,2,0,0,1,1,3,33,1.0,1.0,0.0,0.0,1.0,0.0,0.0,11,2,9,1.0,1.0,0.0
9803414,1,1,0,0,0,1,2,123,1.0,1.0,0.0,0.0,0.0,1.0,1.0,7,1,6,3.0,0.0,3.0
7214,0,0,0,0,0,0,0,299,0.0,0.0,0.0,0.0,0.0,0.0,0.0,4,0,4,,,
9901284,0,0,0,0,0,0,0,130,0.0,0.0,0.0,0.0,0.0,0.0,0.0,46,0,46,16.0,0.0,16.0
210202,2,2,0,0,0,2,32,21,1.0,1.0,0.0,0.0,0.0,1.0,21.0,30,2,28,4.0,1.0,3.0
9407364,0,0,0,0,0,0,0,647,0.0,0.0,0.0,0.0,0.0,0.0,0.0,1,0,1,1.0,0.0,1.0
9305313,0,0,0,0,0,0,0,302,0.0,0.0,0.0,0.0,0.0,0.0,0.0,1,0,1,1.0,0.0,1.0
10179,0,0,0,0,0,0,0,1782,,,,,,,,6,0,6,5.0,0.0,5.0
9804369,5,1,4,7,0,5,11,125,5.0,1.0,4.0,7.0,0.0,5.0,11.0,9,5,4,9.0,5.0,4.0
9909545,0,0,0,0,0,0,0,24,0.0,0.0,0.0,0.0,0.0,0.0,0.0,15,0,15,1.0,0.0,1.0
9905370,0,0,0,0,0,0,0,274,0.0,0.0,0.0,0.0,0.0,0.0,0.0,5,0,5,2.0,0.0,2.0
9602222,0,0,0,0,0,0,0,200,0.0,0.0,0.0,0.0,0.0,0.0,0.0,4,0,4,4.0,0.0,4.0
9706433,0,0,0,0,0,0,0,35,0.0,0.0,0.0,0.0,0.0,0.0,0.0,12,0,12,4.0,0.0,4.0
9908215,0,0,0,0,0,0,0,115,0.0,0.0,0.0,0.0,0.0,0.0,0.0,13,0,13,1.0,0.0,1.0
110322,0,0,0,0,0,0,0,784,0.0,0.0,0.0,0.0,0.0,0.0,0.0,9,0,9,1.0,0.0,1.0
11219,0,0,0,0,0,0,0,259,0.0,0.0,0.0,0.0,0.0,0.0,0.0,2,0,2,1.0,0.0,1.0
207029,0,0,0,0,0,0,0,64,0.0,0.0,0.0,0.0,0.0,0.0,0.0,5,0,5,1.0,0.0,1.0
9903278,0,0,0,0,0,0,0,219,0.0,0.0,0.0,0.0,0.0,0.0,0.0,2,0,2,2.0,0.0,2.0
9804350,0,0,0,0,0,0,0,8,0.0,0.0,0.0,0.0,0.0,0.0,0.0,20,0,20,4.0,0.0,4.0
9812227,0,0,0,0,0,0,0,246,0.0,0.0,0.0,0.0,0.0,0.0,0.0,4,0,4,3.0,0.0,3.0
9508329,0,0,0,0,0,0,0,99,0.0,0.0,0.0,0.0,0.0,0.0,0.0,11,0,11,1.0,0.0,1.0
110074,0,0,0,0,0,0,0,195,0.0,0.0,0.0,0.0,0.0,0.0,0.0,12,0,12,6.0,0.0,6.0
210081,0,0,0,0,0,0,0,107,0.0,0.0,0.0,0.0,0.0,0.0,0.0,12,0,12,1.0,0.0,1.0
111438,0,0,0,0,0,0,0,97,0.0,0.0,0.0,0.0,0.0,0.0,0.0,5,0,5,2.0,0.0,2.0
111235,0,0,0,0,0,0,0,1,0.0,0.0,0.0,0.0,0.0,0.0,0.0,15,0,15,6.0,0.0,6.0
207132,0,0,0,0,0,0,0,146,0.0,0.0,0.0,0.0,0.0,0.0,0.0,5,0,5,1.0,0.0,1.0
208252,0,0,0,0,0,0,0,9,0.0,0.0,0.0,0.0,0.0,0.0,0.0,7,0,7,,,
9608216,0,0,0,0,0,0,0,1800,0.0,0.0,0.0,0.0,0.0,0.0,0.0,3,0,3,1.0,0.0,1.0
211452,0,0,0,0,0,0,0,246,0.0,0.0,0.0,0.0,0.0,0.0,0.0,5,0,5,1.0,0.0,1.0
9612395,0,0,0,0,0,0,0,94,0.0,0.0,0.0,0.0,0.0,0.0,0.0,12,0,12,8.0,0.0,8.0
9706483,0,0,0,0,0,0,0,990,,,,,,,,1,0,1,,,
301198,0,0,0,0,0,0,0,74,0.0,0.0,0.0,0.0,0.0,0.0,0.0,10,0,10,2.0,0.0,2.0
9508404,0,0,0,0,0,0,0,237,0.0,0.0,0.0,0.0,0.0,0.0,0.0,8,0,8,4.0,0.0,4.0
9807562,0,0,0,0,0,0,0,291,0.0,0.0,0.0,0.0,0.0,0.0,0.0,4,0,4,1.0,0.0,1.0
9608367,0,0,0,0,0,0,0,30,,,,,,,,5,0,5,1.0,0.0,1.0
107213,0,0,0,0,0,0,0,1234,,,,,,,,5,0,5,,,
210225,0,0,0,0,0,0,0,12,0.0,0.0,0.0,0.0,0.0,0.0,0.0,13,0,13,10.0,0.0,10.0
112056,0,0,0,0,0,0,0,126,0.0,0.0,0.0,0.0,0.0,0.0,0.0,12,0,12,6.0,0.0,6.0
9401292,0,0,0,0,0,0,0,526,0.0,0.0,0.0,0.0,0.0,0.0,0.0,1,0,1,1.0,0.0,1.0
207283,2,2,0,0,1,1,1,302,0.0,0.0,0.0,0.0,0.0,0.0,0.0,5,2,3,2.0,1.0,1.0
102220,0,0,0,0,0,0,0,157,0.0,0.0,0.0,0.0,0.0,0.0,0.0,12,0,12,2.0,0.0,2.0
9801389,1,1,0,0,1,0,0,726,1.0,1.0,0.0,0.0,1.0,0.0,0.0,1,1,0,1.0,1.0,0.0
9604427,0,0,0,0,0,0,0,41,0.0,0.0,0.0,0.0,0.0,0.0,0.0,8,0,8,4.0,0.0,4.0
9911208,1,1,0,0,0,1,1,158,0.0,0.0,0.0,0.0,0.0,0.0,0.0,5,1,4,2.0,1.0,1.0
210421,0,0,0,0,0,0,0,101,0.0,0.0,0.0,0.0,0.0,0.0,0.0,5,0,5,4.0,0.0,4.0
9611257,0,0,0,0,0,0,0,8,0.0,0.0,0.0,0.0,0.0,0.0,0.0,3,0,3,3.0,0.0,3.0
106007,0,0,0,0,0,0,0,1,0.0,0.0,0.0,0.0,0.0,0.0,0.0,24,0,24,8.0,0.0,8.0
9312314,0,0,0,0,0,0,0,323,0.0,0.0,0.0,0.0,0.0,0.0,0.0,3,0,3,2.0,0.0,2.0
9609335,0,0,0,0,0,0,0,1006,,,,,,,,1,0,1,,,
9312285,0,0,0,0,0,0,0,1856,,,,,,,,1,0,1,,,
9405354,0,0,0,0,0,0,0,75,,,,,,,,3,0,3,2.0,0.0,2.0
210283,2,1,1,1,0,2,41,109,2.0,1.0,1.0,1.0,0.0,2.0,37.0,27,2,25,21.0,2.0,19.0
9306261,0,0,0,0,0,0,0,1531,,,,,,,,1,0,1,,,
9405402,0,0,0,0,0,0,0,332,0.0,0.0,0.0,0.0,0.0,0.0,0.0,4,0,4,4.0,0.0,4.0
9909507,0,0,0,0,0,0,0,11,0.0,0.0,0.0,0.0,0.0,0.0,0.0,12,0,12,2.0,0.0,2.0
9802349,0,0,0,0,0,0,0,148,0.0,0.0,0.0,0.0,0.0,0.0,0.0,5,0,5,2.0,0.0,2.0
9702288,0,0,0,0,0,0,0,21,0.0,0.0,0.0,0.0,0.0,0.0,0.0,5,0,5,4.0,0.0,4.0
107253,0,0,0,0,0,0,0,1063,0.0,0.0,0.0,0.0,0.0,0.0,0.0,5,0,5,1.0,0.0,1.0
9810335,0,0,0,0,0,0,0,416,0.0,0.0,0.0,0.0,0.0,0.0,0.0,3,0,3,1.0,0.0,1.0
9504339,0,0,0,0,0,0,0,94,0.0,0.0,0.0,0.0,0.0,0.0,0.0,14,0,14,7.0,0.0,7.0
9811317,0,0,0,0,0,0,0,79,0.0,0.0,0.0,0.0,0.0,0.0,0.0,7,0,7,5.0,0.0,5.0
9709384,1,1,0,0,0,1,2,88,1.0,1.0,0.0,0.0,0.0,1.0,1.0,3,1,2,2.0,1.0,1.0
9912389,0,0,0,0,0,0,0,116,0.0,0.0,0.0,0.0,0.0,0.0,0.0,4,0,4,4.0,0.0,4.0
301211,0,0,0,0,0,0,0,119,0.0,0.0,0.0,0.0,0.0,0.0,0.0,19,0,19,10.0,0.0,10.0
106349,0,0,0,0,0,0,0,110,0.0,0.0,0.0,0.0,0.0,0.0,0.0,3,0,3,2.0,0.0,2.0
4174,0,0,0,0,0,0,0,115,0.0,0.0,0.0,0.0,0.0,0.0,0.0,6,0,6,1.0,0.0,1.0
9504298,0,0,0,0,0,0,0,199,0.0,0.0,0.0,0.0,0.0,0.0,0.0,1,0,1,1.0,0.0,1.0
9503287,0,0,0,0,0,0,0,355,0.0,0.0,0.0,0.0,0.0,0.0,0.0,5,0,5,1.0,0.0,1.0
202215,0,0,0,0,0,0,0,24,0.0,0.0,0.0,0.0,0.0,0.0,0.0,29,0,29,9.0,0.0,9.0
211319,0,0,0,0,0,0,0,5,0.0,0.0,0.0,0.0,0.0,0.0,0.0,33,0,33,18.0,0.0,18.0
204114,0,0,0,0,0,0,0,2090,0.0,0.0,0.0,0.0,0.0,0.0,0.0,1,0,1,1.0,0.0,1.0
301168,0,0,0,0,0,0,0,1936,,,,,,,,7,0,7,2.0,0.0,2.0
205309,0,0,0,0,0,0,0,157,0.0,0.0,0.0,0.0,0.0,0.0,0.0,12,0,12,4.0,0.0,4.0
9905553,1,1,0,0,0,1,1,218,1.0,1.0,0.0,0.0,0.0,1.0,1.0,3,1,2,1.0,1.0,0.0
9708475,0,0,0,0,0,0,0,134,,,,,,,,4,0,4,,,
9503389,1,1,0,0,1,0,0,163,0.0,0.0,0.0,0.0,0.0,0.0,0.0,5,1,4,4.0,0.0,4.0
9206234,1,1,0,0,1,0,0,409,1.0,1.0,0.0,0.0,1.0,0.0,0.0,1,1,0,1.0,1.0,0.0
9806500,0,0,0,0,0,0,0,1389,0.0,0.0,0.0,0.0,0.0,0.0,0.0,2,0,2,1.0,0.0,1.0
301215,0,0,0,0,0,0,0,18,0.0,0.0,0.0,0.0,0.0,0.0,0.0,6,0,6,2.0,0.0,2.0
9601253,0,0,0,0,0,0,0,1213,,,,,,,,1,0,1,1.0,0.0,1.0
9904381,0,0,0,0,0,0,0,4,0.0,0.0,0.0,0.0,0.0,0.0,0.0,16,0,16,3.0,0.0,3.0
104249,0,0,0,0,0,0,0,20,0.0,0.0,0.0,0.0,0.0,0.0,0.0,26,0,26,5.0,0.0,5.0
211295,0,0,0,0,0,0,0,163,0.0,0.0,0.0,0.0,0.0,0.0,0.0,12,0,12,5.0,0.0,5.0
301083,0,0,0,0,0,0,0,738,0.0,0.0,0.0,0.0,0.0,0.0,0.0,1,0,1,1.0,0.0,1.0
111242,0,0,0,0,0,0,0,41,0.0,0.0,0.0,0.0,0.0,0.0,0.0,19,0,19,8.0,0.0,8.0
9809542,0,0,0,0,0,0,0,70,0.0,0.0,0.0,0.0,0.0,0.0,0.0,8,0,8,,,
9906350,0,0,0,0,0,0,0,26,0.0,0.0,0.0,0.0,0.0,0.0,0.0,6,0,6,3.0,0.0,3.0
211278,0,0,0,0,0,0,0,740,0.0,0.0,0.0,0.0,0.0,0.0,0.0,1,0,1,1.0,0.0,1.0
302083,0,0,0,0,0,0,0,2,0.0,0.0,0.0,0.0,0.0,0.0,0.0,34,0,34,15.0,0.0,15.0
302001,0,0,0,0,0,0,0,2,0.0,0.0,0.0,0.0,0.0,0.0,0.0,17,0,17,10.0,0.0,10.0
112087,0,0,0,0,0,0,0,85,0.0,0.0,0.0,0.0,0.0,0.0,0.0,8,0,8,1.0,0.0,1.0
207060,0,0,0,0,0,0,0,282,0.0,0.0,0.0,0.0,0.0,0.0,0.0,13,0,13,4.0,0.0,4.0
9708318,0,0,0,0,0,0,0,170,0.0,0.0,0.0,0.0,0.0,0.0,0.0,4,0,4,3.0,0.0,3.0
9609406,0,0,0,0,0,0,0,132,0.0,0.0,0.0,0.0,0.0,0.0,0.0,2,0,2,,,
9508364,0,0,0,0,0,0,0,960,,,,,,,,2,0,2,,,
9910386,0,0,0,0,0,0,0,180,0.0,0.0,0.0,0.0,0.0,0.0,0.0,2,0,2,1.0,0.0,1.0
203274,0,0,0,0,0,0,0,2020,,,,,,,,5,0,5,,,
9506429,0,0,0,0,0,0,0,148,0.0,0.0,0.0,0.0,0.0,0.0,0.0,2,0,2,,,
302215,0,0,0,0,0,0,0,2,0.0,0.0,0.0,0.0,0.0,0.0,0.0,10,0,10,9.0,0.0,9.0
301164,0,0,0,0,0,0,0,76,0.0,0.0,0.0,0.0,0.0,0.0,0.0,3,0,3,,,
